12 12
@ @ @ @ @ @ @ @ @ @ @ @ 
@ . . @ @ @ . . @ @ @ @ 
@ . @ . @ . @ . @ @ @ @ 
@ . . . . . . . . . @ @ 
@ @ @ . @ . @ . @ @ . @ 
@ . . . . @ . . @ . . @ 
@ @ @ . @ @ @ . . . @ @ 
@ @ @ @ . . . . @ @ . @ 
@ @ @ @ @ . @ . . . . @ 
@ @ @ @ @ @ . . @ . @ @ 
@ @ @ @ @ @ @ . . @ @ @ 
@ @ @ @ @ @ @ @ @ @ @ @ 
3
6 3 4 3
3 2 4 10
2 1 7 6
