20 20
@ @ @ @ @ @ @ @ @ @ @ @ @ @ @ @ @ @ @ @ 
@ @ . . . . . . . @ @ @ @ . . @ @ @ @ @ 
@ . . @ . @ . @ . @ @ @ . . @ @ @ @ @ @ 
@ @ @ . @ . @ . . . @ @ @ . @ @ @ . @ @ 
@ @ @ . @ . . @ . @ . @ . . . @ . . . @ 
@ @ . . . . @ @ . . . . @ . @ . @ . @ @ 
@ . @ . @ @ @ . . @ @ . . . . . . . . @ 
@ . . . . . . . @ . . . @ @ . @ . @ . @ 
@ . @ . @ . @ . . @ @ @ @ @ @ . . @ . @ 
@ . . @ . . . @ . . @ @ @ @ . @ . . @ @ 
@ . @ @ @ . @ . . @ . @ @ @ . . . @ . @ 
@ . @ @ @ @ . @ . . . . . @ @ @ . . . @ 
@ @ @ . @ . . . . @ . @ . @ . . . @ @ @ 
@ . . . . @ . @ . . @ . @ @ @ . @ @ @ @ 
@ . @ @ @ @ @ . . @ . . . . . . @ @ @ @ 
@ . . . . . . @ . . @ @ . @ @ . @ @ @ @ 
@ . @ . @ @ . . . @ . . @ @ . . @ @ @ @ 
@ @ @ @ @ . @ . @ . @ . @ . @ @ . . @ @ 
@ @ @ . . . . . . . . . . . . . . @ @ @ 
@ @ @ @ @ @ @ @ @ @ @ @ @ @ @ @ @ @ @ @ 
3
5 3 12 3
17 11 4 12
17 17 8 1
