100 100
@ @ @ @ @ @ @ @ @ @ @ @ @ @ @ @ @ @ @ @ @ @ @ @ @ @ @ @ @ @ @ @ @ @ @ @ @ @ @ @ @ @ @ @ @ @ @ @ @ @ @ @ @ @ @ @ @ @ @ @ @ @ @ @ @ @ @ @ @ @ @ @ @ @ @ @ @ @ @ @ @ @ @ @ @ @ @ @ @ @ @ @ @ @ @ @ @ @ @ @ 
@ @ @ @ . @ . @ @ @ @ @ . . @ @ @ @ @ @ @ @ @ @ . @ . @ . . . . . . . . @ . @ @ @ @ @ @ @ @ @ . @ . . @ . @ . . . @ @ . . . . @ @ @ . . @ @ @ @ @ @ @ @ @ @ @ . . . @ . @ . @ . . @ @ @ . . . . @ @ @ @ 
@ @ @ . . . . . @ . . . . @ @ @ @ @ @ @ @ @ @ . . @ . . @ . @ . @ . @ . . . . @ @ @ @ @ @ . . . . . @ . . . @ . @ . . @ . @ @ . @ . @ . . @ @ @ @ @ @ @ @ @ @ @ . @ . . . . . @ . @ @ @ @ @ . @ . @ @ @ 
@ @ . @ . @ . @ . . @ @ @ @ . @ @ @ @ @ @ @ . @ . @ . @ @ . . @ . . @ @ . @ . . @ @ . . . . @ . @ @ . @ . @ . . . . @ . . @ . . . . . @ . . @ @ @ @ . @ @ @ @ . . . @ . @ @ @ . . . @ . . . . . . @ @ @ 
@ . . . . . @ . . @ . @ . @ . @ @ @ @ @ @ @ . . . . . @ . @ @ @ . @ . @ @ @ . @ . . @ . @ . . @ @ . . . . . . @ . @ . @ . . @ . @ . @ . . @ . . @ . . . @ @ @ @ @ . . . . . @ . @ @ . . @ . @ . @ @ @ @ 
@ . @ . @ . . @ . . . . . . . . @ @ @ . . . @ . @ @ . . . . @ @ @ . . . . @ . . @ . . @ . . @ @ @ @ . @ . @ @ . @ . . . . @ . . @ @ . @ . @ @ . . @ . @ @ @ @ . . . @ . @ . . . . . . @ @ @ @ @ @ . @ @ 
@ @ . @ . @ . @ @ @ . @ @ . @ @ @ . . @ @ . . @ @ . @ @ . @ . @ @ @ . @ @ . . @ . @ . @ . @ @ @ @ @ @ . . . @ . @ @ . @ . @ . @ . . . . . . @ . @ . . @ . @ . @ @ . . @ . . @ . @ . @ . @ . @ . . . . @ 
@ @ . . . . . . . . . . . @ @ @ . @ . @ @ . @ @ . . . @ . . . . @ . . . . @ . . . . . . . . . @ . @ @ @ . @ . . . @ @ . . . . @ . @ . @ @ @ . . . @ . @ . . . . . . @ . @ . . @ @ . . . . . . @ . @ @ @ 
@ . . @ @ @ @ @ . @ . @ . @ . . . @ . . . . . . @ . @ . . @ . @ @ @ . @ . @ . @ . @ @ @ . @ @ . . . @ @ . . . @ @ . . @ @ . @ . @ . . . @ @ . @ @ . . . @ @ . @ @ . . . . @ . . @ . @ . @ @ . . . @ . @ 
@ . @ . . . . @ @ . . @ @ . @ @ . . @ @ . @ @ . . . . @ . @ . . @ @ @ . . . . . @ @ @ . @ . @ @ . @ . @ . @ @ . @ . @ @ . . . . . @ @ . @ . . @ . @ . @ . . @ . . . @ @ . @ @ @ @ @ @ @ . . . @ . . . @ 
@ @ . @ @ @ . @ . @ . . . . @ @ @ . @ . @ . @ . @ @ . @ . . @ . @ . . @ @ . @ . . @ . . . . . . . . . . . . @ . . . . @ . @ . @ @ . @ . . @ . @ . . . @ @ . . @ @ . . . @ . @ . @ . @ . @ @ . . @ . @ @ 
@ . . . @ @ . . . . @ @ @ . . . . . @ . . . @ @ @ . . . @ . . @ . @ . @ @ . . @ @ . @ . @ . @ @ . @ . @ . @ @ . @ . @ . . @ @ @ @ . . . @ . . . @ @ . . . @ . @ . . @ . . . . . . . . . . @ @ . @ . . @ 
@ @ @ . @ . @ @ . @ . . . . @ . @ . . @ @ . . . @ @ . @ . . @ @ . . . . . @ . . @ . . . . @ @ . . @ @ . . . . @ @ . . @ . . @ @ . . @ . @ . @ . @ . @ @ . @ . . @ . . @ @ @ . @ @ . @ . @ . . @ @ @ @ @ 
@ @ . . . . . . . . @ @ @ @ @ @ @ @ . @ . @ . @ @ . . . @ . . @ @ @ @ . @ . . @ . . @ . @ . @ @ @ . . @ @ . @ @ . @ . . . @ @ @ @ . . @ . . . @ @ . @ . . @ @ . . . @ . . @ @ @ @ @ @ @ @ @ . . . . . @ 
@ @ @ . @ @ @ @ . @ . . @ . . @ . @ . . . . . @ . @ . @ . @ . . @ . . . . @ . . @ . . @ . . . . . @ . . @ . @ . . . @ @ . @ . . . . @ @ @ . @ . @ . . @ . @ . @ @ . . . @ . . @ @ @ @ . @ . . @ . @ @ @ 
@ @ @ @ @ @ . . . . . @ . . @ . . . . @ @ @ . . . . . . . . . @ . @ . @ . @ . @ . . @ @ @ . @ @ @ @ @ . @ @ @ @ @ . @ . . @ . @ @ . . @ . . . . . @ . . . @ . @ . . @ . . . @ . @ @ . . . @ . . @ . . @ 
@ @ @ @ @ @ @ . @ . @ . @ . . @ @ . @ . . . . @ . @ . @ . @ . @ . . @ . . . . @ @ . . @ . . . @ . @ . . @ . @ @ . . . @ . . @ . @ . @ @ @ . @ @ . . @ @ . @ . @ @ . @ . @ . @ . . . @ . @ @ . @ . @ . @ 
@ @ @ @ @ @ @ @ . . . . . @ . @ @ @ . @ . @ . @ @ . @ @ @ . . . . @ . . @ @ . . @ . @ . @ . @ . . . @ . . . . @ @ @ . . . @ . . . . . @ . . . . @ . @ . . . . . . @ @ . @ . @ . @ . @ . @ . . . . . . @ 
@ @ . @ . @ @ . @ @ . @ . . . . @ @ . . @ . @ @ . . @ @ @ @ . @ @ . @ . @ . . @ . . @ . . . @ @ . @ . @ . @ . . . @ . @ . @ @ @ @ . @ . @ . @ @ . @ . @ @ . @ . @ @ . . . @ . . . @ . . . @ . @ @ . @ @ 
@ . . . . . . . . . @ . @ . @ . . @ . @ . . @ . @ . . @ @ . . . @ . . @ . . @ . @ . . . @ @ . . . . . . @ @ . @ @ . @ . . . @ @ . . . . . . . . . @ . . @ . @ @ @ . @ . @ . @ . @ @ @ . @ . . @ @ . @ @ 
@ . @ . @ . @ . @ @ . . @ . @ . @ . . . @ . . . . . @ . . . @ . . @ . . @ . @ . . . @ . . . @ @ . @ @ @ . . . . @ . . @ . @ . . @ . @ @ . @ @ @ @ @ @ . @ . @ @ . . . . . . . . . @ . . . @ . . @ . . @ 
@ @ @ . . @ . . @ @ @ . . @ . . @ @ . @ . . @ . @ . @ . @ . @ @ . . @ . . . @ . @ . @ . @ @ . @ . . @ . . @ . @ . @ . @ . . @ . . . . @ . @ @ @ @ @ @ . . . . . @ . @ . @ . @ . @ . @ . @ @ . @ . . @ @ 
@ . . . @ . @ . . . @ . @ . @ . @ . . . @ . @ @ @ . @ . . @ @ @ . @ . @ @ . . @ . . . @ @ . . @ . @ @ . @ . . . . . . @ @ . . @ @ . @ @ . . @ @ @ @ @ @ @ @ . @ . @ . . . @ @ @ . . . . . @ . . @ . @ @ 
@ . @ @ . . . . @ . . . . . @ . @ @ . @ . @ . . . . . @ . . @ . . . . @ . . @ . @ . @ . . @ . . . . . @ . @ . @ . @ @ . . . @ . . . @ . @ @ @ @ @ @ @ @ . . . . . . @ . @ . @ @ @ . @ . @ . @ . @ . . @ 
@ @ @ @ @ . @ . @ . @ . @ . . . . . . . . . @ . @ . @ @ @ @ . . @ @ . . @ . . . @ . . . @ @ @ . @ . @ @ . @ . . @ @ . @ @ . . @ @ . . . . . @ . @ @ @ . @ @ . @ . @ . . . . . @ @ @ . . . . . . . @ . @ 
@ @ @ . . . @ @ . @ . @ . @ . @ . @ @ @ . @ . @ . . . @ @ . @ . @ . . @ . . @ . @ . @ @ . @ . . . @ . . . . . @ . . . . . . @ . . @ @ . @ @ . . @ . . . . . . . @ . . @ . @ . . @ @ @ . @ . @ . @ @ @ @ 
@ . . . @ . @ . . . . . . . . . @ . . . . . . @ . @ @ @ @ . . @ . @ . @ . @ . @ @ . @ . . . . @ . @ @ . @ @ . . @ . @ . @ . . . @ @ . . . . @ . @ @ . @ . @ . @ . @ . . @ . . @ @ @ @ @ @ . @ . . @ @ @ 
@ @ . @ . . @ . @ @ . @ . @ . @ @ @ . @ . @ . . . @ @ @ @ . @ . . . . . . . . @ . . . @ @ @ . . @ @ @ @ @ . . @ . @ @ . . @ . @ . . @ . @ @ . . . @ @ @ @ . . . . . . @ . @ @ @ @ @ . . @ . . @ @ @ @ @ 
@ @ @ . . @ @ . . . @ . . . @ @ @ @ @ . . @ . @ . . @ @ . . . @ . @ . @ . @ @ . @ @ . @ . . @ . . @ @ @ @ . @ . . . @ . @ @ . . @ . . . . . @ . @ @ @ @ @ . @ . @ @ . . . @ . . . @ . @ . @ . @ . @ @ @ 
@ @ . @ @ @ @ . @ @ @ @ . @ @ @ @ @ @ @ . . @ . @ . @ . . @ . . . . @ @ @ @ . . . . . . @ . @ @ . . . @ . . . . @ @ . @ . . . @ @ . @ . @ @ @ . . @ . . . @ . @ @ @ . @ . . @ . @ . . . . . . . . . . @ 
@ . . . @ . . . @ . @ . . @ @ @ @ @ @ @ @ @ . . . . . @ . @ . @ . @ . @ @ . @ . @ . @ . . . . @ . @ @ . @ . @ @ . @ . . @ @ . . @ @ . . . @ . . @ . @ . @ @ . . @ @ @ @ . @ . . . @ @ @ . @ @ . @ @ . @ 
@ . @ . . . @ @ . . . . @ @ @ @ @ @ @ @ @ . . @ . @ . . . . @ . . . . . . . . @ . @ . . @ . @ . . . . . . . . . . . . @ . . @ . . @ @ . @ @ @ . . . . . . . @ . . @ @ . . @ . @ . @ @ . . . . @ @ . @ @ 
@ . @ . @ @ @ . @ . @ . @ @ @ @ @ @ @ @ . . @ @ @ @ @ . @ . . @ . @ . @ . @ . . . . @ . @ . . . @ @ . @ . @ @ @ . @ @ . @ . @ . @ . . . . @ . @ @ . @ . @ @ . . @ @ . . @ @ . @ @ . @ @ @ . @ . @ . . @ 
@ @ @ @ . . . . . . . @ . @ @ @ @ @ @ @ @ @ . @ . @ . . @ . @ . @ . . . @ . . @ @ . . @ . . @ @ . . @ @ @ . . . @ . . . . . . . @ . @ . @ . . @ . @ . . . @ @ . . . @ . @ . . . @ . . . @ . . . . . @ @ 
@ . @ @ @ @ . @ @ . @ @ . @ @ @ @ @ @ @ . @ . . . @ @ . @ . @ . @ @ . @ . @ . @ @ . @ @ @ . @ @ @ . @ @ @ . @ . . @ @ . @ . @ . . @ . . . @ . . . @ @ . @ @ . . @ @ . . . @ . @ . @ . @ . @ @ . @ . . @ 
@ . @ @ @ @ @ . @ @ @ . . @ . @ @ @ @ . . . . @ . . . @ . . . . . @ @ . . . . @ @ @ @ @ . . . @ . . @ @ @ . . @ . . @ . . @ . . @ . @ . @ @ . @ . . . . @ @ @ . . . @ . @ . . . . . . . . @ @ @ . . @ @ 
@ . . @ @ . . . . . . . @ . . . @ @ @ @ @ @ @ @ @ @ . . @ . @ . @ @ . @ @ @ . @ @ @ @ . @ . @ @ @ . . @ . . @ @ . @ . @ @ . @ . . . . . . @ @ . @ . @ . . @ @ @ . @ . . @ . @ @ . @ . @ @ . . . @ . . @ 
@ @ . @ . @ @ . @ . @ @ . @ . @ @ . @ . @ @ @ @ . @ @ . . @ @ @ @ @ . . @ . . . @ @ . . . . . @ . . @ . @ @ @ @ . . . . @ . . . @ . @ @ . . @ . . . @ @ . . @ . . @ . @ . . . . @ . . @ . . @ . . @ . @ 
@ . . . . . . . . @ @ @ . . . . . . . . . @ . . . . @ . @ . @ . @ . . @ . @ . @ . . @ . @ . @ . @ . . . @ . @ . . @ @ @ . @ @ @ . . . @ . @ . . @ @ @ @ . @ . @ . . . . . @ . @ . @ @ . @ . . @ @ . . @ 
@ . @ @ . @ . @ . . @ @ . @ . @ . @ . @ . . @ . @ . . . . . . . . @ . . . . . . . @ . . @ . @ . . . @ @ . . . @ . @ @ @ . . . @ @ @ . @ . @ . @ @ @ @ @ . . . @ . @ . @ @ . @ @ . . @ . . . @ . @ @ . @ 
@ @ . @ . @ @ . . @ . @ . . @ @ @ . . . @ . . . . @ . @ . @ . @ @ . @ . @ @ . @ . @ . @ . @ @ . @ . @ . . @ @ . . @ . @ . @ . . @ . . @ @ . @ @ @ . @ @ . @ @ . . . @ . . . . @ . @ . @ @ . . . . . . @ 
@ . . @ . @ . @ . @ . . . @ @ @ @ @ . @ @ @ . @ @ . . . @ . . @ . . . @ . . . . @ @ . . . . . . @ @ . @ . @ . . @ . . . . . @ @ . @ . . @ . . . @ . @ . . . . @ . @ . @ @ . @ . . . . . . . @ . @ . @ @ 
@ @ . @ @ . . . . . . @ . . @ @ @ . . @ @ @ @ @ @ @ . @ . @ . . @ . @ . @ @ . @ . @ . @ @ @ @ . . @ . @ . @ . @ . . @ . @ @ @ . . . . @ @ @ . @ . . @ . @ @ @ . . . . . . . . . @ @ . @ . @ . @ . @ @ @ 
@ . . . . . @ . @ @ . . @ @ . @ . . @ @ @ @ @ @ @ @ . @ . @ @ . . . . . . . . . . . . . @ . . @ @ @ . . . . . . . @ @ @ @ @ @ @ . @ . . @ . . . @ . . . . @ @ . @ . @ @ . @ . @ @ . . . @ . . . . . . @ 
@ @ . @ @ . @ @ . . . @ @ . . . @ . . @ @ @ @ @ @ @ . . . . @ @ . @ . @ . @ . @ . @ . @ @ @ . . . . @ . @ . @ @ . @ . . . @ @ @ @ . . @ @ @ . @ . . @ . @ @ @ . @ . . . @ . . @ @ . @ . . . @ @ @ @ @ @ 
@ . . . @ @ . . . @ . @ . @ . @ . . @ @ @ @ @ @ @ . @ @ . @ . . . . @ @ . . @ @ . @ . @ @ @ . @ @ . . . @ @ @ @ @ @ . @ @ . @ @ . @ . . @ . . . @ . . @ @ @ @ . @ . @ . @ @ . . @ . @ . @ . . . . . . @ 
@ . @ @ . . . @ . @ @ . . . . . . @ . @ @ @ @ @ . . . @ @ @ . @ @ . . . @ . . @ . @ . @ @ . @ . . . @ . . . . . @ . . @ @ . . . . . . @ . @ @ . . . @ . . . . . . @ . @ . . . @ @ @ @ @ . . @ . @ . @ @ 
@ . @ . @ . @ . @ @ @ @ . @ . @ @ . . @ @ @ @ @ @ . @ @ . @ . . @ . @ . . @ @ @ @ . . . . . . @ @ . . @ . @ . @ . @ . . . . @ . @ . @ @ . . @ . @ . . @ @ . @ . @ . . . . @ . @ @ . @ @ . @ . . . @ @ @ 
@ @ . . . . . . @ @ . . . . @ . . @ . . @ @ @ @ @ . . @ . @ . @ . @ @ @ . . . @ . @ @ . @ . @ . . @ @ . @ @ . . . @ . @ @ @ @ @ @ @ @ @ . @ @ . @ . @ @ @ . . @ . . @ @ . . @ . . . . . . . @ . @ . @ @ 
@ . . @ . @ . @ . @ @ @ . @ . @ . . . @ . . @ . . @ . . . . @ . . . . . . @ . . . . . @ . . @ . @ . @ . @ @ @ @ . . . . @ @ @ . . . @ . . . . . . @ @ @ . . @ @ . @ @ @ . @ @ . @ @ . @ . @ @ @ . . @ @ 
@ @ . @ . @ . . . . . @ . . . . . @ . @ . @ . @ . @ . @ . @ . @ @ . @ @ . . @ . @ @ @ . @ @ . . . . . . . @ . @ . @ . @ . @ @ @ . @ . @ . @ . @ . . . . @ . . . @ . . . @ . . @ . @ @ . . . . . . @ @ @ 
@ . . @ . @ . @ @ . @ @ @ . @ . @ . . @ . . . . . . . @ . . . . @ . @ . @ @ . . . . . . . @ @ @ @ . @ . @ . . . @ . . . . . @ . . . . . . . @ @ . @ @ @ . . @ . @ . @ . . @ . . . . . . @ . @ . @ @ @ @ 
@ . @ . . @ @ @ @ @ @ @ @ @ @ @ . . @ . . @ @ . @ @ . . @ @ @ . . @ . . . @ @ . @ . @ . @ . . . . @ . . . . @ . . . @ @ . @ . @ . @ @ @ . @ @ . @ @ @ . . @ . @ . @ @ @ . . @ . @ . @ . . @ . . . . @ @ 
@ . . @ @ . @ @ @ @ @ @ @ @ @ . @ . . @ . @ . . @ . @ @ . . @ @ @ @ @ . @ @ @ @ @ @ @ @ @ . @ @ . . . @ @ . @ . @ @ . . . . . . . @ . . . . . . . @ . @ . . . . . . @ . . @ . . @ . @ @ . . @ . @ @ . @ 
@ . @ . . . . @ @ @ @ @ @ . . . . @ . . . . @ @ . . . . @ . . . @ . . . . @ . @ @ @ @ . . @ . . . @ @ . . . . @ . @ . @ @ @ . @ . . @ . @ . @ . @ @ . . . @ . @ . @ @ @ . . @ @ . . . @ . @ . . . . . @ 
@ @ . @ @ . @ . @ @ . @ . @ @ @ . . . @ . @ . @ . @ . @ @ . @ @ . @ @ . @ . . . @ @ . @ . . @ . @ . . . @ . @ . . @ @ . @ @ @ @ . @ . @ @ @ @ @ @ . . @ . . @ . . @ @ . . @ . @ @ . @ . @ @ @ . @ . @ @ 
@ . . @ . . . . @ . . . . . @ . . @ @ . @ @ . @ . . @ @ . . . @ . @ . . . . @ . @ . . @ . @ @ @ . . @ . . @ . @ . . @ . . @ . . . . . . @ @ . @ @ @ . . @ . @ . @ @ @ @ . @ . @ @ @ . . @ @ . . . @ @ @ 
@ @ . . @ @ @ . . @ @ . @ . . @ . . @ . . . . @ @ . . @ @ . @ . . @ @ . @ @ . @ @ @ . @ . @ @ @ @ . . @ @ . . . @ . . . @ . @ @ . @ . @ . . . @ @ @ . @ . @ . . . @ @ . . . . . . . @ . @ @ @ . @ @ @ @ 
@ . @ . . . . @ . . @ . . @ @ . . @ . . @ @ . @ . . @ @ . . . @ . . . . . . . . @ . . @ . @ . @ @ @ . @ . @ . @ @ . @ @ @ . @ . . . @ @ . @ . . @ . . . . @ @ . @ . . @ @ @ . @ . @ @ . . @ @ . @ @ @ @ 
@ . . . @ . @ @ . @ . . @ . @ @ . . . @ @ . . @ . @ . . @ . @ @ . @ @ @ @ . @ . . @ . . . @ . . @ @ @ @ . . . . . . . . . . . @ @ . . @ @ . . @ . . @ . @ @ . @ @ . @ . @ . . . @ . . @ . @ @ @ @ @ @ @ 
@ . @ . @ @ . @ . . @ . . . @ @ . @ @ . @ @ . @ . . . @ . . . . . . . . @ @ @ @ . @ . @ . @ . @ @ @ @ @ @ . @ . @ . @ . @ @ . . . @ . @ . @ . @ . @ @ . @ . . . . . . . . @ . @ . @ . . . . @ @ @ @ . @ 
@ . @ . . . . . @ . . . @ @ . . . . . . . . @ . . @ @ . @ . @ . @ @ . @ . . @ . @ @ @ @ . . . . . @ @ @ . @ . . @ @ @ @ . . @ @ . @ . . . . . @ . . @ @ . @ . @ @ @ . @ . . . . . . @ @ . @ @ @ @ . . @ 
@ @ . . @ . @ . . @ @ . . . @ . @ . @ . @ . . . @ . . . . . . @ . . . . . @ . . . @ . . @ . @ @ @ . . . . . @ @ @ @ @ . . @ . @ . . . @ @ . @ . . @ . @ . @ . @ . @ @ @ . @ . @ . @ . . . . @ @ @ . @ @ 
@ @ @ @ . . . @ . @ @ . @ @ @ . . @ @ @ @ . @ @ . . @ . @ @ . @ . @ . @ @ @ @ . @ . @ . . . . @ @ @ . @ . @ . @ @ @ . @ . . . . @ @ . @ . @ @ . @ . . . . . @ . . . . . . . @ @ @ . . @ . @ . @ . . . @ 
@ @ @ @ @ . @ . . . . . . @ . . @ . @ . . . @ @ . @ . @ . . @ . . @ . @ @ @ @ . . . @ . @ @ . . @ . . . @ @ . @ @ . . . . @ @ @ . . . . . . . . . . @ @ . @ . @ . @ @ @ . @ @ @ @ @ . @ . . . . @ . @ @ 
@ @ @ @ @ @ @ @ . @ @ . @ . @ . . . @ @ . @ @ @ . . . @ @ . . @ . @ @ @ @ @ . . @ . @ . @ . . @ . @ . @ . . . . . @ @ @ . . @ @ . @ @ . @ . @ . @ @ @ @ . . . . . . @ . . . . @ @ @ @ . . @ @ . @ . . @ 
@ @ @ @ @ @ @ @ @ @ @ . . . . . @ @ . @ @ . @ @ . @ . @ @ @ . . @ . . @ . @ . @ . @ . @ . @ . . . . . . . @ @ @ . . . @ . @ . . . @ . @ . . . @ @ . @ @ . @ . @ . @ . @ . @ . @ @ @ @ @ . . . @ @ . @ @ 
@ @ @ @ @ @ @ @ @ @ @ . @ . @ . . . . . . . . . . . @ @ @ . . @ . @ . . . . . . . . . @ . . . @ @ @ . @ . . . @ @ @ @ @ . . . @ . . . . @ . @ @ . . . @ . . @ . @ . . @ . . @ @ @ @ @ . . @ . . . . . @ 
@ @ @ @ @ @ @ @ @ @ . . @ . @ . @ @ @ @ . @ @ . @ @ @ @ . @ . . . . . @ @ . @ @ . @ @ . @ @ . . . @ @ . @ . @ @ . . . @ . @ . . @ . @ . @ . @ . @ . @ . . @ . . . . @ @ . @ . @ . @ . . @ . @ @ . @ . @ 
@ @ @ @ @ @ @ @ @ @ @ . . @ @ . . . . . @ @ . . @ . @ . . @ . @ . @ . . @ . @ . @ @ . . . . . @ . . @ . @ @ @ . . @ . . . . @ @ . . . @ @ @ @ . . . . @ . . . @ . @ @ @ @ . . . . . @ . . . @ @ @ . . @ 
@ @ @ . @ @ @ . @ . . . @ . @ @ . @ . @ @ . @ . . . . @ . . @ . @ . . @ . @ @ . . . . @ @ @ @ . @ . . . . . . . @ . . @ @ @ . . @ . @ @ @ @ @ @ . @ . . . @ . @ . @ @ @ . @ . @ . @ . . @ @ . @ . @ . @ 
@ . . . . @ . . @ @ @ . @ . . @ . . @ . . . . . @ . @ . @ . . . . . @ . . . . @ . @ @ . @ @ @ . . @ . @ . @ . @ @ @ @ @ @ . @ . @ . @ @ @ @ @ @ @ . @ . @ @ . @ @ . @ . . . @ . . . @ . @ @ . . . . @ @ 
@ @ @ . @ @ @ . . . @ . . . @ @ . @ @ @ . @ . @ . . @ . . . @ . @ . . @ . @ @ . . . . . @ . . . @ . @ . . . @ . @ . . @ . . . . @ . . @ @ @ @ @ . . . . . @ @ . @ . @ . @ @ . @ . @ . . @ . @ @ . @ . @ 
@ @ . . @ @ . . @ @ . @ @ . @ . @ . @ . . @ @ @ @ @ . . @ . @ . @ . @ . . . @ . @ @ . @ @ @ @ . . . . @ @ . @ . @ . @ . @ . @ . . @ @ @ @ @ @ . . @ @ . @ . @ . . . . . . @ . . . . @ . . . . . . . . @ 
@ @ . @ . @ . @ . @ . @ @ . . . . . . @ @ @ @ . . @ @ . @ @ @ @ . . . . @ @ . . . . @ . . . . @ . @ . @ . . . . . . . . . @ . @ . @ . @ @ @ @ @ . . @ @ . . . . @ . @ @ @ . . @ . @ @ . @ . @ . @ . @ @ 
@ . . . . @ . . . . . . . . @ . @ @ . @ @ @ @ @ . . @ @ @ . @ . @ . @ . . . @ . @ @ @ . @ @ . @ . . @ . . @ . @ . @ . @ @ @ . . . . . . @ @ @ . . @ @ . @ . @ . . @ . . . . @ @ @ . @ . @ . . @ @ @ @ @ 
@ . @ . @ . . @ @ . @ . @ @ . . @ @ @ @ @ @ @ @ . @ @ @ . . . . . . . @ @ @ . . . . . . . @ @ @ . @ . @ @ . @ . . . @ @ @ . . @ @ . @ @ . @ @ @ @ . . . . . @ . @ . @ @ . @ @ @ . . . @ . . @ . @ @ @ @ 
@ @ . . @ . @ @ . @ @ @ @ @ @ @ . @ @ @ @ @ @ . . . . @ . @ . @ . @ @ . @ . @ . @ . @ @ @ . . @ . . . @ . . . @ @ @ . . . @ . . @ . @ . . . @ @ @ @ @ . @ @ . . . . . . . . @ . @ . @ . @ . . . . . @ @ 
@ @ @ . . . @ @ . . @ . @ @ . @ . . . . @ . . @ . @ @ . @ . . @ . . @ . @ . @ . . @ @ @ . @ . . . @ @ . @ . @ . @ @ @ @ . @ . @ . @ @ @ . @ . @ . . . @ . . @ . @ . @ . @ . . . . . . . . . @ @ @ @ @ @ 
@ @ . @ . @ @ . @ . . . @ . . . . @ @ . @ @ . @ . . @ . . @ . . @ @ . . @ . . . @ . @ . . . . @ @ . . . . . . . . @ . . . . . . . . . . . . . . @ . @ . @ . . . . @ . @ . . @ . @ . @ . @ . . . . . @ @ 
@ . . . . . @ . . . @ @ . @ . @ . . @ @ @ . . . . @ . . @ . . @ . . @ . . . @ @ . . . @ . @ . @ @ . @ . @ . @ @ @ @ @ . @ . @ . @ @ . @ . @ @ . . . . . . . @ @ @ . . . @ @ . @ . . @ . @ . @ . @ @ . @ 
@ @ @ @ @ . . @ @ . . . . . @ . . @ @ @ . @ . @ . . . @ . . @ @ . @ . @ . @ . @ . @ @ . @ . . @ . . . @ @ @ @ . . @ . . . @ . . . @ @ . . . . @ @ . @ . @ . . . . . @ . . . . . @ @ @ . . @ @ @ . @ . @ 
@ . . @ . . @ . . . @ @ @ @ . @ . . @ . . . @ @ . @ @ . @ . . . . . . . . . . . . . . . . @ . . . @ . @ . . . . @ . @ . @ @ @ . @ . @ @ . @ @ @ @ @ . . . @ . @ @ @ . @ @ @ . @ . . . @ @ @ @ @ . . . @ 
@ . @ . . @ . . @ . . . @ . . @ . @ . @ . @ . @ . . . . . . @ . @ . @ . @ @ . @ @ @ . @ . . . @ @ @ @ . @ @ . @ @ . . . @ . . . . . . @ . @ . @ @ . . @ @ @ @ @ @ . . . . @ @ . . @ @ . @ @ @ @ . @ . @ 
@ . . @ . @ . @ @ . @ . @ @ . . . . . . . . . . . @ . @ . @ @ . . @ . . . @ . . . . @ . . @ . . . . . . . . . . @ . @ @ @ @ @ . @ . @ @ @ . . . @ @ . @ . @ . @ . . @ . @ @ . @ . . @ . @ . @ . . . @ @ 
@ @ . . . @ . @ @ . . @ @ . . @ . @ . @ . @ . @ . . @ @ @ . @ . @ . @ . @ @ . @ . @ @ @ @ @ @ . @ . @ . @ @ . @ @ . @ . . @ . @ @ @ @ @ @ @ @ . @ @ @ @ . @ . @ . @ @ . @ . . @ . @ . . . . . @ . @ . @ 
@ . @ @ . . @ @ @ @ . . . @ . @ . . @ . . . @ . @ . . . . . . @ . . . @ . . @ @ @ . . . @ @ @ @ . @ . . . . @ . . . . . @ . . . . . @ @ @ . . . . @ @ @ . . . . . . . @ . @ . @ . . . @ . @ . . . . . @ 
@ . @ . . @ @ @ @ . @ @ . @ . . @ @ @ @ . @ @ . . . @ . @ . @ @ . @ @ . @ . @ @ . @ . @ . @ . . . @ @ . @ . @ . @ @ . @ @ @ . @ @ @ . @ . . @ @ @ @ @ @ @ . @ . @ @ @ . . . . . . @ . @ @ . . @ . @ @ @ 
@ . . @ . . @ . . . . . . . . @ . . @ @ @ . . @ @ . . @ @ . . . . . . . . . . . . . . . . . . @ . @ . . . @ . @ @ @ . . @ . . . . . . . @ . @ . @ @ . @ . . . @ @ @ . @ @ . @ @ . . @ . @ @ @ . @ @ @ @ 
@ @ . @ . @ . @ . @ . @ . @ @ @ @ . @ @ @ . @ . @ . @ @ . . @ @ . @ . @ @ @ . @ . @ . @ @ . @ . . . @ . @ . . . @ @ . @ . @ @ . @ @ . @ . . . . . . . . @ . @ . @ . . . . . . . @ . . . . . . . @ @ @ @ 
@ . . . . . . . . . @ . @ . . @ @ . . @ . . . . . @ @ @ @ . . . @ @ . . . . @ . . @ . @ @ @ @ @ . @ . . . . @ . . . . . . @ @ @ . . . . . @ . @ @ . @ . @ . . . . @ . @ @ @ . @ @ . @ . @ @ . @ @ @ @ @ 
@ @ . @ @ . @ . @ . @ . . . @ . @ . @ . @ . @ @ @ . @ @ @ @ @ @ . . . @ . @ . @ . @ . . . . @ . @ @ @ @ @ @ . . @ . @ . @ @ @ . @ @ . @ @ . . . . @ @ . . . @ @ . . . . . . @ @ @ . @ . . . @ @ @ @ @ @ 
@ . . @ . . @ @ @ . @ @ . @ . . . . . . . . . . . . . @ @ @ @ @ @ @ . . @ . . . . . @ . @ . . . . @ @ @ @ @ @ . . @ . . @ . . . . . . @ @ @ . @ . . . @ . @ @ . . @ . @ . @ @ @ @ . . @ . @ . @ @ @ @ @ 
@ @ . . @ . @ @ @ @ @ . . . . @ @ . @ . @ . @ @ . @ . . . @ @ @ . . . @ . @ . @ . @ @ @ @ @ . @ . . @ @ @ . . . @ @ @ . . . @ @ . @ . @ . . . . @ . @ . . . . @ . . @ @ @ @ @ @ . @ . @ . . . @ @ . @ @ 
@ @ @ @ @ . . @ @ @ @ . @ . @ . @ @ . @ . @ . . @ @ . @ @ @ @ @ . @ . . . . @ . . . . . @ @ @ . @ @ @ @ @ . @ . . @ . . @ @ . . @ @ @ @ . @ . @ . @ @ @ . @ . @ . @ . @ @ @ @ @ . @ @ . @ @ @ . @ . @ @ 
@ @ @ . . . @ . @ . . . @ . . . . . . . . . . @ @ @ . . . @ @ . @ @ . @ @ @ . @ . @ . @ . @ @ . @ . @ @ @ @ . . @ . @ . @ . . @ . @ . @ @ . . @ . @ @ . . @ . @ . . . . @ @ @ . . . @ . . @ . . . . . @ 
@ @ . @ @ . . . . . @ @ . . @ . @ . @ . @ @ . @ @ @ @ . @ @ . . . . @ @ . @ . @ . . @ . . . . . . . . @ @ . @ . . . . @ @ @ . . . . . . @ @ . . . . @ @ . . @ @ . @ . @ . @ . @ . @ @ . @ . @ . @ . @ @ 
@ . . . . . @ @ . @ . @ . @ . . @ @ @ @ . . . . @ @ @ . . @ . @ . @ @ @ . . . . @ . . . @ @ @ @ @ @ . @ . . . . @ . @ @ @ @ @ @ @ . @ . . . . @ @ . . . @ @ . @ . @ . . . . . . . . . . . . . . . @ . @ 
@ . @ . @ . @ . . . . . @ . . @ @ @ @ . . @ . @ @ @ @ @ . . . . @ @ @ @ @ . @ . . . @ . . . . . . . @ @ @ @ @ . . @ @ @ @ @ @ @ @ @ @ . @ . @ . . . @ . . . . @ @ @ . @ . @ . @ . @ @ @ . @ . @ . . . @ 
@ @ @ @ @ @ @ @ @ @ @ @ @ @ @ @ @ @ @ @ @ @ @ @ @ @ @ @ @ @ @ @ @ @ @ @ @ @ @ @ @ @ @ @ @ @ @ @ @ @ @ @ @ @ @ @ @ @ @ @ @ @ @ @ @ @ @ @ @ @ @ @ @ @ @ @ @ @ @ @ @ @ @ @ @ @ @ @ @ @ @ @ @ @ @ @ @ @ @ @ 
3
71 36 27 91
36 1 81 9
3 87 8 70
