100 100
@ @ @ @ @ @ @ @ @ @ @ @ @ @ @ @ @ @ @ @ @ @ @ @ @ @ @ @ @ @ @ @ @ @ @ @ @ @ @ @ @ @ @ @ @ @ @ @ @ @ @ @ @ @ @ @ @ @ @ @ @ @ @ @ @ @ @ @ @ @ @ @ @ @ @ @ @ @ @ @ @ @ @ @ @ @ @ @ @ @ @ @ @ @ @ @ @ @ @ @ 
@ . . . . @ . @ . . . @ . @ . @ @ . @ @ . . @ @ . @ @ @ @ @ . @ @ @ @ @ @ @ @ @ @ @ @ @ @ @ @ @ @ @ @ @ @ @ @ @ @ . @ . . . @ . . . @ @ . . @ . . @ . @ . . @ @ @ @ @ . @ @ @ . . @ . . @ @ @ @ @ @ . @ 
@ @ . @ . . . . @ @ . . . @ . . . . . @ . @ . . . @ @ @ @ . . . . @ @ @ @ @ @ @ @ @ @ @ @ @ @ @ @ @ @ @ @ @ @ . . . . @ @ . . . @ @ . @ . @ . @ . . . @ @ . . @ @ @ . . . @ @ @ . . @ . . @ @ @ @ @ . @ 
@ @ . . @ @ @ @ . . . @ . @ @ @ . @ . . . . . @ @ . @ @ @ @ . @ @ @ @ @ @ @ @ @ @ @ @ @ @ @ @ @ @ @ @ @ @ @ . @ . @ . . @ . @ @ . @ . . . . . . @ @ . @ . . @ @ @ . @ . @ . @ . . @ . . @ . @ . @ . . @ 
@ @ . @ @ @ @ @ @ . @ @ . @ . @ . @ . @ . @ . . . . @ @ @ . . . . @ @ @ @ @ @ @ @ @ @ @ @ @ @ @ @ . . @ @ . . @ @ . @ . . . . . . . . @ . @ @ @ @ . . . @ . . @ . . @ . @ . @ @ . @ @ . . . . . . @ . @ 
@ @ . . @ @ @ @ @ @ @ . . @ . . @ . . . @ . . @ . @ @ . @ . @ . @ @ @ @ @ @ @ @ @ @ @ @ @ @ @ @ @ @ . @ . @ . @ . . . . @ . @ . @ @ . @ @ @ . @ . @ @ . @ . @ . @ . . . @ . . . . . . . @ @ @ @ @ @ . @ 
@ . . @ . @ @ @ @ @ @ @ . . @ . . . @ . @ @ . . @ @ @ . @ . . @ @ @ @ @ @ @ @ @ @ @ @ @ @ @ @ @ @ . . . . . . @ @ . @ . @ . . @ @ @ @ @ . . . . . . . . . . . . . . @ . @ . @ . @ . @ . . . . . . . . @ 
@ @ . . . . @ . @ @ @ . . @ . @ @ . . @ . . . @ . . . . . . @ . @ . @ @ @ @ @ @ @ @ @ @ @ @ @ @ @ @ . @ . @ . . @ . @ @ . @ . . @ @ @ @ . @ @ . @ . @ . @ @ . @ @ . @ . . . . @ . . . @ @ . @ . @ . @ @ 
@ . . @ @ @ . . @ . @ . @ . . @ . @ . . @ @ @ @ @ . @ . @ . . . . . @ @ @ @ @ @ @ @ @ @ @ @ @ . @ . @ . @ @ @ . . @ @ . . . . @ . @ @ . . . . @ @ @ @ @ . . . . . @ . @ . @ . @ @ . @ @ @ . . @ @ @ @ @ 
@ @ . @ @ @ @ . @ . . . @ @ . . . . . @ . . . @ . @ . . @ . @ @ . @ @ @ @ @ @ @ @ @ @ @ @ @ . . . . @ . . . . . @ . . @ . @ . . . . . @ @ . @ @ @ @ @ @ @ . @ . @ @ . . . . @ @ @ . . . . @ . . @ @ @ @ 
@ . . @ @ @ @ . @ . @ . . . @ @ @ @ . . @ @ . . . . . @ . @ . @ . @ @ @ @ @ @ @ @ @ @ @ @ @ @ @ @ . . . @ . @ . . @ . @ @ . . @ . @ . . . @ @ @ @ @ @ @ @ @ . . . @ . @ . @ @ @ . @ . @ . . @ . @ @ @ @ 
@ . @ . @ . . . @ . . @ . @ . . @ . . @ . @ . @ . @ . . . . . . @ . @ @ @ @ @ @ @ @ @ @ @ @ @ @ @ @ . @ . . . @ . . . . @ @ . @ . . @ @ @ . @ @ @ . @ @ @ @ @ . @ . . @ @ @ @ . . . . @ . @ . @ @ @ @ @ 
@ . . . . @ @ . @ @ . . @ . @ . . @ . . . . @ @ @ . . @ @ . @ . . . . . @ @ @ @ @ @ @ @ @ @ @ @ @ @ . . @ @ @ @ . @ . @ . @ . @ . @ @ . @ . . @ . . . @ @ @ @ @ @ @ . @ . @ @ @ @ @ . @ @ . . @ @ @ @ @ 
@ @ . @ . . . . @ . @ . @ . @ . @ . . @ . @ . @ . @ . . @ @ @ @ @ . @ @ @ @ @ @ @ @ @ @ @ @ @ @ . @ . @ @ @ @ @ @ @ . . . . . @ @ . @ . @ . @ . @ . @ . @ . . . @ . . . . . @ @ . @ @ . @ . @ @ @ @ @ @ 
@ @ @ . @ @ @ . @ . @ . . . . . @ . @ @ . . . . . . . @ . @ . @ @ . @ @ @ @ @ @ @ @ @ @ . . @ . . . @ @ @ @ @ @ @ @ @ . @ @ . . @ . . . . . . . . . . . . @ . @ . @ . @ . @ . @ . . . . @ . . @ @ @ @ @ 
@ @ . . . . . . . . . @ . @ @ . . . . @ . @ @ . @ . @ . . . . . @ . @ . @ @ @ @ @ @ @ . . @ . @ . @ . @ . @ @ @ @ @ @ @ @ . . @ . @ . @ . @ . @ @ @ @ @ @ . . . . . . @ . @ . . @ . @ @ . . @ . @ @ @ @ 
@ @ . @ . @ @ . @ . @ . @ @ . . @ @ @ . @ @ @ @ . @ . @ @ @ . @ . . . . . . @ @ @ @ @ @ . . . . . @ . @ . . . . @ @ @ . . @ . . . . @ @ . @ @ @ . . . . . . @ . @ . @ @ @ . @ . . . @ @ @ . . . . . @ @ 
@ . @ . . @ @ @ . . . . @ @ @ . . @ . . . @ @ @ . . . @ @ . . @ @ . @ . @ @ @ @ @ @ @ @ @ . @ @ . . . . . @ . @ . @ . . @ @ . @ @ . . . . . . @ . @ . @ @ . . @ . . . . . . . @ @ . . . @ . @ @ . @ . @ 
@ . . @ . @ @ @ @ . @ @ @ @ . . @ @ @ @ . . @ . @ @ . . . @ . . @ @ @ . . @ @ . . @ @ @ @ @ . @ . @ @ . @ @ @ . . . . @ . . . @ @ . @ . @ @ . . . . @ @ . . @ @ @ @ . @ @ . @ . . . @ @ . . . @ . . . @ 
@ . @ . @ @ @ @ . . . @ . . . @ . @ @ @ @ . @ . . . . @ @ . . @ . . @ @ . @ . @ . . @ @ @ . . . . . @ . . . @ @ @ . @ @ . @ @ . . @ . . . . @ . @ . . . @ @ . @ . . @ @ @ . @ @ . @ . . @ . @ . . @ . @ 
@ . . . . @ @ . @ . @ @ @ @ . @ . . @ @ . . @ . @ @ . . . @ . . . @ . . @ . . . @ . . @ . @ @ . @ . . @ . @ . @ . . . @ . . @ . @ . @ . @ . @ . . @ . @ . . . . . @ @ @ . @ . . . . . @ @ . @ @ @ @ @ @ 
@ . @ @ @ . . . . . . @ . @ . @ . @ @ @ @ . . @ . . @ @ . . @ . @ . . @ . @ . @ . . @ . . @ @ @ . . @ @ . @ . @ . @ . @ . @ . . . . . @ @ @ . . @ . @ . @ . @ @ @ . @ . . . . @ @ . @ @ . . . @ @ @ @ @ 
@ . . . . . @ @ @ . @ . . . . @ . . @ @ . @ . . . @ @ @ @ . @ . . @ . . . . . . . @ @ @ . @ @ . @ . @ . @ . . . @ . . . . . . @ . @ . . . . @ . . . . . . . . . . . . @ @ @ . . . @ @ . @ . @ @ @ . @ @ 
@ @ . @ . @ @ . . . . @ @ @ . . . @ . . . . @ @ . @ @ @ . . . . @ . . @ @ . @ . @ . . . . . . . . . . . . @ . @ . @ . @ @ . @ . . . @ . @ @ . . @ @ . @ . @ @ . @ . @ @ @ @ @ . @ . . . . . . . . . . @ 
@ . . @ @ . . @ @ @ . @ @ . @ . @ . @ @ @ . @ . . @ @ . @ @ @ . . @ . . . @ . . @ @ . @ @ . @ . @ @ @ @ . . . . . . . @ @ @ @ @ . @ @ . @ . @ . @ . . . @ @ . @ @ @ @ @ @ @ . . . @ @ . @ . @ . @ . @ @ 
@ @ @ . @ @ . . @ . . . . . . . . . . . . . . @ . @ . . . @ . . @ . . @ @ @ @ . @ . . @ . @ . . . . . . @ . @ @ . @ @ . @ @ @ @ @ . . @ . . . . @ @ . @ . . . @ @ @ @ @ @ @ @ . @ . @ . @ . . @ . . . @ 
@ . . . @ . . @ @ @ . @ . @ . @ . @ . @ . @ . . . . . @ . @ . @ . . @ @ @ @ @ . . @ . @ . . . @ . @ @ @ . . . . @ . @ . . . . @ @ . @ . @ @ @ . . . @ . . @ . @ @ @ @ @ @ @ @ . . . . @ . . @ @ @ . @ @ 
@ . @ . . @ . @ . @ @ . . @ @ . @ @ @ . @ @ @ . @ @ . . @ . . . . @ . @ . @ @ @ @ @ @ . . @ . @ . @ . . . @ @ . . . . . @ @ @ . . . . . @ . . . @ . . . @ . @ . @ @ @ @ @ @ . . @ @ @ . @ . @ @ @ @ @ @ 
@ . . @ . . . . . . . . @ . @ . . . . . . . @ @ . @ . @ . @ . @ @ . . . . @ @ @ @ . . . @ . . @ . @ . @ . . @ @ . @ . @ @ @ @ @ . @ . @ . @ @ . . @ @ . . . . . @ @ @ @ @ @ @ . . @ @ . . . . @ @ @ @ @ 
@ . @ . @ . @ . @ . @ @ . . . @ . @ . @ . @ @ . . . . . . . . . . @ . @ . @ . @ . @ . @ . . @ @ @ @ . . @ . . @ . . @ . . @ @ @ @ . . . . . @ @ @ @ . @ @ @ @ @ @ @ @ . @ @ . . @ . . . @ . @ . @ @ @ @ 
@ @ . . . @ . @ @ . @ . @ @ . @ . . @ . . . @ . @ @ @ . @ . @ . @ . @ . . . . . . . . @ @ . . @ . . . @ . . @ @ @ @ @ @ . . @ . . @ . @ @ . @ . @ . . @ . . . . @ @ . . . @ @ . . . @ @ @ . @ . . . @ @ 
@ @ @ . @ . . . @ . @ . . . . . @ @ . @ . @ . @ . . . . . @ . . . . . . @ @ . @ @ @ . @ . @ . @ . @ . . @ . . @ @ . @ . . @ . . @ . . . @ . @ . . @ . . . @ . @ . @ @ . @ . @ . @ . . . @ @ . . @ @ . @ 
@ . . . . . @ . . . . @ @ . @ . . . . . . . . . . @ . @ @ @ @ . @ . @ . . . @ . . . . @ . . . . @ . . @ . . @ . . . . @ . . . @ . . @ @ . @ @ . @ . @ @ . @ . . . . . . . . . . . @ . @ @ . . @ . @ . @ 
@ . @ . @ . @ . @ @ @ @ @ @ @ @ . @ . @ . @ @ . @ @ @ . . @ . @ . @ . . @ . . @ . @ . . @ . @ . . @ . . @ . . @ @ . @ . @ @ . @ . @ . @ . . . . . . . . . . @ . @ . @ . @ . @ . @ . @ . @ @ . . . . . @ 
@ . @ . @ @ @ . . . . @ . . . . . . @ @ @ @ . @ @ @ . @ . . . . . . @ . . @ @ . . @ @ . @ . . @ . . @ . @ . @ @ @ . . . . . . . . . . . . @ @ @ @ @ @ @ @ @ @ . . @ @ . . @ @ . . . . . . . . @ . @ . @ 
@ @ . @ . . . . @ . @ @ @ . @ @ . @ . @ . . . . . . . . . @ @ @ @ . . . @ . . @ . @ . . @ . @ @ . @ . @ . . @ @ @ . @ @ . @ . @ . @ . @ . . . . . . . . . . . @ @ @ . . @ . . . @ @ . @ . @ @ . . . @ @ 
@ . . . . @ @ . . @ @ @ @ @ . . . @ . . @ @ . @ . @ . @ @ @ . . . . @ . @ @ . @ . . @ . @ . . @ . . . @ @ . . . . . @ . . . @ . . . @ @ . @ . @ . @ @ . @ . @ @ @ @ @ . @ . @ . . . @ @ @ . . @ @ . @ @ 
@ @ . @ . @ . . @ @ @ @ @ @ . @ . . . @ . . @ . . . @ . . . . @ . @ @ @ . . . . . @ . @ . . @ . . @ @ @ . @ . @ . @ . @ . @ @ @ . @ . @ . @ . . @ . . . . @ . @ . @ . @ . @ . . @ . . @ . . @ . . . . @ 
@ . . @ . . @ . @ @ . @ @ @ @ @ . @ . @ @ . @ . @ @ . @ @ . @ . . . . . @ @ . @ . . . @ @ . . @ . . @ @ . . . . @ @ . . @ . . @ . . . . @ @ . @ . @ @ . @ . . . . . . @ . @ . @ . . @ . @ . @ . @ . @ @ 
@ @ . . @ @ @ . . . . . . @ @ . @ . . @ . . . . @ . . . . . @ @ . @ . @ @ . @ . . @ . . @ . @ . . @ . . . @ . @ . @ . @ . . @ @ . @ . @ @ . . . . . . @ . . @ @ . @ . . . @ . . @ . . . . . . @ . . . @ 
@ . . @ @ @ . . @ . @ . @ @ . . @ @ @ . . @ @ @ . . @ . @ . . . @ . . . . . . @ . . @ @ . . . @ @ @ @ . @ . . . . . . @ . @ . . @ @ @ @ . @ . @ . @ @ @ @ . @ @ . @ . @ . . @ . @ . @ . @ . @ @ @ . @ @ 
@ @ . . @ @ @ . . @ @ @ @ . @ . . @ . @ . . @ @ . @ . @ . . @ @ @ @ . @ @ . @ @ @ . . . @ . @ @ @ @ @ . . @ . @ . @ . . . @ . @ . . . @ . @ . . @ @ . @ . . @ . @ @ @ . @ @ . . @ . . @ . @ . @ . @ . @ 
@ . . @ . @ @ . @ @ @ @ . . @ . @ . . . . @ . . @ . . @ @ . . . @ . @ @ . @ @ @ @ . @ @ . @ . @ . . . . @ @ . . @ @ . @ . . . . . @ . . . . @ . @ . . . @ . . . . @ @ . @ @ @ . . @ . . . . . . . @ . @ 
@ . @ . . . . @ . @ @ . @ . . . @ @ @ . @ @ . @ . @ . @ @ . @ . @ . . . . @ @ @ @ . @ @ . . . . . @ @ . . @ @ . . @ . . @ . @ . @ . . @ . @ . @ . @ . @ @ . @ @ @ @ @ . @ @ . . @ . . @ . @ . @ @ @ . @ 
@ . . @ @ . @ . . . @ . . @ @ . . . . @ . . . . . . . . . . @ . . @ . @ . . . . . . . . @ @ . @ @ . . @ @ . . . @ . @ . . @ @ . . @ @ . @ . . . . . . . . . @ @ . @ . . . . @ . . @ @ . . @ . . @ . . @ 
@ . @ . . . . @ . @ . @ . @ . @ @ . @ . . @ . @ . @ @ . @ . . @ @ . @ @ . @ @ . @ . @ . @ . @ @ . . @ @ . . @ . . . . @ . . . @ . . . . . . @ . @ . @ . @ . . . . @ @ . @ . @ @ @ @ @ @ . @ @ . . . @ @ 
@ @ @ @ . @ . . . . . . . . . @ . . . @ . @ . . @ . . . . @ . @ @ . @ . . @ @ @ @ . @ . . . . @ @ . . @ @ @ . . @ . @ . . @ @ @ . @ @ @ @ . @ @ @ @ . . . @ . @ @ @ . . . @ . . @ @ @ @ . . . @ . @ @ @ 
@ . @ . @ @ @ . @ . @ . @ @ . . @ @ . . @ . . @ @ @ @ . @ @ @ . . . . . @ @ @ @ @ @ . . @ @ @ . @ . @ . @ . @ . . @ . @ . . . . @ @ . . @ . . . @ . @ . @ @ . @ . @ @ . @ . . @ . @ . . @ . @ @ . @ @ @ 
@ . . . . . . . . @ @ @ @ . @ . @ . @ . @ @ . @ @ . . . . @ @ . @ @ . @ . @ @ @ @ @ @ . . @ . . . . . . . . . . @ . . @ @ . @ . @ . . @ . . @ @ @ . . . . . @ . . @ . . . . @ @ . . . @ . @ . . @ @ @ @ 
@ @ . @ . @ @ . @ . @ . . . . . . . . . . . . . . @ . @ . @ @ @ @ @ . . . @ @ @ @ @ @ . @ @ @ . @ . @ . @ . @ . @ . @ . @ . . @ . @ . @ @ @ @ . @ @ @ . @ . . @ . . . @ @ @ . @ . @ @ . . . @ . @ @ @ @ 
@ . @ . . @ @ @ . . @ . @ . @ . @ @ . @ . @ . @ . @ @ . . @ @ . . . . @ . @ @ @ @ @ @ . . @ @ @ . . @ @ . . @ . . . . . @ @ . . . . . . . . . . . . @ . . @ @ . @ @ . . . . . . . . . . @ . @ . . . @ @ 
@ . . . @ . @ . @ . . @ . . @ @ . @ . . @ . . @ @ @ . @ @ . . . @ @ . . @ . @ @ @ @ @ . @ @ @ . @ @ . . . @ @ @ . @ . @ @ @ . @ @ @ . @ . @ . @ . @ . @ @ . . . . . . @ . @ . @ . @ . @ @ . . . @ @ . @ 
@ . @ . @ . @ . @ . @ . @ @ . . . . . @ @ @ . @ . . . . . . @ . . @ @ . . . @ @ @ @ @ @ . . . . . . . @ . @ @ . @ . . . . . @ . @ @ . @ . . @ . . . . . . . @ . @ . @ . . . @ . @ @ . @ . @ @ @ . . . @ 
@ . . @ . . . . . . . . . . . @ . @ . . @ . . @ . @ . @ . @ @ . @ . @ . @ . @ @ @ @ . @ . @ . @ @ @ . . @ @ . . . @ . @ @ . . . . . @ @ @ . @ @ . @ . @ . @ . . . @ . @ . @ . . . @ . . . . . . . @ @ @ 
@ . @ @ @ . @ . @ . @ @ . @ . . @ . . @ . @ . . @ . . @ @ . . . . . @ @ . @ @ @ . . . . . @ @ . @ . . @ @ . . @ . . . . @ . @ . @ @ @ @ . . @ @ @ @ . . @ @ @ . @ @ . @ @ . @ . @ . . @ @ . @ @ . . . @ 
@ . @ @ . . @ @ . . @ . @ . . @ . . @ @ . . @ @ . . @ . . . @ . @ . . . . @ @ . . @ . @ . . @ . . @ @ . . . @ . . @ . @ . . . @ . . @ @ . @ @ @ . @ . @ . . @ . . . . . . . . . . @ . @ . . . . @ . @ @ 
@ @ . . @ . @ @ . @ . . . . @ . @ . @ . . @ @ . . @ . @ @ . . @ @ . @ . @ . . . @ @ . . @ . @ . @ @ @ @ @ @ . @ . . @ . . @ . . @ . . . @ @ @ . . . . . @ . @ @ @ . @ . @ . @ . @ @ . . @ @ . @ . . . @ 
@ @ . @ @ @ . . . . @ . @ . @ . . . @ . @ . . @ . . . . . @ . @ @ . . @ . @ . @ . . . @ @ . . . . @ @ @ . . . . . @ . @ . . @ . . . @ . . @ . . @ . @ . . . . . @ . @ . . @ @ . @ @ @ . . . @ . @ . @ @ 
@ . . . @ . . @ . @ . @ . . @ . @ . . . . . @ @ . @ @ . @ . . @ . . @ . . @ . @ . @ . @ . . @ . @ @ @ . . @ . @ . . . @ . @ . . @ @ . . @ @ @ . . @ @ @ . @ . @ . . @ . @ @ . @ . . . @ . @ @ . @ . . @ 
@ . @ . . . @ @ . @ . . . @ . @ . . @ . @ . @ @ . . @ . . @ . . @ . . . @ . @ . . . @ @ @ . . @ . @ . @ @ . . . @ . @ @ @ @ @ . . @ @ . . @ . . @ @ @ . . . @ . . @ . . . . . . . @ @ . . . @ . . . @ @ 
@ @ @ @ . @ . . @ . @ @ . . . @ . @ . . . @ @ @ . @ @ @ @ . @ . . @ . @ . . . . @ . @ @ . @ . . . . . . . @ . @ @ @ @ @ . @ . . @ @ @ @ . . @ . . @ . . @ . @ @ . . @ . @ . @ . @ . . @ . @ @ @ @ . @ @ 
@ . @ @ . @ @ . . . . . . @ @ . . @ @ . @ @ @ @ @ @ @ @ @ . @ . @ . . . @ . @ . @ . @ . . . . @ . @ . @ @ @ @ @ @ @ @ @ . . @ . @ . . . . @ @ @ . . @ . @ . @ @ . @ @ . . @ . . @ @ . . . @ @ @ @ . . @ 
@ . . . @ . . . @ . @ @ . @ . @ . . . @ @ @ @ @ @ @ @ @ . . . . . @ . @ . @ . . . @ . @ . @ . . @ . . . . . . @ @ @ @ . @ . @ . @ @ . @ . . @ . . @ @ @ . @ . . . @ . . @ . @ . . . @ @ . . . . @ . @ @ 
@ . @ @ . @ . @ . . . @ @ . . . . @ @ @ @ @ @ @ @ @ @ @ . @ . @ . . @ @ . . . @ . . . . @ . . @ . @ @ . @ . @ @ . @ . . . . . . . @ @ . . @ . . @ . @ . . . @ . @ @ @ . . . . @ . @ . @ . @ @ . @ @ @ @ 
@ . . . . . . @ @ . @ @ @ @ . @ . @ @ @ @ @ @ @ @ @ @ . . . @ @ @ @ . . . @ . . @ . @ @ . @ . . . . . @ . @ @ . . . @ . @ . @ . @ . . @ . @ @ . . . . . @ @ . . @ @ @ @ . @ . . @ . . . . . . @ @ @ @ @ 
@ @ . @ . @ . . @ @ . @ @ @ @ . . . @ @ @ @ @ @ @ @ . @ . @ . @ @ . . @ . . @ . @ @ . . . . . @ . @ . . . @ . @ . @ . @ @ . @ @ . @ . . @ . . . @ . @ . . . @ @ @ @ @ @ . . @ @ . @ . @ . @ . @ @ @ @ @ 
@ @ @ . . . @ . . . . . @ . @ . @ @ @ @ @ @ . @ @ . . . . . . @ . . @ . . @ . @ . @ . @ . @ . . @ . . @ @ . . . . . . . . . . @ . . . @ @ . @ @ . . . @ . @ @ @ @ @ @ @ . @ . @ . . @ . . . @ @ @ @ @ @ 
@ @ @ @ . @ . . @ . @ @ . . . . . . @ . @ . . . . @ . @ . @ @ . . @ . . @ . . @ . . . . @ . . @ @ @ . @ @ . @ @ @ . @ . @ . @ . . @ . . . . @ . . @ . . @ @ @ @ @ @ @ . . . . . @ . . @ . @ @ @ @ @ @ @ 
@ @ @ @ @ @ @ . . @ . . @ . @ . @ . . . @ @ @ . @ . @ . . @ . @ . @ @ . . . @ . . @ . @ . @ . . . . @ @ . . . . @ @ . . @ @ . @ @ @ @ . @ . . @ . @ . @ @ @ @ @ @ @ . @ . @ . @ . @ . . . . @ @ @ @ @ @ 
@ @ @ @ @ @ @ . @ @ . @ @ . @ . . @ . @ @ . @ . @ . @ @ . . . . @ . . . @ . . @ . . @ . . . . @ . @ @ @ @ . @ . @ . . @ . . . . . @ . @ . . @ @ @ @ @ @ @ @ @ @ @ . . @ @ . . . . @ . @ . @ @ @ @ @ @ @ 
@ @ @ @ @ @ @ @ @ . . . . @ . . @ @ @ . @ . @ . . . . . . @ @ . . @ . @ . . @ @ @ . . @ . @ . @ . . @ @ . @ . . . @ . . @ . @ . @ @ . @ @ @ . @ @ @ @ @ @ @ @ @ @ @ . . . @ . @ @ . @ . @ @ @ @ @ @ @ @ 
@ @ @ @ @ @ @ @ . @ . @ @ . @ . . @ . . . . . . @ . @ @ . . . @ @ . . . @ . @ @ @ . @ @ . . @ . . @ @ . . . @ . @ . . @ . . . @ @ . . . . . . @ @ @ @ @ @ @ . @ @ . @ . @ . . . . . . . @ @ @ @ @ @ @ @ 
@ @ @ @ @ @ @ . . . . . . . . . @ . @ . @ . @ . . @ . . . @ @ . . . @ . @ . @ . @ . @ . @ @ . . @ @ . @ . @ . @ . . @ . @ . @ . @ . @ . @ . @ @ @ @ @ @ @ @ . . . . . . . . @ . @ @ . @ @ @ @ @ @ @ @ @ 
@ @ @ @ @ @ @ . @ . @ @ . @ . @ . . . . . @ . . @ @ . @ . @ @ . @ . . @ . @ . . . . . . @ @ @ @ . . . . . . . . @ . . . . . . . . . . @ @ . . . @ @ @ @ @ @ . @ @ . @ . @ . @ . . @ @ @ @ @ @ @ @ @ @ @ 
@ @ @ @ @ @ @ @ @ @ . . . @ . . @ @ @ . @ . @ . . . @ . . . @ @ . . @ . . . . @ . @ . @ @ @ @ @ @ . @ . @ @ . @ . @ . @ . @ . @ @ . @ . . . @ @ @ @ @ @ @ @ @ @ @ @ . . . @ . . @ @ @ @ @ @ @ @ @ @ @ @ 
@ . @ @ . @ @ . @ . . @ . . @ @ @ @ @ @ . . @ @ . @ . @ . @ . . @ . @ @ @ . @ . . . @ . @ @ @ @ . . @ @ @ . . . . . . . @ @ . . . @ . . @ . . . @ . @ . @ . . . @ @ @ . @ . . @ . @ @ @ @ @ @ @ @ @ @ @ 
@ . . @ . . . . . . @ @ @ @ @ @ @ . @ . @ . @ . @ @ . @ . @ @ . . . . . . @ @ @ . @ @ . . @ @ @ @ . @ . . @ @ . @ @ @ . . . @ . @ @ . @ . . @ . . . . . . @ . @ . @ @ @ @ @ . . . @ @ @ @ . @ @ @ @ @ @ 
@ . @ . @ . @ . @ . @ @ . @ @ @ . . . . . . . . . . . . . . @ . @ . @ @ . . @ @ . @ @ @ . . @ @ . . . . @ . . . @ . @ @ . @ . . @ @ @ @ @ . @ . @ . @ @ . . . . . . @ . @ . @ . @ . @ . @ . @ @ @ @ @ @ 
@ . . . . . . @ . . . . . @ . . @ . @ . @ @ . @ . @ . @ . @ @ @ . . . . @ @ . @ . @ @ @ . @ . . @ . @ . @ @ @ . . . . . @ . . @ . @ . @ . @ @ @ . @ @ @ . @ @ . @ . @ . . . . . @ . @ . . . @ @ @ @ @ @ 
@ . @ @ . @ @ . @ . @ . @ @ @ . @ @ . . @ . @ . . . @ . . . @ . . @ . @ . . . . . . @ . . . . @ @ . . @ . @ @ . @ . @ . @ @ . . . . . . . . . . . . @ . @ . @ . . @ . . @ . @ . . . . . @ @ . @ @ . @ @ 
@ . @ . @ . . . . . . @ @ @ . . . . . @ . . . . @ @ . @ . @ . @ . @ . . @ @ . @ . @ . . @ . @ . . @ @ @ . . @ . . @ . . @ . . @ . @ @ . @ . @ . @ . . . . . @ . @ . @ . . @ . . @ . @ . . . . . . . . @ 
@ @ . . . . @ @ . @ . @ . @ . @ . @ . @ @ . @ . @ @ . . . @ . . . @ . @ . @ @ . . . . @ @ . @ . @ . @ . @ . . . @ @ @ . @ @ . . @ . . @ . @ . @ @ @ @ . @ . @ @ . . . . @ @ . @ . . . @ . @ . @ . @ . @ 
@ . @ @ . @ . . . @ . @ . @ @ @ @ . . . @ @ . @ . . . @ . . @ @ . @ . . . . . @ . @ . . @ @ . . . . . . . . @ @ . @ @ @ . . . @ @ @ . @ . @ . @ @ @ . . . @ . @ @ . @ . @ @ . . @ . @ @ . . @ . . @ . @ 
@ . @ . @ . . @ . . @ @ . @ @ @ . @ . @ . . . @ @ . @ . . @ . . . @ @ . @ @ @ @ . . @ . . . @ . @ @ . @ @ . . . . . @ . . @ . . @ . . . . . . . . . @ . @ . . . @ . @ @ . . . @ @ @ @ . . @ . @ @ @ . @ 
@ . . . . . @ . . @ @ . . . . . . . . @ . @ @ @ @ . . @ . . @ . @ @ @ . . @ . @ . @ @ @ . @ @ @ . . . . @ @ . @ . @ @ @ . . @ . . . @ @ @ @ . @ . @ . . @ @ . @ . @ . . @ @ . . @ @ @ @ . . . . . . @ @ 
@ @ @ . @ . @ @ . . . @ . @ . @ @ @ . . . @ . . @ @ @ . . @ . . . @ . . @ . . . . . @ . . . @ . @ . @ @ . . . . @ @ @ @ . @ @ . @ . . . . . @ . @ . @ . . . . . . . @ . . . . @ @ @ @ . . @ . @ . @ . @ 
@ . @ . . @ . . . @ @ . @ . . @ . . . @ . . . @ @ @ @ @ . @ @ @ . @ @ . @ @ . @ . @ . . @ . @ . . . @ . . @ . @ @ @ @ . @ @ @ @ . @ . @ @ . . . @ . . @ . @ . @ . @ . @ @ . @ . @ @ @ @ . . @ . . . . @ 
@ . . . @ @ . @ . @ @ . . @ . . @ @ . @ @ . @ . @ @ @ @ . . . @ . @ . . . @ @ . . @ @ . @ . . @ @ . @ . @ @ @ @ @ @ . . @ @ @ . . @ . . . @ . @ . @ . @ . . @ . @ @ . . @ . . . @ @ @ @ . @ . @ @ . @ @ 
@ . @ . @ . @ . . . . @ . . . @ @ . . . . @ @ . . . @ . @ . @ @ . . @ . @ . . . @ @ . @ @ @ @ . . . @ . @ . @ . @ . @ . . @ . . @ . . @ @ . . . . . . . @ . . . . . @ . @ . @ @ @ @ @ @ . . . . . @ . @ 
@ @ @ @ . . . . @ . @ . . @ . @ @ . @ @ @ . . @ @ . @ . @ . . @ . @ @ . . @ @ . . . . @ @ . . . @ . @ . @ . . . . . . . @ . @ . @ @ . . @ @ . @ . @ . @ . . @ . @ . @ . . . . . @ @ @ @ . @ . @ . . . @ 
@ . @ . @ . @ . @ . . @ . @ @ . . . @ @ @ @ . . . . . . . . @ . . @ . . @ @ @ @ . @ . . . @ . @ . . @ @ @ . @ . @ . @ . . . . . . . . @ @ @ . @ . . @ @ @ . . @ . . @ . @ . @ . . @ @ . . . @ . . @ @ @ 
@ . @ . @ @ @ @ . . @ @ @ . . . @ . @ @ @ @ . @ . @ @ @ . @ . @ @ . @ . . . @ @ @ . . @ . . @ @ . @ . . . @ . . @ . . @ . @ @ @ . @ . . . . @ . . @ . @ @ . @ . . @ @ . @ . . @ . . @ . @ @ . @ . . . @ 
@ . . . @ . @ . . @ @ @ @ . @ @ . . . . @ . @ . . @ . . . . . . @ . . . @ . . @ . . @ @ . @ . @ @ . . @ . @ . @ . . @ @ . . @ @ @ . . @ . @ @ @ . . . . . @ . @ . . @ @ . . @ . @ @ @ . . . . . @ . @ @ 
@ @ . @ @ . . @ . @ @ @ @ @ @ . . @ . @ . . . @ . @ @ . @ . @ @ . . @ . . @ . . @ . . @ . . . . . . @ . . . @ . . @ . @ @ @ . @ . @ . @ @ . @ . @ @ . @ @ @ . @ . @ . @ @ . . . . @ . @ . @ . @ @ . . @ 
@ . . . @ @ . . . . @ @ @ . @ @ . @ . . . @ @ @ @ . . . @ . . . @ . @ . @ @ . @ . . @ . . @ . @ . @ . @ . @ @ . @ . . . . . . . . . . . . . . . . . @ @ . . . . . . . . @ . @ @ . . . @ . . @ . . @ @ @ 
@ . @ @ @ . . @ . @ @ @ . . . . . @ . @ @ @ @ @ . @ . @ . . @ . . @ . . . . @ @ @ . . @ . @ @ @ @ @ . . . @ . @ . @ . @ . @ . @ . @ . @ @ . @ . @ @ @ . . @ . @ . @ . @ @ @ @ . . @ . @ . @ . @ . @ . @ 
@ . @ . @ . @ . . . @ @ @ @ . @ . @ @ . . @ . . . . . @ . @ @ . @ . @ . @ . . @ . . @ @ @ @ @ @ @ @ @ @ . @ . . . . . @ @ . . @ . . @ @ @ @ . . @ . @ . @ @ . @ . . @ @ @ @ . @ . @ . @ . . . . . . . @ 
@ . . . . . . @ . @ @ @ @ @ @ . . . @ @ . . . @ . @ . . @ @ @ @ . . . . @ . @ @ @ . @ @ @ @ @ @ @ @ @ @ . @ @ . @ @ @ . . . @ . . @ . @ @ @ @ . . . @ @ . . . . @ . @ @ @ . . . . @ . @ . @ @ . @ . @ @ 
@ @ . @ . @ @ . . @ @ @ @ @ @ @ . @ . . . @ . . @ @ @ @ @ @ @ @ @ . @ . . @ @ @ @ @ @ @ @ @ @ @ @ @ @ @ @ . . . @ . . . @ @ @ @ . . . . @ @ @ @ . @ @ @ @ . @ @ . . . . . @ . @ . @ @ @ . . . @ . . . @ 
@ @ @ @ @ @ @ @ @ @ @ @ @ @ @ @ @ @ @ @ @ @ @ @ @ @ @ @ @ @ @ @ @ @ @ @ @ @ @ @ @ @ @ @ @ @ @ @ @ @ @ @ @ @ @ @ @ @ @ @ @ @ @ @ @ @ @ @ @ @ @ @ @ @ @ @ @ @ @ @ @ @ @ @ @ @ @ @ @ @ @ @ @ @ @ @ @ @ @ @ 
3
53 76 98 92
55 40 74 87
14 75 64 49
