50 50
@ @ @ @ @ @ @ @ @ @ @ @ @ @ @ @ @ @ @ @ @ @ @ @ @ @ @ @ @ @ @ @ @ @ @ @ @ @ @ @ @ @ @ @ @ @ @ @ @ @ 
@ . . @ @ @ @ @ @ . . . @ @ @ @ @ @ @ @ @ @ @ @ @ @ @ @ @ @ @ . @ . @ . . . @ @ @ @ . . @ @ . . @ @ 
@ @ . . @ . @ @ . @ . @ . @ @ @ @ @ @ @ @ @ @ @ @ @ @ @ @ . . . . . @ . @ . @ . @ . @ . @ . @ . . @ 
@ . . @ . . . @ . . . . . . . @ @ @ @ @ @ @ @ @ @ @ . @ @ @ . @ @ . . @ . . . . . . @ . . . . @ . @ 
@ . @ . @ . @ @ @ @ . @ . @ . @ @ @ @ @ @ @ @ @ @ . . . @ . @ . @ . @ . @ . @ @ @ . @ . @ . @ . . @ 
@ . . . . . . . . . . . @ @ . . . @ @ @ @ @ @ @ . @ . @ . . . . . . . . . . . @ @ . . . . @ @ @ . @ 
@ @ . @ . @ . @ @ . @ . . @ . @ . @ @ @ @ @ @ . . @ . . @ . @ . @ . @ . @ . @ . . . @ . @ . @ . . @ 
@ . . . @ . . . . @ @ . @ . @ . @ @ @ @ . @ . @ . . . @ . . @ @ @ @ . . . @ . . @ . . @ . . . @ . @ 
@ @ . @ @ @ . @ @ . . . . . . . . @ @ . . . . . @ @ . . . @ @ @ @ @ @ . @ . . @ . . @ . . @ @ . . @ 
@ @ @ . . . @ @ @ . @ . @ . @ @ . . @ . @ @ . @ . @ . @ @ . @ @ @ @ . @ . @ . @ @ . @ . @ . @ . @ @ 
@ @ . . @ . @ @ . @ . . . @ @ @ @ @ . @ . . . . . . . . . . @ @ @ . . . . . @ . . . . . . . . . . @ 
@ . @ . @ @ . . . @ @ . @ @ @ @ . @ . . . @ . @ . @ @ . @ . . @ . . @ . @ @ . @ . @ @ . @ . @ . @ @ 
@ . . . @ . . @ . @ . . . @ . . . . @ . @ . . . @ @ . . . @ . . @ . . @ @ . . . . . @ . . @ @ @ @ @ 
@ @ @ . . . @ @ @ . @ . @ . @ @ @ . . . . @ . @ @ @ . @ . @ . @ . . @ @ @ . @ @ . @ . . @ . @ @ @ @ 
@ . @ @ . @ . @ . . . . . . . . . . @ . @ . . . @ . . @ . . @ . @ . . . @ . @ @ . . @ . @ . . . @ @ 
@ . . . . . . . . @ . @ . @ @ . @ @ . . @ @ . @ . . @ @ . @ @ . . @ . @ . . @ @ . @ . . . . @ . @ @ 
@ . @ . @ . @ . @ . . . @ @ . @ @ . . @ . . . @ @ @ . @ . . . @ . . . . . @ . @ . @ @ . @ @ . @ @ @ 
@ . @ @ . . . @ @ @ . @ . @ . @ . @ . . @ @ . @ . . . . . @ @ . . @ . @ @ @ . . . . . @ . . . @ @ @ 
@ . . @ @ . @ . @ . @ . . . . . . . . @ . @ . @ @ @ . @ . . . @ @ . . @ . . @ @ . @ . @ @ . @ . @ @ 
@ @ @ . @ . . . @ . @ @ . @ @ . @ @ . . . . @ @ @ @ @ @ @ @ . . @ @ @ . @ . @ . @ @ @ . . . . . . @ 
@ @ . . . . @ @ . . . . . @ . @ . . . @ . @ . @ . @ . . . . . @ @ @ . . . . . . @ . . . @ @ . @ . @ 
@ . @ . @ . @ . @ . @ . @ . . . . @ @ @ . . . . . @ . @ . @ . @ @ @ @ @ @ . @ . @ . @ . . . @ . . @ 
@ . . . @ @ . . . . . @ @ @ . @ @ . @ @ . @ . @ . . @ . @ . . @ @ @ @ . . . . @ . . . @ . @ . @ . @ 
@ @ . @ . . . @ @ . @ @ @ @ . . . . . @ @ @ . @ @ @ @ . . @ . . @ @ @ @ @ . @ . @ . @ . @ . . . @ @ 
@ . . . @ . @ . . . @ @ @ @ @ . @ . @ @ @ . . . . . . @ . . . @ @ @ @ . . . @ . . . . . . @ @ . @ @ 
@ @ . @ . @ . . @ . @ @ @ @ @ @ . . . @ . @ . @ . @ @ . . @ . @ . @ . @ @ . . . @ . @ @ . @ . . . @ 
@ @ @ . . . . @ . . . . @ @ @ . @ . @ @ . . . . @ @ @ @ @ . . . . . . . . @ . @ . @ @ . @ . @ . @ @ 
@ @ . . @ . @ @ @ . @ . . @ . . @ . @ . . @ . @ . @ @ @ . @ . @ . @ . @ . . . . . . . . . . . . . @ 
@ . . @ . . @ @ @ @ . @ @ @ @ . @ . . @ @ . . . . . @ . . . . . @ . . . @ . @ . @ @ . @ @ . @ . @ @ 
@ @ . . @ @ @ @ @ @ . . . @ . . . . @ @ . @ . @ . @ @ @ . @ . @ @ @ . @ @ . . @ . @ . . @ . . @ @ @ 
@ . . @ . @ @ @ @ . @ . @ . @ . @ . @ . . . . . @ @ @ @ @ . . . @ @ . . . @ . . . . @ @ @ . @ . @ @ 
@ @ . . . @ . . . . . . . . . . @ . . @ . @ . @ . @ . @ @ @ . @ . @ . @ . @ . @ @ . . . @ . . . @ @ 
@ . . @ . . @ . @ . @ @ @ @ . @ . . @ . @ . . . . . . . . . @ . . @ @ . . . @ @ . @ . @ . . @ @ @ @ 
@ . @ . . @ . . @ @ @ @ . @ . @ @ @ . . . @ . @ . @ . @ . @ . @ . @ . . @ . @ . . . . . @ @ @ @ @ @ 
@ . . @ . . @ @ . . . . . . . . . . @ @ . @ @ @ . @ . @ . . . . . @ @ . @ . . @ @ @ . @ @ @ @ @ @ @ 
@ . @ . . @ @ . @ . @ . @ @ . @ @ . . @ . . @ @ . . @ . . @ . @ @ . . . @ . @ . @ @ @ @ @ @ @ @ @ @ 
@ . . @ . @ . . . . @ @ . @ . @ . @ . . @ . @ @ . @ . @ . @ @ . @ @ @ . @ . . . . @ @ @ @ @ @ @ @ @ 
@ @ . @ . @ . @ . @ . . . . . . . . @ @ . . . . . . . . @ . . . . @ . @ @ . @ . @ @ @ @ @ @ @ @ @ @ 
@ . . . @ @ @ . . . @ @ @ @ . @ . @ @ . @ . @ @ . @ @ . @ @ . @ @ . . . . . @ . . . @ @ @ @ @ @ @ @ 
@ @ . @ @ @ . @ . @ . . . . . . @ . . . . . @ @ @ . . . . . . . . @ . @ . @ . . @ @ . @ @ @ @ @ @ @ 
@ . . . @ . . . . . @ . @ @ . @ . . @ . @ . . . @ @ @ . @ . @ @ @ @ @ @ . @ @ . . . . . @ @ @ @ @ @ 
@ @ . @ @ @ . @ . @ @ @ . . . . @ . . @ . . @ @ . . . . . @ @ . @ @ . @ . . @ . @ . @ . @ @ @ @ @ @ 
@ @ . . @ . . . @ @ @ . @ . @ @ . . @ . @ . . @ @ . @ . @ . . . . . . . . @ . . . @ . @ @ @ @ @ @ @ 
@ . . @ @ @ . @ . . . . @ . . @ @ . @ . . . @ @ . @ . . @ @ . @ . @ . @ . . @ . @ . . . @ . @ @ @ @ 
@ @ . . @ . . @ @ . @ . . @ . . @ . @ @ . @ @ @ . @ @ . @ . . @ . . @ . . @ . . . @ @ . @ . @ @ @ @ 
@ @ @ . . @ . . . . @ @ @ . . @ @ @ . . . @ . @ . . @ @ @ @ . @ . @ @ . @ @ @ . @ . . . @ . @ . @ @ 
@ @ @ . @ . . @ . @ @ @ @ @ . . @ . . @ . @ . @ . @ . @ . . . . @ . . . . @ . . @ @ @ . . . . . . @ 
@ . . . . @ @ @ . . @ @ @ . . @ . . @ . . . . . . . . . @ @ . @ @ @ @ . @ @ @ . . . . . @ . @ . @ @ 
@ @ . @ . . @ . . @ @ @ @ @ . @ @ @ @ . @ . @ @ . @ . @ @ @ . . @ . . . . @ . . @ . @ . @ @ . . . @ 
@ @ @ @ @ @ @ @ @ @ @ @ @ @ @ @ @ @ @ @ @ @ @ @ @ @ @ @ @ @ @ @ @ @ @ @ @ @ @ @ @ @ @ @ @ @ @ @ @ @ 
3
21 26 37 2
37 39 11 18
15 42 42 11
