10 10
@ @ @ @ @ @ @ @ @ @ 
@ @ @ @ @ . . . @ @ 
@ @ @ @ . @ @ . @ @ 
@ @ @ . . . @ . . @ 
@ @ @ @ . @ @ @ . @ 
@ . @ . . . @ . . @ 
@ . . @ . @ . . @ @ 
@ @ . @ . @ . @ . @ 
@ . . . . . . . . @ 
@ @ @ @ @ @ @ @ @ @ 
3
8 4 4 8
3 7 7 6
5 7 3 3
