100 100
@ @ @ @ @ @ @ @ @ @ @ @ @ @ @ @ @ @ @ @ @ @ @ @ @ @ @ @ @ @ @ @ @ @ @ @ @ @ @ @ @ @ @ @ @ @ @ @ @ @ @ @ @ @ @ @ @ @ @ @ @ @ @ @ @ @ @ @ @ @ @ @ @ @ @ @ @ @ @ @ @ @ @ @ @ @ @ @ @ @ @ @ @ @ @ @ @ @ @ @ 
@ @ @ @ @ @ . . . . @ @ @ @ @ . @ @ @ @ @ @ @ @ @ @ . . . . @ . . @ . @ . . @ . . @ @ @ @ @ @ @ @ @ . . @ @ . . @ . @ . @ @ @ @ @ @ @ @ @ @ @ @ @ @ @ @ @ @ @ @ @ . @ . @ . @ . . @ . @ @ @ . . . @ @ @ 
@ @ @ @ @ @ . @ . @ . @ @ @ . . . @ . @ @ @ @ @ @ @ @ . @ . . . @ . . . @ . . . @ @ @ @ @ @ @ @ @ . . @ . . . @ . . . . @ @ @ @ @ @ @ @ @ @ @ @ @ @ @ @ @ @ @ @ . . @ . @ . . . @ . . . @ . . @ @ . @ @ 
@ @ @ @ @ @ . . @ @ . . @ . . @ @ . . @ @ . @ . @ @ @ @ . @ @ . @ @ . @ @ . @ . . . @ @ @ @ @ @ . @ . @ . @ . @ @ @ . @ . @ @ @ @ @ @ @ @ @ @ @ @ @ @ @ @ @ @ . . @ . . @ . @ . . @ . @ . @ . . @ . . @ 
@ @ @ @ @ @ . @ . . . @ . @ . @ @ @ . . . . . . . @ @ . . @ . . @ @ . . . @ . . @ @ @ @ @ @ @ @ . . . . @ @ . . @ @ . . . . @ @ @ @ @ @ @ @ @ @ @ @ @ @ @ . . @ . . @ . . @ . . @ @ . @ . . . @ . . @ @ 
@ @ @ @ @ @ . . . @ @ . . . . . . . @ @ . @ . @ @ . @ @ . @ @ . . @ . @ @ @ @ . @ @ @ @ @ @ @ @ . @ . @ . . . @ . . @ @ . @ @ @ @ @ @ @ @ @ @ @ @ @ @ @ . @ . @ @ . . . @ . @ . @ @ . . . @ @ . . @ . @ 
@ @ @ @ . . . @ @ . @ . @ . @ @ . @ @ @ @ . . . . . . . . . . . @ @ . . @ . . . . @ @ @ @ @ @ . @ . . . . @ @ . @ . . . . . @ . . @ @ @ @ @ @ @ @ . @ . . @ . . . . @ @ @ . @ . . . @ . @ . @ . @ . . @ 
@ @ @ . @ @ . . . . . . . @ . . @ @ . @ . @ @ . @ . @ . @ @ @ . . . . @ . . @ . @ @ @ @ @ @ . . @ . @ @ . . . . . @ @ @ . @ . @ . . @ @ @ @ @ @ . . . @ . . . @ @ . . . . . . @ @ . . . . . . . . . @ @ 
@ @ @ . @ . . @ . @ @ @ . . . @ @ . . . . . @ @ . . . @ @ . . . @ @ . . @ @ . . . . @ @ @ . @ . . @ . @ . @ @ . @ . @ . . . . . . @ @ @ @ @ @ . @ . @ . @ . @ . . @ . @ @ @ . @ . . @ . @ @ . @ @ @ @ @ 
@ @ . . . @ . @ . . @ @ @ @ @ . . @ @ @ . @ . @ @ . @ @ @ . @ . @ . @ @ @ @ . @ . @ . @ @ . . . @ . . . @ . . . . . . . @ @ @ @ . . @ @ @ . . . . . . . . . . @ . @ @ . . @ . . @ . @ . . . @ . . . @ @ 
@ . @ @ . . . . @ @ . @ @ . @ . @ . @ . . @ . . . . . @ . . . @ @ . . @ . . @ @ . . . @ . . @ @ . . @ @ . . @ . @ . @ @ . @ . . . @ . @ . @ @ . @ @ . @ . @ . . . . . @ . @ . @ . . . @ . @ @ . @ . @ @ 
@ . @ . @ @ . @ . @ . @ . . . . . . . @ . @ @ . @ . @ . @ . @ . . @ . . . @ . . . @ @ . @ . . @ . @ @ . @ . @ @ @ @ @ . . . . @ @ . . @ . @ . . . . @ . . . @ . @ . @ . . . @ . . @ . @ . . @ . @ . . @ 
@ . . . . . . . . . . . @ . @ . @ @ . @ . . @ . @ @ . . . . @ . @ . . @ @ . @ . @ . @ . @ . @ . . . @ . . @ @ @ . . @ . @ . @ . . @ . . . . . @ . @ @ @ . @ @ . . @ @ . @ . . @ @ . . @ . @ @ @ . . @ @ 
@ . @ . @ @ . @ . @ @ @ @ . . @ . . . @ . @ . . @ . @ . @ . @ . . @ . . @ . . . . . . . . . . . @ . . . @ @ @ @ @ . . . . @ @ . @ @ . @ . @ @ . @ . @ . . . . @ . . @ . @ @ @ . . @ . @ . . @ @ . @ . @ 
@ @ @ @ . . . . @ @ @ @ . @ . . @ @ . @ . . @ . @ . . . @ . @ . @ . . @ @ . @ @ . @ . @ . @ @ . . @ . @ @ @ @ @ . . @ @ @ . @ . . . @ . . @ . . . . @ . @ . @ @ @ @ . . . @ . @ . . . . @ @ . . . . . @ 
@ @ . . @ . @ . . @ . . . . . @ . . @ . @ . . @ . @ . @ . . @ . . . @ . . . . @ @ . @ . . . . @ @ . @ @ @ @ @ . @ . . @ @ . @ . @ . . @ . @ @ . @ . . @ . . . @ @ . @ . @ @ . @ . @ . @ @ . @ . @ @ @ @ 
@ @ @ . . . . @ . . @ . @ @ . . @ . . . . . @ . . . . . @ . @ . @ @ . . @ . @ . . . @ @ . @ @ . . . @ @ @ . . . @ . @ . @ . . . @ . @ . . . . @ . . @ . @ . @ @ . . . . . . . @ @ . . . . . . . @ @ @ @ 
@ @ . . @ . @ . . @ . @ . @ . @ . @ @ . @ . . . @ @ . @ . . . . . . . @ . . . . @ @ . @ . @ . @ . @ . . @ . @ . . . @ . . . @ @ @ @ . @ . @ . . @ . @ . . . . @ . @ . @ . @ . @ . @ . @ @ @ . @ @ @ @ @ 
@ @ . @ . . . @ . @ . . . . . . . . @ @ @ . @ @ . . . @ . @ . @ @ . @ @ @ . @ . . @ . . @ @ . . . . . @ . @ . @ @ . . . @ @ @ . @ . . . @ . . @ . . . @ @ . @ . @ @ @ @ @ . . . . . . @ . . @ @ . @ @ @ 
@ @ @ . @ . @ . @ @ . @ . @ @ @ @ . . @ . @ . @ . @ @ @ @ . . . . @ @ @ . . . @ . @ . @ . @ . @ . @ @ . . @ . . . . @ . . . @ . @ @ . @ @ @ . . @ . @ . @ . . . @ @ @ @ @ @ . @ . @ . . . @ @ @ . . @ @ 
@ @ . . . . . . . @ @ . . @ . . . . @ . . . . . @ @ . . . @ . @ . . @ . @ . @ @ @ . . @ . @ . . @ . . @ . @ . @ . @ . @ . @ . . . @ . . @ . . @ . . . . . @ . @ @ @ @ . @ . . @ @ . . @ @ . @ . . @ @ @ 
@ @ @ . @ . @ . @ . @ @ . @ . @ @ . @ . @ @ . @ @ . @ @ . @ @ . . @ . . @ . . @ . @ . @ . . . @ . @ . . . . @ . . . . @ . @ @ . @ . . @ @ @ . . . @ @ . @ @ . @ @ @ @ . . @ . @ . @ . @ @ . . @ . . @ @ 
@ @ @ @ . . . @ @ . . . . . @ . @ . @ @ @ @ . @ . . . @ . @ . @ . @ @ . . @ @ . . @ . . . @ . @ . . @ @ . @ . @ . @ @ . @ . . . . @ . @ @ . . @ @ . @ . . . @ @ @ . @ . @ @ . . . . @ . @ . @ . . @ @ @ 
@ @ @ @ @ . @ . @ . @ @ . @ . . . @ . . @ . . @ @ @ . . . . . . . . . . @ @ . . @ . @ . @ . @ . . @ . . . . . . . . . . . @ @ @ . . . . . @ . . @ . . @ . @ . . @ . . . . . . @ . @ . . . . . @ . . @ @ 
@ @ @ @ . . . . . . @ . @ @ @ . @ . . @ . @ . . @ . @ @ . @ . @ @ @ @ . @ . @ . . . . . . . @ @ . . @ . @ . @ @ . @ . @ @ . . . @ @ . @ @ . . @ . . @ . @ @ @ . . . @ . @ . @ @ @ . . @ @ . @ . . @ @ @ 
@ @ @ . @ . @ . @ . @ . @ @ . . . . @ @ . @ . @ . . . @ @ . @ . . @ . . @ . . @ . @ @ . @ . @ @ . @ . . @ @ @ @ @ . . @ @ . @ . @ . . . . @ . @ . @ . . . @ . @ @ . . @ . @ @ @ . @ . . . @ . . @ @ @ @ 
@ @ . . . . . @ . . . . . @ @ . @ . . . . . . . . @ @ . @ . . @ . . @ . . . @ @ . . @ @ . . . @ . @ . @ @ @ @ . . . @ . . . . @ . @ @ @ . . . . . . . @ . @ . . . . @ @ . @ . . . . . @ @ . @ . . @ @ @ 
@ @ @ . @ . @ . @ . @ @ . @ . . @ @ . @ . @ . @ . @ . . @ . @ @ @ . @ . @ @ @ @ @ . @ . @ @ . . . . . . @ @ @ @ . @ . . @ @ . . . . . @ . @ . @ . @ @ @ @ . . @ . @ . . . . @ @ . @ . . . . . . @ @ @ @ 
@ @ @ @ . . . . . @ . @ . . @ . @ . @ @ @ @ . . @ @ @ . @ . @ @ . . . . . . @ @ @ @ . . . @ @ . @ . @ @ @ @ @ @ @ @ @ . @ . . @ . @ @ . . @ @ @ @ @ @ @ . . @ . @ @ @ . @ . . . . . @ . @ . @ @ . @ @ @ 
@ @ @ . @ . @ @ @ @ . @ . @ . . @ . . @ @ . . @ . @ @ . . . . . @ @ @ @ . @ . @ @ @ . @ . . . . . @ @ @ @ @ @ @ @ @ @ @ . @ . . @ . . @ . @ @ @ @ @ @ @ @ . . . @ . . . . @ . @ . @ . @ @ . . . . . @ @ 
@ @ . . . . . @ @ . . . . @ . @ . @ . . @ . @ @ . @ @ . @ . @ . @ . . . . . . . @ . @ @ @ . @ . @ . . @ @ @ @ @ @ @ @ @ . @ . @ . . @ . . . . @ @ @ @ @ . @ . @ . @ @ . @ @ @ . . . . . @ @ . @ . @ @ @ 
@ @ @ . @ . @ @ @ @ . @ . . @ . . . . @ . . . . . . . . . @ . . @ @ . @ . @ . @ @ . . @ @ @ . . . . @ . @ @ @ @ . @ @ . . . . @ . @ . @ @ @ . . @ @ @ @ . . . . . . @ . @ @ @ @ . @ . @ @ @ @ . @ @ @ @ 
@ @ @ @ . . . @ @ @ @ . . @ @ @ . @ . . @ . @ . @ @ . @ . @ @ . @ . @ . . . @ @ . . @ . . @ @ @ @ . . . . @ @ . . . @ @ . @ . . . . . . @ . . @ . @ . . @ . @ @ . @ . @ @ @ @ @ . @ @ . . @ . . @ @ @ @ 
@ . . . @ . @ . @ @ . . @ @ @ @ @ . @ . @ @ . . @ . . . @ . . . . . @ @ . @ . . @ . . . @ @ . @ . @ . @ @ . @ . @ . . @ @ . . @ . @ . @ . . @ . . @ @ . @ @ @ . . . . . @ @ @ @ . @ . @ . . @ . @ . @ @ 
@ @ @ . . . . . @ @ @ . @ @ @ @ . . . . . . . @ @ @ . @ . @ . @ . @ . @ . . . @ . . @ . . . . . . . . @ . . . @ @ . @ . . @ . @ . . @ @ @ . . @ . @ . . . @ @ @ . @ . @ . . @ . . . . . . @ . . . . . @ 
@ @ . . @ . @ . @ @ . . @ @ @ @ @ . @ . @ @ . @ @ . . . . . @ . . . . . . @ . @ @ . @ @ . @ . @ @ @ @ . @ . @ . @ . . @ . @ @ . . @ . @ . . @ . . . @ . @ @ @ . . . @ @ . @ . @ @ @ . @ . . . @ . @ . @ 
@ @ . @ . . . @ . . . @ . @ . . @ @ . @ . @ @ . . @ . @ @ @ . . @ . @ @ . . @ . . . @ @ @ @ @ @ @ @ @ . . . . . . @ . . . . . @ . . . . @ . . . @ @ . . @ @ . @ . @ . @ . @ . @ @ @ @ @ . @ @ . @ @ @ @ 
@ @ @ . @ . @ . @ @ . @ . . @ . @ . . @ . . @ @ . . @ . . . @ . @ . . . @ @ . @ . @ . @ . . . . @ . . . @ . @ @ @ . . @ @ . @ . . @ @ @ . . @ @ . @ . @ @ . . @ . . . . . . . . @ . . . . . @ . . @ @ @ 
@ @ . . . . . . . @ @ . . @ @ . . @ . . . @ . @ . @ @ @ . @ . . @ . @ @ @ . . . . . . . @ . @ . . @ @ . @ . @ . @ @ . . @ @ @ @ . . @ . @ . . @ . @ . @ . @ . . . @ . @ . @ . @ @ . @ @ . @ @ . @ @ @ @ 
@ @ @ . @ . @ . @ @ @ @ . @ . . @ . . @ @ . . . . . @ . . @ @ . . @ . . @ @ . @ @ @ . @ . . . @ @ . . . @ @ . . . . @ . @ @ @ . . @ . . . . @ . . . . @ . . @ . @ . @ @ @ @ @ . @ @ . @ . . . . . @ @ @ 
@ . @ @ . . . @ @ @ @ . . @ @ . . @ . . @ . @ . @ . . @ . . . @ . @ . @ . @ . @ . . @ . @ . @ . @ @ . @ . @ @ @ . @ . . . . . @ . . @ @ @ . . . @ @ @ . . @ . . . . . @ @ @ . . . @ . . . @ . @ . @ @ @ 
@ . . . @ . @ . @ . . @ . . . @ . @ . @ . . . @ . . @ . @ . @ . . . . . . . . @ . @ . . . . . . . . . . . . . . . @ @ . @ . @ . . @ @ @ @ . @ @ . . @ . @ . . @ @ @ @ . @ @ @ . @ . . @ @ . @ @ @ . @ @ 
@ @ . @ . . . . . . @ . . @ . @ . . . . . @ . . @ @ . . . . . @ . @ @ @ . @ . . . . . @ . @ . @ . @ . @ @ . @ @ @ . . . @ . . . @ . . @ . . . @ . @ . . . . @ @ . . @ . . @ . . . . @ . . . . @ @ . . @ 
@ . . . @ @ . @ @ . . @ . @ @ . @ . @ . @ @ . @ @ @ @ . @ . @ . . . . @ . . @ . @ . @ . . . @ @ . . @ @ @ . @ . . @ @ . @ . @ @ . . @ @ @ . @ . . . . @ . @ @ @ @ . . . @ @ @ . @ @ . . @ . @ . @ . @ @ 
@ @ . @ . @ . @ . @ . . . @ . . . . . @ @ @ . @ @ @ @ @ . . @ @ @ . @ . @ . . @ @ . @ . @ . . . @ @ @ @ . @ @ . @ @ . . . @ . @ . @ @ @ . . . . @ . @ . @ @ @ . . . @ @ . @ . . @ . . @ . . . . . . @ @ 
@ . . . . @ @ @ . . @ @ . @ @ @ . @ @ . @ . @ . @ @ @ @ @ . . @ . . . . . @ . . . @ @ . . @ @ @ @ . . . . . . . @ . . @ @ @ . . . . @ . . @ . @ @ @ . . @ @ @ @ @ . . @ . . @ . . . @ . @ . @ @ . @ @ @ 
@ @ . @ . @ . . @ . @ . . . . @ . . @ . . . . . . @ . @ @ . @ . . @ . @ @ . . @ . @ @ @ . . @ @ @ @ . @ . @ @ . . @ . . @ . . @ . @ @ @ . @ . . . . . @ . @ . . @ . @ . . @ . . @ @ . . @ . . . @ @ @ @ 
@ @ . . @ . . @ . . . @ . @ . @ . @ . . @ . @ . @ @ . @ . . . @ . . @ @ @ . @ . @ @ @ @ . @ . @ @ @ @ . . . . @ . . @ . . @ @ . . . @ . . . @ . @ @ @ . . . . @ . . . @ . @ . @ . @ . @ . @ . @ @ @ @ @ 
@ . @ . @ @ . @ . @ . @ . @ @ . . . . @ @ @ . . @ @ . @ @ @ . . . @ @ @ . @ . . @ @ @ . @ . . . @ @ @ @ . @ . . @ . . . @ . . @ . @ . @ . @ . . @ . . @ . @ @ . . @ @ . . . . . . . . . . . @ . @ . @ @ 
@ . . . @ . . . @ . . . . . . . @ . @ @ @ @ @ @ . @ . @ . @ . @ . . @ . . . . @ . @ . . . @ . @ @ @ @ . @ @ @ @ . @ @ . . @ . . . . . . . . @ . @ . @ . . . @ . @ . . . @ . @ @ . @ @ . @ . . . . . . @ 
@ . @ . @ @ . @ . . @ . @ . @ . . @ @ @ @ @ @ . . . . . . @ @ . . @ . @ . @ @ . . @ . @ @ @ . . . @ . . . . @ . . @ . . @ @ @ . @ @ @ @ . @ . @ @ . . . @ @ . . . . @ . @ . @ @ @ @ @ @ @ . @ @ . @ . @ 
@ . @ . @ . . . @ @ @ . @ @ . . @ @ @ @ . @ . . @ @ @ . @ . @ @ . . . . . . @ . @ @ . . @ @ . @ @ @ @ . @ @ . @ . . @ . . @ @ @ . . . . . @ . . . @ @ . @ . . @ . @ . @ . . @ @ @ @ @ @ . . . . @ . . @ 
@ @ . . . @ . @ . . @ . @ @ @ . . @ @ . . . @ . . @ @ @ . . @ @ @ @ . @ . @ . . . . @ . . . . . @ @ . . . . . . @ . . . @ . . . . @ . @ . . . @ . . @ . . @ . @ @ @ . . @ . @ @ @ @ @ @ @ . @ . @ @ . @ 
@ @ @ @ . . . . @ . . @ @ @ . . @ @ @ . @ . @ . @ . @ @ @ . . @ . . . . @ @ . @ @ @ . . @ . @ @ . @ @ . @ . @ . . @ @ . @ . @ @ @ . @ . . @ . . @ . @ . @ . . . . . . @ . @ . @ @ @ @ @ @ @ . . @ . @ @ 
@ @ . . @ @ . @ @ . @ @ @ @ @ . @ . . @ . . . . . . . @ . @ . . @ @ . @ . . . @ . . @ . . @ . . . @ @ @ . . @ @ . @ . . @ . . @ @ . . @ . . @ . . @ @ . @ . @ . @ @ . . . . . @ @ @ @ @ @ @ @ @ . . @ @ 
@ . @ . @ @ . . @ . . @ @ @ . . . @ . @ @ . @ . @ . @ . . . . @ @ @ . @ . @ @ @ . @ @ . @ . @ . @ . @ . . @ @ @ . . @ . @ . @ . @ . @ . @ @ . . @ . @ . . . . @ . . . @ @ . @ @ @ @ @ @ @ @ . @ . @ . @ 
@ . . . . . . @ . @ . . @ . . @ @ . . . . @ @ . . @ . @ @ @ . . @ . . . . . @ @ . @ . . . . . . . . @ @ @ @ @ . @ . @ . @ . @ . . . . . . @ @ . . . @ . @ @ @ . . @ . . . @ @ @ @ @ @ @ @ . . . . . . @ 
@ @ . @ . @ . . . . . @ . @ . . @ . @ @ @ . @ @ . . . . @ . . @ . . @ . @ . . @ . . . @ . @ @ @ @ @ . . . @ . . . . . . @ . . . @ . @ . @ . @ . @ @ . . . . . @ @ . . @ . @ @ @ @ @ @ @ @ @ . @ . @ . @ 
@ @ @ . . @ @ . @ @ . . . . . @ . . @ . . . . @ . @ . @ @ @ . . . @ . @ . @ @ . @ . @ . @ @ @ . . . @ . @ . @ . @ . @ . . . @ . . @ . @ . . @ . . @ . @ @ @ . @ @ @ . . @ @ @ @ @ @ @ @ @ @ @ . . . @ @ 
@ @ @ . @ @ . @ . @ . @ . @ . . . @ . . @ . @ @ @ . . . @ . . @ @ . . @ . . @ . . . . . . . @ @ @ . @ . . . . @ . . @ @ . @ . @ . . . @ @ . @ @ @ . . . @ @ @ . @ @ . @ @ @ @ @ @ @ @ @ @ @ . @ . @ . @ 
@ @ @ @ @ . . . . . @ @ @ . @ @ . . @ @ . . . @ . . @ @ . . @ . . @ . . @ . . . @ . @ . @ . . . . . . . @ . @ @ @ . . @ . . . . @ . @ . . . . @ . @ . @ . @ . . . @ . @ @ @ @ @ @ @ @ @ @ . . . . @ . @ 
@ @ @ . . @ @ @ @ . @ @ . . @ @ . @ @ . @ . @ . @ . @ . @ . @ . @ . . @ . @ . @ . . @ . . @ . @ . @ . @ . . . @ . . @ . . @ . @ . @ @ @ @ . @ . . . . . . . @ . @ . @ @ @ @ @ @ . @ @ @ @ @ . @ . @ . @ 
@ @ @ @ . @ . @ @ . @ . @ . . . . . . . . . . . . . . . . . . . @ . @ . . . . . @ @ @ @ @ . @ @ @ @ @ @ @ . @ . @ @ . . @ . @ . . . . . . . . . @ . @ . @ . . . . . . . @ @ @ . . . @ . @ @ . . @ . . @ 
@ @ . . . . . . . . . . . . @ . @ @ . @ . @ . @ . @ . @ . @ @ . @ . @ @ . @ @ @ . . @ @ . . . @ . @ @ @ . @ . . . @ @ . . . . . @ @ @ @ @ @ @ @ . @ . . . @ @ . @ . @ @ @ . . @ . @ . . . @ . @ . @ . @ 
@ @ . @ . @ @ . @ . @ . @ . @ @ . . . . @ . . @ . . @ . . @ . . . . @ . . . @ . . @ . @ @ . @ . . . @ . . . @ . @ @ @ . @ @ @ . . . . . . . . . . @ @ . @ @ . @ . @ . . @ . @ . . . . @ . @ . . . . . @ 
@ @ . . @ . . @ . . @ . @ @ . . . @ . @ @ @ . . @ @ @ . @ . @ . @ @ . @ . @ . @ . . . . . . . @ . @ . @ . @ . . . @ . . . @ . . @ @ @ . @ @ @ . @ @ @ @ @ @ . . . . @ . . . . . @ @ . @ . . @ . @ @ @ @ 
@ @ . @ @ @ . @ @ @ . @ . . @ @ @ . @ . @ @ @ @ . . . @ . . . . . . . . . . . . . @ . @ . @ . . . . . . . . . @ @ . @ . @ . @ @ @ . . @ . . . @ @ @ @ . @ @ @ . @ @ . . @ @ . @ . @ @ . @ . @ . . . . @ 
@ . . . @ . . . @ . . . @ . . . . . @ . . @ @ . . @ . @ @ . @ . @ . @ @ @ . @ . @ . @ . @ @ @ @ @ @ @ @ . @ . . . . . . @ . . . . @ . . @ . @ . @ . @ . @ @ . . . @ . @ . @ @ . . @ . . . @ . . @ @ . @ 
@ @ @ @ . @ . @ . @ . @ . . @ . @ . . . @ @ . @ . @ @ . . @ . . . @ . @ @ @ . . . . . . . . . . . . . @ . . @ @ . @ @ . . . @ @ @ @ . @ . . . . . . . . . . @ . @ . . . . . @ . @ . @ . @ . @ . . . @ @ 
@ . . . . . . . . . . . . @ . . @ . @ . . . . . . . . . @ . @ . @ . . . @ @ @ . @ . @ . @ @ . @ . @ @ @ . @ . . . @ @ . @ . . . . . . . . @ @ @ @ @ @ @ @ @ . . . . @ . @ . . . . . . . . . . . @ @ . @ 
@ @ @ . @ @ . @ . @ . @ @ @ @ @ @ . . @ . @ @ @ . @ @ . . . . . @ . @ @ . . @ . . @ . . . . @ . @ . @ . @ . @ @ . @ . . @ . @ . @ @ . @ . . . . . . . . . . . @ . @ . . @ @ . @ . @ @ . @ . @ . . . . @ 
@ @ . . . @ @ @ @ . . @ . . . @ . . @ @ @ . . . . . @ @ . @ @ . . . . . . @ @ . @ . . @ @ . . . . . . . . . . @ @ . @ . . @ . . . . @ . . @ . @ . @ . @ @ . @ . @ . @ . . . @ @ . . . @ @ . @ . @ @ . @ 
@ @ @ . @ @ @ . @ @ @ . @ @ . @ @ @ @ . @ @ . @ . @ @ . . @ . @ . @ . @ . . . @ . @ . . @ . @ @ . @ . @ . @ @ . . . . . @ @ @ . @ @ . @ . . @ . . . @ . @ @ . . . . . . @ . . @ . @ . @ . . . @ . @ . @ 
@ @ . @ . . @ . . @ . . . . . . . . . . . . . @ @ . . @ . @ . . . . @ . . @ . @ . @ . @ @ @ @ @ @ . . @ . . @ . @ . @ . @ @ . . @ . . . . @ . @ . @ @ . @ . @ @ @ @ @ . . @ . . @ @ . @ @ @ . . . . @ @ 
@ @ . . @ . @ . @ . . @ . @ . @ @ @ . @ @ . @ @ . @ . . . . @ @ . @ @ @ . @ @ . . . . @ @ @ @ @ @ @ . @ . @ . @ . @ . . @ . @ @ @ . @ @ . . . @ . . . . . . . @ @ @ @ . @ . @ . . . @ . . . @ @ @ . . @ 
@ @ @ . . . . . . . @ . . @ . . . @ @ @ @ @ @ . . . . @ . @ @ @ . . . . @ @ @ @ @ @ . @ . @ . @ @ @ . @ @ . . @ . @ @ . . . . @ . @ . @ . @ . . @ . @ . @ . @ @ @ @ . @ . . . . @ @ @ @ @ . . . . . @ @ 
@ @ @ @ . @ . @ . @ . . @ . . @ . @ . . @ . . . @ . @ . . @ . . . @ @ . @ @ @ . . @ . . . . . . @ @ @ . . . @ . . @ . . @ . @ @ . @ . . . . @ . @ . . @ . . . @ @ . . . @ . @ . @ @ @ . @ @ . @ @ . @ @ 
@ @ @ @ @ . . . @ . . @ . . @ . @ . @ . @ @ . @ . . . @ . @ . @ . @ . . . @ . @ . @ @ @ @ . @ @ @ @ . @ . @ . @ . @ @ . . @ . @ . . . @ . @ @ . . @ . @ @ . @ . . @ @ . @ . @ @ . . . . . . . @ . . . @ 
@ @ @ . @ @ . @ . @ . . @ . @ . . . . . @ @ . . @ . @ @ . . @ . . . @ @ . . . . . . . . . @ . . . . . . . . . . . . . @ . . . . @ . @ . . . . @ @ @ @ @ . . . @ . . . . @ @ . . @ @ @ @ @ @ @ . @ . @ @ 
@ @ . . @ @ @ @ . . . @ @ . . @ @ . @ . . . . @ . . @ . . @ @ @ . @ @ . . @ . @ . @ . @ . . . @ @ @ @ @ @ @ @ @ . @ . . @ . @ @ @ . . @ . @ @ @ . @ @ @ @ . @ . . @ . @ . @ . @ . @ . @ . @ . . . @ @ @ 
@ . @ . . . . @ @ . @ . . . @ @ @ . @ @ . @ . @ @ @ . @ . @ . . . . @ . @ . . . @ @ @ . . @ . . . . . . . . . . @ @ @ @ . @ . . . @ @ @ . . . . . . @ @ . . @ . @ . @ @ . @ . . . . . . . . . @ @ . @ @ 
@ . . . @ . @ @ @ @ @ @ . @ @ @ @ . @ . . . @ . . . . . . @ . @ . @ @ . . @ @ . . @ . @ . . @ . @ . @ . @ . @ . . . . . . @ . @ . . @ . . @ . @ . @ . @ @ . . . . . . . . . . @ . @ . @ . @ . . . . . @ 
@ . @ . @ @ @ @ @ @ @ . . @ @ @ @ @ . @ . @ . @ . @ @ . @ . . . @ @ . . @ . . . @ . . . . @ @ . @ . . @ . . @ . @ . @ . @ @ @ . . @ . @ . . @ . . . . . @ . @ . @ . @ . @ . @ @ . . @ @ @ @ . @ . @ . @ 
@ @ . . @ @ . @ . @ @ @ . . @ @ @ @ . . . . . . @ . . . @ @ . @ . @ @ . @ @ @ . @ @ @ @ . . . @ @ . @ . @ . . @ @ . . @ . @ . @ . . . . @ @ . . @ . @ . . @ @ . . @ @ . . @ . . @ . . . . . @ @ @ @ @ @ 
@ @ @ . . . . . . . @ @ @ @ . @ @ . . @ . @ . @ . @ @ . @ . . . . . @ . . . . @ @ . . . . @ . . . @ @ . @ . @ @ . @ . . . . . . . @ . @ @ @ @ . @ . @ . @ @ @ . @ . @ . @ . @ . @ . @ . @ . . @ . @ @ @ 
@ @ . @ @ @ @ @ @ . . . . . . . . . @ . . . @ . . . . . @ . @ . @ @ . . @ . @ @ @ @ @ @ . @ . @ . . . . . @ . . . . . @ . @ . @ @ @ . @ @ @ @ @ . . @ . . . . @ . . . . . . . . . @ . @ . @ @ . . . @ @ 
@ . . . . . . . . . @ @ @ . @ @ @ . @ @ . @ . . @ @ @ . @ . @ . @ . @ . @ . . @ @ . @ . . @ . . @ . @ . @ . @ @ . @ . . @ @ . . . @ @ @ @ @ @ @ @ . . @ @ . @ . @ @ . @ . @ . @ . . . . . . . . @ @ @ @ 
@ @ . @ . @ . @ . @ . . . . . . . @ . . . . @ . @ @ @ @ . . . @ . . . . . @ . . . . . @ . . @ . . @ . . . . . @ @ @ . @ . @ @ @ . . @ @ @ @ @ @ @ . @ . . @ . . . . . @ . . @ @ . @ . @ @ . @ . . . @ @ 
@ @ @ @ . . @ . . . @ . @ . @ . @ @ @ . @ @ . . . @ @ . @ . @ @ @ @ . @ @ . . @ . @ @ @ @ @ @ . @ @ @ . @ . @ . . . . . . . @ . . @ . @ @ @ @ @ . @ @ . @ . . @ @ . @ @ . @ @ @ . . @ . . . . @ . @ @ @ 
@ @ @ @ . @ . @ . @ @ @ . . @ . . . @ @ @ @ @ . @ . . . . . . @ . . . . . @ . . @ @ @ @ @ . @ @ @ @ @ . . @ . @ @ @ . @ . @ . @ . . . . @ @ @ . . . . . . . @ . @ . @ . . . . . @ @ . . @ . @ @ . @ @ @ 
@ . . . . . . @ @ @ @ . @ . . @ @ @ . . . @ . . @ . @ . @ @ @ . . @ @ . @ @ . @ . @ @ @ . . . . @ . @ . @ . . . @ . . . @ . . . . @ . @ @ @ . @ @ . @ . @ . . . . @ . @ . @ . @ . @ . @ . . . . @ @ @ @ 
@ @ . @ . @ @ . @ @ . . . . @ . . . . @ . . @ . . @ @ . @ @ . @ . @ . . . @ . . . . @ @ @ . @ @ . . . . . . @ @ @ @ . @ @ @ @ @ . . @ @ @ . . . . @ @ @ . . @ . @ @ . @ . @ . @ . . . @ @ . @ . @ @ @ @ 
@ @ @ @ . @ . . . . @ @ . @ @ . @ @ . @ . @ . . @ @ . . . . . @ . . @ . @ . . @ . @ @ @ . . . @ @ . @ . @ . . . . . @ . @ . @ . . @ . . . . @ . @ . . . @ . . @ @ . . . . . @ @ @ . @ . . . . @ @ @ @ @ 
@ @ @ . . @ @ . @ . . . . . @ @ . . . . @ . @ . . @ @ . @ . @ . @ @ . . . @ . . @ @ @ . @ . @ . . . @ . . @ . @ . @ . . . . . @ . @ . @ . @ . . . @ @ . @ . @ @ . @ . @ . @ @ @ @ @ @ @ @ . @ @ @ @ @ @ 
@ @ @ @ . @ . . . @ . @ . @ . . . @ @ . . . . . @ . . @ . . . . . @ @ . @ . . @ @ @ . . @ . @ @ . @ . . @ @ . @ . . . @ @ . @ . . @ . . @ @ @ . @ . . . . . . @ . . . . @ @ @ @ @ @ @ @ @ . @ @ @ @ @ @ 
@ @ @ @ @ @ @ . @ @ @ . . @ . @ . . . @ . @ . @ @ . @ @ @ . @ . @ . . . . @ . @ @ . @ . . . . @ . . @ . @ . . . @ . @ @ @ @ . @ . . . @ @ @ @ @ @ @ @ . @ @ @ @ @ @ . @ . @ . @ @ @ @ @ . . . @ @ @ @ @ 
@ @ @ @ @ @ @ @ . @ . @ . . @ . . @ . . @ . . . . . . @ . . . @ @ @ @ . @ . . . . . @ . @ @ @ . @ @ @ @ @ @ . @ . @ . @ @ . . . . @ @ @ @ @ @ @ . @ . . . . @ @ @ @ . @ . . . . @ @ @ @ @ . @ @ @ @ @ @ 
@ @ @ @ @ @ @ . . . . . . @ @ @ . . @ . @ @ . @ . @ . @ . @ . . @ . . . @ . @ . @ . . . . . . . . . . . . @ . @ . @ . @ . @ . @ @ @ @ @ @ @ @ @ . @ @ . @ @ @ @ @ @ . . . @ @ @ . @ @ @ . . . @ @ @ @ @ 
@ @ @ @ @ @ @ @ . @ . @ . @ @ @ @ @ . . . . @ @ @ . . @ . @ . @ . . @ . . @ @ . . @ . @ @ . @ . @ @ . @ . @ @ . . . . . . . . @ @ @ @ @ @ @ @ . . . . . @ @ @ @ @ @ . @ . . . . . . . @ . @ . . . @ @ @ 
@ @ @ @ @ @ @ @ @ @ @ @ @ @ @ @ @ @ @ @ @ @ @ @ @ @ @ @ @ @ @ @ @ @ @ @ @ @ @ @ @ @ @ @ @ @ @ @ @ @ @ @ @ @ @ @ @ @ @ @ @ @ @ @ @ @ @ @ @ @ @ @ @ @ @ @ @ @ @ @ @ @ @ @ @ @ @ @ @ @ @ @ @ @ @ @ @ @ @ @ 
3
41 18 81 40
50 40 57 15
43 55 67 88
