25 25
@ @ @ @ @ @ @ @ @ @ @ @ @ @ @ @ @ @ @ @ @ @ @ @ @ 
@ @ @ @ @ @ @ . @ . . @ . @ @ . @ . @ . . . . @ @ 
@ @ @ @ @ @ . . @ . @ . . . . . . . . @ @ . @ . @ 
@ @ @ @ @ @ @ . . . . @ . @ @ . @ . @ . . . . . @ 
@ @ @ @ @ @ . @ . @ . @ . . @ . @ . . . @ . @ . @ 
@ @ @ @ @ @ . . @ @ . . . @ . . . @ @ . . @ @ . @ 
@ @ @ @ @ . @ . @ @ . @ . . @ . @ @ @ . @ @ . . @ 
@ @ @ @ . . . . . . . . @ . @ . @ @ @ . @ @ @ . @ 
@ @ @ @ @ . @ @ @ @ @ @ . @ . @ @ @ . . @ . @ @ @ 
@ @ @ @ @ @ @ @ @ . . . . . . @ @ . @ . . . . @ @ 
@ @ @ @ @ @ @ @ . @ . @ . @ . @ . . @ @ . @ @ . @ 
@ @ @ @ @ @ @ . . . . @ @ . . @ @ . . . . @ . . @ 
@ . @ @ @ @ . @ . @ . . @ @ . . @ @ @ @ . . . @ @ 
@ . @ @ @ . . @ @ . . @ @ @ @ . . . . . . @ . . @ 
@ . @ @ . @ . @ . @ . . @ @ @ @ . @ . @ . . @ @ @ 
@ . @ . . . . . . . . @ @ . @ @ . @ . @ . @ @ @ @ 
@ . . . @ . @ @ . @ @ . . . . . . . @ @ @ @ @ @ @ 
@ . @ . . @ @ . . @ . @ . @ @ @ . @ @ @ @ @ @ @ @ 
@ @ . . @ @ . . @ @ . @ . . . . @ @ @ @ @ @ @ @ @ 
@ @ @ @ . . @ . @ . . @ . @ . @ @ @ @ @ @ @ @ @ @ 
@ @ . @ . @ . @ . @ . . . . @ @ @ @ @ @ @ @ @ @ @ 
@ . . . . . . @ . . @ . @ . @ @ @ @ @ @ @ @ @ @ @ 
@ @ @ . @ @ . . @ . . . . @ @ @ @ @ @ @ @ @ @ @ @ 
@ @ @ . . . @ . . . @ . @ @ @ @ @ @ @ @ @ @ @ @ @ 
@ @ @ @ @ @ @ @ @ @ @ @ @ @ @ @ @ @ @ @ @ @ @ @ @ 
3
7 6 7 13
16 16 23 7
11 19 12 14
