50 50
@ @ @ @ @ @ @ @ @ @ @ @ @ @ @ @ @ @ @ @ @ @ @ @ @ @ @ @ @ @ @ @ @ @ @ @ @ @ @ @ @ @ @ @ @ @ @ @ @ @ 
@ @ @ @ @ @ @ @ @ @ @ @ @ . @ . @ @ @ @ @ . . . @ @ @ @ @ @ @ . . . . . @ . . . . . . . . . . @ . @ 
@ @ @ @ @ @ @ @ @ @ @ . @ . . . . @ @ @ . @ . @ . @ . @ @ @ @ @ . @ . @ . . @ @ @ . @ . @ . @ @ . @ 
@ @ @ @ @ @ @ @ @ @ . . @ @ @ . @ @ @ @ . . . . . . . . . @ @ @ @ . . . @ . . @ . . . @ . . . . . @ 
@ @ @ @ @ @ @ @ @ @ @ . . . @ . @ . . . . @ . @ . @ . @ . . . @ . . @ . . . @ @ @ . @ . @ . @ @ @ @ 
@ @ @ @ @ @ @ @ . @ @ @ . @ . . . @ @ . @ . . . @ @ @ . . @ . . @ . . @ @ . . @ . @ . . @ . . . . @ 
@ @ @ @ @ @ @ . . . @ . . @ . @ . . @ @ . @ . @ . @ . @ . @ . @ @ . @ . @ . @ @ . @ . @ . @ . @ @ @ 
@ @ @ @ @ @ . @ . @ . @ . @ @ . . @ . . . . . . . @ . . @ @ @ . @ @ . . . . . . . . . . . . @ . @ @ 
@ @ . @ @ . . . . . . . . . . . @ . @ @ . @ @ @ . . . @ @ @ . . . @ @ . @ . @ . @ . @ . @ . . . . @ 
@ . . . @ @ . @ . @ . @ . @ @ . . . . . @ . @ @ @ . @ . . . @ . @ @ . . . @ @ . . @ . @ . @ . @ . @ 
@ @ . @ @ @ @ . . @ @ . . @ . . @ . @ @ . . . @ . . . @ @ . . . . . . @ @ @ @ @ . . . . . @ . . @ @ 
@ . . . @ @ @ @ @ . . @ @ . . @ @ . @ . @ . @ . @ . @ . . @ . @ . @ . . . @ . . . @ . @ @ . @ . . @ 
@ @ . @ . @ . . . @ . . @ @ @ . . . . . . . . . . . . @ . @ @ @ @ . . @ . . @ @ . . @ . . . . . @ @ 
@ . . . . . @ . @ . @ . . . @ @ . @ @ . @ . @ @ @ @ . . . . . . . . @ @ . @ . . . @ @ . @ @ . @ @ @ 
@ @ . @ @ . . . . . . @ @ . @ . @ . @ . . @ . . . . . @ . @ @ . @ . . @ . @ @ . @ . . . . . @ . @ @ 
@ @ @ . . . @ . @ @ . . . . . . . . . . @ @ @ . @ . @ . . @ @ @ . @ . @ . . . @ @ @ @ . @ @ . . . @ 
@ @ @ @ . @ . . . . @ . @ . @ . @ . @ . @ @ @ @ . . . @ . . @ . . @ . @ . @ . @ . @ @ . @ . @ . @ @ 
@ @ @ . . @ @ . @ . @ . @ @ . . . @ . . @ . @ . . @ . @ @ . . @ . . . @ . @ . . . @ @ @ . . . . . @ 
@ @ @ . @ . . @ . @ @ . @ . @ . @ . @ . @ . @ @ . . @ . . . @ @ . @ . . @ @ @ @ . . . . @ . @ @ . @ 
@ @ @ . . @ . . . . . . . . @ @ . . . @ . . . . . @ @ @ . @ . . . @ . @ . @ @ . . @ . @ @ . @ . . @ 
@ . @ . @ @ @ . @ . @ . @ . @ @ . @ . . . @ @ @ . @ @ . . . @ @ @ . . . . . . @ . . @ . . . @ . @ @ 
@ . . . @ @ @ @ @ @ . . @ . . . @ @ . @ . . . @ @ @ . . @ @ . @ . @ . @ @ . @ . . @ . @ . @ . @ . @ 
@ . @ @ @ @ @ . @ . @ . @ . @ . . . @ . . @ . @ . . . @ . . . . . . . @ @ . @ @ . . . . . . . . . @ 
@ . @ . @ @ . . . . . . @ . . @ . @ @ @ @ . . . @ @ . . @ . @ @ . @ . . . @ . . @ @ . @ . @ . @ . @ 
@ . . . . . @ @ @ . @ . @ . @ @ @ @ @ @ @ @ . @ @ @ . @ @ @ . . . @ . @ . @ . @ @ . . . @ @ . . @ @ 
@ @ . @ @ . . . . @ . . . @ @ @ @ @ @ @ @ @ . @ @ . . . . . @ @ . @ . @ . . . . . @ . @ @ . . @ @ @ 
@ @ . @ . @ . @ @ @ @ . @ @ @ @ @ @ @ @ @ @ @ . . @ . @ . @ @ @ @ . . @ . @ @ . @ . . @ . @ @ @ @ @ 
@ . @ . . . @ @ @ . . . . @ . @ @ @ @ @ @ @ . @ . . . @ . @ @ @ @ @ . . @ . . . . @ . . . @ @ @ @ @ 
@ . @ @ . @ . @ . @ . @ . . . @ @ @ @ @ @ . . . . @ @ . . @ @ @ @ @ @ @ . . @ . @ . . @ . @ @ @ @ @ 
@ . . . . . . . . . . . @ . @ . @ . @ @ @ @ @ @ . . . @ . . @ @ . @ . @ . @ . . . @ . . @ @ @ . @ @ 
@ @ . @ . @ . @ . @ . @ . . @ . . . . . . . . . . @ @ . . @ @ . . . . . . . @ . @ . . @ . @ . . . @ 
@ . @ . . @ @ . . @ . @ . @ . @ . @ . @ . @ . @ @ . @ @ . . . @ @ @ @ @ . @ @ . @ @ . . . . @ . @ @ 
@ . . @ . . . @ . . @ . @ . . . . @ . . @ . . . . . . . @ @ . . . . @ @ @ . . . . @ . @ . @ . . . @ 
@ @ . . . @ @ . @ . . . . @ . @ . @ . @ . @ . @ . @ . @ @ @ . @ @ . . . . @ . @ . @ @ . . . . @ . @ 
@ . @ . @ . . . . . @ . @ . @ . . @ @ . . . . @ . . @ . . . . . . @ . @ . @ @ . . . . @ @ . @ @ . @ 
@ . . . @ . @ . @ . . @ . . . . @ . . . @ . @ . . @ @ @ . @ . @ . @ . . @ @ @ @ . @ . @ @ . . . @ @ 
@ @ . @ . . @ @ . @ @ . . @ . @ . . @ . . @ . . @ . @ . @ @ @ @ . . @ . . . @ . . . @ @ @ @ . @ @ @ 
@ . . @ @ . @ . . . . . @ . . @ @ . @ @ . @ . @ . . . . . @ . @ @ . . @ . @ @ @ . @ . . . . . . . @ 
@ . @ @ @ @ . . @ . @ . . @ @ . . . . . @ . @ . @ . @ @ @ . . . @ . @ @ . @ . @ @ . @ @ . @ . @ @ @ 
@ . . @ @ @ @ . . @ . . @ @ @ @ @ . @ . . . . . . . @ @ . . @ @ . @ @ . . . . . @ . . @ @ . . . . @ 
@ @ @ . @ . . . @ . @ . @ @ @ @ @ @ . . @ . @ . @ . . @ @ . . @ . @ . @ . @ . @ . @ . @ . . @ . @ @ 
@ @ . . . . @ . @ . @ . . @ @ @ @ . @ . . @ @ . . @ . . . . @ . . . . . . . @ . . . . . . @ . @ @ @ 
@ . . @ . @ . @ @ . . . @ . . . . . . . @ @ @ . @ . @ @ . @ . @ @ . @ . @ . @ @ . @ @ @ . . . . @ @ 
@ . @ . . . . . @ @ . @ @ @ @ . @ . @ @ @ . . . @ . . . . @ . . . @ . . @ @ . . . @ . . . @ . @ @ @ 
@ @ . @ . @ . @ @ @ @ @ @ @ @ @ . . . . . @ . @ @ @ . @ . . @ . @ . @ . . . @ @ @ . . @ . @ . @ @ @ 
@ @ . . . @ . . @ @ @ @ @ @ @ @ @ . @ . @ . . . @ @ @ . . @ @ . . . . . @ . @ @ @ @ @ . . . @ . @ @ 
@ . . @ . . @ @ @ @ @ @ @ @ @ @ . . @ . @ @ . @ . @ @ @ . @ @ @ . @ . @ @ @ . @ . @ . @ . @ @ . @ @ 
@ . @ . . @ . @ @ @ @ @ @ @ @ @ @ . . @ . . . . . . @ @ @ . @ . @ . . @ @ . . . . . . . . . . . @ @ 
@ . . @ . . . . @ @ @ @ @ @ @ @ @ . @ @ @ @ . @ . @ @ @ @ . . . . . @ @ @ @ . @ . @ . @ . @ . @ @ @ 
@ @ @ @ @ @ @ @ @ @ @ @ @ @ @ @ @ @ @ @ @ @ @ @ @ @ @ @ @ @ @ @ @ @ @ @ @ @ @ @ @ @ @ @ @ @ @ @ @ @ 
3
41 29 7 41
30 46 14 45
30 21 34 34
