50 50
@ @ @ @ @ @ @ @ @ @ @ @ @ @ @ @ @ @ @ @ @ @ @ @ @ @ @ @ @ @ @ @ @ @ @ @ @ @ @ @ @ @ @ @ @ @ @ @ @ @ 
@ @ @ @ @ @ @ . . @ . @ . . . @ . @ . @ . . @ @ @ @ @ @ @ @ @ @ @ @ @ @ @ @ @ @ @ . . @ @ @ @ @ @ @ 
@ @ @ @ @ @ . . @ . . . . @ @ . . . . @ @ . . . . @ @ @ @ @ @ @ @ @ @ @ @ @ @ @ @ . @ . @ @ @ @ @ @ 
@ . @ @ . . @ . . . @ @ @ . . . @ . @ . . . @ . @ . @ . . . . . . @ @ @ @ @ @ @ @ . . . . @ @ @ @ @ 
@ . . . @ . @ . @ @ . @ @ . @ . . @ @ . @ @ . @ . . @ @ . @ @ . @ @ @ @ @ @ @ @ @ . @ @ . . @ . @ @ 
@ . @ . . . . . . . . . . . . @ @ @ . . . . . @ @ . . @ . . @ @ @ @ @ @ @ @ @ @ . . @ @ @ @ . . @ @ 
@ @ @ @ . @ . @ @ @ @ . @ . @ . @ . @ @ . @ @ . @ . @ . @ . @ @ . @ @ @ @ @ @ @ @ . . . @ @ @ . . @ 
@ . . @ @ @ . . . . @ @ . . . . . . . . . . . . . . . . . . @ @ . @ . @ @ @ @ @ . . @ @ @ @ @ . @ @ 
@ @ . @ . @ . @ . @ @ . @ . @ @ . @ . @ . @ . @ . @ @ . @ @ @ . . . . . @ @ @ @ @ . . @ @ @ . . . @ 
@ . . . . . . . @ @ @ . @ . @ . . @ . . @ @ . . @ @ @ . @ @ . @ . @ . @ . @ . @ . . @ . @ . . @ . @ 
@ . @ . @ @ . @ . @ . . . . @ @ . @ @ . . . @ . . . . @ @ . . . . . @ @ . . . . @ . @ . . . @ . . @ 
@ . @ @ . . . . . . @ . @ . . . @ . @ . @ . . @ @ . @ @ @ . @ @ @ . @ . . @ . @ @ . . . @ @ @ @ . @ 
@ @ . . . @ . @ . @ . @ . . @ @ . . . . . @ @ @ @ . @ @ @ @ @ @ . . . @ . . @ . . . @ @ . . @ . . @ 
@ . . @ . . @ . . . . @ @ . . @ . @ . @ . . . @ . . @ . @ @ @ . @ . @ . . @ . @ @ . @ @ . @ . @ . @ 
@ . @ . . @ @ . @ @ . . @ . @ . @ @ . @ . @ . . @ . . . . . . . . . . @ . . . . @ . . . . . . . @ @ 
@ @ . . @ @ @ . . @ . @ . . @ . . . @ . . . @ . . @ . @ . @ . @ . @ . . . @ . @ @ . @ @ @ @ @ @ . @ 
@ @ @ . . @ . . @ . . . @ . . . @ . . @ . @ @ . @ @ @ @ @ . . . @ @ . @ . @ . . . . @ . . . . . . @ 
@ @ @ @ . @ @ . @ @ . @ . . @ @ . @ @ @ . . . @ . . . @ . . @ . . . @ . . @ . @ @ . . . @ @ @ @ . @ 
@ @ @ @ . @ . . . @ . . @ . . . . . . . @ . @ . @ @ . @ . @ . @ . @ @ . @ @ @ @ @ . @ . . . . . @ @ 
@ @ @ @ . . @ . @ . . @ . @ . @ . @ . @ @ . @ . @ . . . . . . . @ . . . . @ . . @ . . @ . @ . @ @ @ 
@ @ @ @ @ @ . . @ @ @ . . . @ . . @ . @ . . . . . @ . @ . @ . @ . @ . @ . . . @ @ @ @ . . . @ @ @ @ 
@ @ @ @ @ @ @ @ @ . @ @ . @ . @ . . @ . @ @ @ . @ @ @ . . . @ . . . . @ . @ @ @ @ . . @ . @ . @ @ @ 
@ @ @ @ @ @ @ . . . . . . . . . . @ . . @ @ @ @ @ @ . @ . @ . @ . @ . @ . . . @ . @ . . . . . . @ @ 
@ @ @ @ @ @ @ @ . @ . @ . @ @ . @ @ . @ . @ @ . . @ . . . @ . . @ @ @ . . @ @ . . . @ . @ @ . @ @ @ 
@ @ @ @ @ @ @ @ @ . . . @ . . . @ . . . . . . . @ @ . @ . . . @ . . @ @ . @ @ @ . @ . @ @ @ . @ @ @ 
@ @ @ @ @ @ @ @ @ @ . @ . @ @ . . @ @ @ . @ . @ @ @ @ . . @ . . . @ . . @ . . . . @ . . . . . @ @ @ 
@ @ @ @ @ @ @ @ @ . . @ . @ @ . @ @ @ . . . @ @ @ @ @ . @ . . @ . @ @ . @ @ . @ . . @ . @ . @ @ @ @ 
@ @ @ @ @ @ @ . . . @ . . . . . . @ . @ . @ . @ @ @ . . . @ . . @ @ . . . . . . @ @ @ @ . . @ . @ @ 
@ @ @ @ @ @ . . @ . . @ . @ . @ @ . . . . . . . . . @ . @ @ @ . . . @ @ . @ @ . . . . @ . @ . . . @ 
@ @ @ @ @ @ . @ . . @ @ @ . . . . . @ . @ . @ . @ . @ . . . @ . @ . . . . . . @ . @ @ . . . . @ @ @ 
@ @ @ @ @ . @ . . @ . @ @ @ . @ . @ @ @ . @ @ @ . @ . @ @ @ @ . . @ . @ @ . @ . . @ . @ . @ . . . @ 
@ @ @ @ . . . . @ @ . . @ . @ @ . . . . . . . . . . . @ . @ . . @ @ . @ . @ . @ . @ . . . . @ . @ @ 
@ . @ . @ @ @ @ . . . @ . . . @ . @ @ @ . @ . @ . @ . . . . @ . . . @ . . @ . . @ . . @ . @ @ . . @ 
@ . @ . @ . @ . . @ @ . @ . @ @ @ @ . . @ . . . @ . . @ . @ @ @ . @ . @ . . . @ @ @ @ @ . . . @ . @ 
@ . . . . . . . @ @ . . @ . . @ @ . @ . . @ . @ . @ . . @ @ @ @ . . . . . @ @ . @ @ @ . . @ . . @ @ 
@ @ @ . @ . @ . @ . @ . . . @ . @ . @ . @ @ . . . . @ . . . @ @ . @ . @ . . . . . @ . @ @ @ @ @ . @ 
@ @ @ @ . . @ . . . . @ . @ . . . . . . . . . @ . @ @ . @ @ @ @ . . @ . . @ . @ . . . . . . . . . @ 
@ . @ @ @ . @ . @ @ . . . . . @ . @ . @ . @ . . @ . . . . . . @ . @ . @ . . @ @ . @ . @ . @ . @ . @ 
@ . @ @ . @ . . . @ @ @ . @ . . @ . . . @ . . @ . @ @ . @ . @ @ @ @ . . @ @ . . . . @ @ . . @ . . @ 
@ . . @ . . @ . @ @ @ @ @ . . @ . @ . @ @ @ . . . . . @ @ @ @ @ @ @ . @ @ @ @ . @ @ @ @ . @ @ @ @ @ 
@ . @ . @ . @ . @ @ @ @ @ . @ . . . . . @ @ . @ . @ . @ . . @ @ @ . . . @ . . . . . @ @ @ @ @ @ @ @ 
@ . . . . . . . . . @ @ @ @ . @ @ . @ @ . @ . . @ @ @ @ . @ . @ . @ . @ . @ . @ . @ @ @ @ @ @ @ @ @ 
@ . @ . @ . @ . @ @ @ @ . . . . . . @ . . . . @ . @ . @ . . . . . . . . . . . @ . . . @ @ @ @ @ @ @ 
@ @ . . . @ . . @ . @ @ @ . @ . @ @ . . @ . @ . . . . . . @ . @ . @ . @ . @ . @ . @ @ @ @ @ @ @ @ @ 
@ @ @ . @ . @ . . . . . @ @ . . . . @ . . @ . @ . @ . @ . . @ . . @ @ @ @ @ . @ . @ @ @ @ @ @ @ @ @ 
@ @ . @ . . . . @ @ . @ @ @ . @ . @ . . @ @ . . @ . . . @ . . @ . . . @ . . . . @ @ @ @ @ @ @ @ @ @ 
@ . . . . @ . @ @ . . @ @ @ @ @ @ . . @ @ . @ . . . @ . @ . @ . . @ @ @ @ @ @ @ @ @ @ @ @ @ @ @ @ @ 
@ @ . @ @ . . . . @ . @ @ @ @ @ @ @ . . . . . @ . @ . . @ . @ @ . . @ @ @ @ @ @ @ @ @ @ @ @ @ @ @ @ 
@ . . . . @ . @ . @ . . @ @ @ @ @ . . @ . @ . @ . @ . @ . . @ . . @ @ @ @ @ @ @ @ @ @ @ @ @ @ @ @ @ 
@ @ @ @ @ @ @ @ @ @ @ @ @ @ @ @ @ @ @ @ @ @ @ @ @ @ @ @ @ @ @ @ @ @ @ @ @ @ @ @ @ @ @ @ @ @ @ @ @ @ 
3
38 19 7 7
21 34 23 39
15 48 9 15
