50 50
@ @ @ @ @ @ @ @ @ @ @ @ @ @ @ @ @ @ @ @ @ @ @ @ @ @ @ @ @ @ @ @ @ @ @ @ @ @ @ @ @ @ @ @ @ @ @ @ @ @ 
@ @ @ @ @ @ @ @ @ @ @ @ @ @ @ @ @ @ @ @ @ @ @ @ @ @ @ @ @ @ @ @ @ @ @ @ @ @ . . . . . @ . @ @ @ @ @ 
@ @ @ @ @ @ @ @ @ @ @ @ @ @ @ @ @ @ @ @ @ @ @ @ @ @ @ @ @ @ @ @ @ @ @ @ @ @ . @ @ . @ . . . . . @ @ 
@ @ @ @ @ @ @ @ @ @ @ @ @ @ @ @ @ @ @ @ @ @ @ @ @ @ @ @ @ @ @ @ @ @ @ @ @ @ @ . @ . . . @ . @ . . @ 
@ @ @ @ @ @ @ @ @ @ @ @ @ @ @ @ @ @ @ @ @ @ @ @ @ @ @ @ @ @ @ @ @ @ @ @ @ @ . . . . @ @ . @ @ @ . @ 
@ @ @ @ @ @ @ @ @ @ @ @ @ @ @ @ @ @ @ @ @ @ @ @ @ @ @ @ @ @ @ @ @ @ @ @ @ @ @ . @ . . . . . @ @ @ @ 
@ @ @ @ @ @ @ @ @ @ @ @ @ @ @ @ @ @ @ @ @ @ @ @ @ @ @ @ @ @ @ @ @ @ @ @ @ @ . @ . @ . @ . @ @ @ @ @ 
@ @ @ @ @ @ @ @ @ @ @ @ @ @ @ @ @ @ @ @ @ @ @ @ @ @ @ @ @ @ @ @ @ . @ . @ @ . . . . . . @ @ @ @ @ @ 
@ @ @ @ @ @ @ @ @ @ @ @ @ @ @ @ @ @ @ @ @ @ @ @ @ @ @ @ @ @ @ . . . . . . . @ @ . @ . @ @ @ @ . @ @ 
@ @ @ @ @ @ @ @ @ @ @ @ @ @ @ @ @ @ @ . . @ @ @ @ @ @ @ @ @ . @ @ @ . @ @ @ @ . @ @ . . @ @ . . @ @ 
@ @ @ @ @ @ @ @ @ @ @ @ @ @ @ @ @ @ @ @ . . @ @ @ @ @ @ @ . . . @ . . @ . . . . @ . . @ @ . @ . @ @ 
@ @ @ @ @ @ @ @ @ @ @ @ @ @ @ @ @ @ @ . . @ @ @ @ @ @ @ . @ . @ . @ . @ @ . @ . @ @ . @ @ . . . . @ 
@ @ @ @ @ @ @ @ @ @ @ @ @ @ @ @ @ @ @ @ . . @ @ @ . . . . . . . . . . . . . @ . . . . @ @ @ @ . @ @ 
@ @ @ @ @ @ @ @ @ @ @ @ @ @ @ @ @ @ @ @ . @ . @ . @ . @ . @ . @ . @ . @ @ . . @ . @ . . @ . . . . @ 
@ @ @ @ @ @ @ @ @ @ @ @ @ @ @ @ @ . @ . . . . . . . . . @ . . @ @ . . . . @ @ . @ . . @ . @ @ . @ @ 
@ @ @ @ @ @ @ @ @ @ @ @ @ @ @ @ . . . @ . @ . @ . @ . @ . @ . . @ @ . @ . . @ . @ @ . . . . . . . @ 
@ @ @ @ @ @ @ @ @ @ @ . @ @ @ @ . @ . . @ . . . @ . @ . . . . @ . @ . @ @ @ . . . . . @ . @ . @ . @ 
@ @ @ @ @ @ @ @ @ @ . . . @ @ @ @ . @ . @ @ . @ . . . . @ . @ . . . . . . @ @ . @ . @ @ @ . . . @ @ 
@ @ @ @ @ @ @ @ @ @ @ . @ @ @ . . . . . . . @ . . @ . @ @ . . @ . @ . @ @ . . @ . . . @ . @ . @ . @ 
@ @ @ @ @ @ @ @ @ @ . . . @ @ @ . @ @ . @ . . . @ . . . @ . @ . @ . @ . . @ . . . @ . . . @ . . . @ 
@ . . @ @ @ @ . @ . @ . @ . @ . . . @ . . @ . @ @ @ . @ . @ . . . . @ . @ @ @ . @ . @ . @ . . @ . @ 
@ @ . @ . @ . . . . . . . . . . @ @ . @ . . @ @ @ . @ . . . @ . @ . . . . . . . @ . @ @ . @ . . @ @ 
@ . . @ . . @ . @ . @ . @ . @ . . @ . @ @ @ . . . . . . @ . . @ . @ @ . @ . @ . . . . @ . . . @ . @ 
@ @ . @ . @ . . @ @ . . @ . @ @ . . . . . . @ @ @ . @ . @ . @ @ . . . . . @ . . @ . @ @ @ @ . . . @ 
@ . . . . @ @ @ . . . @ . . @ . . @ . @ . @ . . . . @ @ . . . . @ . @ . @ @ @ . @ @ @ @ @ @ @ @ . @ 
@ @ @ . @ @ . . . @ . . @ . . @ @ . . . @ @ @ . @ . . . @ . @ . . @ . . . @ . . . . . . @ @ . . @ @ 
@ @ . . @ . @ . @ . . @ @ . @ . . @ . @ @ @ @ @ . . @ . @ . @ . @ @ @ . @ @ @ . @ . @ . . . @ . . @ 
@ . @ . . . @ @ . . @ . . . . . @ . @ @ @ @ @ @ @ . @ @ @ . . @ @ @ @ @ . . . . @ @ . . @ @ @ @ . @ 
@ . . @ @ . @ @ @ . @ @ @ . @ . . . . @ . @ @ @ . . . @ . @ . . @ @ @ @ . @ @ . . @ @ . @ @ @ . . @ 
@ . @ . . . . @ @ @ @ . . @ . . @ @ . . . @ @ @ @ . @ . . @ . @ @ @ @ . . @ @ . @ . @ . @ @ . . @ @ 
@ . . . @ . @ . . @ @ @ . . @ . . . @ . @ @ @ @ @ @ @ . @ . . . . @ @ . @ . . . . . . @ @ . . @ . @ 
@ @ . @ . . . . @ . @ . @ . @ . @ . @ . @ @ @ @ @ @ . . . @ . @ . . . . . @ @ . @ . @ @ @ @ . . . @ 
@ @ @ @ @ . @ . . . . . . . . . . @ . @ @ @ @ @ @ . . @ @ @ . . @ . @ . @ . @ @ . . . . @ . @ . @ @ 
@ @ @ @ . @ . @ . @ . @ @ @ . @ @ . . @ @ @ @ @ . @ . . @ @ @ @ @ @ . . . . . . @ . @ . . . . . . @ 
@ @ . @ . @ . . . @ . @ . . . @ @ . @ @ @ @ . . . . . @ @ . @ . @ . @ . @ @ @ @ . @ . @ . @ . @ @ @ 
@ . . . . . @ . @ @ @ . . @ @ @ . . @ . @ . . @ . @ . @ . . @ . . . . . @ @ . @ . . . @ . . @ . @ @ 
@ . @ . @ . . . . . @ . @ . . . @ . . . @ @ @ . @ . . . @ . . . @ . @ . . @ . . @ @ . @ . @ . . . @ 
@ @ . @ . @ . @ . @ @ @ . @ . @ . @ @ . . . . . @ . @ . . @ . @ . . @ . @ . @ . @ . . . . . . @ @ @ 
@ . . . . . . @ . . @ . . . . . . . @ @ @ . @ . . @ . @ . @ @ . . @ . . . . . . . @ . @ . @ . . . @ 
@ @ @ @ . @ . @ . @ @ @ . @ . @ @ . @ . @ @ . @ . . . . . . . . @ @ @ . @ @ . @ @ . . . @ @ . @ . @ 
@ . @ . . . @ . . . . @ @ . . @ . . . . . . . . . @ . @ . @ @ . @ . @ . . . @ . . @ . @ . . . @ . @ 
@ . . . @ . . @ . @ @ . . @ . . @ @ @ . @ . @ . @ . . . @ . @ @ . . . . @ . . . @ . . . @ @ . . @ @ 
@ . @ . . @ @ @ @ . @ . @ @ @ . . @ @ @ @ @ @ . . @ . @ . . . . @ . @ . @ . @ . . @ . @ . @ @ . . @ 
@ @ . @ @ . . . . . . . @ @ . @ @ . @ . @ @ . . @ . @ @ @ . @ . @ @ . . . @ @ . @ . . . . . @ @ @ @ 
@ . . @ . . @ . @ . @ . . . . . . . . . . @ @ . . . . @ @ @ . . @ @ @ . @ @ . . . @ . @ . @ @ @ @ @ 
@ @ . . @ . . @ . . @ . @ . @ @ . @ . @ . @ . @ @ . @ @ @ @ @ . @ . @ . @ . @ . @ . . . @ @ @ @ @ @ 
@ @ @ . . . @ @ @ . @ . . @ . . . @ @ . . . . . @ . @ @ @ . . . . . . . . . @ . . @ . @ @ @ @ @ @ @ 
@ @ . . @ . @ @ @ @ @ @ @ . @ . @ . . . @ . @ . . . @ @ @ @ . @ @ . @ . @ . . @ . @ . @ @ @ @ @ @ @ 
@ @ @ . @ @ @ @ @ @ @ . . . . . . @ . @ @ @ . . @ . . . @ @ . . . @ . . . @ @ @ @ . . . @ @ @ @ @ @ 
@ @ @ @ @ @ @ @ @ @ @ @ @ @ @ @ @ @ @ @ @ @ @ @ @ @ @ @ @ @ @ @ @ @ @ @ @ @ @ @ @ @ @ @ @ @ @ @ @ @ 
3
26 16 22 44
21 37 46 34
41 43 25 19
