10 10
@ @ @ @ @ @ @ @ @ @ 
@ . @ . . . . . . @ 
@ . . @ . @ . @ . @ 
@ @ . . @ . . @ @ @ 
@ @ . @ . . @ @ @ @ 
@ . . . . @ @ @ @ @ 
@ . @ @ @ . @ . @ @ 
@ . . . . . . . . @ 
@ . @ . @ . @ . @ @ 
@ @ @ @ @ @ @ @ @ @ 
3
2 6 4 4
5 3 6 7
2 2 7 5
