20 20
@ @ @ @ @ @ @ @ @ @ @ @ @ @ @ @ @ @ @ @ 
@ @ @ . . @ . . . . . @ . . . @ . . @ @ 
@ @ @ . @ . @ @ . @ @ . . @ @ . . @ @ @ 
@ @ @ . . . . . . . @ . @ . @ . @ . @ @ 
@ @ . . @ @ @ . @ @ . . . . . . . . . @ 
@ @ @ . . @ . . @ . . @ @ . @ @ . @ @ @ 
@ @ @ . @ @ @ . @ @ . @ @ . @ . . . . @ 
@ @ . . . @ @ @ . @ . . @ @ . . @ @ . @ 
@ . @ . @ . . . . . . @ . @ @ . . @ . @ 
@ . . . @ . @ @ @ . @ . . @ . . @ . . @ 
@ @ @ . . . . @ . @ @ @ . . @ . @ @ . @ 
@ @ @ . @ . @ . . . @ . . @ . @ @ . . @ 
@ @ . . . @ @ . @ @ . @ . . . . @ @ . @ 
@ . @ . @ . @ . . . . . . @ . @ @ . . @ 
@ . . . @ . . . @ @ . @ @ @ @ . @ @ . @ 
@ @ @ . . . @ @ . . @ . @ . . . @ . . @ 
@ . . . @ . . . @ . . . . @ @ . @ @ . @ 
@ . @ . . @ @ . . . @ @ . . . . . . @ @ 
@ . @ @ . @ . . @ @ @ @ . @ @ . @ @ @ @ 
@ @ @ @ @ @ @ @ @ @ @ @ @ @ @ @ @ @ @ @ 
3
8 7 6 10
18 4 3 6
16 18 17 14
