100 100
@ @ @ @ @ @ @ @ @ @ @ @ @ @ @ @ @ @ @ @ @ @ @ @ @ @ @ @ @ @ @ @ @ @ @ @ @ @ @ @ @ @ @ @ @ @ @ @ @ @ @ @ @ @ @ @ @ @ @ @ @ @ @ @ @ @ @ @ @ @ @ @ @ @ @ @ @ @ @ @ @ @ @ @ @ @ @ @ @ @ @ @ @ @ @ @ @ @ @ @ 
@ @ @ @ @ @ @ @ @ @ . . @ . . @ . . . . @ . . @ @ @ @ @ @ @ @ @ @ @ @ @ @ @ @ @ . . . . . @ @ . . @ . @ . @ @ . @ @ @ @ @ @ @ @ @ @ @ @ . . . @ . . @ . @ . @ @ . . . . . . . . @ @ @ @ . . . @ @ @ @ @ 
@ @ @ @ @ @ @ @ @ . . @ . . @ . @ . @ @ . @ . . @ @ @ @ @ @ @ @ . @ @ @ @ @ @ @ @ . @ @ @ . @ . @ @ . . . . @ . . @ @ @ @ @ @ @ @ @ @ . . @ @ . . @ . . . . . @ . @ . @ @ . @ . @ @ . . @ . @ @ @ @ @ @ 
@ @ @ @ @ @ @ @ @ @ . . @ . @ . . . @ @ . . . @ . . . @ @ @ @ . . . . @ @ @ @ . . . @ . . . . . . . @ . @ . . @ . . @ @ @ @ @ @ @ @ . @ . @ . . @ . @ . @ . @ . . . @ . . @ . . . . @ . . . @ @ @ @ @ @ 
@ @ @ @ @ @ @ @ @ . @ . . . . @ @ . . . @ @ . @ . @ . . @ @ . . @ . @ @ @ @ . . @ @ . . @ . @ . @ @ @ @ . @ . . . @ @ @ @ @ @ @ @ . . . . . @ . . . @ @ . . . . @ @ . . @ . @ @ @ @ . . @ . . @ @ @ @ @ 
@ @ @ @ @ @ @ @ @ . @ @ @ @ . . . . @ . @ . . @ . . @ @ . @ . @ . @ @ @ @ . @ . . @ @ . @ @ . . . . . . . . @ @ . @ @ @ @ @ @ @ . @ . @ . @ . . @ . @ @ @ . @ @ . @ . @ . . @ @ @ @ @ @ . . @ @ @ @ @ @ 
@ @ @ @ @ @ @ @ . . . . @ @ @ . @ . . @ @ . @ . . @ . @ . . . . . . @ @ . . . . @ . . @ @ @ . @ . @ . @ . @ . . . . @ @ @ @ . . . @ @ @ . . @ . . @ @ @ . . . . . . . . . @ @ @ @ @ . . @ . . @ @ @ @ @ 
@ @ @ @ @ @ . . @ . @ . . . . @ . . @ . @ . . @ . @ . . . @ @ @ @ @ . . @ @ @ . @ . @ . . @ . . @ @ @ . . . . @ . @ @ @ @ . @ @ . . . . @ . . . @ . @ @ @ . @ @ . @ . @ . . @ . @ . @ . @ . @ . @ @ @ @ 
@ @ @ @ @ . @ . @ . . @ . @ @ . . @ . . @ . @ @ . . . @ . . . . . @ @ . @ . . . . . @ . @ . @ @ @ @ @ @ @ @ . @ @ @ @ @ @ . @ . @ @ @ . . . @ . @ . . @ . . @ . @ @ . . @ . . . . . . . @ . . . . @ @ @ 
@ @ @ @ . . . . . . @ . @ @ . @ . . @ . . . . . @ @ . . @ . @ . @ @ @ . . @ @ @ @ . . . . . @ . @ @ . . . @ . . . . @ @ . . . . . @ . @ @ . . @ @ . @ @ @ . . . @ @ @ @ . @ . @ . @ . @ . . @ . @ @ @ @ 
@ @ . . . @ . @ @ . @ . . . . . . @ . @ @ . @ @ @ @ . @ @ @ . . . @ . @ . @ . @ . @ @ @ . @ . . @ . @ . @ . . @ @ @ . . . @ @ @ . . . . . . @ . . . . @ . . @ . @ @ . . . . . . @ @ @ @ @ . . @ @ @ @ @ 
@ @ @ . @ . @ @ . . . @ @ . @ @ . . . . @ . . @ . @ . . @ @ @ . @ . . . . . . . . . . . . @ @ . . . . . . @ . @ . . . @ @ @ . . . @ @ . @ . @ . @ . @ . @ . . @ @ @ @ . @ . @ @ @ @ @ @ . . @ @ @ @ @ @ 
@ @ @ @ . . . @ @ @ . . @ @ @ . @ . @ . . . @ . . @ . @ . @ . @ @ @ . @ . @ @ @ @ @ @ @ . . . @ @ @ . @ . . . . @ @ . . . . @ . @ . @ @ @ . . @ . . @ . @ . @ . . @ @ @ . . . . @ @ @ @ @ . . @ @ @ @ @ 
@ @ @ @ @ . @ @ . . @ . . . . . @ @ . . @ @ . @ . . . . . . . . @ @ . @ @ . @ . @ . . @ @ @ . @ . @ . . @ . @ . . . @ @ . @ @ @ . . . @ . @ . @ . @ @ . . . @ . @ . @ @ @ . @ @ . @ @ @ . . @ . @ @ @ @ 
@ @ @ @ . . @ @ @ . @ . @ . @ . . . @ . @ @ . . @ @ . @ . @ @ . @ . @ . . . @ . . . @ . @ . . . . . . @ @ @ . @ . @ . @ @ . @ . @ @ . @ . . . . . . . @ @ . @ . . . . . @ . @ . . . @ @ . @ . . . @ @ @ 
@ @ @ . @ . . @ . . . @ @ . . @ @ . . . . . . @ @ @ @ . . . . @ . . @ @ @ . . @ @ . . . . . @ . @ @ @ @ @ . . . . . . . . . . . . . . . . @ . @ . @ . . @ . @ . @ . @ @ . @ . @ . @ . @ . @ . @ . . @ @ 
@ . . . . . @ . @ . @ . . @ @ . . . @ . @ @ . @ . . @ . @ . @ . @ . . @ . @ . @ . @ @ @ . @ . @ @ @ . @ @ @ . @ . @ @ . @ @ @ . @ . @ . @ . . . @ . @ @ . . @ . . @ . @ . . . . . . . . . . . @ . @ . @ 
@ @ . @ . @ . . . . . . @ . . @ . @ . . @ @ @ @ . @ @ @ . . . . . . @ . . . . . . . . @ @ . . @ @ . . . @ . . @ @ . . . . @ . @ . . . @ @ . @ . . . . @ . @ . @ . . . @ . @ . @ @ . @ . @ @ . @ . . . @ 
@ @ @ . . . @ . @ . @ @ . @ . . @ @ @ . . @ . . . . @ @ @ . @ . @ . . . @ @ . @ . @ . @ . @ . @ . @ . @ . . @ . . . @ . @ @ . . @ . @ @ . @ . @ @ . @ . . . . @ . @ @ . @ . . @ . @ @ . . @ . @ @ . @ @ 
@ @ . @ @ . @ @ . . . . . . . @ . @ . . @ . . @ . @ . @ . . @ @ . @ @ . @ . @ @ @ . . . . . . . . . . . . @ . @ . @ . . . . @ . . . @ . . . . . @ . @ . @ . @ . . . . . @ . @ . . . @ . @ @ . @ . @ @ @ 
@ . . . @ . . @ @ . @ @ . @ . . . @ . @ . @ @ . . . . @ @ . . . . . . @ . . . . . . @ @ . @ @ @ @ @ . @ . . . @ . @ @ . @ . @ @ . @ . @ . @ . @ . . . . . @ . @ . @ . @ . @ . @ . @ . . . @ . . . . @ @ 
@ @ . @ . @ . . @ . @ . @ . . @ @ . . . . . . . @ @ @ . . . @ . @ . @ . @ @ @ @ @ . . . @ . @ @ @ . @ . . @ @ @ @ . . . . @ @ @ @ . . . . . @ . @ . @ @ @ . . . . . @ @ . . . . . . . @ @ . @ . @ @ @ @ 
@ . . . . . . @ . . @ . @ @ . . . @ . @ @ . @ . . . @ . @ @ @ @ @ . @ . . . . . . @ @ @ . . . @ . . . @ @ @ . @ . . @ . @ . . @ . @ . @ . @ . . . . . @ . . @ @ . @ . @ @ @ . @ . @ @ . @ . @ @ @ @ @ @ 
@ @ @ @ . @ . @ @ . . . . . @ @ . . . . @ . . @ . @ . @ . . @ @ @ @ @ @ . @ . @ . @ @ . @ @ . . @ . @ @ . . . @ . @ . . . . @ . . . @ . . @ @ . @ . @ @ @ . @ . . . . . . @ . @ . @ @ . . . . @ @ @ @ @ 
@ @ . . @ . . . @ . @ @ . @ @ @ @ @ @ . . @ . . @ . . . @ . . @ . . . . @ . @ . . . @ . @ . @ . @ . @ . @ . @ . . @ @ . @ . . @ . @ . @ . @ . @ . . . . @ @ @ @ . @ . @ . @ . @ . @ . . @ . @ @ @ @ @ @ 
@ . . @ . @ . @ . @ @ . @ @ @ . . . . . @ @ @ @ . @ . @ . . @ . @ . @ . . . . . @ . @ . . . . . . . . . . . @ @ . . . @ . . @ . . . . . . @ . @ @ . @ . . . @ . . . @ @ @ . . . @ . . @ . . @ @ @ @ @ @ 
@ @ . . . . . . . . . . . @ . @ @ . @ . . @ @ . . . . . . @ . . . . . @ . @ . @ . . . . @ @ @ @ @ . @ . @ . . @ @ . @ . @ . . @ . @ @ @ . . . . . @ . . @ @ . @ . @ . @ . @ . @ . @ . . @ . @ @ @ @ @ @ 
@ @ @ @ . @ . @ . @ @ @ @ . . @ @ . @ . @ @ @ @ . @ . @ . . @ . @ . @ @ @ . . . @ @ . @ . @ . @ . @ . . @ . @ . @ . @ . . . @ . @ . . . . @ . @ @ @ @ . . . . . . . . . . . . . . . . @ . . @ . @ @ @ @ 
@ @ @ @ . @ @ . . . . @ . @ . @ @ @ . . @ @ @ @ @ . . . @ . @ @ . . . @ @ @ . @ . @ @ . . . . . . . @ @ . . . . . @ @ @ @ @ . . . . @ @ . @ . . @ . . . @ . @ . @ . @ . @ @ @ @ . @ @ . @ . @ . . @ @ @ 
@ @ @ @ @ @ @ @ . @ . . . . . . @ . @ . . @ . @ . @ . @ . @ @ @ . @ @ @ @ @ @ . . . @ @ . @ . @ . @ @ . @ . @ . @ @ @ . . . @ . @ . @ @ @ . @ . @ @ . @ @ @ . . . @ . @ @ @ @ . @ @ @ . . . @ . @ . @ @ 
@ @ @ @ @ @ @ @ @ . @ @ @ @ @ . . . . . @ . . . . . . . . @ @ . . . . @ @ @ @ @ . @ . @ @ . @ . . @ @ . . . . @ @ @ . @ . @ @ @ . . @ @ @ . . . @ . . . @ . @ . @ . . @ @ . @ . @ @ @ @ @ . . . . . . @ 
@ @ @ @ @ @ @ @ @ . . . . . @ . @ . @ . . . @ . @ . @ . @ @ @ @ @ . @ @ @ @ @ . . . . . @ . . @ . . . . @ . @ @ @ . . . . . @ . @ . . @ . . @ . . @ . @ @ . @ . @ . @ . . . . . . . @ . . . @ @ . @ . @ 
@ @ . @ @ @ @ @ @ . @ . @ . . @ @ @ @ . @ @ . @ . . @ @ @ @ @ @ . . . @ @ @ . @ . @ . @ @ @ . @ @ . @ @ . . . @ . . @ @ @ . @ . @ . @ . @ . @ @ @ . . . @ . . . . . . . @ @ . @ . @ @ . @ @ . . @ . . @ 
@ . . . . . . @ . @ @ @ @ @ . . @ @ @ . . . . . @ . @ . @ . @ @ . @ . . @ . . . . @ @ . @ . . . @ @ . . @ . @ . @ @ . @ . . . . . . . . @ . . @ . . @ @ . @ @ . @ . @ . . . @ . . @ . @ . @ . @ @ @ . @ 
@ @ . @ @ @ . . . . @ . . . . @ . @ . . @ @ @ @ @ . @ . . . @ . @ . . @ . @ @ @ . . @ . @ @ . @ . . @ . . . . . . . . . . @ . @ . @ @ @ . . @ @ @ . . . . . . @ . . @ . @ . . @ . . . . . . . . @ . @ @ 
@ @ @ . . . . @ . @ @ @ . @ . . . @ @ . @ . . @ . @ . . @ . @ . . @ @ . . @ @ @ . @ . . @ . . . . @ . @ . @ @ @ . @ . @ @ . . . @ @ . . @ . @ @ . . @ . @ . @ @ @ . . @ @ @ @ . . @ . @ . @ @ . . . . @ 
@ @ @ @ . @ . @ . . @ @ @ . . @ @ . . . . @ . . . . @ . . @ . . @ . . @ . . @ . . . . @ @ . @ . @ . . . . @ @ @ @ @ @ @ @ @ . @ . . . @ . . . @ @ . . @ @ . . @ . @ @ @ @ . . @ . . @ @ . . . @ @ . @ @ 
@ @ @ @ @ @ @ . . @ @ @ @ @ . . @ @ @ . @ . @ . @ . . . @ . . @ . @ . @ . @ . @ . @ @ . . . . @ @ . @ . @ @ . @ . . . @ @ . . @ @ @ . . @ . @ . . . @ @ @ @ . . . . @ @ . @ . . . @ . @ . @ . . . @ . @ 
@ @ @ @ @ @ @ . @ @ @ @ @ . . @ . . . . . . . @ . @ @ . . @ . . . . . @ . . . . . . . @ @ . @ . . @ . . @ @ . . @ @ . @ @ . @ . @ . @ . . . . @ @ . @ @ @ . . @ . @ @ @ . . @ @ . . . . @ @ . @ . @ . @ 
@ @ @ @ @ @ . . . @ . @ . @ . . @ . @ . @ @ @ . . @ . @ . @ . @ @ . @ . @ @ . @ . @ . . . . @ . @ . @ . . @ . @ @ . . . . @ . . . . @ . @ . @ . . . . @ @ @ . @ . . . . . @ @ . . @ . @ . . @ . . @ . @ 
@ @ @ @ @ . @ . @ . . . . @ @ . @ @ . . . @ . @ . . . . . . . . @ @ . . . @ @ . @ . @ . @ . . . . . . . @ @ . @ . @ . @ @ @ @ . @ . . @ . . . @ @ . @ . @ . @ . @ . @ . @ . @ . @ @ @ . . @ . @ . . . @ 
@ @ @ @ . . . . . @ . @ @ . . . . . . @ . @ . . . @ . @ . @ . @ . @ @ . @ . @ . . . . . . @ . @ . @ . @ @ . . . . . . . @ @ @ @ . . @ . @ . @ . . . . . . . @ . @ . @ @ @ . . @ . @ . @ . . . . @ . @ @ 
@ @ . . . @ . @ . . . . @ @ . @ . @ . @ . . @ @ . . @ @ . . @ @ . . . . . . . @ . @ . @ @ . @ . @ . . @ . @ . @ . @ . @ @ @ . . @ . @ . . . . . @ @ . @ @ @ . . . @ @ . @ . @ . . . . @ . @ . @ @ @ @ @ 
@ . . @ . @ @ . @ @ . @ @ @ @ . . . @ . @ . @ . . @ . . . @ . . @ . @ . @ . @ . . . @ . . . . . . . @ . . . . . @ . . @ @ @ @ . . . . @ @ . @ . . @ . . @ . @ . @ . @ . . . . . @ . @ . . . @ . @ @ @ @ 
@ . @ . . @ . . . @ . . @ . . @ @ @ . . . . . @ . . @ . @ @ @ . . . @ . . @ @ @ . @ @ @ . @ . @ @ . . @ . @ . @ @ @ . @ @ @ . @ . @ . . . @ . . @ . . @ . . . . . . . @ . @ . @ . . . . @ . . . . . @ @ 
@ . @ @ . . @ . @ . @ . @ @ . . . . @ . @ @ . @ . @ . @ @ . . . @ . . @ . @ @ . . . @ . @ . . @ . . @ @ @ . . @ . @ @ @ . . . . @ . . @ . . @ . @ . @ . @ . @ . @ @ . . . . @ @ @ . @ @ . . @ . @ @ . @ 
@ @ . . . @ . . . . . . . . . @ @ @ . . @ . . . . @ . . @ @ . @ . . @ . . . . @ . @ . . . @ . . @ . . @ . @ . . . . @ @ @ . @ . . @ . . @ @ . . . @ . . @ @ . . . @ @ @ . @ . @ . . @ . @ @ @ . . . . @ 
@ @ . @ . . @ . @ . @ . @ @ . @ @ @ @ . @ . @ @ . @ @ . . @ . @ . @ . @ . @ . @ @ . . @ . @ . @ @ . @ . . . . @ . @ @ @ @ @ . @ . @ @ . @ . @ . @ . @ . @ . @ . @ . . . @ . . . @ @ . . . @ . . @ @ . @ 
@ . @ @ @ . . @ . . @ @ . . . . @ @ @ @ . @ @ . . @ . . @ . @ . . . . . @ @ @ . @ @ . . @ @ @ @ @ @ @ @ . @ . . @ . @ @ @ . . . . . . . . . . . . . . . . . . . . @ . @ . @ @ . @ . @ @ . @ @ . . . @ @ 
@ . @ . @ . @ @ @ . @ . @ . @ @ . @ @ . . @ @ @ . . @ . . . . @ . @ @ @ . . . . @ @ . @ . @ @ @ . @ @ @ @ @ . @ . . . @ @ @ . @ . @ . @ . @ . @ . @ @ . @ . @ . @ @ . . . . . . . . . @ . @ . @ @ @ . @ 
@ . . . @ . @ @ @ @ . . . . . . . @ . @ . . @ . . @ . . @ @ . . . . @ . @ @ @ . @ . . . . . @ . . . @ . . . . . @ . @ @ @ @ @ . . @ . @ . . @ @ @ . . . @ @ @ . @ . . @ @ . @ . @ . @ @ . . . . @ . . @ 
@ . @ . . @ @ @ @ @ @ . @ . @ @ . . . . . @ . @ . . . @ @ @ . @ @ . . . . . . . . @ . @ . @ . @ . @ . @ @ . @ . . . . @ @ @ . @ . . @ . . @ . @ . . @ . . @ . . . @ . . @ . . @ . . . . @ . @ @ @ @ . @ 
@ . . @ . @ @ @ @ @ @ @ . . @ @ . @ . @ . . . . @ @ . @ @ @ @ . . . @ . @ . @ @ . . . . @ . . . . @ . @ @ @ . @ @ . @ . @ . . . @ . @ @ @ . . . . @ . . @ . @ . @ . . @ . . @ @ @ . @ . . . . . . . . @ 
@ . @ . @ . @ @ @ @ @ . @ . @ @ @ @ @ . . @ . @ @ . . . @ @ @ . @ . . @ . . . . @ . @ @ @ @ . @ . . . . . . . . . . . . @ @ . @ @ . @ . . @ . @ . @ @ @ . . . . . @ . @ @ . @ @ @ @ . . @ @ @ . @ . @ @ 
@ . . . . . . . @ @ @ . @ . . . . @ . @ . @ . @ . @ . @ @ @ @ @ . . @ @ @ . @ . . @ @ @ @ @ @ . . @ @ @ @ . @ . @ . @ @ . . . @ . @ . . @ . . . @ . @ @ @ . @ . @ @ . . @ . @ . @ @ @ . . . @ . . @ . @ 
@ . @ . @ . @ @ . . . . . . @ @ @ . . @ . . @ . . . . . @ @ @ @ @ @ . . . . @ . @ @ @ @ @ @ . @ . @ . @ @ . . @ . . . . @ @ . . . . . @ . @ . @ . . . @ . @ @ . @ . . @ . . . . . @ @ . @ . @ . @ . . @ 
@ . . @ . @ @ . . @ @ . @ . @ @ @ @ . . @ . . @ . @ . @ @ @ @ @ @ @ @ . @ . . @ @ @ . . . . . . . . . . @ . @ @ @ . @ . . @ . @ . @ @ @ . . . . . @ @ @ . @ . . @ . @ . @ @ . @ . . . @ . . @ . . . @ @ 
@ @ . . . . . . @ . @ @ @ @ @ @ @ @ . @ @ @ . . @ . . . @ @ @ @ @ @ @ @ . . @ . @ . @ . @ . @ @ . @ . @ . @ @ @ @ @ @ @ @ . . @ . @ . . @ @ . @ . . @ . . . @ . @ . . . @ . . . @ . @ @ @ . @ . @ . . @ 
@ . . @ @ . @ . . . . @ @ @ @ @ @ . . . @ . @ . . @ . @ . @ @ @ @ @ @ . . @ . . . . @ @ @ @ . . @ . . . . . @ @ @ . @ . . . @ . @ @ @ . @ . . . @ @ @ @ . @ . . . . @ . @ @ . @ @ @ @ @ @ @ . @ . @ . @ 
@ @ . @ . @ . @ . @ @ . @ . @ @ @ . @ . . . @ . @ . . . . . @ @ @ @ @ @ @ @ @ . @ . . . . @ . @ . @ . @ . @ . @ . . . . @ @ . . . @ . . . @ . @ @ @ @ @ . . . @ . @ @ @ . . @ @ @ @ @ @ @ . . @ . @ . @ 
@ @ . . . . . @ . @ @ . . . . @ @ @ . @ @ . . . . . @ . @ @ @ @ @ @ @ @ @ . . . @ . @ @ @ . . . . @ . @ . . . @ @ @ @ . . @ . @ @ . @ . @ . @ . @ @ @ . . @ @ . . @ @ @ @ . @ @ @ @ @ @ @ @ . . . . @ @ 
@ . . @ . @ . . @ . . . @ @ . @ @ @ . @ . @ . @ @ . @ @ @ @ @ @ @ @ @ . . @ @ . @ . . . @ @ . @ . . @ . . @ . . . . @ . @ . . . . . . . . . @ . @ @ . @ . @ . @ . . @ @ . . . @ @ @ @ . @ . . @ . @ @ @ 
@ . @ . . . @ @ . @ @ . @ @ @ @ @ . . . . . . . . @ . . @ @ @ @ @ @ @ @ . @ @ @ . . @ @ . @ . @ . @ @ @ . . @ . @ . . . . . @ @ @ @ . @ . @ @ . . @ . . @ . . . . @ . @ @ . @ . @ @ . . . @ . @ . @ @ @ 
@ . @ @ . @ @ . . @ . . @ @ @ @ . @ @ . @ @ . @ @ . @ . . @ . @ @ @ @ . . . @ . @ . @ . . . @ . . . @ . . @ . @ @ . @ . @ . . . @ @ @ . . . @ . @ . . @ . @ @ @ . . . . . . . . . @ @ . @ . . . @ @ @ @ 
@ @ . . . @ @ @ . . @ . @ @ @ . . . . @ @ . . . . . . . @ . . @ . @ . @ . @ . . . . . @ . @ . @ . @ . @ . @ . . @ . . @ . . @ . . @ @ . @ @ @ . @ . @ . . . . . . @ . @ . @ . @ @ . @ . @ . @ . . @ . @ 
@ @ @ . @ @ @ . @ . @ . @ @ . @ . @ . . . . @ . @ . @ . . @ . @ . @ . @ . @ . @ . @ . . . . . . . . . . . . . @ . @ @ @ . @ . . @ @ @ @ @ @ . . @ . . @ . @ . @ @ . . . @ . . . . . . . . . . @ . . . @ 
@ @ @ @ . . . . . . . . . . . . @ @ @ . @ . . @ @ @ . @ . . . . . . . . . . . @ . . @ @ . @ . @ . @ . @ . @ @ . . . @ . @ . @ @ @ @ @ . @ . @ . @ . @ . . @ @ . @ . @ @ @ @ . @ . @ . @ . @ @ . @ @ @ @ 
@ @ . @ . @ . @ . @ @ . @ . @ . . . . . @ . @ . @ . . . @ . @ . @ . @ @ @ . @ . . @ @ . @ . . @ @ . . @ . . . . @ @ . . . . . @ @ . . . . . . . @ . . @ . . @ . . @ . @ @ @ @ @ @ @ . @ . @ @ . . . @ @ 
@ . . @ . . @ . . . . @ . . . @ . @ . @ . . . . . . @ . . @ @ @ . . @ @ @ @ . @ . @ . . . . @ . . . @ @ . @ . @ . . @ . @ . @ @ . @ . @ . @ @ . @ @ . @ . @ . . @ @ . . @ . @ @ @ @ @ . @ . . . @ . . @ 
@ @ . . . @ @ . @ @ @ @ . @ . . @ . . @ @ . @ . @ . . @ @ @ @ . @ . . @ . . . @ . . @ . @ . . @ . @ @ . . . @ . @ . @ @ . . . @ . @ . . @ @ . . @ . . . . . @ . @ . @ . . . . @ @ @ . . . @ . @ . . @ @ 
@ . @ . @ . @ @ . . . . . @ . @ . @ . @ @ @ @ . . @ . . . @ . . . . @ @ @ . @ . . @ @ @ . . @ @ . @ . @ @ . . . . . . . . @ . . . . . @ @ . @ . . @ . @ . @ . . . . . . @ . @ @ @ . @ . @ . @ . @ . @ @ 
@ . . . . . @ . . @ . @ . @ . @ . @ . . @ . . . @ @ . @ . . @ . @ @ . @ . . . . @ . . . @ @ . @ @ . . @ @ @ @ @ @ @ . @ @ . @ . @ @ . @ . . . . @ @ @ . . . @ . @ . @ . @ @ @ @ . . . . . . . . . . . @ 
@ @ . @ @ . . @ . . @ . . . @ . . . @ . . @ @ . . . @ . @ . @ @ . @ . . @ . @ . . @ . @ @ @ . @ . @ . . . . . @ . @ @ . @ . . @ . @ @ @ @ . @ . @ @ @ . @ . . @ . . . @ . . @ . @ . @ . @ . @ . @ . @ @ 
@ @ . . @ . @ @ @ @ @ @ . @ . . @ . . . @ . @ . @ . . . . @ @ @ . . @ . @ . @ . @ . . . . . . . . @ . @ . @ @ . . . . . . @ . @ . @ . @ . @ . . . . @ . @ @ @ . @ . @ . @ . . . . . . @ . . @ . . @ @ @ 
@ . . @ . . . @ . . @ . @ @ . @ @ . @ . . . @ @ . . @ @ . @ @ . @ . . . . . @ . @ . @ @ . @ . @ @ @ . . @ . . . @ @ @ @ . . . . . . . . . . @ . @ . . . . . . . . . . . . . @ . @ @ . . @ @ . . @ @ @ @ 
@ @ . @ . @ . . @ . . . @ @ @ . . . @ @ @ @ . . @ . . @ @ @ . . . . @ . @ . @ . . . . . @ @ . @ . . @ . @ . @ . @ . . . . @ . @ @ . @ . @ . @ @ . @ @ . @ . @ . @ . @ . @ . . @ . @ . @ @ @ @ . @ @ @ @ 
@ . . . @ @ . @ @ . @ . . @ . @ @ . . . @ . @ . . @ @ . @ . @ @ . @ . @ . . @ . @ . @ @ @ @ @ . . @ . . . . @ @ . @ @ @ @ . @ @ @ @ . . @ . @ . . . . . @ @ @ @ . . . @ . . @ @ . @ . . @ @ . @ . @ @ @ 
@ @ . @ @ @ @ @ . @ @ . @ . . @ . . @ @ . . . @ . . . . . . @ @ @ . . . . @ . . . @ @ @ @ @ @ @ . . . @ . @ . . . . . . . . . @ . . . @ . . . @ . @ @ . @ @ @ . @ . @ @ @ . @ . . . . @ @ @ . . . . @ @ 
@ @ @ @ @ @ . . . @ . . . @ . . @ . @ . @ @ . . @ . @ . @ @ @ @ @ @ . @ . . @ . @ . @ @ @ @ @ @ @ . @ . . @ @ . @ . @ @ . @ . @ @ . @ . @ @ . . @ . . . @ @ . . . . . . @ . @ @ . @ @ . @ . @ @ . @ . @ 
@ @ @ @ @ . @ . @ . @ @ . @ . @ . @ . . . . @ . @ @ . . . @ @ @ @ . @ . . @ . . . . @ @ @ @ @ @ @ @ . . @ @ @ @ @ . @ . @ . . . . @ . . @ @ @ . . . @ . . . @ . @ . @ @ . . @ . . . . . . . . . . . . @ 
@ @ @ @ . . . . . . . . . . . . . . . @ @ . . . . . @ . @ . @ @ . . . @ . @ @ . @ . . . @ @ @ @ @ @ @ . @ @ @ @ @ @ @ . @ . @ @ . @ . @ . @ . @ . @ . . @ . . @ . . @ @ @ . . @ . @ . @ . @ . @ @ . @ @ 
@ @ @ @ @ . @ . @ . @ . @ @ . @ @ . @ . @ @ @ . @ . . . . . . . @ . @ @ @ . . . . @ . @ @ @ @ @ @ . . @ @ @ @ @ @ @ @ . @ . @ . . . . . . . . . . @ @ . . @ . @ @ . . @ @ . @ @ @ . . . @ . . . . @ @ @ 
@ @ @ . @ @ . . . @ . . . . @ . @ @ @ . @ . @ @ @ @ @ @ @ @ @ . . . . . . . @ @ . . @ @ @ @ @ @ @ @ . . @ @ @ @ @ @ @ . . . . @ . @ . @ . @ . @ . . @ . @ @ . @ @ . @ @ . . @ @ . . @ @ @ @ @ . @ @ @ @ 
@ @ . . . . @ @ . . @ . @ @ @ . . @ . . . . . . . . . . . . . . @ . @ . @ . @ . . @ . . @ @ @ @ @ . @ . . @ @ . @ @ @ @ @ @ @ @ @ @ @ . . @ @ . . @ @ . . . @ @ @ . @ . @ . . . @ @ . @ @ @ @ . @ @ @ @ 
@ . . @ . @ @ . . @ . @ @ . . . @ . . @ . @ . @ . @ . @ . @ . @ . . @ @ . . . @ . @ . @ . @ @ @ . . . . @ @ . . . . . . . . . @ . @ . @ . . . @ . . @ @ . @ @ @ @ . . . . @ . @ . . . . @ @ @ @ @ @ @ @ 
@ @ . . @ @ @ @ @ . . . @ @ . @ . . @ @ . . @ @ @ . . @ . . @ @ @ . @ @ @ . @ . . . . @ . . @ @ @ . @ . . . @ @ @ @ @ @ @ @ . . . . . . . @ @ @ . @ . . . @ @ @ @ @ @ . @ @ @ . . @ . @ . @ @ @ @ @ @ @ 
@ . . @ . @ @ @ . . @ . @ . . . @ . @ @ . @ . @ . @ . . @ @ @ @ . . . @ @ @ . @ . @ . @ @ . . @ @ @ . . @ . @ . . . . . . . . @ . @ . @ . @ @ @ . @ @ . @ . @ @ . . @ @ @ @ @ @ . . @ . . . @ . @ @ @ @ 
@ . @ . . . @ @ . @ . @ . . @ . . @ @ @ @ . . . . . . @ . @ @ @ @ . @ @ @ . . . @ . . @ . . @ . @ . . @ . @ . @ . @ . @ . @ . . @ . . @ @ . . . . @ . . @ . . . . @ . . @ @ . @ . @ . @ . @ . . . @ @ @ 
@ . . @ @ . . @ . . . @ . @ . . @ . . . . @ . @ . @ . . . . @ @ . . @ . . . @ @ . @ @ . @ . @ . . @ . . . . . . . . @ . . . @ . @ @ . @ . @ . @ . . @ . @ . @ @ . @ . @ . @ . . . . . . . . . @ @ . @ @ 
@ @ . @ . . @ @ . @ . @ @ . @ . . . @ . @ . . . @ . . @ . @ @ @ @ . . @ . @ . @ . . . . . . . . @ . @ @ . @ . @ . @ . @ . @ . @ . @ . . . . @ . . @ @ . . . . @ . . . . . . . @ . @ . @ . @ . . . . . @ 
@ @ . . @ . . . @ . . . . . . @ @ . @ @ . @ . @ . @ . . @ @ @ @ . @ . . . . . . . @ @ . @ @ . @ . . . . . . @ . . . . @ @ . . . . . . @ . @ . @ . @ . . @ . @ @ @ . @ . @ . @ @ @ @ . @ @ @ @ . @ @ . @ 
@ . @ . . @ . @ @ @ . @ @ @ . @ . . . @ . . . . . . @ . @ @ @ @ . @ @ . @ . @ . @ @ . @ . . . . @ . @ @ . @ . @ . @ @ . . @ . @ . @ @ @ @ . . . . . @ . @ . @ . @ @ . . . @ . . . . . . . . @ . . . @ @ 
@ . @ @ . . . . @ . @ @ . . . . @ . @ . @ @ . @ . @ @ . . @ @ . . . . . . @ . . . . . . @ @ . @ . @ @ . . @ . . . @ @ . @ . @ . . @ . @ . . @ @ . @ @ . . @ . . . @ @ @ . @ . @ . @ . @ @ . . @ @ . . @ 
@ . @ . @ . @ . . . @ . @ . @ . . . . . . . . @ @ @ . . @ @ . . @ . @ . @ . @ . @ . @ @ . @ @ . . . . @ . . @ . @ . . . . . . . @ . . . . @ . . . @ . . @ . . @ . . . . @ . . @ @ . . . . @ . @ @ . @ @ 
@ . . . @ @ . . @ @ @ . . @ @ @ . @ . @ . @ @ @ . . . @ @ @ @ @ @ @ . . . . . @ . . . . . . . . @ . @ @ @ @ . @ . . @ @ @ @ @ . @ . @ . @ @ @ @ . . @ . @ . @ . @ @ . @ . . @ . . . @ @ . @ . . . @ @ @ 
@ . @ . @ . @ . @ @ . @ . @ @ @ @ . . . @ @ . @ . @ @ @ @ @ @ @ @ @ @ . @ . @ @ @ . @ . @ . @ @ . . . @ @ . . @ @ @ . . . . . . . @ . . . @ . . @ . . @ . . . . @ . @ . @ . @ . @ . . @ . . @ . @ . @ @ 
@ @ . . . . . . . . . . . . @ @ . @ . @ @ . . . . @ @ @ @ @ @ @ @ @ @ . . @ . . @ . @ . . @ . @ @ . @ . . . @ . . . . @ . @ @ . @ @ @ . @ . @ . . . @ . @ . @ @ @ . @ . . . . @ . . @ . . @ @ . . . . @ 
@ @ @ . @ . @ . @ @ @ @ . @ . . . . @ @ . @ . @ . @ @ @ @ @ @ @ @ @ . . @ @ . @ . . . @ . . . @ @ . @ @ . @ . @ . @ . . @ @ @ @ . . . . . . . @ @ . . . . . . @ . . . @ . @ . . @ . . @ . . . @ . @ . @ 
@ @ @ @ . . @ . . @ @ @ . . . @ @ . . . . . . @ . . @ @ @ @ @ @ @ @ @ . . . . @ @ . @ @ @ . @ . . . . . . . . . @ @ @ . . @ @ @ @ . @ . @ . @ @ @ @ . @ . @ . . . @ @ . . . @ @ . . @ . . @ . . @ @ . @ 
@ @ @ @ @ @ @ @ @ @ @ @ @ @ @ @ @ @ @ @ @ @ @ @ @ @ @ @ @ @ @ @ @ @ @ @ @ @ @ @ @ @ @ @ @ @ @ @ @ @ @ @ @ @ @ @ @ @ @ @ @ @ @ @ @ @ @ @ @ @ @ @ @ @ @ @ @ @ @ @ @ @ @ @ @ @ @ @ @ @ @ @ @ @ @ @ @ @ @ @ 
3
28 19 17 72
80 4 78 93
65 76 17 11
