50 50
@ @ @ @ @ @ @ @ @ @ @ @ @ @ @ @ @ @ @ @ @ @ @ @ @ @ @ @ @ @ @ @ @ @ @ @ @ @ @ @ @ @ @ @ @ @ @ @ @ @ 
@ @ @ . . . . . . @ . @ @ . @ . @ @ @ . @ @ @ @ @ @ @ . . @ . . @ . . . . . . . . @ @ @ . @ @ @ @ @ 
@ @ . . @ . @ @ . . . . . . . . @ @ . . . @ @ @ @ @ . . @ @ @ . . @ @ . @ @ @ . @ . @ . . . @ @ @ @ 
@ . @ . . @ . @ @ . @ . @ . @ . @ . @ . @ @ @ @ . . @ . . @ . @ . . . . . @ . @ @ . . @ . @ . @ . @ 
@ . . . @ @ . @ . . @ . @ @ . . . . . . . @ @ . @ . . . @ . . . @ . @ . @ . . @ . . @ . . . . . . @ 
@ . @ . @ . . @ @ @ . @ @ . @ . @ . @ . @ @ @ . @ . @ . . . @ . @ . @ . . @ . . . @ . . @ . @ . @ @ 
@ @ @ @ . @ . . . . . . . . . . . @ . . . @ . . . @ . @ . @ . . . @ . . @ . @ @ . @ . @ . @ @ . . @ 
@ @ @ @ . @ @ . @ @ @ @ @ . @ . @ . @ . @ . @ . @ . . @ @ . @ . @ . @ . @ . . . . . . . . @ . @ . @ 
@ . @ . . . @ @ . @ . . . . @ @ . . . . . . . . . @ . @ . . . . . . . . . . @ @ . @ @ . @ . . @ . @ 
@ . . @ . @ . . . . @ @ @ @ . . . @ . @ . @ . @ . . . . . @ @ . @ . @ . @ . . . @ . . @ @ . @ . @ @ 
@ @ . . . @ . @ . @ . . @ . @ @ @ @ . . @ @ @ . @ . @ @ @ . . . . @ @ . . @ . @ . @ . . . . . . . @ 
@ @ . @ . . @ . . . @ . . . . @ . . . @ @ @ . . . . . . . @ @ . @ . . . @ . @ @ . @ . @ . @ . @ . @ 
@ @ @ . . @ . . @ @ . . @ . @ . @ @ . @ @ @ . @ . @ @ . @ . @ @ . . @ . . . @ . . @ . . @ @ . . @ @ 
@ @ . @ . . @ . . @ . @ . . . . . . . . @ @ @ . . @ . . . . . . @ . . @ . @ @ @ . . . @ . . @ . . @ 
@ . . . @ . @ . @ . @ . @ . @ . @ . @ @ . @ . @ . . @ . @ . @ . @ . @ @ @ . @ @ @ . @ . @ . @ @ @ @ 
@ . @ . . . . . . . . . @ @ . @ @ @ . . . . . . . @ . . . @ @ . @ . . @ . . . @ . . . . . . . @ . @ 
@ @ . @ . @ @ . @ . @ @ . . . . . . . @ . @ . @ @ . @ . @ . @ @ . . @ . @ . @ @ @ . @ @ . @ @ . . @ 
@ @ . . . @ . . @ @ @ . @ . @ . @ . @ . . @ . . @ . . . . . . @ @ . . . . . . . . . @ . @ . . . @ @ 
@ . . @ . . @ . . @ . . . @ @ @ . . @ . @ . . @ @ . @ . @ . @ @ . . @ @ . @ . @ @ . . . . . @ @ . @ 
@ @ . @ @ . @ . @ . @ . @ . @ . @ @ . @ @ . @ @ @ @ . . . @ @ @ @ . . @ . . @ . . . @ . @ . . . . @ 
@ @ . . . @ . . . . . . . . . . @ . . . @ @ @ @ @ . @ . @ @ @ . @ . @ . @ . @ @ @ . . @ . . @ @ @ @ 
@ @ @ @ @ . . @ @ . @ . @ . @ @ . . @ . . @ @ . . . . . . @ . . . . . . . @ @ @ @ @ @ @ @ . @ . . @ 
@ @ @ @ . @ . @ . @ @ @ @ @ @ . @ . @ @ . . . @ @ . @ . @ @ @ @ @ . @ @ @ . @ . @ . @ @ . . @ . @ @ 
@ @ . . . . . . . @ @ . @ . . . @ @ . @ @ @ . . @ @ @ @ @ @ @ @ . . . @ . . . . . . . . @ . . . . @ 
@ @ @ . @ @ . @ . . . . . . @ . . @ . @ @ . . @ @ @ . @ @ . @ . @ . @ @ @ . @ . @ . @ @ @ . @ @ @ @ 
@ @ . . @ @ @ @ . @ . @ @ . @ . @ . . @ . @ . @ . . . . . . . . . . . @ @ @ . . . @ . . . . @ . . @ 
@ @ . @ . . . @ . @ @ . . . @ . . @ . . . . . . . @ . @ . @ . @ . @ @ @ @ @ @ . @ . @ @ . @ . . @ @ 
@ . @ . . @ . @ @ . . @ @ . @ @ . @ . @ . @ @ @ . @ . @ . @ . @ . . @ @ @ @ @ . . . . @ @ @ @ . . @ 
@ . . @ . @ @ @ . . @ @ @ @ . . . . . @ @ . . . . @ @ @ . . @ . . @ . @ . @ . @ . @ @ @ @ @ . . @ @ 
@ @ . . . . . . @ . . @ @ . @ . @ . @ . @ . @ @ @ . . . . @ . @ . . . @ . @ . . . . . @ . . @ . . @ 
@ @ @ . @ . @ . @ . @ . . . . @ . . . . @ . @ . . . @ . @ . . . . @ . . . . . @ @ @ @ . @ . . . @ @ 
@ @ @ @ @ @ . . . . . . @ @ . . . @ @ . @ @ . . @ @ . . @ @ . @ . . @ @ . @ . . . . . . . . @ . @ @ 
@ @ @ @ @ @ @ . @ . @ . . @ . @ . . @ @ @ @ @ . @ . @ @ . . . @ @ . . . @ . . @ @ @ . @ . @ @ . . @ 
@ @ @ @ @ @ @ @ . . @ . @ . @ . . @ @ . @ @ . @ . . . . . @ . @ . . @ @ @ @ . . . @ . @ . @ @ . @ @ 
@ @ @ @ @ @ @ . . @ . . @ . @ . @ . . . . . . . . @ @ @ . @ . @ . @ @ . @ @ @ @ . . @ @ @ . . . . @ 
@ @ @ @ @ @ @ @ . @ . @ . . . @ @ @ @ . @ . @ @ @ @ @ @ @ . . @ . @ . . . @ @ @ . @ @ @ . . @ . @ @ 
@ @ @ @ @ @ @ @ @ . . . . @ @ @ @ @ @ @ . . . @ @ @ @ @ @ @ . @ @ @ @ @ . @ . @ @ @ @ @ @ @ . . . @ 
@ @ @ @ @ @ @ @ @ @ . @ . @ @ @ @ @ @ @ @ . @ @ @ @ @ @ @ @ @ . . . . . . . . . @ @ @ @ . . @ @ . @ 
@ @ @ @ @ @ @ @ @ @ @ @ @ @ @ @ @ @ @ @ . . . @ @ @ @ @ @ @ @ @ . @ @ @ @ @ . @ @ @ @ . @ . @ . . @ 
@ @ @ @ @ @ @ @ @ @ @ @ @ @ @ @ @ @ @ @ @ . @ @ @ @ @ @ @ @ @ @ . @ . @ . . . . @ @ . . . . @ . @ @ 
@ @ @ @ @ @ @ @ @ @ @ @ @ @ @ @ @ @ @ @ @ @ @ @ @ @ @ @ @ @ @ @ @ . . . . @ @ @ . . . @ @ . . . . @ 
@ @ @ @ @ @ @ @ @ @ @ @ @ @ @ @ @ @ @ @ @ @ @ @ @ @ @ @ @ @ @ @ @ @ . @ . . . @ . @ . @ @ @ @ . @ @ 
@ @ @ @ @ @ @ @ @ @ @ @ @ @ @ @ @ @ @ @ @ @ @ @ @ @ @ @ @ @ @ @ @ . @ @ @ . @ . @ . @ . @ . @ . . @ 
@ @ @ @ @ @ @ @ @ @ @ @ @ @ @ @ @ @ @ @ @ @ @ @ @ @ @ @ @ @ @ @ . . . . . . . . . . . . . . . . @ @ 
@ @ @ @ @ @ @ @ @ @ @ @ @ @ @ @ @ @ @ @ @ @ @ @ @ @ @ @ @ @ @ @ . @ . @ . @ . @ @ . @ . @ @ . @ @ @ 
@ @ @ @ @ @ @ @ @ @ @ @ @ @ @ @ @ @ @ @ @ @ @ @ @ @ @ @ @ @ @ @ @ . . @ . @ @ . . . . @ . . . . . @ 
@ @ @ @ @ @ @ @ @ @ @ @ @ @ @ @ @ @ @ @ @ @ @ @ @ @ @ @ @ @ @ @ . . @ . . . @ . @ . @ @ . @ . @ . @ 
@ @ @ @ @ @ @ @ @ @ @ @ @ @ @ @ @ @ @ @ @ @ @ @ @ @ @ @ @ @ @ . . @ . @ . @ . @ . @ . @ @ . . @ @ @ 
@ @ @ @ @ @ @ @ @ @ @ @ @ @ @ @ @ @ @ @ @ @ @ @ @ @ @ @ @ @ @ @ @ . . . . . . . . . . . @ @ @ @ @ @ 
@ @ @ @ @ @ @ @ @ @ @ @ @ @ @ @ @ @ @ @ @ @ @ @ @ @ @ @ @ @ @ @ @ @ @ @ @ @ @ @ @ @ @ @ @ @ @ @ @ @ 
3
7 26 43 42
17 29 2 35
22 45 10 43
