50 50
@ @ @ @ @ @ @ @ @ @ @ @ @ @ @ @ @ @ @ @ @ @ @ @ @ @ @ @ @ @ @ @ @ @ @ @ @ @ @ @ @ @ @ @ @ @ @ @ @ @ 
@ @ @ . . @ . @ . @ . . . @ @ @ @ @ @ @ @ @ @ @ @ @ @ @ @ @ @ . . @ . . @ . . @ . . @ @ @ @ @ . @ @ 
@ @ . @ . . . @ . . . @ @ . @ @ @ @ @ @ . @ @ @ @ @ @ @ @ @ @ @ . . @ . @ . @ . . @ @ @ @ @ @ . . @ 
@ . . . . @ @ . . @ . @ . . . . @ . @ . . . @ @ @ @ @ . @ @ @ @ @ . . . . . . . @ . @ @ @ @ . . @ @ 
@ @ . @ . @ @ . @ . @ . @ . @ . . . . @ . @ . @ @ @ . . . @ @ @ @ . @ . @ . @ @ . . . . @ . . @ . @ 
@ @ @ . . @ . . . . . . . . . @ . @ . . . . . @ @ . @ . @ . @ @ @ . . @ @ @ . . @ . @ @ . . @ . . @ 
@ @ . . @ . . @ . @ . @ . @ @ . @ . @ @ . @ @ . . . . . . . . @ @ . @ . @ . @ . @ . . @ . @ @ . @ @ 
@ . @ . . . @ @ . . @ . @ . @ . @ . @ . . . . @ . @ . @ @ . @ . . . . . . . . . . . @ . . . . . . @ 
@ . @ . @ . @ . @ . . . . . . . . . . @ @ . @ @ . @ . @ . @ . . @ @ . @ @ @ @ . @ . . . @ . @ . @ @ 
@ . . . @ @ . . . @ . @ @ . @ . @ . @ . . @ . . @ . . @ . @ . @ . . . @ . . . . @ . @ @ . . @ . . @ 
@ . @ . . . @ . @ . . @ . @ @ @ @ @ . . @ . . @ . . @ . . . @ @ @ . @ . . @ . @ . . . @ . @ . . @ @ 
@ @ . . @ @ . . . @ @ . . . @ @ @ . @ . @ . @ . @ . . @ . @ . @ @ @ . . @ @ @ . @ . @ @ @ . @ . . @ 
@ @ @ . @ . @ . @ @ @ @ . @ @ . @ . @ . . . . . @ @ . . . . . . @ @ @ . @ @ . . . . . @ @ . . . @ @ 
@ . . . . . . . . . @ @ . . @ . . . . . @ . @ . . @ . @ . @ @ @ . @ . . @ . @ . @ . @ @ @ @ . @ @ @ 
@ @ . @ @ @ @ @ @ . . . @ . . . @ . @ . . @ . . @ . . @ . @ @ @ . . @ . @ . @ @ . . @ @ @ @ @ . @ @ 
@ @ @ . . . @ . @ . @ . @ @ @ . . @ . . @ @ @ @ . . @ . @ . @ . . @ . . . . . @ @ . @ @ @ @ . . . @ 
@ . . @ @ . . . @ @ @ . . @ . . @ . @ . . @ @ . @ . . . . . . . @ @ @ . @ . @ @ . . @ @ @ . @ . @ @ 
@ @ . . . @ @ . . @ . . @ @ @ . . . @ . @ @ @ . . . @ . @ . @ @ @ @ @ @ @ . @ . . @ . . @ . . . . @ 
@ . . @ . @ . . @ @ @ . . @ . . @ @ . @ @ @ @ @ @ . @ @ @ . . . @ @ @ . . . . @ . . . @ @ . @ . @ @ 
@ @ . . @ . @ . . @ . . @ . @ . . @ . . @ @ @ @ @ . . @ @ @ @ . . @ @ @ . @ @ @ @ . @ . . . . @ @ @ 
@ . . @ . . . . @ . @ . . . . . @ . . @ @ @ . @ @ . @ . @ @ . @ . . @ . @ @ @ . @ . . @ @ @ . . @ @ 
@ @ . . @ . @ . . . . . @ . @ . . . @ . @ . . . . . . . . . . . @ @ . . . @ @ . . @ . @ @ . . @ . @ 
@ . . @ @ @ @ . @ . @ @ @ @ . . @ @ . . . @ @ . @ . @ . @ . @ @ . . @ . @ . @ @ . . . . . @ . @ . @ 
@ @ . . . . @ . @ . . @ @ @ @ . @ @ . @ . @ @ @ . . . @ . . @ @ @ . @ . . . @ @ . @ @ @ . . . . . @ 
@ @ @ . @ . . @ @ . @ @ @ @ . . . . . . @ @ @ . . @ @ . @ . . @ @ . . @ . @ . . @ . . @ @ @ . @ @ @ 
@ @ @ . @ . @ . . @ @ @ @ . . @ . @ . @ @ @ @ . @ . @ . @ @ . . @ . @ . . . . @ . @ . . @ . . . @ @ 
@ . . @ . . . . @ . @ . . @ . . @ @ . @ @ . . . . . @ . . @ @ @ . . . @ . @ . @ . . . @ . @ . @ . @ 
@ . @ . @ . @ . . . . @ . . . @ . . @ . @ @ @ @ . @ @ @ . . @ . @ . @ . . . @ . . @ @ . . . . . . @ 
@ . . . @ @ . @ . @ . . @ @ . . . @ . . . . @ . . . @ . . @ . . . . . . @ @ . @ . . . . @ . @ . @ @ 
@ @ @ . . @ . @ . . @ . . . @ . @ . @ @ . @ . @ . @ . . @ @ @ . @ . @ . . @ . . . @ @ @ . @ . . . @ 
@ @ . . @ . . . @ . @ . @ . . . . . . . . . . . . . . @ . @ @ @ . @ . . @ . . @ @ . @ @ . . @ . @ @ 
@ . . @ . @ . @ . @ . @ @ @ @ @ @ @ @ @ @ . @ . @ @ . @ . . . . . @ @ . @ . @ . @ . . . . @ @ @ @ @ 
@ @ . . . . . . . . . . . . . . . . . . @ @ . @ . @ . . . @ . @ . @ . . . . . . . . @ . @ @ @ . @ @ 
@ . . @ . @ . @ @ . @ . @ . @ . @ . @ . . . . . . . . @ . . @ @ @ @ @ . @ . @ @ . @ @ @ @ @ . . . @ 
@ . @ . . @ @ @ . @ @ . . @ . . @ . . @ @ . @ . @ . @ . . @ @ @ @ @ . . . @ @ @ . . . . @ . . @ . @ 
@ @ . . @ . . . . . . . @ . @ . . @ . . . @ . @ @ @ . @ . @ . @ . @ . @ @ . @ . @ @ . @ @ @ . @ . @ 
@ . . @ . @ . @ @ . @ . . . @ @ . . @ . @ . . . @ . . . . . . . . . . . . . @ . . @ . . @ @ @ . . @ 
@ . @ . . @ @ @ . @ . . @ . @ . . @ . . @ @ . @ . . @ . @ . @ @ . @ . @ . @ @ . @ . . @ @ @ . @ . @ 
@ . @ @ . . @ . . @ @ . . @ . @ . . @ . @ . . . . @ . . . @ . @ @ . @ @ . @ . . @ @ . . @ . . . . @ 
@ @ @ @ . @ @ . @ . @ @ @ @ . . . @ @ @ @ @ . @ @ . . @ . . . . @ . . . . . @ . . . . @ @ @ . @ . @ 
@ @ @ . . @ . . . . . . . . . @ . . @ @ @ . . @ . @ . @ @ . @ . . @ . @ . @ . . @ . @ @ @ @ @ . . @ 
@ . . @ . . @ @ . @ @ . @ . @ . . @ @ @ @ . @ . . . . . @ . . @ @ @ . . @ @ @ . . @ . @ @ @ . @ . @ 
@ @ . . @ . @ . @ . . @ . @ . @ . . @ @ @ @ . @ . @ . @ . . @ . . . . @ @ @ @ @ . . . . . . . . . @ 
@ @ @ . . . . . . . @ . . . . @ . @ @ @ . . . . . @ @ . @ . @ . @ . @ @ @ @ @ @ @ @ . @ @ . @ . @ @ 
@ @ @ @ @ . @ . @ . . @ . @ . @ . @ @ @ @ @ . @ . . . . . @ . . . @ @ @ @ @ @ @ @ . @ . . . . @ . @ 
@ . @ . @ . . @ . @ . @ . @ @ . @ . @ @ . @ @ . . @ . @ . . @ . @ @ @ @ @ @ @ @ . . . @ . @ . . . @ 
@ . . . @ . @ . . . . . . . . . . . . . . . . @ . . @ . . @ @ @ @ @ @ @ @ @ @ . @ . @ . @ @ . @ . @ 
@ @ @ . . . @ . @ . @ . @ . @ @ @ . @ @ . @ . . . @ . @ . . . @ @ @ @ @ @ @ @ . . . . . . . . . @ @ 
@ . . . @ . . @ . . . @ . . . @ @ . . @ @ @ . @ . @ . . . @ @ @ @ @ @ @ @ @ @ . @ . @ . @ @ @ @ @ @ 
@ @ @ @ @ @ @ @ @ @ @ @ @ @ @ @ @ @ @ @ @ @ @ @ @ @ @ @ @ @ @ @ @ @ @ @ @ @ @ @ @ @ @ @ @ @ @ @ @ @ 
3
19 31 9 30
32 22 34 1
20 12 48 22
