100 100
@ @ @ @ @ @ @ @ @ @ @ @ @ @ @ @ @ @ @ @ @ @ @ @ @ @ @ @ @ @ @ @ @ @ @ @ @ @ @ @ @ @ @ @ @ @ @ @ @ @ @ @ @ @ @ @ @ @ @ @ @ @ @ @ @ @ @ @ @ @ @ @ @ @ @ @ @ @ @ @ @ @ @ @ @ @ @ @ @ @ @ @ @ @ @ @ @ @ @ @ 
@ @ . @ @ @ @ . . @ . . @ . @ . @ @ . @ . @ . . . . @ @ @ @ @ @ @ @ @ . @ . . . . @ . . . @ @ @ @ @ @ @ . @ . . @ . . . @ . @ @ . @ @ @ @ @ @ . @ @ @ . . @ . . @ . @ . @ @ . @ . @ . . @ . . . @ @ . @ 
@ . . . @ @ . . @ . . @ . . . . @ . . . . . @ . @ . . @ @ @ @ @ . @ . . . @ . @ @ . . @ . . @ @ @ @ @ @ . @ . @ @ . @ @ . . @ . . . @ @ @ @ @ . . @ . @ . . . @ . . . . . . . @ . . . @ . . @ @ . . . @ 
@ @ . @ @ . @ . @ @ . . @ . @ @ . @ @ @ @ . . @ . . @ . @ . @ . . . @ @ . @ . . @ @ . @ @ @ . . @ @ @ . . . . . @ . @ @ . @ . @ . @ . @ . . . . @ . . . @ @ . . @ . @ . @ @ . . . @ . @ . @ @ @ . @ @ @ 
@ @ . . . . . . . @ . @ . . . @ . . . . . . @ . @ . . . . . @ . @ . . . . . @ . @ . . . . @ . @ @ @ . @ . @ . @ . . . . . . . . . . . . @ . @ . . . @ . . @ . @ . @ @ @ . @ . @ . . @ . . . . . . @ @ @ 
@ . @ @ . @ @ @ . . . . @ . @ . @ . @ . @ . . . . . @ . @ . . @ @ . @ . @ . . . . @ . @ . . . @ . . . . . . @ . @ . @ @ . @ . @ . @ . @ @ @ . @ . @ . @ . . . . . . @ . . . . . @ @ . . @ . @ @ . . @ @ 
@ . . . @ . . . . @ @ . @ . @ . @ @ . @ . @ @ . @ . . @ @ . @ . . . @ . . @ @ . @ @ . . @ @ @ @ . @ @ . @ . . . . . . . @ . @ . . @ @ . . . . . . . . . @ . @ . @ @ . @ . @ . @ @ . @ . . @ @ . . @ @ @ 
@ @ @ . . . @ . @ @ @ . . . . . . . . @ . @ @ @ . . @ . . @ . @ @ @ . @ @ @ . . @ . . @ . @ . . @ . . @ . . @ . @ . @ @ . . . @ . @ . . @ . @ . @ . @ @ . @ @ . @ @ . . @ . . . @ . @ . @ . @ @ . . @ @ 
@ . . . @ @ . . . @ @ . @ . @ . @ @ . @ . . @ . @ . . . @ @ . @ @ @ . @ . @ @ . . @ . . . . . @ . @ . @ @ . . @ @ . @ @ @ . @ . @ . @ . . @ @ @ @ @ . . . . @ . @ . . @ @ . @ @ . . . . . . . @ . @ @ @ 
@ . @ . . . @ . @ . . @ . . @ . . @ @ . . @ . . . . @ . @ @ . . @ . . @ . . @ @ . . @ . @ . @ @ . . . . @ . @ . . @ . . . . . . @ . . . @ . @ . @ @ @ . @ . @ @ . . @ . . . . @ . @ . @ . @ @ . @ @ @ @ 
@ @ . @ . @ . @ . @ . @ . @ . @ . @ . @ . . @ . @ . . @ @ @ . @ . @ . . . @ @ . @ . . @ . . . . . @ . @ . . @ . @ @ @ . @ . @ . @ . @ . . . . . . . . . @ @ @ @ @ . @ . @ . @ @ . . @ . . . . . . . @ @ 
@ . . . . . . . . . . . @ . . . . . . . . @ @ . @ . @ . @ @ . . . . . @ . @ . . . . @ . @ @ @ @ . @ @ @ @ . . . . @ . . . @ . . . @ @ . @ . @ . @ . @ @ @ . . @ . . . @ . . . @ . @ . @ @ . @ . @ . @ @ 
@ @ @ @ . @ @ . @ . @ @ . @ @ . @ @ . @ . . . @ . . . . . @ . @ . @ . @ @ . . @ @ . . . . . . . . . . @ . . @ . @ . @ @ . . @ . @ @ . . . @ @ @ . . . . . . @ . @ . @ . @ . @ . . . . @ . . . @ . . . @ 
@ . . . . @ @ @ @ . @ . . . . @ @ . . @ @ . @ . @ @ @ . @ . @ @ @ @ . . . . @ @ . . @ . @ @ . @ . @ @ . @ . . @ @ . . @ . @ . . . . @ . @ . @ . @ . @ . @ @ . . . . . . . . . . @ @ @ @ @ @ @ . . @ . @ 
@ @ @ . @ . . . @ @ . @ @ . @ . @ @ . @ @ . . . . . . . . . . . . . @ @ . @ . . . @ . . . @ . @ . . . . . . @ @ . @ . @ @ . @ . @ . . . . . . . . @ @ . @ . . @ @ . @ . @ @ @ . . . . . . . . @ . . @ @ 
@ . @ @ . . @ . @ . . . . . . . . @ . @ . . @ . @ . @ @ . @ . @ @ . . . . @ @ . @ . @ . @ . @ . @ . @ @ . @ . . . . . . . . . . @ @ @ . @ . @ . @ @ . @ . @ . @ . . . @ @ . . . @ . @ . @ . @ . . @ @ @ 
@ . . . . @ . . . @ . @ . @ . @ . . @ @ @ @ . @ . @ . . . . @ . . . @ . @ . . . . . . @ . . . . . . @ . . . . @ . @ @ @ @ . @ @ . @ . @ @ . . @ @ . . . . . . . @ . @ . @ @ . @ @ . . @ @ @ @ @ . @ @ @ 
@ . @ . @ . @ . @ . . @ . . @ . . @ @ @ . . . . . . . @ . @ . @ . @ . . @ @ . @ . @ . . @ @ . @ @ . @ @ . @ @ . . . @ . . . . @ . . . . . @ . @ @ @ . @ . @ . @ . . . . . @ . . @ . @ @ @ . @ . @ . @ @ 
@ . . @ . . . . . . @ @ . @ @ @ @ @ . . @ @ . @ @ @ . @ @ . . . . @ @ . . . @ @ @ . . @ @ . @ . . @ . . . @ @ @ . @ . @ . @ @ . . @ @ @ . @ . . . . . @ . . @ . @ . @ . @ . @ @ @ . . . . . . . . . @ @ 
@ @ @ . @ @ @ @ @ . @ . @ @ @ @ @ @ @ . . . . . . @ . @ . . @ . @ . . . @ . . @ @ @ . @ . . @ @ . @ . @ . . @ @ @ . . . . . @ . @ . @ . . . . @ . @ @ . . @ . . . . @ . . . . . . @ . @ @ . @ @ . @ @ @ 
@ @ @ . @ . . @ . . @ . . @ @ @ @ @ @ @ @ @ . @ . . @ . . @ . . @ @ . @ . . @ @ . . @ . . @ . . . @ . @ @ @ . @ . @ @ @ . @ @ . @ . @ . @ @ . . @ @ @ . @ @ . @ @ . . @ @ . @ @ @ . . . . @ . @ . . @ @ 
@ . . . . . @ . @ . . . @ @ @ @ @ . @ @ . . . . @ @ . . @ . . @ . . . . @ . @ @ . @ @ . @ . @ @ . . @ . . . . . . . . . . @ . @ . . . . @ . . @ . @ . @ . . @ @ @ . @ . @ @ . @ . @ . @ @ . . @ . @ @ @ 
@ @ . @ @ . . . . . @ @ . @ @ @ . . . @ . @ . @ @ @ @ . @ @ @ . . @ . @ @ @ . . . . . . . . @ . @ . . @ @ . @ @ . @ @ . @ . . . . @ . @ . @ . . . . . . . @ . @ . . . . . . . . . . @ . . . @ . @ . @ @ 
@ @ @ @ @ @ @ @ @ . . . . @ @ . @ . @ . . @ @ . @ @ . @ @ @ . @ . @ @ . @ @ @ . @ . @ . @ . . . . @ . @ @ @ @ . @ . . . @ . @ . @ . . . . . @ . @ . @ . @ . . . @ @ @ . @ . @ . @ . @ @ @ . . . . . @ @ 
@ @ @ @ @ . . . . . @ @ . . . . . . . . @ @ @ . . @ . @ . @ . . . . . . . . @ . . @ @ . . @ . @ . . . @ @ @ . . @ . @ . . @ @ . @ @ . @ . @ . @ . @ @ . . @ . @ . @ . @ . @ . @ . @ . @ . . @ . @ . @ @ 
@ @ @ @ @ @ . @ @ @ @ . @ @ . @ @ @ . @ @ @ . . @ . . . . . . @ . @ . @ . @ . @ @ . . @ . . @ . @ @ . @ @ . @ . @ @ . . @ @ @ @ . . . . @ . . . . . . . @ . . . . . . . . . . . . . . . @ . . @ @ @ @ @ 
@ @ @ @ @ @ @ . . . . . . . . @ @ . . @ @ . . @ @ @ . @ . @ . @ . . @ @ . @ . . . @ . @ @ @ . . . . . . . . . . . . @ . . . @ . @ . @ . @ @ . @ @ . @ . . @ . @ . @ . @ . @ @ . @ @ . @ @ . @ . . @ . @ 
@ @ @ @ @ @ @ @ . @ . @ @ . @ @ . . @ . . @ . @ . . . . @ . . . @ . @ . . @ . @ @ . . . . @ @ . @ @ @ . @ . @ . @ @ . @ . @ . . . @ . . @ . @ . . @ . . @ @ . . @ @ @ @ . . . @ @ @ @ @ @ . . . @ @ . @ 
@ @ @ @ @ @ @ @ @ . . @ @ @ @ . . @ @ @ . . . . . @ . @ @ @ . @ . @ . . @ . . @ . @ . @ @ . . @ @ . . @ @ @ @ . . . . . . @ @ . @ . @ . . . @ . @ @ @ . . . . @ @ @ . @ . @ . @ @ @ @ @ @ @ @ . . . . @ 
@ @ @ @ @ @ @ @ . @ . . @ . @ @ . . @ @ . @ @ @ @ . . . @ @ . . . . @ @ @ @ . . . . . . . . @ . @ . @ . @ . . . @ . @ . @ . . . . . . . @ . . . . @ . . @ . @ @ @ . . . @ @ @ @ @ @ @ @ @ @ @ @ . @ @ @ 
@ @ @ @ @ @ @ . . . . @ . . . . @ @ @ @ . @ @ . . . @ @ @ . . @ . @ @ @ @ . @ . @ . @ . @ . . . . . . . . . @ . . @ @ @ . . @ . @ @ @ . . @ . @ @ . @ . @ @ . @ . @ . @ . @ @ @ @ @ @ @ @ @ @ . . @ @ @ 
@ @ @ @ @ @ @ @ . @ @ . @ . @ @ @ . @ . @ . . . @ . . . @ @ . . @ @ @ @ @ . @ @ . . @ . . @ . @ . @ . @ . @ . . @ . . . . @ . . @ @ . @ . . @ . @ . . . . . . . . . . . . . @ @ @ @ @ @ @ @ @ . @ @ @ @ 
@ @ @ @ @ @ @ . . . . . . . . @ . . @ . . @ . @ . . @ @ . . . @ . @ @ . . . . @ @ . @ . @ . @ @ @ @ @ @ @ . . @ @ @ . @ . @ @ . @ . . . . @ @ . . . @ . @ . @ . @ . @ . @ . @ @ @ @ @ @ @ @ @ . . @ @ @ 
@ @ @ @ @ @ @ @ . @ . @ . @ . @ @ . . . @ @ @ . @ . . . @ @ . . . . . @ @ . @ @ @ @ . . . . . . . @ @ @ @ @ . . @ . . @ @ . . . . @ . @ . . @ @ . @ . . . @ . . . @ @ . . @ . @ @ @ @ @ . @ . . @ @ @ @ 
@ @ @ @ @ @ @ @ . . @ @ . @ . @ . @ @ . @ @ @ . . @ @ . . . @ . @ . @ @ . . . @ @ @ @ . @ @ . @ . @ @ @ @ @ @ @ . . @ . . . @ . @ . . @ . @ . @ @ . @ . @ @ @ . @ @ . . @ @ . . @ @ @ . . . @ . . @ @ @ 
@ @ @ @ @ @ @ @ @ . . . @ @ @ . . . . . . @ @ @ . . . . @ . @ . @ . @ . @ . @ . @ @ @ . @ @ . . @ @ @ @ @ @ @ @ @ . . @ @ . @ . @ . @ . . . . . @ . . . . @ . . . @ . @ . @ . @ . @ @ . @ . . . @ . @ @ 
@ @ . @ @ . . @ @ . @ @ @ @ @ @ @ . @ . @ . @ . @ . @ @ @ @ @ . . @ . . . . . . . @ . . . @ @ @ @ @ @ @ @ @ @ @ . . @ @ . @ . . @ . . @ . @ . @ . . @ . @ @ @ . @ . . . . . . . . . . @ . @ @ . . . . @ 
@ @ . @ . @ . @ . . . @ . @ . @ . @ . . . . . . . @ . @ @ . @ . @ . @ . @ . @ . @ @ @ . @ @ @ @ @ . @ . @ @ @ @ . @ @ . . . @ . @ . @ . @ . . . @ . . @ . @ . . . @ @ @ . @ . @ . @ . . . . . @ @ . @ @ 
@ . . . . . . . . @ @ . . . . . . . @ @ @ @ @ @ . . . . . . . . @ . . . . @ . . . @ . . . . @ @ . . . . . @ . . . . . @ @ . . . . @ . . . @ . @ @ @ . . . @ . @ . . . . @ @ @ . . . @ . @ . @ . @ . @ @ 
@ . @ . @ @ . @ . . . @ . @ . @ @ . . . . . . . . @ @ @ . @ @ @ . . @ . @ . @ . @ . @ . @ . @ . . @ @ . @ @ . @ . @ @ @ . . @ . @ . @ . @ . @ @ . . . @ . @ . . @ . @ . . @ @ @ . @ @ @ . . . . . . . @ 
@ @ @ @ . . @ @ @ . @ @ @ . . @ . . @ . @ @ . @ . . . . @ @ @ @ @ . @ @ . . . . . . . . @ . . @ @ . . . . . . . @ . . . . @ . . . . . . . . . . @ @ . . @ @ . @ . . @ . @ . . . . . @ . . @ . @ . @ @ @ 
@ . @ @ @ . @ @ . . @ @ . . @ . @ @ . . . @ @ . . @ . @ . @ @ @ @ @ @ @ @ . @ @ @ . @ @ . . @ . . @ . @ . @ . @ . @ . @ . . @ . @ @ . @ . @ @ . . . @ . . . @ @ @ . @ @ @ @ . @ . @ . @ @ @ . . @ . @ @ 
@ . . @ . . @ @ . @ . . @ . @ . . . . @ @ . . @ . . @ @ . . @ @ @ . . . @ . @ . @ . . . @ . . . @ . @ . @ . . @ . . . @ . @ @ @ . . . . @ . @ . @ . @ . @ @ . @ @ . @ @ @ . . @ . . . . . . @ @ . . @ @ 
@ . @ . @ . @ . @ . @ . @ @ . @ . @ . @ . @ . . . @ . . . @ . . . @ . @ . . @ . . . @ @ . . @ @ . . @ . @ @ . . @ . @ @ . . @ @ @ . @ . . . . @ . . @ . . . . @ . @ @ @ @ @ @ . . @ . @ @ . . @ . @ . @ 
@ . . . . . . . . . . . . . . . . . @ . . . . @ @ . @ . @ . . @ @ . . . . @ . . @ . . . @ . . @ @ . @ . . . @ . . @ . . . @ @ @ . . @ . @ . @ @ @ @ @ @ . @ @ . . . @ @ @ @ @ @ @ @ @ . . . @ @ . . . @ 
@ @ . @ . @ . @ . @ . @ @ @ . @ . @ . @ @ @ . @ . . . . . . @ @ @ @ . @ . @ @ . . @ . @ @ @ . @ . . @ . @ @ @ @ @ @ . @ . . . . @ . @ . . @ @ @ @ . . . . . @ . @ @ . @ @ @ @ @ . @ . . @ . . . . @ @ @ 
@ . . @ . @ . @ . @ @ . @ . . . @ . . . . . . . @ . @ . @ . @ @ @ . . . @ . . . @ . . @ @ @ @ @ @ . . . @ . . . . @ . @ . @ . @ @ . @ . @ @ @ @ @ @ . @ . @ . . . . . . . . @ @ . @ @ . . @ . @ . . . @ 
@ . @ . . . @ . . @ . . . @ . @ @ @ . @ . @ @ @ . . . @ . . . @ @ @ . @ . @ @ . @ . @ . @ @ . @ . @ . @ . @ @ @ . . . @ . . @ . . . @ @ @ . @ . @ @ @ . . . . @ @ @ @ @ @ @ @ @ . . . . @ . @ @ @ . @ @ 
@ @ . @ @ . . @ . . @ @ . . . @ . . @ . . . @ . @ . @ @ @ . @ . @ @ @ . . . . @ @ . @ . @ . . . . . . . . . . . . @ @ . . @ @ @ @ . . . . . @ . . @ . @ . @ . . . . . . . . @ . . @ . @ . . . @ . . @ @ 
@ . . . . . @ . @ @ . . . @ . @ @ . . . @ . @ . . . . @ . . . . . @ @ @ . @ . @ @ . @ . . . @ . @ @ . @ . @ @ @ @ . . @ . . . . . @ @ . @ . . @ . . . . . . @ . @ @ . @ . @ . @ . . @ . . @ @ @ @ . . @ 
@ @ @ . @ . . . . @ . @ @ . . @ . . @ . @ @ . @ @ . @ @ @ . @ . @ . @ @ @ . . . . . . @ @ @ . . . @ @ . . . . . @ @ . @ . @ @ . @ @ . . @ . @ @ . @ . @ . @ @ . . . @ . . . . @ @ . . . @ @ . @ . @ @ @ 
@ @ @ @ @ . @ . @ . . . . @ . @ @ . @ @ . . . . @ . @ . . . . @ . . . @ @ @ . @ @ . @ @ @ @ @ . @ @ @ @ @ . @ . @ . . . . . . @ @ @ @ . . @ . . @ . @ @ . . . @ @ . @ @ . @ . @ . @ @ @ . @ . . . @ @ @ 
@ @ @ @ @ @ @ @ . @ . @ @ @ @ . . . . . @ @ . @ . @ . @ @ . @ . @ @ . @ . @ . @ . . . @ @ @ . . @ . . . . . @ . . @ . @ . @ @ . @ @ @ @ . @ . @ . . . . . @ . . . @ . @ . . @ @ . . @ @ . . . @ . . . @ 
@ @ @ @ @ . @ . . . . . @ . . @ @ . @ . . @ . @ . . . . . . . . . . . . . . . @ @ . @ . @ . @ . . @ @ . @ . . @ . @ @ . . . . . . . @ . . @ . . . @ @ . @ . . @ . . . . @ @ . @ . @ . @ . @ . @ @ . @ @ 
@ @ . @ . . . @ @ . @ @ . . @ @ . @ @ . @ @ . . . @ . @ @ . @ . @ @ . @ . @ . @ . . . . . . @ . @ . . @ . . @ . . . . @ . @ . @ . @ @ @ . @ . @ . @ @ @ . @ . . @ . @ . . . . . . . . . . @ . @ @ @ @ @ 
@ @ . . @ @ . . . @ . . @ . . @ . . . @ . . @ @ @ . @ . . . @ @ . . . . @ @ @ . @ . @ @ . @ . @ . @ . . @ @ . @ . @ @ . . @ . . @ @ . . . @ . . @ . . . . @ @ . . @ @ @ . @ . @ . @ @ . @ . @ . @ . @ @ 
@ @ @ . @ . @ . @ . @ . @ . @ @ . @ @ . @ . @ . @ . . . @ @ . . . @ . @ @ @ @ . . . . @ . . . @ . . @ . @ @ . . @ @ . @ . @ . @ @ @ . @ . @ . @ @ @ . @ . . @ @ @ @ . . @ . . @ @ @ . . . . . . . . . @ 
@ @ . . . . . . . . . . . . . . . . . . . . . . . . @ . . . @ . @ . . @ @ @ @ @ @ . @ @ @ . @ . @ . . . . . . @ @ . . @ @ @ . @ . . @ . . @ . . . @ @ . . @ @ @ @ @ @ . . . @ @ . @ @ . @ . @ . @ . @ @ 
@ . . @ . @ . @ . @ @ . @ . @ . @ @ @ . @ . @ . @ . @ @ . @ @ @ . . @ @ @ @ @ @ . @ @ @ . . @ . . @ . @ . @ . @ @ @ . @ . . . @ @ . . . @ . . @ . @ @ @ . @ . . @ . @ @ @ . . . . . @ . . @ . . . @ @ @ 
@ @ . @ @ . . @ @ . . . . @ . . . @ . . @ @ @ @ . . @ @ @ @ @ @ . @ @ @ @ @ @ . . @ @ . @ . . . @ . @ @ @ . . . . . . . @ . @ . . @ . @ @ . @ @ . . @ . . . . @ . . . @ . . @ . @ @ . . @ @ @ . @ @ @ @ 
@ @ @ . . . @ . . . @ . @ @ @ @ . . @ . . . @ . @ . @ @ . . . . . . @ . @ @ @ @ . . @ . . . @ . . . . . @ @ . @ . @ @ . . . . @ . . . @ . . @ . . @ . @ @ @ . . . @ @ . @ . @ . . . @ @ @ @ @ @ @ @ @ @ 
@ . @ @ . @ . . @ @ . . . @ . @ . @ . @ @ @ . . . @ @ @ @ @ @ @ . @ @ . . . @ . . @ @ . @ @ @ . @ @ . @ @ . @ . @ . @ . @ . @ @ @ @ @ @ @ . @ @ . @ . . . @ . @ . . . . @ . . @ . @ @ @ @ @ @ @ @ @ @ @ 
@ . . . . . @ . @ . @ . @ . . . . . . . . . @ @ . . @ @ @ . . @ . @ . . @ @ . @ . @ . @ . @ . @ @ . @ . . . . . . . . @ . . @ @ . @ . @ . . . . @ @ @ @ . . . . @ . @ . . @ . . @ @ @ @ @ @ @ @ @ @ @ @ 
@ @ . @ . @ . @ . . . . @ . @ @ . @ @ . @ . . . @ . @ . . @ . @ . @ @ . . . . . . . . . . . . . . . . . @ @ . @ @ . @ . @ . . . . . . @ @ . @ @ . @ . . . @ @ @ . @ @ @ @ @ . @ @ @ @ @ @ @ @ @ @ @ @ @ 
@ . . @ @ @ . . @ . @ @ . @ . . . . . @ @ . @ @ . . . @ . . . . . . . @ . @ . @ . @ . @ . @ @ @ . @ . @ @ @ . @ . . . . . . @ . @ . @ . . @ @ @ . . . @ @ . . @ . . @ @ . . . . @ @ @ @ @ @ @ @ @ @ @ @ 
@ @ . . @ . @ . . . @ . . . . @ . @ . . . @ @ . @ . @ . . @ . @ . @ @ . . . @ . . . @ . . . @ @ @ . . . @ @ @ @ @ . @ . @ . @ . . @ . @ . @ @ @ @ . @ @ @ . @ . @ . @ . @ . @ @ @ @ @ @ @ @ @ @ @ @ @ @ 
@ . . @ . . . . @ . @ . @ . @ . . . @ . @ @ . . . . . @ @ . . . @ . . @ . @ . @ . @ . @ . @ . @ . . @ . . . @ @ . . . @ . . . @ . . . . . . . . . . . @ . . . . . . . . . . . @ @ @ @ @ @ @ @ . . . @ @ 
@ @ . . @ @ . @ @ @ @ @ @ . . @ . @ . @ @ @ @ @ . @ . @ @ @ . @ @ @ . @ @ . . . . @ . @ @ . . . @ @ . @ @ @ . @ @ . @ @ @ . @ @ @ . @ @ . @ . @ . @ @ @ . @ . @ . @ . @ . @ . . @ @ @ @ . @ . @ . @ @ @ 
@ . . @ . @ . . @ . @ @ . . @ @ . @ . @ @ @ @ @ @ . . . @ . . . @ . . . @ @ . @ . @ . . . . @ . . . . . . . . @ . @ . @ @ . @ @ @ . . . @ . . . @ . @ . @ . . . @ . . . @ . . @ @ @ . . . . . . . . @ @ 
@ . @ . . . . @ . . . . . @ . . . @ . @ @ @ @ @ . @ . @ . @ . @ @ @ . @ . @ . @ @ . . @ . @ @ @ . @ . @ . @ . . . . . . . . . . . @ @ . @ @ @ . . . . . . @ . @ . @ . @ . @ . . . @ . @ . @ . @ . @ @ @ 
@ @ . @ . @ . @ . @ @ . @ . . @ . @ . . . @ @ . . . . . . . . . @ . . . . . . . @ @ . . @ . . . . @ @ @ @ . . @ . @ . @ . @ . @ . @ . . . . . @ . @ . @ . . @ . . . . . . @ @ . @ @ @ @ @ @ @ . . . . @ 
@ @ . . @ . . @ @ @ . . @ @ @ . . . . @ @ . . . @ @ . @ . @ . @ @ . @ . @ . @ @ . . @ @ @ @ . @ . . . . @ @ @ . . . @ . . @ . @ . @ @ . @ @ . @ . . @ . . @ . . @ @ @ . @ . . . @ @ @ @ . @ @ @ . @ . @ 
@ @ @ . @ @ . @ . . @ . @ @ @ @ . @ @ . @ @ . @ . . . @ . . @ . . @ . . . @ . @ @ . @ . @ . @ . . @ @ . . . . @ . @ @ @ @ . . . @ . . . @ @ . @ . @ @ @ @ @ @ . . @ @ . @ . @ . . . @ . . . @ . . . @ @ 
@ @ @ . . . . . @ . . . . @ @ . @ . . . . @ . @ @ . @ . . @ . . @ . @ . @ . . @ . . . . . . . . @ @ . @ . @ @ . . @ @ @ @ @ . @ @ @ @ . . . @ @ @ . . . . @ . . @ @ . . @ . . @ . @ @ @ . @ . @ . @ . @ 
@ @ @ @ . @ . @ . @ . @ @ . . . . . @ . @ . @ . . . @ @ . . . @ . . . . . @ . . . @ . @ @ . @ @ . . . . @ . @ @ . @ @ @ @ @ . . @ . @ . @ @ @ @ @ @ @ . @ . @ . . @ @ . @ . @ . @ . @ . . . . . . . . @ 
@ @ @ @ @ . . @ . . . . . @ . @ . @ . . . . . . @ . . @ @ @ . . @ . @ . @ @ @ . @ . . @ . . . @ . @ @ . . . . . . . @ @ @ . @ . . . . @ . @ @ @ @ @ . . . . . . @ . . . @ . . . . . . @ . @ @ . @ . @ @ 
@ @ @ @ @ @ . @ . @ . @ . @ @ . . @ @ . @ . @ @ . . @ @ @ @ . @ . @ . . @ @ @ @ . . @ @ @ . @ @ @ @ . @ . @ . @ . @ . . @ . @ . @ . @ . . . @ @ @ . @ . @ . @ . . @ . @ . . @ . @ . @ . . . @ . @ . . @ 
@ @ @ @ . . @ . . . @ @ . . @ @ @ . . . . @ . . @ . @ @ @ @ . . . . @ . . @ @ . @ . @ @ @ . @ @ . . . . . . @ @ . . @ . . . . . . @ @ . @ @ . @ . . . @ . . . @ . @ @ @ @ . . @ @ @ @ . @ . . @ . @ . @ 
@ @ . @ . @ . @ . @ @ @ @ @ . . @ @ . @ @ @ @ . . . . @ @ @ @ . @ . @ . @ @ . . . @ . . . . . . @ @ . @ @ . @ . . @ @ @ @ . @ . @ @ . . . @ . . @ . @ . @ . @ @ @ @ @ . @ @ @ @ @ @ . . . @ . . . . @ @ 
@ . . . . . . . . @ @ @ @ @ @ . . . . @ @ @ @ . @ . @ . . @ @ @ . . . @ @ . @ . @ @ @ . @ . @ @ . @ . . . @ . @ . . @ . . . . @ @ . . @ @ . . @ @ . . . @ . . @ @ @ . . . . . @ @ . @ . @ . @ . @ @ . @ 
@ . @ . @ . @ . @ . @ . @ @ . . @ . @ . @ @ . @ . . @ @ . . @ . . @ . . . . . . . . . @ . . @ . . . . @ @ . . . . @ . . @ . @ @ . . @ . . . @ . @ . @ @ . . @ . . . @ @ . @ . . . . . . @ . @ . @ . . @ 
@ . . @ . . @ . @ . @ . . . @ @ @ . @ . . . . . . @ . @ . @ . @ . @ . @ . @ . @ . @ . . @ @ . @ . @ . . @ @ . @ . . @ @ @ . @ . @ . @ @ @ . . . . . . @ . @ @ . @ . . @ @ . @ @ . @ @ . . . . @ @ @ . @ 
@ . @ . @ . @ . @ . @ @ @ . . . . . . @ . @ @ . @ @ . . . . . . . . @ . @ @ @ @ . . @ . @ . . . @ . . @ @ . @ . . @ . . . . . . . . . . . . @ . @ . @ . . @ @ @ @ . @ . @ . @ . @ . . . @ . @ . @ . . @ 
@ . . . @ . @ @ @ . . . . . @ . @ . @ @ @ @ @ . . . @ @ . @ . @ . @ . . @ @ @ . . @ . . . . @ @ . @ . . @ . . @ . . @ @ . @ @ . @ . @ . @ @ . @ . @ @ @ . @ . . . . . . @ . @ . @ @ @ . . @ . . . @ . @ 
@ . @ @ . . @ . . . @ . @ . . @ @ @ . . . . . . @ . . @ . @ @ . . @ . @ . @ . @ @ @ @ . @ @ . . . . . @ @ @ . @ @ . . @ . . @ . . @ . . . . . . . . @ . @ . @ . @ @ @ @ . . . . . @ . . @ . . @ . @ . @ 
@ @ . . . @ . . @ . . @ . . @ @ @ @ @ . @ . @ . @ . @ . . . @ @ . . . . . . . . . . . @ . . @ @ . @ . @ . . . . . . @ @ . @ . . @ . @ . @ . @ . @ . . . . . . . @ . . . . @ @ @ . . @ . @ . @ . @ @ . @ 
@ . @ . @ . @ . @ . @ . @ . . @ @ @ @ . . @ . . . @ @ @ . @ . @ . @ . @ @ . @ . @ . @ . . @ @ @ @ . . . @ @ @ . @ . . . @ . @ . @ . @ @ @ . . @ @ . @ . @ . @ . . . @ @ . . . . @ . . . . . . . . . . @ 
@ . @ @ @ . . . @ @ . . . . @ . . . @ . @ . @ . @ @ @ @ @ . . . . . @ . . . . @ @ . . . @ @ . . @ @ . @ . . . @ . . @ . @ . . . . . . . . @ . . . @ . @ . @ @ @ . @ . @ . @ . @ @ @ . @ . @ . @ . @ @ @ 
@ . . @ . @ . @ . . @ . @ . @ . @ . . . . . @ @ @ @ @ @ @ @ . @ . @ . @ . @ . . . @ . @ . @ . @ . . @ @ @ @ . @ @ . . @ . @ @ @ @ . @ . @ @ @ . @ . . . . @ @ . . @ . @ @ @ @ . @ . @ . . @ . @ @ @ @ @ 
@ @ . @ . . . . @ . . @ . . @ . @ @ @ @ . @ . @ @ @ @ @ . . @ . . @ . @ @ @ @ . @ . . @ . . . . @ . . @ . . . @ @ @ . . . . @ . . . . @ . @ @ . . . @ . @ @ @ @ . . . . . . . . . . . @ @ @ @ . . . @ @ 
@ . . . . @ . @ @ . @ . @ . . @ . . . . . . . . @ @ @ . @ . @ @ . . . . . . @ @ @ @ . . @ . @ . @ . @ . @ @ . . @ @ . @ . @ @ @ . @ . . . . . @ . @ @ @ @ @ @ @ . @ @ @ . @ . @ . @ . @ . @ . @ . @ . @ 
@ . @ . @ . @ . . . . . . . @ . @ . @ . @ . @ @ @ @ . . . . . . . @ . @ . @ @ @ @ @ . @ . @ . . @ . @ . @ . . @ . @ . . @ @ . @ . @ . @ . @ . . @ @ @ @ @ @ @ @ @ @ @ @ @ @ . . @ @ . . . . . . . . . @ 
@ . @ . . . @ . @ . @ . @ @ . . . . @ @ . . . @ @ @ . @ . @ . @ . . @ . @ . . @ @ . . . . . @ . . . . . . @ . @ . @ . @ . . . . . @ . . @ . . @ @ @ @ @ @ @ @ @ @ @ @ @ @ @ . @ . @ @ . @ . @ . @ . @ @ 
@ . @ @ . @ @ @ . @ . . @ @ @ . @ . . @ @ . @ @ . . @ . . @ @ . . @ . . . @ . . @ @ . @ . @ @ @ . @ @ @ . . . . . @ . . @ . @ @ . @ . @ . @ . @ @ @ @ @ @ @ @ @ @ @ @ @ . . . . . . @ @ . @ . . . @ @ @ 
@ . @ . . @ @ . . . @ . @ @ @ @ . . @ @ @ @ . . @ . . @ . . . @ . . @ . @ . . @ . . . . @ @ @ @ @ @ @ . . @ . @ @ . . @ . @ . . . @ . . . . @ @ @ @ @ @ @ @ @ @ @ @ @ . . @ . @ . @ . @ . @ @ . @ . @ @ 
@ . . @ . . @ @ . @ @ @ @ @ @ @ @ . . @ . @ . @ . . @ . . @ @ . . @ @ . @ . @ . @ @ @ . . @ @ @ . @ @ @ . @ . . . @ . . . . @ . @ . . @ . @ @ @ @ @ @ @ @ @ @ @ @ @ @ @ . @ . @ . . . . . . . @ . . @ @ 
@ . @ @ @ . . . . @ @ @ @ @ @ @ . @ . @ . @ . . . @ @ @ . . . @ . . . . . . . . . . @ . @ @ @ @ . . . . . . @ @ . @ . @ @ . @ . . @ . . @ @ @ @ @ @ @ @ @ @ @ @ @ @ @ . . . @ . . @ . @ . @ . . . @ @ @ 
@ . . @ . . @ . @ @ @ @ @ @ @ . . . . . . . @ @ . . . . . @ @ . @ . @ . @ . @ @ @ . . @ @ @ @ @ . @ @ @ . @ @ . . . . . @ . . @ @ . . @ @ @ @ @ @ @ @ @ @ @ @ @ @ @ @ @ . @ @ @ @ . . @ . . @ . @ @ @ @ 
@ @ . . @ . . @ @ @ @ @ @ @ @ @ . @ . @ . @ @ @ . @ . @ @ @ @ . . . . @ @ @ @ @ @ . @ @ @ @ @ @ @ . . . . @ @ . @ @ . @ @ . @ . . . @ @ @ @ @ @ @ @ @ @ @ @ @ @ @ @ @ @ @ @ @ @ @ @ . . @ . @ @ @ @ @ @ 
@ @ @ @ @ @ @ @ @ @ @ @ @ @ @ @ @ @ @ @ @ @ @ @ @ @ @ @ @ @ @ @ @ @ @ @ @ @ @ @ @ @ @ @ @ @ @ @ @ @ @ @ @ @ @ @ @ @ @ @ @ @ @ @ @ @ @ @ @ @ @ @ @ @ @ @ @ @ @ @ @ @ @ @ @ @ @ @ @ @ @ @ @ @ @ @ @ @ @ @ 
3
68 27 75 88
75 81 85 10
72 80 3 75
