10 10
@ @ @ @ @ @ @ @ @ @ 
@ . . . . . . . @ @ 
@ @ . @ @ @ . @ @ @ 
@ @ @ . @ . . . @ @ 
@ . . . . . @ . . @ 
@ . @ . @ @ . . @ @ 
@ @ . . . . @ . . @ 
@ @ @ . @ @ @ . @ @ 
@ @ . . . . @ . @ @ 
@ @ @ @ @ @ @ @ @ @ 
3
1 6 4 3
6 2 1 2
5 3 6 4
