50 50
@ @ @ @ @ @ @ @ @ @ @ @ @ @ @ @ @ @ @ @ @ @ @ @ @ @ @ @ @ @ @ @ @ @ @ @ @ @ @ @ @ @ @ @ @ @ @ @ @ @ 
@ @ . @ . @ @ @ . . . @ @ @ @ @ @ . . . . . . . . @ . . @ . @ @ @ @ @ @ . @ . . . . @ . . @ @ @ @ @ 
@ . . . . @ @ . @ . @ . @ @ @ @ . . @ @ @ . @ . @ @ . @ . . . @ @ @ . . . . . @ . @ @ . @ @ @ . @ @ 
@ @ @ @ . @ . . . . . . @ . @ . @ . . . @ @ . . @ . . . @ . @ . @ @ @ @ @ @ . @ . @ . . . @ . . . @ 
@ @ @ @ . . @ . @ . @ . . . . . . . @ . . @ @ @ . @ . @ . . . . . . @ @ @ . . . @ @ @ . @ . @ . @ @ 
@ @ @ . @ . @ @ @ @ @ @ . @ @ . @ . . @ . . @ . . . . . . @ @ @ . @ . @ . @ . @ . @ . . . . @ . @ @ 
@ @ . . . . . @ @ @ @ @ @ @ @ @ . . @ . @ . @ . @ . @ @ . . . @ @ . . . . . . . . . @ . @ @ . . @ @ 
@ @ @ @ @ . @ . @ . @ @ . @ @ @ @ . . . . @ @ . @ . . @ @ . @ @ @ @ @ @ . @ @ . @ @ @ . . @ @ . . @ 
@ @ . @ . . . . . . @ @ . @ . @ . . @ . @ . . @ . . @ . @ @ . @ @ @ . . . . . @ . . @ @ . . . . @ @ 
@ . . . . @ . @ @ . . . . . . . @ . . @ . @ . . @ . . . @ . . . . . @ @ . @ . @ . @ . @ . @ @ @ . @ 
@ @ . @ @ . . . . @ . @ @ . @ . . @ . @ . . . @ @ . @ . @ @ . @ @ . @ . . . @ . . . . . . . . @ . @ 
@ @ @ . . . @ . @ @ @ . . . @ . @ . . . @ @ . @ @ . @ @ @ . . . @ @ @ @ . @ . @ . @ . @ . @ @ . . @ 
@ @ @ . @ . . @ @ @ @ @ . @ @ . . @ . @ . . . . . . . . . . @ @ . @ @ @ . @ . @ . . @ @ @ @ . . @ @ 
@ @ @ @ . . @ @ @ @ @ @ @ @ . @ . . . . . @ . @ . @ . @ . @ . . . @ . . . . . @ . @ . @ . @ . @ . @ 
@ @ @ @ @ . @ @ @ @ @ @ @ . . . . @ . @ @ @ . . @ @ @ . @ . @ @ . . . @ . @ @ @ . . . . . . . . . @ 
@ @ @ @ @ . @ @ @ @ @ @ @ @ . @ . @ . . @ . . @ @ @ @ . . . @ . . @ @ . . @ . . . @ . @ @ @ . @ . @ 
@ @ @ @ @ @ @ @ @ @ @ @ @ @ . @ @ @ . @ @ @ @ @ @ @ @ . @ . . @ . . @ @ . . @ @ . . @ @ @ . @ . @ @ 
@ @ @ @ @ @ @ @ @ @ @ . @ . @ . . . . @ @ @ . @ @ @ @ @ @ @ . @ . @ @ @ @ @ . @ . @ . @ . . @ . . @ 
@ @ @ @ @ @ @ @ @ @ . . . . . . @ @ . . . . . . . @ @ @ @ @ . @ . . @ . @ . . . . . . . @ . @ . @ @ 
@ @ @ @ @ @ @ @ @ @ @ . @ . @ @ . @ @ @ . @ . @ . . @ @ . . . . @ . . . . . @ . @ . @ . . . . . . @ 
@ @ @ @ @ @ @ @ @ @ @ @ . . . . . . . @ @ @ . @ . @ . . @ . @ . @ . @ . @ @ @ . . @ @ . @ . @ . @ @ 
@ @ @ @ @ @ . @ @ @ . @ @ . @ . @ . @ @ @ @ @ . . . . @ . @ . . . . @ @ @ . . @ . . . @ @ . . @ @ @ 
@ @ @ @ @ . . . @ . . . @ . @ . . @ @ @ @ @ @ @ . @ @ . . . @ . @ . . @ . @ . @ @ . @ . . @ . @ @ @ 
@ @ @ @ @ @ @ . . @ . @ @ . @ . @ @ @ @ @ @ @ @ . . . . @ . . @ . . @ . . . . . . @ . @ . . @ @ @ @ 
@ @ @ @ . . . @ . . . @ . . @ . @ @ @ @ @ @ @ @ . @ @ @ . . @ . @ . . . @ . @ . @ . . . . @ @ @ @ @ 
@ @ @ @ . @ @ . . @ @ . @ @ . @ @ @ . @ @ @ . . . . @ @ @ . . . . . @ @ . . . @ . . @ @ . . @ @ @ @ 
@ @ @ . . . @ . @ . @ . . @ . @ @ @ . . @ @ . @ . @ . @ . . @ @ . @ @ @ @ . @ @ @ @ . @ . @ . . @ @ 
@ @ . @ . @ . . @ . . . @ . . . . . . @ . . . . @ @ . . @ . . . @ . @ . @ . . @ . . . . . @ . @ . @ 
@ @ . @ . . . @ . . @ . . @ . @ . @ . . . @ . @ . . @ . @ @ . @ @ . @ . . @ . @ . @ . @ . @ . . . @ 
@ . . @ @ . @ . . @ . @ . @ @ . . @ . @ @ @ . . @ . . . . @ . . . . . . @ @ @ . @ @ @ . . . . @ . @ 
@ . @ . . . . . @ . . . @ . . . @ . . . @ @ @ @ . . @ @ @ . @ . @ @ . @ @ @ @ . @ @ . @ . @ @ . @ @ 
@ . . . @ . @ @ . @ . @ . @ @ . . @ @ . @ @ @ @ . @ . @ @ . . @ @ @ @ . . @ . . @ . . . . . . . . @ 
@ . @ . . @ @ . . . . . . . . @ @ . @ . . @ . . . . . . . @ . . . . . @ . . @ . @ @ @ . @ @ @ @ . @ 
@ @ . . @ . . @ . @ . @ . @ . @ . . . . @ @ . @ . @ . @ @ @ . @ . @ @ . . @ @ . . @ @ @ . @ . . . @ 
@ . @ . . . @ . . @ @ . . . @ . @ . @ . . . . . @ . . @ . . . . @ . @ . @ @ @ . @ . @ . . . @ @ . @ 
@ . . . @ . . @ . . @ . @ . @ . @ @ . . @ @ @ @ @ @ . @ . @ . @ . . . . . @ . . . . . . @ @ . . . @ 
@ @ @ . . @ @ @ . @ . . . @ . . . . @ . . @ @ @ @ @ @ @ @ . . . . @ . @ @ . @ @ @ . @ . @ . . @ . @ 
@ . . . @ . @ @ @ . @ . @ @ @ @ @ . . . @ . @ @ @ @ @ @ @ @ . @ @ . . @ . . @ @ @ @ . . . @ @ . . @ 
@ @ @ . . . . @ @ . . . . @ . . @ @ @ . @ . . @ @ @ @ @ . . . @ @ @ . @ @ . . . @ @ @ . @ . . . @ @ 
@ . . . @ . @ . @ . @ . @ . @ . . . @ . @ . @ . @ @ . . @ @ . @ @ @ . @ . . @ @ . @ . . @ . @ @ . @ 
@ @ @ . . @ . . @ @ . . @ . . . @ . @ . @ . . . . @ @ . @ . . . @ @ @ @ @ . @ @ . @ @ . . . @ . . @ 
@ . . . @ . @ . @ . @ . @ . @ . @ @ . . @ . @ . @ @ @ . @ @ . @ . @ @ . @ . . . . . . @ @ . @ . @ @ 
@ @ @ . . . . . . . . . . @ . . . . @ . . . @ . @ . . . . . . . . . . . . . @ . @ @ . . . . . . @ @ 
@ . . . @ . @ @ @ . @ . @ . @ . @ @ . @ . @ . @ . @ @ . @ . @ . @ . @ @ @ . . @ . . . @ . @ @ @ @ @ 
@ @ @ @ . . . . . @ . . . . . . @ . . . . . . . . . . . . @ @ . . @ @ @ @ . @ . @ @ @ . @ . @ . @ @ 
@ @ @ @ @ . @ . @ @ @ . @ . @ . @ @ . @ @ @ . @ . @ @ @ . @ @ . @ . @ . . . . . . . . . . . . . . @ 
@ @ @ @ @ . . @ @ @ . . . @ @ . . . . . . @ @ @ @ . @ . @ . @ . . . . @ @ . @ . @ . @ @ . @ . @ . @ 
@ @ @ @ @ . @ . @ @ @ . @ @ . @ @ . @ @ . . . @ . . . . @ . . . @ . @ @ . . . @ @ . . . @ . . @ @ @ 
@ @ @ @ @ . . . . @ @ @ @ . . . . . . @ . @ . . . @ . @ . . @ @ . . . . @ @ . . @ @ . @ @ @ . . . @ 
@ @ @ @ @ @ @ @ @ @ @ @ @ @ @ @ @ @ @ @ @ @ @ @ @ @ @ @ @ @ @ @ @ @ @ @ @ @ @ @ @ @ @ @ @ @ @ @ @ @ 
3
10 15 22 29
48 22 12 18
5 44 6 34
