12 12
@ @ @ @ @ @ @ @ @ @ @ @ 
@ @ @ @ @ @ @ @ @ . . @ 
@ @ @ @ @ @ @ @ . . @ @ 
@ @ @ @ @ @ . . @ . . @ 
@ . @ @ @ . @ . @ . @ @ 
@ . . @ . . . . . . . @ 
@ . @ . @ @ . @ @ . @ @ 
@ . @ . . @ . @ . . . @ 
@ . @ . @ . @ . @ @ . @ 
@ . @ . . . . . . @ . @ 
@ . . . @ @ . @ . . . @ 
@ @ @ @ @ @ @ @ @ @ @ @ 
3
7 3 7 1
8 3 5 5
9 1 10 3
