50 50
@ @ @ @ @ @ @ @ @ @ @ @ @ @ @ @ @ @ @ @ @ @ @ @ @ @ @ @ @ @ @ @ @ @ @ @ @ @ @ @ @ @ @ @ @ @ @ @ @ @ 
@ @ @ @ @ @ @ @ . @ @ @ @ @ . . . @ @ . . . @ @ @ . . @ . . . @ . @ @ @ @ @ @ @ . @ . @ @ . @ . . @ 
@ @ @ @ @ @ @ . . . @ @ @ . . @ . . . . @ . . @ . . @ @ . @ . @ . . @ @ @ @ @ . . . . . . . . @ . @ 
@ @ @ @ @ @ @ @ . @ @ @ @ @ . . @ . @ . . @ . . @ . @ . @ . . . . @ . @ @ . @ @ . @ @ . @ @ . @ . @ 
@ @ @ @ @ @ @ . . . . @ @ . . @ @ @ . . @ @ @ . . . . . . . @ @ . . . @ . . @ . . @ . @ @ @ . . . @ 
@ @ @ @ @ @ @ @ . @ . . @ @ . @ @ . @ . . @ @ @ @ . @ . @ . . . @ @ . . @ . . @ @ . . @ @ . @ . @ @ 
@ @ @ @ @ @ @ . . @ . @ @ . . . . . @ . @ . . . @ @ @ . @ @ @ @ . @ @ . @ . @ @ . @ . . @ . . . . @ 
@ @ @ @ @ @ . @ . . @ @ . @ . @ . @ @ @ . . @ @ . . . @ . @ . . . @ . . . . @ . . . . @ . @ @ . @ @ 
@ @ @ @ @ . . . @ . @ . . @ . . @ . @ @ @ . @ @ @ @ . . . . @ . @ . @ . @ @ @ @ . @ . @ . . . . . @ 
@ @ @ @ . @ . @ . . . . @ . . @ . . @ @ . . . @ @ . @ . @ . . . . . . . @ . . @ @ . . . @ @ @ . @ @ 
@ @ @ @ . . . . @ . @ @ . @ . . @ . . . @ . @ . . . . . . @ @ . @ . @ . @ . @ . @ @ . @ . @ . . . @ 
@ @ @ . @ @ @ . . . @ . . . . @ . @ . @ . . . . @ . @ . @ @ . @ @ @ . . . . . . . . . . . . @ . @ @ 
@ @ @ . . . @ . @ . @ @ . @ @ . . . . @ @ . @ @ . . . @ . @ . . @ . @ @ . @ . @ @ @ . @ @ . . . . @ 
@ @ @ . @ . @ @ . . @ . @ . @ @ . @ . . @ . . . @ . @ . . @ @ . @ . . @ . . @ . @ @ . . . @ @ . @ @ 
@ @ . @ . . . . @ . . . @ . @ . @ @ @ . @ . @ @ . @ @ @ . @ @ . . . @ @ @ . . . . . @ . @ . . . . @ 
@ . . . . @ @ . @ . @ @ . . . . . @ @ . @ . . @ . . . . . @ . @ . @ . . . . @ . @ . @ . @ . @ . @ @ 
@ @ @ @ . @ . @ . . . . . @ . @ . . . . @ . @ . . @ . @ . . . . . . . @ . @ @ . . @ @ @ . @ @ . @ @ 
@ . . @ . . . @ @ @ . @ . @ . . @ . @ . . . . @ @ . @ . @ . @ . @ . @ . . . . @ . . . . . . . @ @ @ 
@ . @ . . @ @ . @ . @ . . @ . @ @ . . @ . @ . . @ . . . . . @ . . @ @ @ . @ @ . . @ . @ . @ . . . @ 
@ . . . @ . @ . . . @ . @ . . @ . . @ . @ . . @ @ @ . @ . @ . . @ . @ . @ @ . @ . . @ . . . @ . @ @ 
@ . @ . . . . . @ . @ @ . . @ @ @ . . . . @ . @ @ . @ . . . @ . . . @ . . . . . . @ . @ . @ @ @ @ @ 
@ @ @ . @ . @ @ . @ . . @ . . @ . @ @ . @ @ @ . . . . . @ . @ @ . @ @ @ @ . @ @ . . . . @ @ . @ @ @ 
@ @ @ . @ . . @ . . @ . @ . @ @ . . . . . @ @ . @ . @ . @ @ . . . . @ . . . . . @ . @ . . . . . . @ 
@ . . . . @ @ . @ . @ . @ @ . @ . @ @ . @ @ . . @ @ @ . . . @ . @ . @ . @ . @ @ @ . @ . @ . @ . @ @ 
@ @ @ . @ . @ . . . . . . . . . . @ . @ @ @ . @ . . . . @ . . @ . . @ . @ . @ . . . . @ . . . @ @ @ 
@ @ @ . @ . . @ . @ . @ . @ . @ . @ . . . . @ . . @ @ . . @ @ @ @ . . @ . . @ . @ . @ @ @ @ . . @ @ 
@ @ . . . . @ . @ . . @ @ . @ . @ . @ @ . @ . @ . @ . . @ @ . . . . @ @ @ . @ . @ . . . . . @ . . @ 
@ . @ . @ @ . . @ @ @ . . . . . . . . . . . . . . . @ @ @ @ @ . @ . . . . @ @ @ . . @ @ . @ @ . @ @ 
@ . . . . . @ . @ . . @ . @ . @ @ . @ . @ . @ . @ @ . @ @ . . . . @ . @ . @ @ . @ . @ @ . @ @ @ @ @ 
@ . @ . @ . . . . . @ . . . @ . . . . @ @ @ . . @ . . @ . @ @ . @ @ @ @ @ @ @ . @ . @ . . . @ @ @ @ 
@ @ @ @ . @ @ . @ @ @ @ @ @ @ @ . @ . . @ @ @ . @ @ . . . . @ @ @ @ @ @ @ @ . . . . @ @ . @ @ @ @ @ 
@ . @ @ . . . . . . . . . . . . . @ . @ @ @ @ @ . . . @ @ @ @ @ @ @ @ @ @ . . @ . @ @ . . @ @ @ @ @ 
@ . @ @ @ . @ @ . @ . @ . @ . @ . @ . @ . @ @ @ @ . @ @ @ @ @ @ @ @ @ @ @ @ @ . . . @ . @ @ @ @ @ @ 
@ . @ @ @ . . @ @ . . . @ @ @ . . @ . . . @ @ @ . . . @ @ @ @ @ @ @ @ @ @ @ @ @ . @ @ @ @ @ @ @ @ @ 
@ . . @ @ . @ . @ @ . @ @ @ @ @ . @ . @ . @ @ . @ . @ @ @ @ @ @ @ @ @ @ @ @ @ @ @ @ @ @ @ @ @ @ @ @ 
@ @ . . @ . . . . . @ . . . . . . @ . . @ . . . . . . @ @ @ @ @ @ @ @ @ @ @ @ @ @ @ @ @ @ @ @ @ @ @ 
@ @ . @ . . @ . @ . . @ . @ . @ . . @ . . @ . @ @ . @ @ @ @ @ @ @ @ @ @ @ @ @ @ @ @ @ @ @ @ @ @ @ @ 
@ . . . . @ . . . @ @ @ @ @ @ . . @ . @ . @ . @ . . . @ @ @ @ @ @ @ @ @ @ @ @ @ @ @ @ @ @ @ @ @ @ @ 
@ @ . @ . @ @ . @ @ @ @ @ . @ @ . . . @ . . @ . @ . @ @ @ @ @ @ @ @ @ @ @ @ @ @ @ @ @ @ @ @ @ @ @ @ 
@ @ @ . . . . @ . @ . . . . . . @ . @ . @ . . . @ . . @ @ @ @ @ @ @ @ @ @ @ @ @ @ @ @ @ @ @ @ @ @ @ 
@ @ . @ . @ . @ . . @ . @ @ @ . . . @ . @ . @ . @ . @ @ @ @ @ @ @ @ @ @ @ @ @ @ @ @ @ @ @ @ @ @ @ @ 
@ @ . . . @ @ @ @ . . . @ . . . @ . . . @ . . @ @ . @ @ @ @ @ @ @ @ @ @ @ @ @ @ @ @ @ @ @ @ @ @ @ @ 
@ @ @ . @ @ . @ . @ @ . @ @ . @ @ @ @ @ . @ @ @ . . . @ @ @ @ @ @ @ @ @ @ @ @ @ @ @ @ @ @ @ @ @ @ @ 
@ @ . . . @ . . . @ . @ @ @ . . . . . . . @ . . @ . @ @ @ @ @ @ @ @ @ @ @ @ @ @ @ @ @ @ @ @ @ @ @ @ 
@ @ @ . @ . . @ . . . . . . . @ . @ @ . @ @ @ . . . @ @ @ @ @ @ @ @ @ @ @ @ @ @ @ @ @ @ @ @ @ @ @ @ 
@ @ . . . @ @ . . @ @ @ . @ @ . . . @ . . @ @ @ @ . @ @ @ @ @ @ @ @ @ @ @ @ @ @ @ @ @ @ @ @ @ @ @ @ 
@ @ @ . @ @ @ . @ @ @ @ . . @ @ . @ . . @ . @ . @ . . @ @ @ @ @ @ @ @ @ @ @ @ @ @ @ @ @ @ @ @ @ @ @ 
@ @ @ @ @ @ @ @ @ @ . @ . @ . @ @ . @ . . . . . . . @ @ @ @ @ @ @ @ @ @ @ @ @ @ @ @ @ @ @ @ @ @ @ @ 
@ @ @ @ @ @ @ @ @ . . . . . . . . . . @ @ . @ @ . @ @ @ @ @ @ @ @ @ @ @ @ @ @ @ @ @ @ @ @ @ @ @ @ @ 
@ @ @ @ @ @ @ @ @ @ @ @ @ @ @ @ @ @ @ @ @ @ @ @ @ @ @ @ @ @ @ @ @ @ @ @ @ @ @ @ @ @ @ @ @ @ @ @ @ @ 
3
17 29 35 14
25 8 12 3
38 18 9 35
