50 50
@ @ @ @ @ @ @ @ @ @ @ @ @ @ @ @ @ @ @ @ @ @ @ @ @ @ @ @ @ @ @ @ @ @ @ @ @ @ @ @ @ @ @ @ @ @ @ @ @ @ 
@ . . . @ @ @ @ @ . @ @ @ . @ . @ . @ @ @ . . @ @ @ @ @ @ @ . @ @ @ @ @ . . @ . @ . . . @ @ @ . . @ 
@ . @ . . @ @ @ . . @ . @ . . . . . . @ @ . @ . @ @ @ @ @ . . @ @ @ @ @ @ . . . . @ . @ . @ . @ . @ 
@ @ . . @ @ @ @ @ . . . . . @ @ . @ . . . . . . . @ @ @ . @ . . @ @ . @ . @ @ . @ . . . . . . . . @ 
@ @ @ . . . @ @ . . @ . @ . . . @ . @ . @ . @ . @ . @ . . . . @ . . . . . . . . . . @ @ . @ . @ . @ 
@ @ . @ @ . . @ @ . . @ . @ @ . . . . @ . . @ . . . . @ @ @ . . . @ . @ . @ @ @ @ @ . . @ @ . . @ @ 
@ @ . . @ . @ @ @ . @ . . . @ @ @ @ . . @ . . @ . @ . . @ . . @ @ @ . . @ . . . @ @ . @ . @ . @ @ @ 
@ . @ . . . . . . . . . @ @ @ . @ . . @ @ . @ . . . @ . . @ . . @ @ . @ @ @ @ . @ . . . . . @ @ @ @ 
@ . . . @ . @ @ . @ @ @ . @ . . . @ . @ . @ @ @ . @ . @ @ . . @ @ . @ @ . . . . . @ . @ . @ @ @ @ @ 
@ . @ . . @ @ @ . @ . . . @ . @ . @ . . . . @ . . . . @ @ @ . . @ . @ . @ . @ @ . . . @ . @ @ @ @ @ 
@ . @ . @ . @ @ @ @ @ @ . . @ . . . . @ . @ . @ . @ @ . @ . . @ . . . . . . . @ @ . @ . @ . @ . @ @ 
@ . @ . . . . @ . @ . @ . @ @ @ @ @ . . @ . . @ . . @ . . . @ . . @ . @ @ . @ @ . . @ . . . . . . @ 
@ @ . . @ . @ . . . . . . . . . @ @ @ . @ @ . . . @ @ @ @ . . @ @ @ @ @ @ . @ @ @ . @ . @ . @ . @ @ 
@ @ @ . . @ . @ . @ . @ . @ . @ @ @ @ . . @ . @ . . @ . . . @ . . . @ @ . . . @ . @ @ @ . . . @ @ @ 
@ @ . . @ @ . . . . @ . . @ . @ . @ . . @ @ @ @ @ @ @ . @ . . . @ @ @ . . @ @ . . . @ . @ . @ . @ @ 
@ . @ . . . @ . @ . . @ . . @ . . . @ . @ . . @ . . @ @ . . @ @ . @ . . @ . @ . @ . . . @ . . . . @ 
@ . . . @ . . @ . . @ . @ @ . . @ @ . @ . . @ . @ . @ . @ . . @ . . @ . . . . . @ . @ @ . . @ . @ @ 
@ @ @ . . @ @ . @ . @ . . . @ . @ . . . @ . . . . . . . . . @ . . @ . . @ . @ @ @ . @ . @ . . @ @ @ 
@ @ . . @ @ @ . @ . . . @ . . . . . @ . . @ . @ . @ . @ @ . . . @ . . @ . @ @ . @ . @ . . . @ . @ @ 
@ . @ . @ @ @ . . . @ @ . @ . @ . @ . . @ . @ . . @ . @ . . @ @ . . @ @ . . . . . @ @ . @ . . . . @ 
@ . . . . @ . . @ . . @ . . @ . . . @ @ @ . . @ @ . . @ . @ . @ @ . . @ . @ @ @ @ . . @ . . @ . @ @ 
@ @ @ . @ . @ . @ @ . @ . @ . @ . @ . . @ . @ . @ @ @ . . . . @ . . @ . . @ @ . @ . @ . @ . . @ @ @ 
@ . . . . . . . . . @ . . @ . @ . . @ . . . . . . . . @ . @ @ . @ . @ . @ . . . . . . . . . @ @ @ @ 
@ @ . @ @ . @ . @ . . @ . . . @ @ . @ . @ . @ . @ @ . . . . . . . . . . . . @ . @ @ . @ . @ . @ @ @ 
@ . . . @ @ . . . @ . @ . @ . @ . @ @ @ . . . @ @ @ . @ . @ @ . @ @ . @ . @ @ . . . @ . . . . . @ @ 
@ @ . @ . . . @ @ @ @ . . . @ . . . . . @ . @ . . . @ . . . @ @ . . @ . @ . . . @ @ . . @ . @ . . @ 
@ @ @ . @ @ . @ . @ . @ . @ . @ . @ . @ @ . . @ . @ . @ @ @ . . @ . @ . @ . @ . @ . @ . @ . . @ @ @ 
@ . . . . . . . . . . . . . . . . @ . . . . @ . . . . . @ . . @ . . . . @ . @ @ @ . . @ . @ . . . @ 
@ . @ @ . @ @ @ . @ . @ . @ . @ @ . @ . @ . . . @ . @ . . @ . . . @ @ . @ @ @ . . @ . . . . @ . @ @ 
@ @ . . . . . . @ . . . @ @ . . . . . @ . . @ . @ @ . @ . . . @ . @ . @ . @ . @ . @ @ . @ . . @ @ @ 
@ @ @ @ . @ . @ . . @ . . . @ . @ . @ @ @ @ . @ @ . . . @ @ @ @ . . . @ . . . . . . . @ @ @ . . . @ 
@ @ @ @ . . @ @ @ . @ . @ @ @ . . @ . @ . . . . . . @ @ . . @ . . @ . . @ . @ . @ . @ . @ . . @ . @ 
@ @ @ @ @ . . @ @ . @ . . . . @ . . . . . @ @ . @ . . . . @ @ @ . @ . @ @ . . @ . . @ . @ . @ . @ @ 
@ @ @ @ @ . @ . . . @ . @ @ . . @ . @ . @ @ . @ . . @ . @ . @ @ . . @ @ . . @ @ . @ @ . . . . . . @ 
@ @ @ @ @ @ . . @ . @ . . @ . @ @ . @ . . @ . . @ . @ @ @ . . . @ @ . . @ . @ @ . . @ . @ . @ . @ @ 
@ @ @ @ @ @ @ . @ . @ . @ . @ @ . @ . . @ . @ . . . . . . . @ @ . @ . @ . @ . @ . @ . . @ . . @ @ @ 
@ @ @ @ @ @ . @ @ . @ . . . @ @ . @ @ . . . . @ @ . @ . @ . . . . . . . . . . . . . . @ . . @ @ @ @ 
@ @ @ @ @ . . . . . @ . @ . . . . . . @ . @ . . @ @ @ . . @ . @ . @ . @ . @ . @ @ . @ @ @ @ . . @ @ 
@ @ . @ @ . @ . @ . @ . @ . @ . @ @ . . @ @ @ . . . @ @ @ . @ . . . @ @ @ . . . . @ . @ . @ . @ . @ 
@ . . @ . @ . . . @ @ @ . . . @ . . . @ . @ . . @ . . . . . . @ . @ . @ . @ . @ . . . . . @ . . . @ 
@ @ . . . @ . @ . . . @ @ . @ . @ @ . @ . @ @ . . @ . @ . @ @ @ . . . . . . @ @ . @ . @ . . . @ . @ 
@ @ @ . @ @ @ . . @ @ . . . . . . @ . . . . . @ @ . . . @ . @ . @ . @ @ . @ . @ . @ @ . . @ @ @ . @ 
@ @ . . . . . . @ . @ @ @ . @ . @ . . @ @ . @ @ @ . @ . . . . . @ . @ . . . . . @ . @ . @ . @ . @ @ 
@ @ @ . @ . @ . . . . . . @ . . @ @ @ @ @ . . . @ . . @ . @ . @ @ @ . @ . @ . @ . . . . . . . . . @ 
@ @ . . . @ . @ . @ . @ @ . . @ . . . . . . @ . @ . @ @ @ @ . @ . . . . . . @ . @ @ . @ . @ . @ @ @ 
@ . @ . @ . . . . . @ . . . @ @ @ . @ . @ . . @ @ @ @ @ . . . @ . @ . @ . @ . . . @ @ @ . . @ @ @ @ 
@ . . . @ . @ . @ . @ . @ . . @ @ @ @ @ . . @ @ @ @ @ @ @ . @ . @ . @ @ . . . @ . . . . @ @ @ @ @ @ 
@ @ @ . . @ . . @ . . @ @ . @ . . . @ . . @ @ . @ . @ @ @ . . . . . . . @ . @ . . @ . @ @ @ @ @ @ @ 
@ @ . . @ @ @ . @ . @ @ . . . . @ . . @ . . . . . . . . . @ . @ @ . @ . . @ @ @ . . @ @ @ @ @ @ @ @ 
@ @ @ @ @ @ @ @ @ @ @ @ @ @ @ @ @ @ @ @ @ @ @ @ @ @ @ @ @ @ @ @ @ @ @ @ @ @ @ @ @ @ @ @ @ @ @ @ @ @ 
3
31 16 28 23
5 15 18 45
14 16 44 6
