10 10
@ @ @ @ @ @ @ @ @ @ 
@ . . . @ . . . . @ 
@ @ . @ . @ . @ @ @ 
@ . . . . @ . . @ @ 
@ . @ @ . @ . @ . @ 
@ @ . . . . . . . @ 
@ @ @ . @ . @ . @ @ 
@ @ @ @ @ . . @ @ @ 
@ @ @ @ @ . @ @ @ @ 
@ @ @ @ @ @ @ @ @ @ 
3
7 5 1 6
3 6 5 2
1 8 4 1
