50 50
@ @ @ @ @ @ @ @ @ @ @ @ @ @ @ @ @ @ @ @ @ @ @ @ @ @ @ @ @ @ @ @ @ @ @ @ @ @ @ @ @ @ @ @ @ @ @ @ @ @ 
@ @ @ @ @ . . @ . . @ . @ . . . @ @ . @ @ @ @ @ @ @ @ @ @ @ @ . @ @ . @ . @ . @ . . @ @ . . @ . @ @ 
@ @ @ @ . @ . . @ . @ . . @ @ . . . . . . @ @ @ @ @ @ @ @ @ . . . . . . . . . @ @ . . @ @ . . . . @ 
@ @ . @ . . @ . . . @ . @ @ . . @ . @ . @ . @ @ @ @ @ @ @ . @ . @ . @ . @ . @ @ @ . @ @ . @ @ . @ @ 
@ @ . . . @ . @ @ . @ . . . @ . . @ . . . . . @ @ @ @ @ @ . . . @ . . @ . . @ @ . . . @ . . . . . @ 
@ . @ @ . . . @ . . @ . @ @ . . @ . @ . @ . @ @ @ @ @ @ . @ @ . . @ @ @ @ @ . @ @ . @ . @ . @ @ . @ 
@ . . @ . @ . . @ . @ . . @ . @ . . @ @ . @ @ @ @ @ @ . . . @ . @ @ @ @ . . . . . . . . . @ @ @ . @ 
@ . @ . @ . @ . . . . . @ @ . . . @ @ . . @ . @ @ @ . . @ . . . . . @ . @ . @ . @ . @ . @ . @ @ . @ 
@ . @ . . . @ @ . @ . @ . @ . @ @ . . @ . . . . . @ @ @ . . @ . @ . . . @ . . @ @ @ . . . . . . . @ 
@ . @ . @ . @ @ @ . . . . . . . . @ . @ @ @ @ @ . @ @ @ @ . @ @ . @ . @ . @ @ . @ @ . @ . @ . @ @ @ 
@ . . . . @ . @ . @ . @ @ . @ @ @ . . . @ . . . . @ @ @ @ . @ . . . . . . . . . . . . @ . . @ . @ @ 
@ @ . @ . . . @ . . . . @ @ @ @ . @ . @ . @ . @ . . . @ . . . @ . @ @ @ . @ . @ . @ . . @ . . . . @ 
@ @ . . @ @ @ . @ . @ . . . @ . . . . . . @ @ . @ . @ . @ . @ . . . . . @ . @ . @ @ . @ . @ . @ . @ 
@ @ . @ . . @ . . @ . . @ . . @ . @ . @ . . . . . . . . . . . @ @ . @ . . . . . . @ @ . . @ . @ . @ 
@ . . . . @ . . @ . @ . . @ @ @ @ @ @ . @ . @ . @ @ . @ . @ . . @ @ . . @ . @ . @ @ @ @ . @ . . @ @ 
@ @ . @ @ @ @ . @ . . . @ . . @ @ @ . . . . . @ @ @ @ . . . @ @ . @ @ . . @ . . . @ @ . . . @ @ . @ 
@ . . . . @ . . @ . @ . . . @ . @ . @ . @ . @ . @ . . @ . @ @ . . . . . @ @ @ . @ . . @ . @ . @ . @ 
@ . @ . @ . @ . @ @ . . @ @ . . . . . @ . . . . . @ . . @ . . @ @ . @ . . . . @ . @ . . . . . . . @ 
@ @ . . . . . . . . @ . . . @ @ . @ . @ @ . @ . @ @ . @ . @ . @ . @ . . @ @ . . . . . @ . @ . @ @ @ 
@ @ @ . @ . @ . @ . . . @ @ @ @ @ . . . . @ . @ . . . . . . . . . . @ . . . @ . @ . @ @ @ @ @ @ @ @ 
@ @ @ . @ @ . @ . . @ . @ @ @ @ @ . @ . @ . . @ @ . @ . @ . @ . @ . . . @ . . @ @ @ @ @ @ @ @ @ @ @ 
@ @ @ . @ @ . . . @ . . . @ . @ @ @ @ . @ . @ . . . . @ . . . @ . . @ . @ . @ @ @ @ @ @ @ @ @ @ @ @ 
@ @ @ @ . . @ . @ @ . @ . @ . @ . . . . . . . . @ . @ @ @ . @ @ @ @ . . . @ @ @ @ @ @ @ @ @ @ @ @ @ 
@ @ @ . . @ . @ . @ @ @ . . . . . @ . @ @ . @ . . @ . . . @ . . @ . @ . @ @ @ @ @ @ @ @ @ @ @ @ @ @ 
@ @ . @ . . . . . . . . . @ . @ . . @ . . . . @ . . @ . @ . @ . . . . . @ @ @ @ @ @ @ @ @ @ @ @ @ @ 
@ . . . . @ . @ . @ . @ . . @ . . @ . . @ . @ . . @ . . . . @ @ @ @ @ . @ @ @ @ @ @ @ @ @ @ @ @ @ @ 
@ @ @ @ . . @ . . . @ . . @ . @ . @ . @ . . @ @ . . @ . @ . . . . . @ @ @ @ @ @ @ @ @ @ @ @ @ @ @ @ 
@ @ @ . @ @ . @ . @ @ @ . . . . @ . . . @ . @ . . @ . @ @ . @ . @ . . @ @ @ @ @ @ @ @ @ @ @ @ @ @ @ 
@ . . . . . . . . . @ @ @ . @ . . @ . @ @ . . @ . . . . . . @ @ . @ . . @ @ @ @ @ @ @ @ @ @ @ @ @ @ 
@ @ . @ . @ . @ . @ . . . . . @ @ @ @ . . . @ @ . @ @ . @ . . . . . @ @ @ @ @ @ @ @ @ @ @ @ @ @ @ @ 
@ @ . @ . . @ . . @ . @ . @ @ . . @ . . @ . . . @ . . . . @ . @ . @ . . @ @ @ @ @ @ @ @ @ @ @ @ @ @ 
@ @ . @ @ @ . @ . @ @ @ @ . @ . @ . @ . @ . @ . . @ @ . @ . . @ @ . @ . . @ . @ @ @ @ @ @ @ @ @ @ @ 
@ . . . @ @ . . @ . . . . . . . . . . . @ . . @ . @ . . . @ . . . . . . @ @ . . . @ . @ @ @ @ @ @ @ 
@ @ . @ . . @ . @ @ @ @ . @ . @ @ @ . @ . . @ @ . . @ . @ @ . @ . @ . @ @ @ . @ . . . . @ @ @ @ @ @ 
@ . . . . @ . . . . . . . . @ . . . . . @ . . @ @ @ . . . . @ . . . @ @ @ . . . @ @ . @ @ @ @ @ @ @ 
@ @ . @ @ . . @ . @ . @ . @ @ @ . @ . @ . @ . . . @ @ . @ . @ @ . @ . @ . @ . @ . @ . @ . . @ @ @ @ 
@ . . @ . @ . @ @ . . @ . . . @ @ . . @ . . . @ . . @ . . @ @ . . . . . . . . . . . @ . . @ @ @ @ @ 
@ @ . @ . @ . . . @ . @ . @ @ @ . @ . @ . @ . @ . @ @ @ . . . @ . @ . @ . @ . @ . @ . . @ @ @ @ @ @ 
@ @ @ . . . . @ @ @ @ . @ . . . . . . @ . . @ @ . . @ . . @ . . @ . . . @ . . @ . . @ . . @ @ . @ @ 
@ @ @ @ @ @ . @ @ @ @ . @ @ . @ . @ . @ . @ @ @ . @ @ @ . . @ . @ @ . @ @ @ . . @ . . . @ @ . . @ @ 
@ . @ @ @ . @ . . @ . . . . . . @ . . @ . @ @ @ @ @ @ @ @ . . @ @ . . @ @ . @ . . @ @ . . @ @ . @ @ 
@ . . @ . . @ @ . @ . @ . @ . @ @ . @ . . @ @ @ @ @ @ . . . @ @ . @ . . @ . @ . @ . @ @ . @ @ . . @ 
@ . @ . @ . @ @ . @ @ . @ . . @ . . @ @ . . @ @ . @ . . @ . . . . @ . @ . . @ . . . . . @ @ . . @ @ 
@ . . . . . . . . . . . . . @ . . @ @ @ . @ @ . . @ @ . . @ . @ . . @ . . @ . . @ . @ . . . @ . @ @ 
@ @ @ . @ . @ . @ . @ @ . @ . . @ @ @ . . @ @ @ . . . . @ . . . @ . @ . @ @ @ . . @ . . @ . . . . @ 
@ @ @ @ . . . @ . @ . . . . @ . . @ @ . @ . @ . @ . @ . . @ . @ @ . . . . @ @ . @ @ @ . . @ @ . @ @ 
@ @ @ . . @ @ @ . @ . @ . @ @ @ . . . @ @ . . . . . @ . @ . . . . @ . @ . . @ . @ @ @ @ @ @ @ @ @ @ 
@ @ @ @ . . . . . . @ @ @ @ @ @ . @ . . . @ . @ @ . @ . . @ . @ @ . . @ . @ @ . . @ @ @ @ @ @ @ @ @ 
@ @ @ @ . @ . @ . @ @ @ @ @ @ @ . @ @ . @ @ . . . @ @ . @ @ . @ @ . @ @ @ @ @ @ . . @ @ @ @ @ @ @ @ 
@ @ @ @ @ @ @ @ @ @ @ @ @ @ @ @ @ @ @ @ @ @ @ @ @ @ @ @ @ @ @ @ @ @ @ @ @ @ @ @ @ @ @ @ @ @ @ @ @ @ 
3
7 27 26 9
22 25 37 20
42 39 44 26
