50 50
@ @ @ @ @ @ @ @ @ @ @ @ @ @ @ @ @ @ @ @ @ @ @ @ @ @ @ @ @ @ @ @ @ @ @ @ @ @ @ @ @ @ @ @ @ @ @ @ @ @ 
@ @ @ @ @ @ @ @ @ . @ @ @ @ @ . @ @ @ @ @ @ @ @ @ @ @ @ @ @ @ . . @ . . . @ . . @ @ @ . . . @ . @ @ 
@ @ @ @ @ @ @ @ @ . . @ @ @ . . . @ @ @ @ @ @ @ @ @ @ @ @ @ @ @ . . . @ @ . @ . . @ . @ . @ @ . . @ 
@ @ @ @ @ . @ @ . @ . @ @ . @ . @ @ @ @ @ @ @ @ @ @ @ @ . . @ @ . @ . . . . . . @ . . . . @ @ . @ @ 
@ @ @ @ . . . . . . . . . . @ . . @ @ @ . @ . @ @ @ @ . . @ @ @ @ . . @ @ . @ @ . @ . @ @ . . . . @ 
@ @ @ @ @ . @ . @ @ @ . @ . . . @ @ @ . . @ . . @ @ @ . @ . @ @ @ @ . . @ . @ . . . . . . . @ @ . @ 
@ @ @ @ . . . @ @ @ @ @ . @ @ . . @ . @ . . . @ . @ . . . . @ @ @ @ @ . . @ . . @ . @ . @ . . . @ @ 
@ @ @ @ @ . @ @ @ @ . @ . @ @ . @ . . @ . @ . . . . . @ @ . @ . . . . . @ @ @ @ @ @ . @ @ @ . @ @ @ 
@ @ @ @ @ . @ . @ @ . . . . . . . . @ @ @ . . @ . @ . @ . . . . @ . @ @ . @ . . . . . . @ @ . . @ @ 
@ @ @ @ @ @ . . @ . @ @ . @ @ . @ . @ . . @ @ . . @ @ . @ . @ . . @ @ . . . @ . @ @ . @ . @ . @ . @ 
@ @ @ @ @ . @ . @ . @ @ @ @ . @ . . . @ . @ @ . @ . . . . @ @ . @ @ . @ . @ . @ . @ . . . . . . . @ 
@ @ . @ . . . . . . @ @ @ . . . @ @ . . . . @ @ . @ @ @ . @ @ . @ . . . . . . . . @ . @ . @ @ . @ @ 
@ . . @ @ . @ @ @ . . . . . @ @ . . . @ @ @ . . . @ . @ . @ . . . @ . @ @ @ . @ . . . @ . . . @ @ @ 
@ @ . . . @ . . @ @ . @ @ . . @ @ @ . @ . . . @ . . . . . . @ . @ @ . . . @ . @ . @ . . @ @ . . @ @ 
@ . @ . @ . @ . . . . @ . . @ . . @ . . @ @ @ . @ . @ . @ . . . . @ @ @ @ . @ . @ . @ . . . @ . . @ 
@ . . . . . . . @ . @ . @ . @ . @ . @ . @ . @ . . @ . . . @ . @ . . @ @ . . @ . . . . . @ @ . @ . @ 
@ . @ . @ . @ . @ @ . . . . . . . . . . . . . @ . @ @ . @ @ . @ . @ . . @ . @ . @ . @ . . @ . . @ @ 
@ . . @ @ . . @ . . @ @ . @ . @ . @ . @ . @ . . . @ @ . @ @ @ @ . . . @ . . . @ @ . @ . @ @ . @ @ @ 
@ . @ @ @ . @ . . @ . . @ @ @ . . @ @ . . . @ @ . . @ . . @ . . @ @ . . @ . @ . . @ . . @ . . . @ @ 
@ . . . . @ @ . @ . . @ @ @ @ @ . @ @ @ . @ @ @ . @ . @ @ . @ . @ . . @ . . @ @ . . @ . @ @ . @ . @ 
@ . @ @ @ @ . . . @ . @ @ @ @ @ @ . . . . . @ @ . . . . . . . . . @ . . @ . @ . . @ . . . @ . . . @ 
@ . @ . @ . @ . @ . . . @ @ @ @ @ @ . @ . @ @ . @ . @ . @ @ @ . @ . @ . . . @ . @ . @ . @ . . @ . @ 
@ . @ . . . . . . . @ @ . . @ @ @ @ . . @ @ @ . @ @ . @ . @ . . . . @ . @ . @ . . . . . . . @ . @ @ 
@ . . . @ . @ . @ @ @ @ @ . . . @ . . @ @ @ . . . . . @ . . . @ @ . . @ @ . . @ @ . @ . @ @ @ . @ @ 
@ @ . @ . . . @ @ @ @ @ @ . @ @ @ @ . . @ . @ @ . @ . . @ . @ @ @ . @ @ @ . @ . . @ . . @ @ @ . . @ 
@ . @ @ @ @ @ @ @ @ @ @ . . . . . . . @ . . . . @ . . @ @ @ @ @ . . . @ . . . . @ . . @ . @ @ . @ @ 
@ . @ @ . @ @ @ @ @ @ @ @ . @ . @ . @ . @ . @ @ . @ . @ @ . @ . @ . @ . @ . @ @ . @ . @ . . @ . @ @ 
@ . @ . . . @ @ @ @ @ @ @ @ . . . @ . . . . . . . . . . . . . . . . . . . . . . . . . . . @ @ . @ @ 
@ . . @ @ . . . @ @ @ @ @ . @ @ . @ @ . @ . @ . @ @ . @ . @ . @ . @ . @ . @ . @ . @ . @ @ . . . . @ 
@ @ . @ . @ . @ @ @ @ @ . . . . . . . @ @ . . @ . . . @ . . @ . . @ @ . . @ @ . @ . . . . . @ @ . @ 
@ . . . . . . . @ @ @ . . @ . @ . @ . . @ . @ . @ . @ . . @ . . @ . . . @ . . . . . @ . @ . . . @ @ 
@ @ @ @ . @ . @ . @ . @ . . @ . . . @ @ . . @ . . . @ @ . . @ . . @ . @ . . @ . @ . . @ @ @ @ @ @ @ 
@ . @ @ @ . . . . . . . @ @ @ . @ . . . @ . @ @ . @ @ . @ @ . @ . . @ . @ . . @ . . @ @ . @ . . @ @ 
@ . . @ @ @ @ @ @ @ @ . . . . . @ . @ . . @ . . . . @ . . . . . . @ . . . . @ . @ . . . . . @ . . @ 
@ @ . . @ . . . . . . . @ . @ . @ . . @ @ . . @ @ . . @ . @ . @ . @ @ . @ . . . @ @ . @ . @ . . @ @ 
@ . . @ . . @ . @ . @ . @ @ . . @ @ . . . @ @ @ . . @ . . . @ . . @ @ @ . . @ @ . . . . @ . . @ . @ 
@ @ . @ @ . . @ @ @ . . @ . @ @ . . . @ @ . @ @ @ . . @ . @ @ @ @ . @ @ . @ @ @ . @ . @ @ @ . . . @ 
@ . . . . . @ . @ . @ @ @ . @ . . @ @ @ . . . . . . @ @ @ @ @ . . . . . . . . @ . @ . . . . . @ . @ 
@ . @ . @ . . . . . . @ . . . . @ @ @ @ @ . @ . @ . @ @ . @ @ @ @ . @ @ . @ @ . @ . . @ . @ . . @ @ 
@ @ @ @ . . @ . @ @ . . @ . @ . @ @ @ @ . . . @ . . . . . . @ @ . . @ @ . . @ . . . @ . . . @ . . @ 
@ @ @ @ @ . @ . . . @ @ @ @ . . . @ @ . @ @ . . @ . @ . @ . . . @ @ . . . @ . . @ . . @ @ @ @ . @ @ 
@ @ @ @ . . . @ @ . . . @ @ @ . @ . . . . . . @ @ @ . . @ @ . @ @ @ . @ . . @ . @ @ . @ @ . . . . @ 
@ @ @ @ @ . @ . . . @ . @ @ @ . . @ . @ . @ . . @ . @ . . . @ . @ . @ . . @ . . @ . . @ . @ @ . @ @ 
@ @ @ @ @ @ @ . @ . . @ @ @ @ . @ . . @ @ . . @ . . . . @ . . . . . . @ . . @ . . @ . . . @ . . @ @ 
@ @ @ @ @ @ @ @ . . @ @ @ @ @ @ @ @ @ . . . @ . . @ . @ . . @ . @ . @ @ @ . @ . @ . . @ . . @ . . @ 
@ @ @ @ @ @ @ @ @ @ @ @ @ @ @ @ @ @ @ @ @ . @ . @ . @ @ @ @ @ @ . . . . . @ . . @ . @ . . @ . . @ @ 
@ @ @ @ @ @ @ @ @ @ @ @ @ @ @ @ @ @ @ @ @ @ . . . . . . @ . @ . @ . @ @ . . @ . . @ @ @ . . @ . . @ 
@ @ @ @ @ @ @ @ @ @ @ @ @ @ @ @ @ @ @ @ @ @ @ . @ . @ . . . @ . @ . . . @ . . @ . @ @ @ @ @ . . @ @ 
@ @ @ @ @ @ @ @ @ @ @ @ @ @ @ @ @ @ @ @ @ @ @ @ . . @ . @ @ . . . . @ . . @ . @ . @ @ @ @ @ @ . . @ 
@ @ @ @ @ @ @ @ @ @ @ @ @ @ @ @ @ @ @ @ @ @ @ @ @ @ @ @ @ @ @ @ @ @ @ @ @ @ @ @ @ @ @ @ @ @ @ @ @ @ 
3
10 16 18 34
21 23 32 1
31 31 6 47
