10 10
@ @ @ @ @ @ @ @ @ @ 
@ . . . . . . . @ @ 
@ @ . @ @ @ . @ . @ 
@ . . @ . @ . . . @ 
@ . @ . . . . @ @ @ 
@ . @ @ . @ . . . @ 
@ @ . . . . @ . @ @ 
@ . . @ . @ @ . . @ 
@ . @ . . @ @ @ . @ 
@ @ @ @ @ @ @ @ @ @ 
3
4 4 4 5
2 2 6 3
8 8 6 7
