100 100
@ @ @ @ @ @ @ @ @ @ @ @ @ @ @ @ @ @ @ @ @ @ @ @ @ @ @ @ @ @ @ @ @ @ @ @ @ @ @ @ @ @ @ @ @ @ @ @ @ @ @ @ @ @ @ @ @ @ @ @ @ @ @ @ @ @ @ @ @ @ @ @ @ @ @ @ @ @ @ @ @ @ @ @ @ @ @ @ @ @ @ @ @ @ @ @ @ @ @ @ 
@ @ @ @ @ @ @ @ . . @ @ @ @ @ . @ . @ . . . @ @ . . . @ @ @ @ @ . @ . @ . @ . @ @ @ . @ @ @ @ . . . . . @ @ . @ @ @ @ . @ . . . . . . . @ . . . . @ @ @ . . @ @ . . @ . . @ . @ @ @ . @ . @ . @ . @ @ @ 
@ @ @ @ @ @ @ . . @ . @ @ @ . . . . . . @ @ . . @ @ . @ @ @ . . . . . . . . . @ . . . . . @ @ @ . @ . @ @ . . @ @ @ . . . @ . @ @ . @ @ . @ @ . @ . @ . @ . @ @ . @ . @ . . . . @ . . . . . . . . . . @ 
@ @ @ @ @ @ @ @ . . . . @ . . @ @ . @ . @ . @ . @ . . @ @ @ @ @ . @ @ @ . @ . . @ @ . @ @ . @ @ @ . . @ . @ . . @ @ @ . @ . . @ @ . @ . . . . . . . . . . . . . . . . @ . @ @ . . @ . @ . @ . @ . @ @ @ 
@ @ @ @ @ @ @ @ . @ . @ . @ . @ @ @ . . . . . . . @ . @ . @ . @ @ . . . @ . @ . @ . . @ . . @ . @ @ . @ . . . @ . @ . . . . @ . . @ . @ . @ . @ . @ . @ . @ . @ . @ @ . . . . @ . @ @ . . . @ . . . . @ 
@ @ @ @ @ @ @ . @ . . . . . . . @ @ . @ . @ . @ . . . . . . . . . @ . @ . . . . . @ . @ . @ . . . . . . @ @ . . . . @ . @ . @ . @ . . . . @ . . @ . . . @ @ . . @ @ @ @ @ . @ @ @ . @ @ . @ . @ . @ @ @ 
@ @ @ @ @ @ . . . . @ . @ . @ . @ @ @ @ . @ @ . @ @ @ . @ . @ @ . . . . . @ . @ . . . . . . . @ . @ . @ . . . @ . @ . . . @ . . . . @ @ . @ . @ @ @ . @ @ . @ @ @ @ @ @ . . . @ . . @ @ @ . . . . . . @ 
@ @ @ @ @ @ @ . @ . @ @ . . @ . . . @ . . . @ . @ @ @ @ . @ @ @ @ . @ @ . . @ . . @ @ . @ . @ . . @ . @ @ @ . . @ . @ . @ . @ . @ @ . @ . @ . . . . @ . . . . . . . . @ @ . @ . @ . . @ . @ . @ . @ . @ 
@ @ @ @ @ @ @ . @ . . . @ . @ . @ . . @ . @ . . . @ @ . . . @ @ @ @ @ @ @ @ . @ @ . . @ @ @ . . @ . . . @ . . @ @ . . . @ . . . . . . . @ @ @ . @ . @ . @ . @ . @ . @ @ . . . . . . @ . . @ . @ @ @ . @ 
@ @ @ @ @ @ @ @ . . @ . @ . . @ . . @ @ @ . @ . @ . . @ @ . . @ @ @ @ @ . @ . @ . @ . @ @ @ @ @ . @ . @ . . @ @ @ @ @ . . . @ . @ . @ . . @ @ . @ @ . . . @ . . . @ @ @ . @ @ . @ . . . @ . . . @ @ . @ 
@ @ @ @ @ @ @ @ @ . . @ . . @ @ @ . . @ . . . . . . @ . @ . @ . @ @ @ . . . . . . . . . @ . . . . . . . @ . @ . @ . . . @ . . @ . @ . . @ . @ @ . @ @ . @ @ @ . @ @ @ . @ @ @ @ @ . @ @ . . @ @ . . @ @ 
@ @ @ @ @ @ @ @ @ . @ . @ . @ . @ @ @ @ @ @ @ @ @ . . . . . . . . @ . @ . @ . @ . @ . @ . . @ @ . @ @ . . . . . . . @ . . @ . . . . @ . . . . . . . . . . @ @ . @ @ @ . . . @ @ . . . . . @ . @ . @ . @ 
@ @ @ @ @ @ @ @ @ @ . . . . . . @ . @ . . . . . . . @ @ . @ . @ . . . . . . @ . @ . . . . @ . . . . . @ . @ . @ . @ . . @ . @ . @ @ . @ . @ . @ @ . @ . @ @ . @ . @ . . @ @ . @ . @ . @ . . . . . . . @ 
@ @ @ @ @ @ @ @ @ @ @ . @ . @ . @ . . . @ @ . @ . @ . . . @ . . @ . @ . @ . @ . . . @ . @ @ @ @ . @ @ . @ . . @ . @ @ . . . . @ . . . . . . @ . . . @ @ . @ . . . . @ . @ . . . @ @ @ @ . @ @ @ @ @ . @ 
@ @ @ @ @ @ @ @ @ @ @ @ . . @ . @ . @ . . . @ @ @ @ @ . @ . . @ . @ . . . @ . @ . @ . . . @ . @ @ . . . @ @ . @ @ . . . @ . @ . @ . @ @ . @ @ @ . @ @ @ . . @ @ . @ @ . . @ @ . . @ . . . . . @ . . @ @ 
@ @ @ @ @ @ @ @ @ @ @ @ @ . . @ @ @ . . @ @ . @ . @ . . @ @ @ . . @ @ . @ . . . . . @ . @ . . . . . @ . . . . @ @ . @ . . @ . . @ @ @ @ . . . @ @ @ @ . @ . . . . . @ . @ . @ . @ . @ @ . @ @ @ . @ . @ 
@ @ @ @ @ @ @ @ @ @ @ @ . . @ @ @ @ @ . @ . . @ . . @ . @ @ @ @ . . . . . @ . @ . @ . @ @ @ . @ @ . @ @ . @ . . . @ . . @ . . @ . @ @ . . @ . . . @ . . . . @ . @ . . . . . . . . . . . . . . . . . . @ 
@ @ @ @ @ @ @ @ @ @ @ @ @ . . @ @ @ . @ @ . @ . @ . @ @ . @ @ . . @ . @ @ @ @ . . . . @ @ @ @ @ . @ . . . @ @ @ @ @ @ . . @ . . . . . @ . . @ . @ . @ @ @ . @ @ @ . @ . @ . @ @ . @ . @ @ . @ . @ . @ @ 
@ @ @ @ @ @ @ @ @ @ @ @ @ @ @ @ @ . . . . . . . . . . . . . . . @ . . . . . . @ . @ . . @ @ . . . . . @ . . . . @ @ . . @ @ . @ @ . @ . . @ . . @ . . @ . . . . . @ . . . @ @ @ @ . . @ . @ @ . @ . @ @ 
@ @ @ @ @ @ @ @ @ @ @ @ @ @ @ @ . . @ @ . @ . @ . @ . @ @ . @ . . @ . @ . @ . @ @ . . @ . . @ . @ @ @ . . @ @ @ . @ @ . . . . . @ . . @ . @ @ . @ . @ . @ @ . @ @ . @ . @ @ @ @ . @ . . . . . @ . . . @ 
@ @ @ @ @ @ @ @ @ @ @ @ @ @ @ . . @ . . . @ @ . . . @ . . . . @ . . @ @ @ . . . . @ . . . @ . . @ . . @ . . @ . . . @ @ . @ @ @ . @ @ . . . @ . . . . . . . . . . . @ . . @ . . . . . @ . @ @ @ @ . @ @ 
@ @ @ @ @ @ @ @ @ @ @ @ @ @ . . @ . . @ . . . @ . @ . @ . @ . . @ . . @ @ @ @ . @ @ . @ . . @ . @ @ . . . @ . @ @ . . . . . @ . . @ . @ . @ @ . @ @ . @ . @ . @ . @ . . @ . @ @ @ @ . @ . . . . @ . . @ 
@ @ @ @ @ @ @ @ @ @ @ @ @ . @ @ . . @ . . @ @ . @ . . . . @ . @ @ . @ @ @ . @ . . @ . @ . @ @ @ @ . @ . @ . . . . . @ @ . @ @ @ . . . . . . . @ . @ @ @ . . @ @ . . @ . . . . . . @ . . @ @ @ . @ @ . @ 
@ @ @ @ @ @ @ @ @ @ @ @ . . @ . @ @ . . @ . @ . @ @ . @ . . @ @ . . . @ . . . . @ @ . . @ . @ @ . . @ @ @ . @ . @ @ . . . . . @ . @ . @ . @ . . . . @ . @ . . @ @ . @ @ @ . @ . @ . . @ @ @ @ . . . @ @ 
@ @ @ @ @ @ @ @ @ . @ @ @ . . . . @ @ . @ . . . . . . . @ @ @ . @ . @ . @ . @ . . . @ . . . . . @ . . . @ . . @ . . . @ @ . @ . . @ . . @ @ . @ . @ . . . @ . . @ @ @ . . . . @ @ @ . @ @ @ . . @ . . @ 
@ @ @ @ @ @ @ @ . . . @ . . @ . @ @ @ . . @ . @ . @ . @ . . . . . . . . . @ . . @ @ . . @ . @ @ . @ . @ . @ @ . @ @ . @ . . @ @ . @ . @ . @ . . @ . @ @ . . . @ @ . . . @ . @ . @ @ . . . . @ . . @ . @ 
@ @ @ @ @ @ @ . @ . @ @ @ . @ @ . @ @ . @ @ @ @ @ . . . @ @ . @ @ . @ . @ @ . @ @ . @ . @ . @ . . . . . . . . . @ . . @ . @ . . . @ . . . . @ . . . . . @ . @ . @ @ . @ . . . . . . @ @ . @ @ . @ @ @ @ 
@ @ @ @ @ @ . . . . . . @ . . @ . . . @ @ @ . @ @ @ . @ @ @ @ . . . . @ . . . @ . . . . . @ . @ @ @ . @ @ . @ . . @ . . @ . @ . @ . . @ . @ @ . @ @ . @ . @ @ . . @ . @ @ . @ . @ . . . @ @ . @ . @ . @ 
@ @ @ @ @ @ @ @ @ . @ @ . . @ . @ . @ . @ . . . @ . . . . @ . @ @ . @ . . @ . @ @ @ @ . @ . . @ . @ . . . @ @ @ . . . @ . . . . . @ . . @ . . . . . @ . . . . . @ . @ . . . @ . . @ @ . . @ . @ . . . @ 
@ @ @ @ @ @ . . . . . . @ . . . . . . . . @ . @ @ @ . @ @ . . . . . @ . @ . . . @ @ @ @ @ @ . @ . @ @ . @ . @ @ . @ . . @ . @ @ . . @ @ @ . @ . @ @ . . @ . @ . . . . . @ . @ . @ . @ . @ @ . @ . @ @ @ 
@ @ @ @ . . @ . @ . @ . . . @ @ . @ @ . @ . . . @ @ @ . . . @ . @ . . @ @ @ . @ @ @ @ . . . . . . . . . . . . @ @ @ @ @ @ . . . @ . . . @ @ . . . @ @ @ . @ . . @ . @ . . @ . @ @ . . . . . . . . . . @ 
@ @ @ . @ . . @ @ . @ . @ @ . @ . @ . @ . @ . @ . @ @ @ @ . . @ . . @ . . . . . @ @ @ @ . @ . @ . @ @ . @ . @ @ . @ @ @ . @ . @ @ @ . @ @ . @ . @ @ . . . . . @ . . . @ . . . . . @ @ . @ . @ . @ @ . @ 
@ @ . . . . @ @ . . . @ @ . . . @ . . . . . . . . . . . . . @ . @ . @ @ . @ . @ @ @ @ @ . @ @ . @ . . . @ @ . . . . . . . . . . @ . . . @ . . @ @ @ @ . @ . @ . @ . @ @ . @ . @ . . . @ . . @ @ @ @ @ @ 
@ . @ . @ . @ . @ . @ @ . @ . @ . @ . @ . @ . @ . @ . @ . @ . . . . . @ @ . . @ @ @ @ @ . @ . . . @ . @ @ . @ @ . @ @ @ @ . @ @ . @ . @ . @ . . @ @ @ @ . . @ . @ . @ . . . @ . . @ . . @ . . . . @ @ @ 
@ . . @ . . . . . . . . . . . . . . . . @ @ @ @ @ @ @ . . @ @ @ @ . @ @ . @ . . @ @ @ @ . @ . @ . . . @ . . . . @ . . . . . @ . . . . @ . . . @ . . @ . . @ . . . . @ . @ @ @ @ . . @ @ @ . @ . @ @ @ @ 
@ @ . . . @ . @ @ @ . @ . @ . @ . @ . @ @ @ @ @ @ @ @ @ @ . . . @ . . . . @ . @ @ @ @ . . @ . . @ @ . . . @ @ @ @ @ . @ . @ . . @ . @ . . @ . . @ . . @ @ . . @ . @ . . @ @ @ @ . @ . . . . @ . . . @ @ 
@ @ @ @ . . @ . . . . . @ . . @ @ @ . . . . @ @ @ @ @ . @ @ @ . @ . @ . @ @ @ @ . . @ @ @ . . @ . @ . @ . . . . . @ @ . . @ @ @ . . @ @ @ . @ . @ . @ . . @ @ @ . @ @ . . @ @ @ @ . . @ @ . @ @ . @ . @ 
@ @ @ @ @ @ . @ . @ . @ . @ . @ . @ . @ . @ @ . @ @ . . . . . . @ . . @ . @ . . @ . @ @ . @ . @ . @ . . @ @ . @ . @ @ @ . . @ . . @ . @ . . @ . @ . . . @ . . . . @ . @ @ @ @ . . . @ . . . @ . . . . @ 
@ @ @ @ @ @ . . . @ @ @ . . @ . . . . . @ . @ . . @ . @ . @ @ . @ @ @ . . . . @ . . . . . . . @ . . . @ . . @ @ . . @ @ . @ . @ @ @ . . @ . @ . . . @ @ . @ @ @ . . . @ . @ @ @ @ . @ . @ . @ @ . @ . @ 
@ @ @ @ @ @ @ . @ @ @ . @ . . @ @ @ . @ . . @ . @ . @ @ @ . . . . . . @ . @ . . . @ . @ . @ . @ @ @ . @ @ . @ @ . @ . . . . . . @ . @ . . . . . @ @ . . . . . . . @ . . . . . . @ . @ @ . . . . @ . . @ 
@ @ @ . @ @ @ . . @ @ . . . @ @ @ . . . . @ . . . . . @ @ @ @ . @ . @ . . . @ . @ . . @ @ . . . @ . . . . . . . @ @ @ @ . @ . @ . . . . @ . @ . . . . @ . @ . @ . . @ . @ . @ . . @ . . . @ . @ @ @ . @ 
@ @ . . . @ . . @ . . . @ @ . @ @ @ . @ . . @ . @ @ . . @ @ @ @ . . . . @ @ . @ . . @ . . . @ @ @ @ . @ . @ . @ @ @ . . . . @ . . @ . @ . . . @ . @ . @ . . @ . . @ @ . . @ . @ @ . . @ . @ . @ @ . . @ 
@ @ . @ . . @ . @ . @ . . . . . . . . . @ . . @ @ @ . @ . @ @ . @ @ @ @ @ . . . . @ . . @ . @ . . . . . @ . . . @ . . @ . @ . @ @ @ @ @ @ . @ . @ . . @ . @ . @ . . . @ . . . . @ . @ . . @ . @ @ @ @ @ 
@ . . @ @ . . . . @ @ . @ @ @ @ . @ . @ . @ . . @ . . . . . . . . . . . . . @ @ @ . @ @ @ @ . @ @ . @ @ . @ . @ @ @ @ . . . . . @ @ . @ . . @ . . . @ . . . . @ . @ @ @ @ . @ @ . @ . @ . @ . . @ @ @ @ 
@ @ . @ @ @ . @ . @ . @ @ @ . @ . . @ . . . @ @ @ @ . @ . @ . @ . @ . @ . @ . . . . . . . . . . . . . @ . . . @ @ @ . . @ @ @ . @ . . . . @ . . @ . @ @ @ @ . . @ @ . @ @ . . @ . . . @ . @ . @ . @ @ @ 
@ . @ . @ . @ . . @ . . @ . . . . @ @ @ . @ @ . @ . . @ @ . . @ . @ @ @ @ @ @ @ . @ . @ . @ . @ @ . @ @ . @ . . . . @ . @ @ @ . @ @ . @ . @ . @ . . . @ . . . @ @ . . . . . @ @ @ . @ @ @ @ @ . . . @ @ 
@ . . . . . . . @ @ @ . . . @ . @ @ @ . . . . . . . @ . . . @ @ @ . . . . @ . @ . . @ . . @ @ . . . @ . . @ . @ . @ @ . @ @ . . @ . . @ @ . @ . @ @ @ . . @ . . . @ @ . @ . . . @ . @ @ . @ . @ . @ . @ 
@ @ @ . @ . @ @ . . . @ @ . @ @ . . . . @ . @ . @ . . @ @ . @ @ . @ @ @ . . . . . @ @ @ @ . . . @ . . @ . @ . . @ . . . . . @ . . @ . @ . . @ . . @ . . @ . . @ . . . @ . . @ . . . . . . . . . . . . @ 
@ @ @ @ . . . @ . @ . . . . . . @ @ @ . @ @ . . @ . @ . . @ @ . . . . . . @ . @ . @ @ . . . @ . @ . @ @ @ . . @ . . @ . @ . @ . @ . @ @ @ . . . @ @ @ . @ @ . . @ . @ . @ . @ . @ . @ @ @ @ . @ . @ . @ 
@ @ @ @ @ @ @ . . @ @ . @ . @ . . . . @ . . . @ . . . @ . @ @ @ . @ . @ . @ . @ @ . . . @ @ . . . @ @ @ . @ . @ @ @ . . . @ . . . . . @ . @ . @ @ @ @ @ . @ . @ @ @ . . . . . @ @ . @ . . . . @ . . @ @ 
@ @ @ @ @ @ @ @ @ . . @ . . . @ . @ @ . @ @ . @ . @ . . . . @ . @ . . @ @ @ . @ @ . @ . . . @ . @ . @ . . . . . . . @ . @ @ @ . @ . @ . . . . . @ @ @ . . @ @ @ @ . . @ . @ . . . @ . . @ . @ @ . @ @ @ 
@ @ @ @ @ @ @ @ . . @ @ @ . @ @ @ . @ . @ . @ @ @ . . @ . @ . . . @ @ . . . . @ @ @ . . @ @ @ . . . . @ . @ . @ . @ . . . @ @ @ . @ . . @ @ @ . . . @ @ . @ . @ . @ . . @ . . @ . . @ . @ . @ . . . @ @ 
@ @ @ @ @ . @ . . @ . @ @ . . @ . . . . @ . @ @ . @ . . @ @ . @ . @ . @ @ . @ . @ . @ . . @ @ @ . @ . . @ . . . @ . @ . @ . @ @ . . @ @ @ @ . . @ . . . . . . . . . @ . @ @ @ . @ . . @ . . . @ . @ @ @ 
@ @ @ @ . . . . @ . . @ . @ @ @ @ . @ . . . . . . . . @ . @ @ @ . . . . . @ . . . . . . @ . . . . @ . @ . @ . @ @ . . . . . . . @ . @ . @ @ . @ . @ . @ . @ . @ . @ . . . @ @ . . . @ @ @ . @ @ @ @ @ @ 
@ . @ . @ . @ @ . @ . . . . . . . . . @ . @ . @ @ . @ . . . . @ . @ . @ . . @ . @ @ @ . . @ @ . @ . . @ . . . . . @ @ . @ . @ . @ . @ . . . . . . @ @ . @ @ . . @ . @ . @ @ @ . @ @ @ @ @ @ @ @ @ @ @ @ 
@ . . . . . . . . . @ . @ . @ . @ . @ . @ . @ . . . . . @ @ @ . . . @ @ . @ @ @ . . . . @ . @ . . @ @ @ @ . @ . @ @ @ @ @ @ . . . . . . @ . @ . @ @ @ . @ @ @ @ @ . @ @ @ @ @ @ @ @ @ @ . @ @ @ . @ @ @ 
@ @ . @ @ @ @ @ @ . . . . @ @ @ . @ . . . . . . @ . @ . . @ . @ . @ . . @ @ @ . @ . @ . . . @ . @ . . . . . @ @ . @ . . @ . . @ . @ @ . @ . . @ . @ . . . @ @ @ . . @ . . @ @ . . . @ . . . @ . . . @ @ 
@ @ @ . . . . . . . @ . @ @ @ . . . . @ . @ . @ . . . @ . @ . . . . . @ @ @ . . . . @ @ . @ @ @ @ @ . @ @ . . . . . . @ @ @ . @ . . . @ . @ @ @ . @ . @ @ . @ . @ . . . @ @ . @ . @ . @ . @ . @ @ . . @ 
@ @ @ @ . @ . @ . @ . . . @ . @ . @ . . @ . . . @ . @ . @ @ . @ @ @ . @ . @ @ . @ . @ . . @ . . @ . @ . . . @ . @ @ . . @ . . @ . @ . . . . . . . . . . . . . . . @ @ . . . . . . . . . . . . . @ . @ @ 
@ @ . . . . @ . . . @ . @ . . . @ . . @ @ @ . @ @ . @ . . . @ . . . . . . @ . @ . . . @ . . . @ . . . @ . @ . . . @ . @ @ @ . @ . . @ . @ @ . @ . @ . @ . @ . @ @ @ @ . @ @ @ . @ . @ @ . @ @ . . . . @ 
@ @ @ @ . @ @ @ . @ . . @ @ . @ . @ . . @ . . @ @ . @ . @ . @ . @ . @ @ . . . . . @ . @ . @ @ . . @ . . . @ @ . @ @ @ @ @ . . . @ . . @ @ . . . @ @ . . @ . . @ @ @ . . . . @ @ @ . . . @ . @ . @ . @ @ 
@ @ . . . @ @ . @ . . @ . . . . . @ . @ @ . @ @ @ . @ @ . . . . . @ @ @ @ @ . @ . @ . . @ . @ @ . . @ @ . . . @ . @ . @ . @ . @ . . @ @ . @ @ . . . @ @ @ @ @ @ @ @ . @ @ . . @ . . @ . . . . @ @ . . @ 
@ @ . @ . @ . . . . @ . . @ . @ . . . @ . @ . . . . . . @ . @ . @ . @ @ . . @ . . . @ . . . . . @ @ . @ @ @ . @ . . . . . . . . @ . . . . . . @ . @ . @ @ . @ . @ . . . . @ . . @ . . @ @ . @ . @ . @ @ 
@ @ . @ @ . . @ . @ . @ . . @ . @ @ @ . . . . @ . @ . @ . @ . . . . . . . @ @ @ . @ . . @ . @ . @ . . . . @ . . @ @ . @ . @ . @ . @ @ . @ . @ @ @ . . . . . . . . @ . @ . @ @ @ @ . @ . @ . . . . @ . @ 
@ @ @ . . . @ . @ . . . . @ @ . . . . . @ . @ . . . @ . . . @ @ . @ . @ . @ @ . . . @ @ . @ . . @ . @ @ . . . @ . @ @ . . . @ . . @ . . . @ . @ . @ . @ . @ . @ . . . . @ . . . . . . . . @ . @ . . . @ 
@ @ @ . @ @ . . . @ . @ . . . @ @ . @ . @ . . @ @ . . @ @ . . . . @ @ . @ . @ . @ . . . . @ @ . @ . @ @ . @ . @ . @ @ @ @ . @ . @ . @ . @ . . . . . . @ @ @ @ @ @ . @ . . @ . @ @ . @ . @ . . . @ . @ @ 
@ @ @ . @ @ @ @ . @ @ @ . @ @ . . . . @ @ . @ . . . @ @ @ @ . @ . . @ . @ . @ . @ . @ . @ @ . . @ . @ @ @ . . . . . @ . . . . . @ . . . . @ @ . @ @ . @ @ @ @ @ @ @ . . @ . . @ . . . @ . @ . @ @ @ . @ 
@ . . . . @ @ . . . . @ . @ . @ . @ @ . @ . . @ @ @ @ @ @ . . . @ . . . . . @ @ . . @ . . . @ . @ @ . @ . @ . @ . @ . @ @ . @ . @ . @ . @ . @ @ . . . . . @ @ @ @ @ @ . @ . @ . @ . @ @ . @ . @ @ @ . @ 
@ . @ . @ . . . @ . @ . . . . . @ . . . . . @ @ @ @ @ @ @ @ . @ @ @ . @ . @ @ @ @ . @ . @ . @ . . @ . . . . . @ . @ . @ . . . @ . @ . . . . . . @ @ . @ @ @ @ @ @ @ @ @ @ . @ . . . . . . . @ @ @ . . @ 
@ @ . @ . @ . @ . . . . @ . @ @ . . @ . @ . . . @ @ @ @ @ . . . @ . . . @ @ @ @ @ . . @ @ . @ . @ @ @ . @ . @ . . . . . @ . @ . . @ . @ . @ . @ . @ . . . @ @ @ @ @ @ @ @ @ . . @ . @ . @ . @ @ . @ . @ 
@ . . @ . . @ @ . @ @ . . @ . @ @ . . @ . . @ . . @ @ @ @ @ . @ @ @ . @ @ @ @ @ @ @ . . . @ @ . . @ . @ . . . @ . @ . @ . . . . @ . . @ . . @ @ . @ . @ @ . @ . @ @ @ @ @ @ @ . . @ @ @ . . . . . . . @ 
@ @ . . @ . @ @ @ @ . @ @ . . . . . @ . @ . . @ @ . . @ @ @ @ @ @ @ @ . . @ @ @ @ . . @ . . . @ . . . @ @ . @ @ . @ @ @ @ . @ . . @ . @ . @ . . . . . @ . . . . . @ @ @ @ @ @ @ @ @ @ @ . @ . @ . @ . @ 
@ . @ . . . . @ . . . . . . @ @ @ . . . @ @ . . . @ . @ @ @ @ @ . . @ @ . @ @ @ . @ . . @ . @ . . @ . . . @ @ @ . . . . @ . . @ @ . . . @ . @ . @ . @ @ @ . @ . @ @ @ @ @ @ @ @ @ @ @ . . @ . . @ . . @ 
@ . @ . @ . @ . . @ . @ . @ . . . . @ @ @ @ . @ . . . . @ @ @ . @ . @ . . . @ . . . . @ . . . @ . . @ . @ @ . . @ . @ . @ . @ @ @ @ . @ . . . . @ . @ @ . . @ . @ @ @ . @ @ @ @ . @ . @ . @ . @ @ @ @ @ 
@ . . . @ @ . @ @ . . @ . @ @ . @ . @ . @ . @ . . @ . @ @ @ . . . . . . @ @ . @ . @ . @ @ . @ @ @ @ . @ @ . . @ . . @ . @ . . . @ . . . @ @ . @ . @ @ @ @ . @ @ . . @ . . @ @ . . . . . . @ . . . . . @ 
@ @ @ . . . . . . . @ . . . @ @ . . . . @ . . . @ . . @ . . @ . @ . @ . . . . @ . . @ . . . . @ @ @ . @ . @ . @ @ . . @ @ @ . @ . . @ . . . . . . . . @ . . . . . @ . @ . . @ . @ @ . @ . . @ . @ . @ @ 
@ . . @ . @ . @ @ @ . . @ @ . @ . @ . @ @ @ @ . . @ @ . @ . . . . @ @ @ . @ . . . @ . @ @ . @ @ @ . . . . . . . . . @ @ @ . . . @ . . @ . @ @ . @ . @ . . @ @ @ . . . . . @ . @ . . . . @ . @ @ . . . @ 
@ @ . . @ . @ . . . . @ @ . . . . @ . . @ . . . @ @ . . . . @ . @ . . . . . @ . @ . . @ . @ . @ . . @ . @ . @ . @ . . . . @ . @ @ . @ . . . . @ . . . @ . . . . @ @ @ @ . . . . . @ . @ @ @ @ @ @ . @ @ 
@ @ . @ . . . @ . @ . @ . . @ @ . @ . @ . @ . @ @ @ @ . @ @ . @ . @ . @ . @ @ @ @ . @ . . . . . . @ @ @ . . . @ . . @ . @ @ . @ . @ . @ . @ . @ @ . @ . . @ . @ @ @ @ . @ . @ . @ . . . . . . @ . @ . @ 
@ . . . @ . @ . @ . . @ @ . . . @ @ @ . . @ . . @ @ @ @ . . . . . . . . @ . @ . . . @ @ @ @ . @ . @ . . @ . @ @ @ . . @ @ . . @ . . . . . . @ @ @ @ . @ . @ . @ @ . . . @ @ . . @ @ . @ . @ . @ . @ . @ 
@ @ @ . . . . . . @ . . . @ @ . . @ . @ . . . @ . @ @ @ @ @ . @ . @ . @ @ . @ . @ @ . . @ @ @ . . @ . @ . . @ @ . . @ @ @ @ @ . . @ . @ . @ . @ @ . . . . . @ @ @ @ @ . @ . @ . @ @ . @ . @ . . . . . @ 
@ . @ . @ . @ . @ @ @ @ . @ @ . @ . . . . @ . . . . @ . . . @ . @ . . . . . . . . @ @ . @ . . @ . @ . . . @ . . . @ . @ @ . . @ . . @ . . . . . . @ . @ . @ @ @ @ . . . . . . @ . . . . @ @ . @ . @ @ @ 
@ . . @ @ @ . . . @ @ @ . @ @ @ . @ . @ @ . . @ . @ @ @ @ . . . . . @ . @ . @ . @ . @ . . @ . . @ @ @ . @ @ . @ . . . . . . @ . . @ . @ . @ @ @ @ @ @ @ @ @ @ @ @ @ . @ . @ . . . @ . @ . @ . . @ . @ @ 
@ @ . . @ . @ . @ . @ . . . . @ . . . @ @ @ . @ . . . . @ @ @ . @ . @ . @ . . @ @ . @ . @ . . @ @ @ @ . @ @ @ . . @ @ . @ @ . . @ . . . . @ @ . @ . @ @ . @ @ @ @ @ @ @ . @ @ . @ . . . . . @ . . . @ @ 
@ . . @ . . . . . . @ @ . @ . . @ . @ . . . . @ . @ @ @ @ . @ @ . . @ . . @ . . . . @ . @ @ . @ . @ . @ . . . . @ . . @ @ . @ . . @ . @ . @ . . @ . . . . @ @ @ @ @ . @ . @ @ @ . . @ . @ . . @ @ . @ @ 
@ @ . . . @ @ . @ . . . . @ @ @ @ @ . . @ @ @ . @ . . @ . . . @ @ . @ . @ . @ . @ . @ . . . . . . . . @ @ . @ . . . @ . . . . . @ . . @ @ . @ . . . @ @ @ . @ @ . @ . . @ @ @ @ @ . @ . @ . @ . . . . @ 
@ . . @ @ . . . . @ . @ . @ @ . @ . @ . . . . . @ @ . . @ @ . . . . @ . . . @ @ @ @ . . @ . @ . @ @ . . . . . @ . @ . @ . @ @ . . @ . . . . . @ . @ @ . @ . @ . . . . @ . . . . . . @ . . @ @ @ . @ . @ 
@ . @ @ @ @ @ . @ @ @ . . . . . @ . @ . @ . @ @ . . . @ . @ @ . @ . . @ . @ . @ @ . . @ @ @ @ @ @ @ @ . @ . @ @ @ @ . . . . @ . @ . . @ . @ . . . . . . . . . . @ . @ . @ . @ . @ . @ . @ @ @ @ . . @ @ 
@ . @ @ @ @ @ @ @ @ @ @ . @ . @ . . . . . @ . . . @ . . . @ @ . @ . @ . . . . . . @ . @ @ . . . . . . . @ @ . @ . @ @ . @ . . @ @ @ . @ @ @ . @ . @ . @ . @ . @ . . . . . @ @ @ . . @ . @ @ @ @ . @ @ @ 
@ . @ @ @ @ @ @ @ @ @ @ @ @ @ . @ . @ . @ @ @ @ @ . . @ . . @ @ @ @ @ @ . @ . @ . @ . @ . @ @ . @ . @ . . . . . . @ . . @ . @ @ . . . . . . @ . . . @ . . . @ . @ . @ . @ @ @ @ @ . @ . . @ . . @ . . @ 
@ @ @ @ @ @ @ @ @ @ @ @ @ @ @ . . . @ @ @ @ @ . . @ . @ . @ . . . @ @ . . @ . @ . @ @ @ . @ @ @ . @ . . @ . @ @ @ . @ . @ @ . @ @ @ . @ . @ . @ . @ . @ . @ . . @ . . @ @ @ @ @ . . @ @ . . . @ . @ . @ 
@ @ @ @ @ @ @ @ @ @ @ @ @ @ . . @ . @ @ @ @ @ @ . @ . . @ @ @ . @ . @ @ @ . . . @ . . . . . . . . . . @ . . . . @ . . @ . . . . . . . . @ . . . . . . . @ . . @ . . @ @ @ @ @ @ @ @ . . . @ . . . . . @ 
@ @ @ @ @ @ @ @ @ @ @ @ . . . @ . . . @ @ @ . . . . . @ . . . . . . . @ @ . @ . . @ @ . @ . @ . @ . @ @ @ . @ . . @ . . . @ . @ . @ . @ @ @ . @ . @ @ . . . @ . @ @ . @ @ . @ @ @ @ @ . @ . . @ . @ @ @ 
@ @ @ @ @ @ @ @ @ @ . . . @ . . @ . @ @ . . @ . @ @ . . @ @ . @ . @ . @ @ . . @ . . . @ . . . @ . . . @ . . @ . @ @ @ . @ . . . @ @ . . @ . . . @ . . . @ . . . . . . . . . . @ @ @ @ . @ . @ . . . . @ 
@ @ @ @ @ @ @ @ @ @ . @ @ . . @ @ . @ @ . @ . @ . . . @ @ . . . @ @ @ . . . @ . . @ @ . @ . @ @ @ . @ @ @ . . @ @ @ . @ @ @ . @ @ . . @ . . @ @ @ . @ . . @ . @ @ . @ . @ . @ . @ @ @ @ . . . @ @ . @ @ 
@ @ @ @ @ @ @ @ @ @ . . @ @ . @ @ . . . . . . . @ @ . . @ . @ @ . @ @ . @ . . @ . @ . . @ . . @ . . . @ . . @ . @ . . . @ . @ . @ @ . @ @ . @ . . @ @ . @ . . . . @ @ @ @ . . . . . @ @ @ . @ . . . . @ 
@ @ @ @ @ @ @ @ @ @ @ . @ @ @ . . . @ . @ . @ . . @ . @ . . . . . . @ . @ . @ . . @ @ . . . @ @ @ . @ @ @ . . . . @ . @ . . . . . . @ . . . @ . @ @ . @ . @ . @ . . @ . @ . @ . @ . . . @ @ . . @ . @ @ 
@ @ @ @ @ @ @ @ @ @ @ @ . @ . @ @ . . @ . . . @ . . . . . @ @ . @ . . @ . . . @ @ @ @ . @ . @ @ . . @ . @ @ @ . @ . . . . @ @ @ . @ . @ @ . @ . . . . . . . . @ @ . . . . @ . . . @ . @ . . . @ . . . @ 
@ @ @ @ @ @ @ @ @ @ @ . . . . . . . @ @ @ . @ . . @ . @ . . @ @ . . @ @ @ . @ @ @ @ @ @ . . . . @ . . . . @ . . . . @ . @ @ @ @ @ . . . . . @ . @ . @ @ . @ . @ . . @ . @ @ @ . @ . . . @ @ . . @ . @ @ 
@ @ @ @ @ @ @ @ @ @ @ @ @ @ @ @ @ @ @ @ @ @ @ @ @ @ @ @ @ @ @ @ @ @ @ @ @ @ @ @ @ @ @ @ @ @ @ @ @ @ @ @ @ @ @ @ @ @ @ @ @ @ @ @ @ @ @ @ @ @ @ @ @ @ @ @ @ @ @ @ @ @ @ @ @ @ @ @ @ @ @ @ @ @ @ @ @ @ @ @ 
3
46 3 11 42
67 52 87 85
15 70 53 32
