50 50
@ @ @ @ @ @ @ @ @ @ @ @ @ @ @ @ @ @ @ @ @ @ @ @ @ @ @ @ @ @ @ @ @ @ @ @ @ @ @ @ @ @ @ @ @ @ @ @ @ @ 
@ . . . . . . . @ . @ . @ . . @ @ @ @ . @ @ . @ . . . . @ . . @ @ @ . . . . @ . . . @ @ @ @ . . @ @ 
@ @ . @ @ . @ . . . . . . @ . @ . @ . . . @ . . @ . @ @ . @ . @ @ @ . @ . @ . @ . @ . @ @ @ @ . . @ 
@ . . @ . @ @ @ . @ . @ . . . . . . @ @ . @ . @ . . . . . . . . @ @ . . @ . . . . . . . @ . . . @ @ 
@ . @ @ . . . @ @ @ @ @ @ . @ . @ . . . . @ . . . @ @ @ . @ . @ . . . @ @ @ . @ . @ . @ . . @ @ @ @ 
@ . @ . @ @ . . @ . @ . . @ . @ . @ . @ . . . @ . . . @ . . @ @ . @ . . @ @ @ . @ . . . . @ . . @ @ 
@ . . . @ . . @ . . @ @ . . . @ . @ . . @ . @ . . @ . . @ @ @ . @ . @ . . @ @ . @ . @ . @ . . @ @ @ 
@ @ . @ . @ . . . @ . . @ @ . . . . @ @ @ @ . @ . @ . @ @ . . . . . . . @ . . . . @ . . . . @ . @ @ 
@ . . @ . . . @ @ @ @ . @ . @ @ . @ . @ @ . . . . . @ . . . @ . @ . @ . . @ @ . @ . @ . @ @ . . . @ 
@ . @ . . @ . @ . . @ . . . . . . . . . . . @ . @ . @ . @ . . @ . . . @ . . . . . . . . . . . @ @ @ 
@ @ . @ . . @ . . @ . . @ . @ . @ . @ . @ . @ @ . . . @ . . @ . . @ . @ @ @ . @ @ . @ . @ . @ @ . @ 
@ . . . . @ . @ . @ . @ . . @ . @ . . @ . . . @ . @ . . @ . . @ . @ . @ . @ @ . . . @ @ . . . @ . @ 
@ @ . @ . . . . . . . @ @ . @ . . @ @ . @ . @ @ @ . @ . @ @ @ . @ . @ . . . . . @ . . @ . @ . . . @ 
@ . . . @ . @ . @ @ . . @ @ . . @ @ @ . @ . @ . . . . . . . . . @ . . @ . @ @ . @ . @ @ @ . @ . @ @ 
@ . @ @ @ @ . . @ . @ @ . @ @ . @ @ . . . @ . . @ . @ @ @ @ . @ . @ . . . @ @ @ . . . . . . @ . . @ 
@ @ @ @ @ @ . @ . . . . . . . . . . @ . @ @ @ . @ . . @ @ @ . . . . . @ . . @ @ @ . @ . @ @ . . @ @ 
@ @ @ @ . . . @ @ @ . @ . @ . @ . @ . . . . . @ . . @ . @ . @ . @ . @ . . @ . @ . @ . . . . @ . @ @ 
@ @ @ . . @ . @ . @ . . @ . . @ . @ . @ . @ . . @ @ . . . . . . @ . @ . @ @ . . . . @ . @ @ . . . @ 
@ @ @ @ . @ @ . . . . @ . @ . @ . @ . . @ @ @ . @ . @ . @ . @ . . @ . . . . @ . @ . . . . . @ . @ @ 
@ @ @ . . . @ . @ @ @ . . . . @ . @ . @ @ @ @ . @ . @ . . @ . . @ . @ . @ . @ @ . . @ . @ . @ . @ @ 
@ @ @ . @ @ . . . . @ @ . @ . @ . . . . . @ @ @ . . . . @ @ . @ . . . . . @ . . . @ @ @ . . . @ @ @ 
@ @ @ . . . @ . @ @ . . . @ @ . . @ @ @ . . @ . @ @ @ . @ . . . @ . @ . @ . . @ . . @ @ . @ . . @ @ 
@ @ . @ @ @ . @ . . . @ . . . @ @ . . . . @ . . . @ . @ . @ . @ @ @ . . @ @ . @ . @ @ . . @ . @ . @ 
@ @ . . . . . . . @ . @ . @ . @ @ @ . @ . . @ @ . . . @ . . @ . @ . @ @ @ . . @ . . . @ . @ . . . @ 
@ . . @ . @ . @ . . @ . . . @ . . @ @ @ . @ @ . @ @ . . . @ . . . . @ . @ @ . . @ . @ . . @ . @ . @ 
@ @ . . @ . . @ . @ @ @ . @ . . @ . . @ @ @ @ . @ . @ @ . . @ @ @ . . . @ . . @ . . @ . @ @ . @ . @ 
@ . . @ @ . @ . . . @ @ @ . @ . . . @ @ @ @ . . . . . . . @ . @ . . @ . . @ . @ @ . @ . . @ . @ . @ 
@ @ . . . @ @ @ @ @ . @ @ . . . @ @ . . @ . . @ . @ . @ . . . . @ @ . @ . @ . @ . . @ . @ . . . @ @ 
@ . @ @ @ . @ . . . . . . . @ . @ @ . @ . @ . . @ . . . @ . @ . . . . . . . . @ @ . @ . . @ . @ @ @ 
@ . . . . . . . @ . @ @ . @ . . . . . . . . . @ . . @ @ . @ . . @ . @ @ @ . @ . @ . @ . @ . . . . @ 
@ . @ . @ . @ . @ @ . . @ . . @ . @ . @ @ @ . @ . @ . . . @ @ . . @ . . . . . . . @ . . . @ @ . @ @ 
@ . . @ . . @ @ @ @ @ . @ . @ . . @ @ . . . . . @ . @ . @ . @ . @ @ @ . @ . @ @ @ . @ . @ @ . @ . @ 
@ . @ . @ . . . . @ . . . . @ . @ . @ @ . @ . @ . . . . . . . . @ . @ @ . . . @ . . . . @ @ . @ . @ 
@ @ . . . @ . @ @ @ @ . @ @ . . . . . . @ . . . @ . @ . @ . @ . . . . @ . @ . . @ . @ . . . . . . @ 
@ . . @ @ @ @ @ . @ . @ @ . @ @ . @ . @ . @ . @ @ @ @ @ . . @ . @ . @ . . @ . @ . @ . . @ . @ . @ @ 
@ . @ . . @ . . . . . . . . . . . @ . @ . . @ . @ . . @ @ @ . . @ @ . @ . @ @ @ . @ @ . . @ @ . . @ 
@ . . . @ . . @ . @ . @ . @ . @ . . @ . @ . . . . @ . @ . . . @ . . . . . @ @ . . . . . @ . @ . @ @ 
@ . @ . @ @ . . @ . . @ @ . . . @ @ . . @ @ . @ . . . @ @ . @ . . @ . @ @ . . . @ . @ . . . . @ @ @ 
@ @ . . . . . @ @ @ . . @ @ . @ . @ . @ . @ @ . @ @ . @ @ @ . . @ . . . . @ @ . @ @ @ . @ . @ @ @ @ 
@ . . @ . @ . @ @ . @ @ . . . . . . . . . . . . @ . . . @ . . @ . . @ . @ . @ @ . . . . . @ @ @ @ @ 
@ . @ . . @ @ . . . . . . @ . @ . @ . @ . @ . @ . . @ . @ @ . @ . @ @ . . . . . @ . @ . @ @ @ @ @ @ 
@ . @ @ . @ @ . @ @ @ . @ . . @ . @ . @ . . @ . @ . . @ @ @ @ . . . @ @ . @ @ . . @ @ @ @ @ @ @ @ @ 
@ . @ . @ . . . . . . @ . @ . . @ . @ . @ @ @ . . . @ . @ @ @ @ . @ . . . . . @ . @ . @ . @ . @ . @ 
@ @ @ . @ @ . @ @ . @ @ . . . @ @ . . . . . . @ @ . . . . @ . @ . . @ . @ . @ . . . . . . . . . . @ 
@ . . . . . . . @ . @ @ @ . @ . @ . @ . @ @ . @ . @ @ . @ . . . @ . @ . . @ . @ . @ . @ . @ . @ @ @ 
@ @ . @ . @ @ @ @ @ @ @ @ . @ . @ @ . . . @ . . . . . . . @ . @ . . @ . @ . . @ . . @ . . @ . @ @ @ 
@ @ @ . . . . @ @ @ @ . . . . . . @ @ . @ @ . @ @ @ @ @ . . . . . @ @ @ @ . @ . . @ @ @ . . @ @ @ @ 
@ @ @ @ . @ . . @ @ @ @ @ . @ . @ @ . @ . @ @ @ . . . . . @ . @ . . @ @ . . . . @ @ @ . . @ @ @ @ @ 
@ @ @ @ . . @ @ @ @ @ @ . . @ . . . . . . . . . @ . @ @ . . @ @ . @ @ @ @ . @ . . . . @ . @ @ @ @ @ 
@ @ @ @ @ @ @ @ @ @ @ @ @ @ @ @ @ @ @ @ @ @ @ @ @ @ @ @ @ @ @ @ @ @ @ @ @ @ @ @ @ @ @ @ @ @ @ @ @ @ 
3
1 36 14 43
6 36 33 45
30 16 19 31
