50 50
@ @ @ @ @ @ @ @ @ @ @ @ @ @ @ @ @ @ @ @ @ @ @ @ @ @ @ @ @ @ @ @ @ @ @ @ @ @ @ @ @ @ @ @ @ @ @ @ @ @ 
@ @ @ @ @ . . . . . . @ . @ @ . @ . . . @ @ . . @ . @ . @ @ . @ . . . @ @ @ @ @ @ @ . @ @ @ . @ @ @ 
@ @ @ @ . @ . @ . @ @ @ . @ . . . . @ . . . @ . . . . . . . . . . @ @ @ @ @ @ . @ . . . @ . . . @ @ 
@ @ @ . . @ @ . . . @ . . . @ @ . @ . @ . @ @ @ @ . @ @ . @ . @ @ @ . @ @ . . . . @ . @ . @ . @ . @ 
@ @ . @ . @ . @ . @ . @ . @ . @ @ . . . . . . @ . . @ @ @ @ . @ . . . . @ . @ . @ @ . @ . @ . . . @ 
@ . . . . . . . . . . . . . . @ @ @ . @ . @ @ . @ . @ . . @ @ @ . @ . @ . @ . . . . . . . . . @ . @ 
@ @ . @ . @ . @ @ @ . @ . @ . . @ @ @ @ . . @ . @ . . @ . @ . . . @ @ @ . @ . @ . @ @ . @ @ @ . . @ 
@ @ . @ @ @ . . @ @ @ . . . @ . . . . @ . @ @ . @ @ . @ . @ @ @ . . . . . . . . @ @ @ @ . @ @ . @ @ 
@ . @ . . . . @ . @ . @ . @ . @ . @ . . . . . . . . . . . @ . . . @ @ . @ @ @ . . @ . . . . . @ @ @ 
@ . . . @ . @ . . . . . . . . . @ . . @ @ . @ . @ . @ . @ @ . @ @ . @ @ . . . @ @ . . @ @ . @ . @ @ 
@ @ @ . @ @ @ @ . @ . @ . @ . @ . @ . . . @ . . . @ . . . . . . . . . @ . @ @ . @ . @ . @ . . . . @ 
@ . . . @ @ . . . @ @ . . . @ @ . . . @ @ @ @ . @ . @ @ . @ . @ . @ . . . . . . . . . . @ @ . @ . @ 
@ . @ @ . . . @ . @ . @ . @ . @ @ . @ @ @ @ @ . . . . . @ . . . @ . . @ @ . @ . @ @ . @ @ @ @ . . @ 
@ . @ . @ . @ @ @ . . . . . . . @ @ . @ @ @ @ . @ @ . @ . @ . @ @ @ . . . @ @ @ @ . . . @ @ @ @ @ @ 
@ @ . . . . @ . . @ @ @ . @ @ . . . . . @ @ @ . @ @ . . . @ . . @ . . @ @ . @ @ . @ . @ @ @ @ @ @ @ 
@ . @ . @ . . . @ @ @ . . . . @ . @ . @ . . @ . . . @ . @ . . @ @ @ . . . . . . . . @ @ @ @ @ @ @ @ 
@ . . . @ @ @ . . . . @ . @ @ @ @ . . . @ . . . @ . . @ . . @ @ @ @ . @ . @ @ @ . @ @ @ @ @ @ @ @ @ 
@ @ . @ @ @ . . @ . @ @ . @ . @ . @ . @ @ @ @ @ @ . @ @ @ . . @ @ @ . @ . . . . @ @ @ @ @ @ @ @ @ @ 
@ @ @ @ @ . @ . . @ . . @ @ . . . . . . . . . . . @ @ @ . . @ . @ . . @ . @ . @ @ @ @ @ @ @ @ . @ @ 
@ @ @ @ . . . . @ @ @ . @ @ @ . @ . @ @ . @ . @ . . @ . @ . . . . @ . . @ @ @ @ @ @ @ @ @ @ . . . @ 
@ @ . . . @ @ @ @ @ . . . . . . @ . . . @ @ . @ . @ . . . . @ . @ . . @ @ @ @ @ @ @ @ @ @ . @ . @ @ 
@ . . @ . . . . @ @ @ . @ @ . @ . . @ . . @ @ @ . . @ @ . @ @ @ @ @ @ @ @ @ @ @ @ @ @ @ . . . . . @ 
@ . @ . . @ @ @ @ @ . . @ . @ . . @ @ . @ . . . . @ . @ @ . @ @ @ @ . @ @ @ @ @ @ @ @ . @ . @ . @ @ 
@ @ . @ . . @ . @ . . @ . . . . @ @ @ . . @ @ . @ @ . . @ . . @ . . . . @ @ @ @ @ @ @ . . . . @ @ @ 
@ . . . . @ @ . . . @ @ @ . @ @ @ @ @ @ @ @ @ @ @ . @ . @ . @ . @ @ . @ . @ @ @ . @ . @ @ . @ . @ @ 
@ . @ . @ . @ . @ . @ @ @ @ . @ @ @ @ @ @ @ @ . . . . . . . . . . . . . . . @ @ . @ . . . . . . . @ 
@ @ . . . . . @ @ @ @ @ @ . . . @ @ @ @ @ @ @ . @ @ @ . @ . @ @ . @ @ . @ . @ . . . . @ @ . @ @ @ @ 
@ . . @ . @ @ . @ . . . @ @ . @ @ @ @ @ @ @ . . . @ . @ @ @ @ @ @ @ . . . @ . . @ . @ . . @ @ @ . @ 
@ @ . @ . . . . . . @ . @ . . . @ @ @ @ @ @ @ . @ . . . @ @ @ @ @ @ @ . @ @ . @ . @ @ @ . . @ . . @ 
@ @ @ @ @ . @ . @ . @ . . . @ . . @ @ @ @ @ . . @ @ . @ . . . . @ . @ . . . . . . . . . . @ . @ . @ 
@ @ @ @ @ @ . . . @ @ @ . @ . @ . @ . @ @ @ @ . . . . . . @ . @ @ . @ . @ . @ . @ . @ . @ . . . . @ 
@ @ @ @ @ . @ . @ @ @ @ . . . . @ @ . @ . @ . @ @ . @ @ @ @ @ @ . . . @ . . . @ @ @ . . . . @ @ @ @ 
@ @ @ @ @ . . . @ . @ . @ . @ . . . . . . . . . . . . . @ @ . . @ . @ . @ @ @ @ @ @ @ . @ . . . . @ 
@ @ @ . . @ @ . . . . . @ @ @ . @ . @ . @ @ . @ . @ . @ . @ . @ . . . . . . @ @ @ @ @ @ @ . @ . @ @ 
@ @ . . @ . . . @ @ . @ . . . . @ . . @ . . @ . . . @ . . . . . . @ . @ . @ @ @ @ @ @ @ @ @ @ @ @ @ 
@ @ @ . @ @ . @ @ @ @ . @ . @ . . @ . @ . @ . @ . @ @ @ @ . @ @ . . @ . @ @ @ @ @ @ @ @ @ @ @ @ @ @ 
@ @ . . . . . . @ . . . . . @ . @ . @ @ . @ . @ . . @ . . . . @ . @ . . @ @ @ @ @ @ @ @ @ @ @ @ @ @ 
@ @ @ . @ . @ . @ @ @ . @ . @ . . . @ . . . . . . @ . @ . @ @ . . . @ . . @ @ @ @ @ @ @ @ @ @ @ @ @ 
@ @ . . @ . . @ . . @ . @ . . @ . @ @ @ . @ . @ . . . . . . @ . @ @ . @ . @ @ @ @ @ @ @ @ @ @ @ @ @ 
@ @ . @ . . @ @ . @ . @ . @ @ . . @ . . @ . . @ @ . @ @ @ . . @ . @ . . . . @ @ @ @ @ @ @ @ @ @ @ @ 
@ . . @ @ . . . . . . . . . @ @ . @ . @ @ @ @ . . . . . @ . @ @ . @ . @ . @ @ @ @ @ @ @ @ @ @ @ @ @ 
@ . @ . . . @ . @ . @ . @ . . . @ . . @ @ @ @ @ @ . @ @ . . . . . . . . @ @ @ @ @ @ @ @ @ @ @ @ @ @ 
@ @ . . @ . @ . . @ . . @ . @ . . . @ @ @ @ @ @ . . @ @ . @ @ . @ . @ @ . . @ @ @ @ @ @ @ @ @ @ @ @ 
@ . . @ . . @ @ . @ @ @ . @ @ . @ . @ @ @ @ @ @ @ . . @ . . . @ . . @ @ @ . . @ @ @ @ @ @ @ @ @ @ @ 
@ @ . @ @ . . @ . . . . . . . @ @ . @ @ @ @ @ @ . . @ . . @ . @ @ . . @ @ . @ . @ @ . @ @ @ @ @ @ @ 
@ @ @ . . . @ @ . @ . @ @ . @ . @ @ @ @ @ @ @ @ . @ . @ . . @ . @ . @ @ . . . . . . . @ @ @ @ @ @ @ 
@ . . . @ . . . @ . . . @ . . . . . @ @ @ @ @ . @ . . . . @ @ . . . . . . @ . @ . @ @ @ @ @ @ @ @ @ 
@ . @ . . @ . @ . @ . @ . . @ . @ @ @ @ @ @ . . . . @ . @ . . . @ . @ . @ . . . @ @ @ @ @ @ @ @ @ @ 
@ @ . . @ @ @ . . . . . @ @ . . . @ @ @ @ @ @ . @ . . @ @ . @ . @ . @ . @ @ . @ @ @ @ @ @ @ @ @ @ @ 
@ @ @ @ @ @ @ @ @ @ @ @ @ @ @ @ @ @ @ @ @ @ @ @ @ @ @ @ @ @ @ @ @ @ @ @ @ @ @ @ @ @ @ @ @ @ @ @ @ @ 
3
31 45 27 1
26 27 13 5
16 9 2 39
