10 10
@ @ @ @ @ @ @ @ @ @ 
@ @ @ . . @ @ . @ @ 
@ @ . @ . . @ . @ @ 
@ . . . . @ . . . @ 
@ @ @ @ . . . @ @ @ 
@ . . . . @ @ . . @ 
@ @ . @ . . . . @ @ 
@ . . . @ . @ . . @ 
@ @ . @ @ . . @ . @ 
@ @ @ @ @ @ @ @ @ @ 
3
2 7 3 8
3 4 7 1
6 5 6 7
