25 25
@ @ @ @ @ @ @ @ @ @ @ @ @ @ @ @ @ @ @ @ @ @ @ @ @ 
@ @ @ @ @ @ @ @ @ @ @ . @ . @ @ @ @ @ @ . @ @ @ @ 
@ @ @ @ @ @ @ @ @ @ . . @ . . @ @ . @ . . . @ @ @ 
@ @ @ @ @ @ @ . @ . @ . @ . @ . . . @ @ . @ @ @ @ 
@ . @ @ @ @ . . . . . . . . . @ @ . @ @ . . @ @ @ 
@ . @ @ @ @ @ . @ . @ @ . @ . . . . @ . . @ . @ @ 
@ . . . @ . . . . @ . . . . @ . @ @ . @ . . . . @ 
@ . @ @ . @ . @ . @ @ . @ . . @ . . . . . @ . @ @ 
@ . . . . . . @ . . . @ . . @ . . @ @ . @ @ @ @ @ 
@ . @ . @ @ . . @ . @ @ @ . @ . @ . . . . . @ @ @ 
@ @ . . @ . . @ . @ @ @ . . @ . @ @ @ . @ @ . @ @ 
@ . @ . . @ . . . @ @ @ @ . . . . @ . . . . . . @ 
@ . . . @ @ @ @ . . @ @ . . @ . @ @ @ . @ @ @ . @ 
@ . @ . . @ . . . @ . . @ . . @ @ @ @ @ . . @ . @ 
@ @ @ . @ @ @ . @ @ . @ . @ . . . @ @ . . @ . @ @ 
@ @ @ @ @ @ @ @ . . . . . . . @ . . @ . @ @ . @ @ 
@ @ @ @ @ @ @ @ @ @ . @ @ @ . . @ . . . . . . . @ 
@ @ @ @ @ @ @ @ @ @ @ . . @ . @ . . @ @ . @ . @ @ 
@ @ @ @ @ @ @ @ @ @ @ . @ @ @ @ @ . . . @ @ @ @ @ 
@ @ @ @ @ @ @ @ @ @ . . . . . @ . . @ @ @ @ @ @ @ 
@ @ @ @ @ @ @ @ @ @ . @ @ @ . . . @ . @ @ . . @ @ 
@ @ @ @ @ @ @ @ @ @ . . . @ @ @ . . . . . @ . @ @ 
@ @ @ @ @ @ @ @ @ @ . @ . . @ @ . @ . @ . . . . @ 
@ @ @ @ @ @ @ @ @ . . . @ @ . . . . @ . . @ @ . @ 
@ @ @ @ @ @ @ @ @ @ @ @ @ @ @ @ @ @ @ @ @ @ @ @ @ 
3
14 7 15 19
15 11 23 19
11 8 4 17
