25 25
@ @ @ @ @ @ @ @ @ @ @ @ @ @ @ @ @ @ @ @ @ @ @ @ @ 
@ . @ @ . . @ . . @ . . @ @ @ . @ . . . . . . . @ 
@ . @ . . @ . @ . . . @ . @ . . . . @ . @ . @ . @ 
@ . . @ . . . . . @ @ @ . . @ @ . @ . @ . . . @ @ 
@ @ . . . @ . @ . . @ . @ . . . . . . @ . @ @ @ @ 
@ . @ @ . . @ . . @ . . . . @ @ . @ . @ . @ @ @ @ 
@ . . @ @ @ . @ . . @ @ @ . . . @ . @ . @ . @ @ @ 
@ @ . . . @ . . @ . . @ . . @ . . . . . . . . . @ 
@ . . @ . . @ . . . @ . @ . @ @ . @ . @ . @ . @ @ 
@ @ . @ . @ . @ @ . @ . . . . @ @ @ @ @ @ @ . @ @ 
@ . . . @ . . @ @ . @ @ @ . @ . @ @ @ @ . . @ @ @ 
@ . @ @ . @ . . @ . . @ . . . . . @ . . . @ . @ @ 
@ . . . . . . @ @ . @ . @ . @ @ @ . @ @ . . . . @ 
@ . @ @ @ @ . . . . . . . . . . . . . . . @ . @ @ 
@ @ . . . . . @ @ . @ @ . @ @ . @ . @ @ . . @ @ @ 
@ . . @ . @ . . @ @ . . . . . @ . . @ . . @ @ @ @ 
@ @ . . @ . . @ @ . . @ . @ . @ @ @ . . @ @ @ @ @ 
@ . . @ @ @ . . @ . @ . . @ @ . @ @ @ . . @ @ @ @ 
@ @ . @ . . . @ @ @ . . @ @ @ . @ @ @ @ . @ @ @ @ 
@ @ @ . @ @ . . @ . @ . . @ . . @ @ @ @ @ @ @ @ @ 
@ . . . . . . @ . . . . @ . @ . @ @ @ @ @ @ @ @ @ 
@ @ . @ . @ . . @ . @ . . . . . . @ @ @ @ @ @ @ @ 
@ . . . @ . . @ @ @ @ @ . @ @ . @ @ @ @ @ @ @ @ @ 
@ . @ . @ @ . @ @ @ @ @ . . . @ @ @ @ @ @ @ @ @ @ 
@ @ @ @ @ @ @ @ @ @ @ @ @ @ @ @ @ @ @ @ @ @ @ @ @ 
3
15 10 10 20
4 9 18 5
15 7 20 6
