10 10
@ @ @ @ @ @ @ @ @ @ 
@ @ . . @ @ . . @ @ 
@ . @ . @ @ @ . @ @ 
@ . . . . @ @ . @ @ 
@ . @ . @ @ . . . @ 
@ @ . . . . . @ . @ 
@ . . @ . @ @ . . @ 
@ @ . @ . @ @ . @ @ 
@ . . . @ @ @ @ @ @ 
@ @ @ @ @ @ @ @ @ @ 
3
4 3 6 7
1 6 7 2
2 7 2 3
