10 10
@ @ @ @ @ @ @ @ @ @ 
@ @ . . @ @ . @ @ @ 
@ . . @ . . . . @ @ 
@ @ . . . @ @ . @ @ 
@ @ @ @ . . @ @ . @ 
@ @ . . . @ @ @ . @ 
@ . @ . @ . @ @ . @ 
@ . @ . . . . . . @ 
@ . . . @ @ @ @ @ @ 
@ @ @ @ @ @ @ @ @ @ 
3
8 3 7 7
2 7 6 8
7 5 3 2
