12 12
@ @ @ @ @ @ @ @ @ @ @ @ 
@ . @ . @ @ . @ . @ . @ 
@ . . . . . . @ . . . @ 
@ @ . @ . @ . . . @ . @ 
@ @ @ @ @ . . @ . @ . @ 
@ @ @ @ @ @ . . @ @ @ @ 
@ @ @ @ @ . . @ . @ . @ 
@ @ @ @ . @ . @ . . . @ 
@ @ @ . . @ . . . @ @ @ 
@ @ @ @ . . . @ . . @ @ 
@ @ @ @ @ . @ @ @ @ @ @ 
@ @ @ @ @ @ @ @ @ @ @ @ 
3
2 9 7 9
6 10 4 6
9 5 4 10
