12 12
@ @ @ @ @ @ @ @ @ @ @ @ 
@ @ @ @ @ @ @ @ @ . @ @ 
@ @ @ @ @ @ @ @ . . . @ 
@ @ @ @ @ . @ . @ . @ @ 
@ @ . @ . . . . . . . @ 
@ @ . @ . @ @ . @ . @ @ 
@ . . . . @ @ . . @ . @ 
@ . @ . @ @ @ @ . . . @ 
@ . . @ @ @ @ @ @ @ . @ 
@ . @ @ @ @ @ @ @ . . @ 
@ . . @ @ @ @ @ @ @ . @ 
@ @ @ @ @ @ @ @ @ @ @ @ 
3
7 3 2 9
9 10 7 8
10 2 2 10
