12 12
@ @ @ @ @ @ @ @ @ @ @ @ 
@ @ @ . @ . . . . . . @ 
@ @ @ . @ . @ @ . @ . @ 
@ @ . . . . . . @ . @ @ 
@ @ @ . @ . @ . . . . @ 
@ @ . @ . . . @ . @ . @ 
@ @ . . . @ . @ . . @ @ 
@ . @ . @ . . . @ . . @ 
@ . . . @ . @ . . @ @ @ 
@ . @ . @ . @ . @ @ @ @ 
@ @ . . . @ . . . . @ @ 
@ @ @ @ @ @ @ @ @ @ @ @ 
3
7 1 4 10
8 5 6 2
1 8 2 10
