12 12
@ @ @ @ @ @ @ @ @ @ @ @ 
@ . . . . . @ . @ @ @ @ 
@ . @ @ . @ . . @ @ @ @ 
@ @ @ . . @ . @ . @ @ @ 
@ @ . @ . . . . . . . @ 
@ . . . . @ @ @ @ @ @ @ 
@ @ . @ . . . . . . . @ 
@ @ @ . . @ . @ . @ . @ 
@ @ @ @ . . @ . . . @ @ 
@ @ @ @ . @ . @ @ . . @ 
@ @ @ . . . . . @ . @ @ 
@ @ @ @ @ @ @ @ @ @ @ @ 
3
4 5 10 3
6 9 7 4
6 2 6 10
