50 50
@ @ @ @ @ @ @ @ @ @ @ @ @ @ @ @ @ @ @ @ @ @ @ @ @ @ @ @ @ @ @ @ @ @ @ @ @ @ @ @ @ @ @ @ @ @ @ @ @ @ 
@ @ . @ . @ @ . . @ . . . @ @ @ @ @ @ @ . @ . . . . . . . . @ . . . . . . . @ @ @ @ @ @ . @ . . . @ 
@ @ . @ . . @ . @ . @ . @ @ @ @ @ @ @ . . . . @ @ . @ @ . @ @ @ . @ . @ . @ @ @ @ @ @ . . @ . @ . @ 
@ @ . @ . @ . . . . . . . @ @ @ . . . @ . @ . . . @ . . . @ @ @ @ . . . @ @ @ @ @ @ @ @ . . @ . . @ 
@ @ . . . . . @ . @ @ . @ . . @ . @ . . . . @ @ . @ @ . @ @ @ . . @ @ . @ @ @ @ @ @ @ . . @ @ @ . @ 
@ . @ . @ . @ . @ . . @ @ . @ . @ . . @ . @ . . @ @ @ @ . . @ . @ . @ . . @ @ @ @ @ @ @ . . @ @ . @ 
@ . . . @ . . . . @ . . . . . . . . @ . @ . @ . @ . @ @ @ . @ . @ . @ . @ . @ @ @ @ @ . . @ @ @ . @ 
@ . @ . @ @ @ @ @ . . @ @ @ . @ @ . . . . . . . . . . @ . . . . . . . . . . . @ @ @ @ @ . . . . . @ 
@ @ @ . @ @ . @ . @ . . . @ . @ . @ . @ . @ . @ @ @ . . @ . @ @ . @ . @ . @ @ . @ @ . . . @ @ . @ @ 
@ . . . . . . . . . . @ @ . @ . . . @ @ @ @ @ . . @ . @ . . . @ . . @ @ . . . . . . @ @ . @ @ . . @ 
@ . @ @ . @ . @ . @ . . . . . . @ . @ . . . . @ . . @ . @ . @ . @ @ @ . . @ . @ . @ @ . . . @ . @ @ 
@ . . @ . @ @ @ . . @ . @ . @ @ @ . . . @ @ @ . @ . @ . @ . . . . @ @ @ . . @ @ . @ . . @ . . @ @ @ 
@ . @ . . . . . @ . . @ . . @ @ . @ @ @ . @ . . . . . . . . @ @ @ . . . @ . . . @ @ @ . . @ . . . @ 
@ @ . @ . @ @ . . @ . @ @ . . . . . . . . . . @ . @ . @ . @ @ @ @ . @ @ . @ . @ @ @ . . @ . @ @ . @ 
@ . . . . . . @ . . @ @ . . @ . @ . @ . @ . @ . @ . . @ @ @ @ @ . . . . . . . @ . @ @ . . . . @ . @ 
@ . @ @ . @ @ . . @ . . @ @ . @ . @ @ @ . . . . . @ . . @ @ @ @ @ . @ @ @ @ @ . . @ . . @ @ @ . @ @ 
@ . @ @ . . . @ . . . @ @ . . . . . @ . @ . @ . @ . . @ . @ @ @ @ @ . . . . . . @ . @ . . . . . . @ 
@ . @ @ . @ . @ . @ . @ @ . @ . @ @ . . . . . @ . @ . . . . . . @ @ @ @ . @ @ . . . . . @ . @ . @ @ 
@ @ . . . @ @ @ . . @ @ . @ . . @ . @ . @ . @ . . . . @ . @ . @ . @ . @ @ . @ . @ @ . @ . @ @ @ @ @ 
@ @ @ @ . . . . @ . . . . . @ . . . @ @ . . . @ . @ . . @ . . . . . . . . . . . . @ . @ . @ @ . . @ 
@ . . . . @ @ . . @ . @ . @ . . @ . . @ @ . @ @ @ . . @ . @ . @ . @ @ . @ . @ . @ . @ @ . @ . @ . @ 
@ @ @ @ @ @ . . @ @ @ @ @ . . @ @ . @ @ @ . @ @ @ @ . . . . @ @ . . . @ @ . @ . . . . . . . . . . @ 
@ @ . @ . . @ . . . . @ . @ . . . @ @ @ . . . . @ @ @ . @ . . . @ @ . . . @ . . @ . @ . @ . @ @ . @ 
@ . . . . @ . @ . @ . . . . . @ @ @ @ @ @ @ . @ @ @ . . . @ . @ @ . @ @ . . @ @ @ . . @ @ @ @ @ @ @ 
@ @ . @ . . . . . . @ @ . @ . . . . @ @ . . . . @ @ @ . @ @ . . @ . . . . @ . . . . @ . @ . @ . @ @ 
@ @ @ . . @ . @ . @ . . . @ . @ . @ . . . @ . @ @ @ @ . . . @ @ . . @ @ @ . @ . @ . . . . . . . . @ 
@ @ @ @ . @ @ . . . @ @ . . @ @ . . @ . @ . . . @ @ @ . @ . . @ @ @ . @ . . . @ @ . @ . @ . @ . @ @ 
@ @ @ @ @ @ . @ . @ @ . . @ . . . @ @ @ . @ . @ . @ . . @ @ . @ . @ . @ @ . @ . @ . . @ . . @ . . @ 
@ . @ @ . @ . @ . . @ . @ . . @ . . @ @ . . . . . . @ . @ . . . . . . . . . . . . @ @ . @ . . @ . @ 
@ . . . . . . . . @ @ @ @ @ . . @ . @ @ @ @ . @ . @ . @ @ @ @ @ . @ @ . @ . @ @ @ . . . . . @ @ . @ 
@ . @ . @ . @ @ . . . . @ @ . @ . . . . . . @ @ @ . . @ . @ @ @ . @ @ @ . . . . @ @ . @ . @ . . @ @ 
@ . @ . @ @ . . . @ . @ @ . . @ @ . @ . @ @ @ . @ @ . . . . . . @ . @ . @ . @ @ @ @ . . @ @ . @ @ @ 
@ @ . @ @ . @ . @ . . @ @ @ . @ . . . @ @ . . . . . . @ @ . @ . @ . . . . . @ @ . . . @ @ . . . @ @ 
@ . . . . . . . . @ @ . @ . . . @ . @ . . . @ . @ . @ @ @ @ . . @ . @ . @ . @ @ @ @ . . . @ . @ @ @ 
@ @ . @ @ . @ . @ . @ . . @ . @ . @ . @ @ . @ @ . . @ @ . @ @ . . @ . @ . . . @ . . . @ . . . . . @ 
@ @ . @ . @ @ . . . @ . @ @ . . . . . . . . . . @ @ . @ . @ @ . @ @ . . @ . @ @ @ @ . . @ . @ . @ @ 
@ @ @ @ . . . . @ . . . . @ @ @ @ @ . @ . @ @ @ . @ . . . . . @ . @ . @ . . . @ . . @ . @ . . @ @ @ 
@ @ @ @ @ . @ . . @ @ . @ . @ . @ . @ . . . . . . . . @ . @ . . . . . @ . @ . @ . @ . @ . @ . @ @ @ 
@ @ @ @ @ @ . . @ . @ @ . . . . . . . @ . @ . @ . @ . @ . . @ @ . @ . @ . @ . @ . . . . . @ @ . @ @ 
@ @ @ @ @ . @ . . . . . @ . @ @ . @ . . @ . . @ . . @ @ . @ . @ @ . . @ . @ . . . @ @ @ . . . . . @ 
@ @ @ @ . . . . @ . @ . . . . . @ @ . @ @ @ . . @ @ @ @ . . . . @ . @ . . @ . @ . . . . @ @ @ @ . @ 
@ @ @ @ @ @ . @ . . . @ . @ . @ @ . . . @ . @ . @ . @ . @ . @ . . @ . @ . @ . . @ . @ . . . . . @ @ 
@ @ @ @ @ . @ @ . @ . @ . . @ @ . @ . @ @ . . . . . . . @ . . @ . . . @ . @ . @ . . . @ . @ . @ @ @ 
@ @ @ . . . . . . . @ . . @ . . . @ @ @ @ . @ . @ . @ . @ @ . . @ . @ @ . . @ @ @ . @ @ . . @ . @ @ 
@ @ . @ . @ . @ . @ . @ . @ @ . @ . . @ @ @ . . . @ @ . . @ @ @ @ . . @ . @ @ @ . . @ @ @ . . . . @ 
@ . . . . . @ . . . . @ . . . . . . @ @ @ @ . @ . . . @ . . . @ . @ @ @ . . . @ @ . @ @ . @ . @ @ @ 
@ @ . @ @ . . @ . @ . @ . @ . @ . @ . @ @ @ . . @ . @ . . @ . . . . . . @ . @ @ . . . . . . @ . @ @ 
@ @ . @ . @ @ . . . @ @ . . @ . . . . . @ @ . @ . . . @ . @ . @ . @ . @ @ . . . @ @ . @ @ . . . . @ 
@ @ @ . . . . . @ @ @ @ . @ . . @ . @ . @ @ @ @ @ . @ @ @ . . @ . . @ . . . @ . . . @ . . . @ . @ @ 
@ @ @ @ @ @ @ @ @ @ @ @ @ @ @ @ @ @ @ @ @ @ @ @ @ @ @ @ @ @ @ @ @ @ @ @ @ @ @ @ @ @ @ @ @ @ @ @ @ @ 
3
36 18 29 8
39 33 31 3
33 2 14 34
