10 10
@ @ @ @ @ @ @ @ @ @ 
@ . . . . @ . @ @ @ 
@ . @ . @ . . . . @ 
@ @ @ . . . @ @ @ @ 
@ @ @ . @ @ @ @ @ @ 
@ @ . . . . @ @ @ @ 
@ @ @ . @ . @ . @ @ 
@ @ . . @ @ . . . @ 
@ @ @ . . . . @ . @ 
@ @ @ @ @ @ @ @ @ @ 
3
5 3 7 3
7 6 6 5
6 7 2 7
