25 25
@ @ @ @ @ @ @ @ @ @ @ @ @ @ @ @ @ @ @ @ @ @ @ @ @ 
@ . . . . . . @ . . @ . . . . . . . @ @ @ @ @ @ @ 
@ . @ . @ . @ . @ . . @ @ . @ @ . @ @ @ @ @ @ @ @ 
@ @ . @ @ . . . . . @ @ . . . @ . @ @ @ @ @ @ @ @ 
@ . . . . . @ . @ . . . @ . @ @ . @ @ @ @ @ @ @ @ 
@ . @ @ @ @ . @ . @ . @ @ . . . @ . @ @ @ @ @ @ @ 
@ @ @ . . . . @ . . . . . . @ @ @ . . @ @ @ @ @ @ 
@ . . . @ . @ @ @ . @ . @ . @ . @ . @ . . @ @ @ @ 
@ @ . @ . . . @ @ . @ . . @ . . . . . @ . . . @ @ 
@ @ @ . @ @ . @ . @ . . @ . @ . @ @ @ @ . @ . @ @ 
@ @ . . . . . . . . @ . . . . . . @ @ . . @ @ . @ 
@ . . @ . @ . @ . @ . @ . @ . @ . . @ @ . . . . @ 
@ . @ . . @ . @ . . . . . . @ . @ . . @ . @ . @ @ 
@ . . @ . . @ . @ @ . @ @ @ . . . . @ . . . @ . @ 
@ . @ . @ . . . . . @ @ @ @ @ . @ . . . @ . . . @ 
@ . . . . @ . @ . @ . @ @ @ @ @ . . @ @ . @ . @ @ 
@ . @ @ . @ @ . . . . @ @ @ @ @ @ . @ . . . . . @ 
@ @ @ . . . . @ . @ . . . . @ @ @ @ @ @ . @ . @ @ 
@ @ . @ . @ @ . . . @ . @ @ @ @ @ @ @ @ @ @ @ @ @ 
@ . . . . . . @ @ . . @ @ @ @ @ @ @ @ @ @ @ @ @ @ 
@ @ @ @ . @ @ @ @ @ @ @ @ @ @ @ @ @ @ @ @ @ @ @ @ 
@ . . . . @ @ @ @ @ @ @ @ @ @ @ @ @ @ @ @ @ @ @ @ 
@ . @ . @ @ @ @ @ @ @ @ @ @ @ @ @ @ @ @ @ @ @ @ @ 
@ . . @ @ @ @ @ @ @ @ @ @ @ @ @ @ @ @ @ @ @ @ @ @ 
@ @ @ @ @ @ @ @ @ @ @ @ @ @ @ @ @ @ @ @ @ @ @ @ @ 
3
6 12 1 6
4 13 9 20
6 9 11 6
