12 12
@ @ @ @ @ @ @ @ @ @ @ @ 
@ @ @ . . . @ @ . @ @ @ 
@ @ @ . @ @ . . . . . @ 
@ @ . . @ . . @ . @ . @ 
@ . @ . . @ . @ . . @ @ 
@ . @ . @ . . @ . @ @ @ 
@ . @ . . . @ . . @ @ @ 
@ . @ . @ @ @ @ . . . @ 
@ . . . @ @ @ @ @ . @ @ 
@ @ . @ @ @ @ @ @ . . @ 
@ . . . @ @ @ @ . . @ @ 
@ @ @ @ @ @ @ @ @ @ @ @ 
3
9 2 7 10
9 9 1 5
7 8 5 1
