20 20
@ @ @ @ @ @ @ @ @ @ @ @ @ @ @ @ @ @ @ @ 
@ @ @ @ @ @ @ @ @ . . @ @ @ @ @ @ @ @ @ 
@ @ @ @ @ @ @ @ . . @ . @ @ . @ @ @ @ @ 
@ @ @ @ @ @ @ @ @ . . . . . . . @ @ @ @ 
@ @ @ @ @ @ @ @ . . @ . @ . @ . . @ @ @ 
@ @ @ @ @ @ @ @ @ . @ @ . . @ . @ . @ @ 
@ @ @ @ @ . @ . . . . @ . @ @ . . . . @ 
@ @ @ @ . . @ . @ . @ . . @ @ . @ . @ @ 
@ @ @ @ @ . @ . @ . @ @ @ . @ . . @ . @ 
@ @ @ @ . . @ . . @ . . @ . . @ . . . @ 
@ @ @ @ @ . . . @ . @ . @ . @ . @ . @ @ 
@ @ @ @ @ @ . @ . . . . . . . . @ @ @ @ 
@ @ @ @ @ . . . . @ @ . @ @ . @ . @ @ @ 
@ @ . . . . @ . @ . . @ @ . . . . . @ @ 
@ . @ @ @ . @ . . . @ . . . @ @ . @ @ @ 
@ . @ @ @ . . @ . @ @ @ . @ . . . . @ @ 
@ . . @ . . @ . @ @ @ @ . . @ @ . @ . @ 
@ . @ . @ . . . . . @ @ @ @ @ @ . . . @ 
@ . . . . . @ . @ . @ @ @ @ @ @ @ . @ @ 
@ @ @ @ @ @ @ @ @ @ @ @ @ @ @ @ @ @ @ @ 
3
14 9 7 9
4 13 16 5
12 16 11 9
