100 100
@ @ @ @ @ @ @ @ @ @ @ @ @ @ @ @ @ @ @ @ @ @ @ @ @ @ @ @ @ @ @ @ @ @ @ @ @ @ @ @ @ @ @ @ @ @ @ @ @ @ @ @ @ @ @ @ @ @ @ @ @ @ @ @ @ @ @ @ @ @ @ @ @ @ @ @ @ @ @ @ @ @ @ @ @ @ @ @ @ @ @ @ @ @ @ @ @ @ @ @ 
@ @ . @ . @ . @ @ . . . @ . @ @ . @ . @ . @ @ . @ . . @ . @ @ @ . . . . @ . . @ . . @ . . @ . . @ @ . . @ . @ @ @ . @ . @ @ . @ . . @ . . @ . @ @ @ @ @ . . @ . . . . . @ . . . @ . @ @ . . @ . @ . @ @ 
@ . . . . . . . . . @ @ @ . @ . . . . . . @ . . @ . @ . . . @ . . @ @ @ . @ . @ . @ . @ . . @ . . . @ . . . . . @ . . . . . . @ . @ @ @ . . . @ @ . @ . @ . . @ . @ @ . @ . @ @ . . . @ . @ . . . . . @ 
@ . @ . @ . @ . @ . @ . @ . @ . @ @ . @ . . @ . @ . . @ . @ @ @ . @ . @ . . . @ . . . . . @ . . @ @ . . @ @ . @ . . @ . @ @ . @ . . . @ . @ . . @ . @ . . . @ . @ . . . . . @ @ . @ @ . . . . @ . @ . @ 
@ @ @ @ @ @ @ @ . . . . . . . @ . . @ . . @ . . . @ . . . . @ . . @ . @ . @ . . @ @ . @ . . @ . @ . @ . . @ . . @ . @ . @ . . @ . @ . @ . . @ @ @ . . . @ . . . . . @ @ . @ . . . . @ @ . @ . @ @ . @ @ 
@ . @ . @ . @ @ . @ . @ . @ . . . @ @ @ . . @ . @ . @ @ . @ . @ . . . . . . @ @ @ @ @ . @ . . . @ . . . @ . . @ . @ . . @ @ . . @ @ . @ . @ . @ . . @ @ . . @ @ @ @ . . . . . @ @ . @ . . @ . . . . . @ 
@ . . . . . . . @ . @ @ @ . @ . @ . @ . @ . @ . @ . @ @ . @ . @ . @ . @ . @ . @ @ @ @ . . @ . @ . @ @ . . @ @ . . . @ . @ @ @ . @ . . . . . . @ @ . . @ @ . @ @ . . @ @ . @ . . . @ . . @ . @ . @ . @ @ 
@ . @ @ @ . @ @ . . . @ . . . . . . . . . . @ . @ . . . . . . . . . @ @ . @ . @ @ @ . @ . . . . . @ @ . @ . @ @ . @ @ . . @ @ @ @ @ . @ . @ @ . . . @ @ @ @ . . . @ @ @ @ . . @ . @ @ . . . . @ @ . @ @ 
@ @ . . . . . . . @ . @ @ @ . @ . @ . @ @ . @ . @ @ . @ . @ . @ . @ @ . . @ . . @ @ . . @ @ . @ @ . . . . . @ . . . . . @ . @ @ @ . . . @ . @ . @ . . . @ @ @ . @ . @ . @ @ . . @ @ . . @ . @ . . @ . @ 
@ . . @ @ . @ . @ . . . @ . @ @ . @ @ @ . . @ . @ @ @ . . . @ . @ @ @ @ . @ @ . @ . @ . @ @ . . . @ @ . @ @ . . @ . @ @ . . . @ . @ @ . @ . @ . @ . @ @ . @ . . . . . . . @ . @ @ @ @ . @ @ . . @ . . @ 
@ @ . . @ . . @ . . @ . . . @ . @ @ . . @ . . . . @ . @ . @ . . . @ @ @ @ @ . . @ . . . . . . @ @ . . . @ @ @ . @ @ @ . . @ . . . . . . @ . @ @ . . . . . . @ . @ @ @ @ @ @ . @ @ @ . . . @ @ . . . @ @ 
@ @ . @ @ . @ @ @ @ . . @ . . . @ @ . @ . @ . @ @ . . . . . . @ @ . @ @ @ . @ . . @ . @ . @ . @ . . @ @ @ @ . . . @ . @ . . @ . @ @ @ @ . . . . . @ . @ . @ @ . @ . . . @ @ @ . @ @ @ . @ @ @ . @ @ . @ 
@ @ @ @ @ @ @ @ @ @ @ @ . @ . @ . . . . . . . . . @ . @ @ @ . . . . . . . . @ . @ @ . @ @ . . . @ . . @ @ . @ . @ . . . . @ . @ . . @ @ . @ . @ . . @ . . . . . @ . @ @ @ @ @ . @ @ @ . . @ . . . @ . @ 
@ @ . @ @ . @ @ @ @ . . . . . . . @ . @ . @ . @ @ @ @ @ . . . @ . @ . @ . @ @ . . . @ . . . @ @ @ . @ . . . . . . . @ . @ @ . . @ . . . . . @ . @ @ @ @ . @ . @ . . . . @ @ . . . @ . . @ @ @ . @ . . @ 
@ . . . . . . @ @ . @ . @ . @ . @ . . . @ . . @ . . @ @ @ . @ . . . @ @ . @ . @ . @ . @ @ . . @ . . . @ . @ @ @ . @ . . @ . . @ . @ @ . @ @ . . @ @ @ @ @ . . @ . @ . @ . . @ . @ . @ . . @ @ . . . @ @ 
@ . @ . @ @ @ . @ . . @ @ @ . . . @ . @ . . @ @ . @ . @ . . . @ . @ . . . @ . . . . . . . . @ @ . @ . @ . . . @ . @ @ . @ @ . . . . . . . . @ . @ @ . @ @ @ @ . . . @ . @ . . . . . . . @ . . . @ @ . @ 
@ . . @ @ @ . . . . @ @ . . @ @ . @ @ . . @ . . . . . @ @ . @ . @ . . @ . . @ . @ . @ @ @ . . . . . @ . . @ @ . @ . . @ @ @ . @ . @ @ . @ . . . . @ . . @ @ @ @ . @ . . . @ . @ @ . @ . @ . @ . . . . @ 
@ . @ . @ . @ . @ @ . . @ . . . . @ . @ . . @ @ @ @ . . . . . . @ . @ @ @ @ @ @ . @ . . . . @ @ . @ . @ . . . . @ . @ . @ . . . @ . . @ . @ @ @ @ @ . @ @ @ @ . . . @ @ . . . . @ @ . . . @ . . @ . @ @ 
@ . . . . . . . . . @ . . @ @ @ @ . . . . @ . . @ . @ . @ . @ @ . @ . . @ @ @ @ . . . @ @ . @ @ . @ . @ . @ . @ . . . . @ . @ . . @ . @ . @ . @ . @ . . . @ . @ . @ . . @ @ . @ @ . @ . @ . @ . . @ @ @ 
@ @ . @ @ . @ . @ @ . @ . @ . @ . @ . @ . . . @ @ . @ . . @ @ . . @ . @ . @ . @ @ . @ @ @ @ . . . @ . . . . @ @ . @ . @ . . @ @ . . . . . . . . . . . @ . . . . . . . @ . @ . @ . . . . . . . . @ . @ @ 
@ @ @ @ . @ . . . . . . . . . . . @ @ . . @ . . @ . . . @ @ . . @ . . . . . . . @ . . @ @ @ @ @ . . . @ . @ . . . . @ . . @ . . . @ . @ @ @ . @ @ . @ . . @ @ @ . @ @ @ . . @ @ . @ . @ . @ . @ . . @ @ 
@ . . . . . @ . @ @ @ @ @ . @ @ . . @ . @ . . @ . @ . @ . . @ . @ . @ . @ @ @ @ . @ . @ @ @ . . @ . @ . @ . @ @ . @ . @ . . @ . @ @ . @ . . . . . @ . . @ . @ @ @ @ @ . . @ @ @ @ . . . @ . . @ . @ . @ 
@ @ . @ . @ @ @ . . . @ @ @ @ . . @ @ @ @ @ . . . . . . . @ . . . . @ @ . . @ . . . @ . @ . @ . . . @ . . . . . . . . . . @ . . . . @ . @ @ . @ . @ @ . @ . . @ @ @ . @ . . @ @ @ @ . @ @ @ . . . . . @ 
@ . @ . . . . . . @ . @ . . . @ . @ @ . @ . @ @ . @ . @ @ @ . @ . @ @ @ . @ . @ @ . . . . . . @ @ . @ . @ @ . @ . @ . @ . @ @ . @ . . . . @ . @ . @ . . . . @ . @ . . . . @ . . @ @ @ @ @ . . @ . @ . @ 
@ . . . @ . @ @ @ . . . . @ . . . . . . . . @ . @ . . . @ . . @ . @ @ . . . . . . @ . @ @ @ . . . . . . . @ . . @ . @ @ @ @ . . @ . @ . @ @ . @ . @ @ . @ @ . . @ @ . @ @ . . @ . @ . @ @ @ . . @ . . @ 
@ . @ . @ @ . @ @ @ . @ @ . . @ @ @ @ @ @ . . . . @ . @ . . @ @ . . . @ @ . @ . @ @ . @ . . @ . @ . @ . @ . . @ @ . . @ . @ @ . . @ @ @ @ . @ . @ . . . @ . @ . . . . . . . @ @ . . . . @ . @ . . @ @ @ 
@ . . @ @ . . @ @ @ @ . . . @ . . . . @ . @ . @ . . . . @ . . @ . @ @ @ . @ . . . . @ . . @ . @ @ . @ . @ @ . @ @ . @ . . @ . . @ @ @ @ @ . . . . @ @ . . . @ @ . @ @ . @ @ . @ . @ . @ @ . @ . @ . @ @ 
@ @ . . . @ . @ @ @ . @ @ . . @ . @ . . . . @ . @ @ @ . . . @ . @ . @ . . . @ . @ @ . @ . . . @ . . @ . @ @ @ . . . @ @ . . @ @ @ . . @ @ . @ . @ @ @ . @ . . . . @ @ @ @ . . . . . @ @ @ . . . @ . . @ 
@ . . @ @ . . @ @ @ . @ @ . @ . @ @ @ . @ . . . . . . . @ . . . . . . @ . @ . . . @ . . . @ . @ @ . . @ @ @ . . @ . @ . . @ . . . @ . . . . . @ . @ @ @ @ . @ @ @ @ @ @ . @ @ @ . @ . . . @ . @ @ . @ @ 
@ @ @ @ . @ . . @ . . . . @ . . @ @ . @ . @ . @ . @ . @ . . @ . @ @ @ . . . . @ @ . . @ @ . @ @ @ . @ . @ . . @ . . . . @ @ . @ @ . @ @ @ . @ . . . @ . . . . @ @ @ @ . . . @ . . . . @ @ . . . . . . @ 
@ @ . . . . . @ . @ . @ @ . @ . @ . . . . . . @ @ . . . @ . @ @ @ @ . . @ . @ . @ . @ . . . @ . . . @ . . @ . @ @ . @ . @ . . . . . . . . . . . @ @ @ @ @ . @ . @ @ @ @ . @ . @ @ @ . . @ . @ @ . @ . @ 
@ @ . @ . @ . . . . . . . . . . . @ @ . @ . @ . . . @ . @ . . . @ @ @ . . @ @ . . . . @ @ . . @ @ . . . @ . @ . @ @ @ . . @ . @ . @ . @ . @ @ . . . @ @ . @ . . . . @ . . . . @ . . . @ . . @ . . @ @ @ 
@ . . @ . @ . @ . @ . @ . @ . @ . . . @ . . @ @ @ . . @ . . @ @ . @ . . @ . . . @ . @ @ . @ . . . . @ @ . . . . . @ . . @ @ @ @ @ . @ . @ . @ . @ . @ . . @ . @ @ @ . @ @ @ . . @ @ . . . @ . @ . . @ @ 
@ . @ . . . @ . . . @ . . @ @ . . @ . @ . @ . . @ . @ @ . @ . @ . . @ . . . @ . . @ . . . . @ . @ . . . . @ . @ @ @ . @ @ @ @ @ @ . . . @ . @ @ @ . . @ . . . . @ @ . @ @ . @ . @ . . @ @ . . . @ @ @ @ 
@ . @ @ . @ @ @ . @ @ . @ . . @ . . @ @ @ @ . @ @ @ @ @ . . . . . @ . . @ . @ . @ . @ . @ . @ @ @ . @ . @ . @ . . . . . @ @ @ @ @ . @ . @ . . . . . @ . . @ . @ . @ . @ . . . . . @ . . . . @ @ @ @ @ @ 
@ @ . . . . . . @ . . . @ @ . . @ . . @ . @ . . @ @ @ . . @ @ . @ @ @ . . @ . . @ . . . . @ . @ . . . @ . . . . @ @ . @ . @ @ @ . . @ @ . . @ @ . @ @ . @ . @ @ . . . . @ . @ @ . . . @ . @ @ @ @ @ @ @ 
@ @ @ . @ @ @ @ . @ . @ @ @ @ . . . @ . . . . @ . @ . @ . . . @ . @ @ . @ @ @ . . @ . @ . . . . @ . @ @ @ . @ @ . . @ @ . . @ . . @ . . @ . @ . . . . . . . . . . @ . @ . @ . @ @ @ . @ @ @ @ @ @ @ @ @ 
@ @ @ @ . . @ . . . . . @ @ @ @ @ . @ @ . @ . @ . @ . . . @ @ . . . . . . @ @ . @ . . @ . @ @ . @ . . @ @ . . @ . @ . @ . @ . @ . . @ . . . . @ . @ @ . @ . @ . @ . . . . . . . . @ . @ @ @ @ @ @ @ @ @ 
@ @ @ @ @ . . . @ @ . @ @ @ @ @ . . . @ @ . . . . . . @ . @ . @ . @ @ . @ . @ @ @ @ . @ . @ @ @ . . @ . @ . @ . . . . . . . . . @ . . . @ . @ @ @ @ . . @ . @ @ . @ @ . @ . @ . @ @ . . . @ @ @ @ @ @ @ 
@ @ @ @ . . @ . . @ . . . . @ @ @ @ . @ . @ . @ @ . @ . . . . @ @ . . . . . . . @ @ @ . . . @ @ @ . @ . . . . . @ . @ . @ . @ @ . . @ @ . . @ @ @ @ @ . . @ @ . . . . @ . . . @ @ . . @ @ . @ @ @ @ @ @ 
@ @ @ @ @ . @ @ . @ . @ . @ @ @ @ . . . . . . @ . @ @ . @ . @ @ . . @ . @ . @ @ . @ . @ . @ . . . . . . @ @ @ @ @ @ . @ @ @ . @ . @ . @ @ @ @ @ @ @ @ . @ @ @ @ . @ . @ @ . @ @ @ @ . . @ . . @ @ @ @ @ 
@ @ @ @ @ @ @ @ @ @ @ . . . @ @ @ @ . @ @ @ @ . . . . . . @ @ . @ . @ . . @ @ @ . . . . . . . @ @ . @ @ . . . @ @ @ . @ @ @ . . . @ . . @ @ @ @ @ @ . . @ @ @ . . . @ . . . @ @ @ @ . @ @ . @ . @ . @ @ 
@ @ @ @ @ @ @ @ @ @ @ @ . @ . . @ @ @ @ @ @ . . @ . @ @ @ . @ . . @ . . @ . @ @ . @ . @ . @ @ . . @ @ . @ . @ . @ . . @ @ @ . @ . . . @ . . @ @ @ . @ @ @ @ . @ . @ . @ . @ . . @ . . . . . . . . . . @ 
@ @ @ @ @ @ @ @ @ @ @ @ . @ . @ . @ @ @ . @ @ . @ @ @ @ . . . . @ . @ . . . . @ @ . @ . . . . @ . . . . . . . . . @ . . @ . @ . . @ . @ @ . . . . . . . @ . . . . . . . @ . @ . . . @ @ @ . @ . @ @ . @ 
@ @ @ @ @ @ @ @ @ @ . . @ . . . . . @ . . . @ . . @ @ @ @ . @ . . . . . @ . @ . . . . . @ @ . . . @ . @ . @ @ . @ . . @ . . @ . @ . @ . . . @ @ . @ . @ @ @ @ . @ @ . @ . . . . @ @ . @ . @ . . @ . @ @ 
@ @ @ @ @ . . @ @ @ @ . . @ . @ @ @ . @ . @ @ . @ . @ @ @ @ . . @ @ . @ . . . @ . @ @ . @ @ @ . @ @ @ . @ @ . . @ . @ . @ . . . @ . . . @ . . @ . . @ @ @ @ @ @ @ . . . . @ @ @ . @ . @ . . @ . @ . . @ 
@ @ @ @ . @ . . @ . . . @ . . . @ . . @ . . . . . . . @ . . @ . . . @ @ . @ . @ @ . . . . @ @ . @ @ . . . @ . @ . . . . @ . @ @ . . @ @ . @ @ . @ . @ @ @ @ @ @ . . @ @ @ . . @ . . . @ . @ . @ . . @ @ 
@ @ @ . . @ . @ . @ . @ . @ . @ . @ . . @ . @ . @ . @ . @ . . . @ @ . @ . . @ @ @ . @ . @ . @ @ @ @ @ @ . . @ @ . @ . @ . . . . . @ . @ . . @ . . @ . . @ @ @ @ @ . @ . @ . @ . . @ . . . . . . . @ @ @ 
@ @ @ @ . . . . . . . . . . . . . . @ . . @ . . @ @ . . . @ @ . . @ . . @ @ . . . @ . . . . . @ . @ @ . . @ . . . . @ @ @ . @ . @ @ . . . @ . . @ . @ . . @ @ @ @ . @ . . . . . @ . @ @ . @ . @ . @ @ @ 
@ @ @ @ . @ . @ . @ . @ @ . @ . @ . . . @ . @ . . . . @ @ . . @ . . . @ @ @ @ @ . @ @ . @ @ @ . . . @ @ . . . @ . @ . @ . . @ . @ . . @ @ . . @ @ . . . @ . . . @ . . . @ . @ @ . . . @ . @ @ . @ @ @ @ 
@ . . . . . @ @ @ @ . . . @ @ @ . @ @ . . . . . @ @ . . . @ . . @ @ . . @ @ @ . . . . . . . @ . @ . . . . @ @ @ . @ . . @ . . @ @ @ . . @ . @ . . @ @ . . . @ @ @ . @ @ . . @ . @ . @ . @ @ @ . . @ @ @ 
@ . @ @ @ . . @ . . @ @ . . @ . . @ . . @ @ @ . . . @ . @ . @ . @ . @ . @ @ . @ . @ . @ . @ . . . @ . @ . . . . @ @ @ . @ . @ @ @ . . @ . . . @ . . . . @ . . . . . @ . @ @ @ . @ . . . @ . . . @ @ @ @ 
@ @ . . . @ @ . @ . @ . . @ @ @ . . @ . @ . . . @ @ . @ . . . . . . . . . . . . @ . . . @ . . @ . . @ @ @ . @ . . @ . . . . @ @ . @ . @ . @ @ . @ . @ . . @ . @ @ . @ . . @ . . @ . @ @ . . @ . @ @ @ @ 
@ . . @ . @ . . . . . @ @ @ @ . . @ @ @ . @ @ . . . . @ @ @ . @ . @ @ . @ . @ @ @ . @ @ . . @ . @ @ . @ . @ . . @ @ @ @ . @ . . . . . . . @ @ . . @ @ . @ . . . @ . . . @ . . @ . . . @ @ . @ . . @ @ @ 
@ . @ @ . . @ . @ . @ @ @ @ . @ . . . @ . @ @ . @ . @ . . @ @ . @ . @ . @ @ @ . . . . @ . @ @ . . @ . . . . @ . @ @ @ . . . . @ . @ . @ . @ @ . @ @ . . @ . @ . . @ @ @ . @ . @ @ . @ . @ . @ @ . . @ @ 
@ . @ . . @ @ @ @ . . @ . . . @ @ @ . . . . . . . @ . . @ . . . . . @ . . @ . @ . @ @ . . @ . . @ . @ . @ @ . @ . @ . @ . @ @ . @ . . . @ . . . @ . . @ @ . @ . @ @ @ @ . @ . . @ . @ . @ @ . . . @ . @ 
@ . @ @ . . . @ . . @ . @ . @ . . . . @ . @ @ . @ . @ . . @ @ . @ . @ . @ @ . @ . . @ . @ . @ . . . . . . @ . @ . . . . . . @ . @ . @ . . @ @ . . @ . . @ @ . . . @ . . . @ @ . . . . . . . @ @ . @ . @ 
@ @ @ @ . @ . @ @ . . . . . . . @ . @ @ . @ @ . . . . @ . . . @ @ . @ . @ . . . . @ . . . . . . @ . @ . @ . . . . @ . @ @ @ . . . @ . @ @ . . @ . . . @ . @ @ . @ @ . @ . @ . . @ . @ @ . @ @ . . . . @ 
@ @ @ @ @ . . . . . @ . @ . @ . . @ . . @ . . . @ . @ @ @ . @ @ @ . . . . @ @ @ . . . @ . @ . @ @ @ . @ @ . @ . @ . . @ . @ . @ . @ . . @ . @ . @ @ . . . . @ @ @ @ @ . . . . @ @ @ . . @ . . @ @ . @ @ 
@ @ @ @ @ @ @ . @ @ . . @ @ . . @ . @ . . @ @ . . @ . @ . . . @ . . @ . @ . . @ . @ @ @ @ @ @ . . @ . @ . . . @ @ @ . @ . @ . . @ . @ . . . . . . . . @ @ @ . @ . @ @ @ . @ . @ @ @ @ . . @ . . . . . @ 
@ @ @ @ @ @ @ @ . . . @ . . . @ . . . . @ @ . . @ @ . @ @ . @ @ @ . . @ . . @ . . . @ @ . @ @ . @ . . . . @ . . @ @ @ . . . . @ . . @ . @ . @ . @ @ . . @ . . . . . @ @ @ . . . @ @ @ . @ . . @ @ . @ @ 
@ @ @ @ @ @ @ @ @ @ . . @ . @ . @ . @ . . @ . @ . @ . . @ . @ @ @ . @ . @ . . . @ . . . . . . . . @ @ . @ . @ @ @ @ @ @ @ @ . . . @ . @ @ @ . @ . . . @ . @ . @ . @ . @ . @ . @ . @ . . @ . @ . @ @ @ @ 
@ @ @ @ @ @ @ @ @ . . @ @ @ @ . @ . @ . @ . . . . . . @ @ . . @ . . . . . . @ @ . @ . @ . @ . @ @ . @ . . . . @ @ @ @ . @ . @ @ . @ . @ @ @ . @ @ @ . . . . . @ . . . . . @ . . . . @ . . . . . . @ @ @ 
@ @ @ @ @ @ @ @ @ @ . . @ @ . . @ @ . . . @ . @ . @ @ . . . @ . @ . @ @ @ . . @ . @ @ @ @ @ . @ . . @ . @ . @ . @ @ . . . . . @ . @ . . @ . . @ . . . @ . @ @ @ @ . @ @ @ . . @ . @ . . @ @ @ . @ . @ @ 
@ @ @ @ @ @ @ @ @ @ @ . @ . @ . . . . @ . . . @ @ @ . @ @ . . . . . . . . @ @ . . . . @ . @ . @ @ . . . . @ . . . . @ . @ . @ . . @ . @ . @ . . @ @ . . @ @ . @ . @ @ @ @ @ . . @ @ @ . . . @ . @ . . @ 
@ @ @ @ @ @ @ @ @ @ @ @ . . . @ @ @ . . @ @ . . @ . . . . . @ . @ . @ @ . @ . . @ @ @ . . . @ @ . @ . @ . . @ . @ @ . . . @ @ @ . @ . . . . . @ . @ . @ . @ . . . . @ . @ . . @ . @ . . @ @ . @ @ . @ @ 
@ @ @ @ @ @ @ @ @ @ @ . @ @ . . . @ . @ @ . @ . . @ . @ . @ @ @ . . @ @ @ @ . @ . @ @ . @ @ . @ . . . @ . @ @ . @ @ @ . @ . @ . . @ . @ . @ @ . . . . . . . @ . @ @ . . @ @ . . . . . @ @ @ . @ . . @ @ 
@ @ @ @ @ @ @ @ @ @ . . @ @ @ @ . . @ . . . . . @ @ @ @ . @ . . @ . . . . . . . . . . . . . . . . @ @ @ . . @ . . @ . . . . . @ . . . . @ . . . @ . @ . @ . @ . . @ @ . . @ . @ . @ @ . . @ . @ @ . @ @ 
@ @ @ @ @ @ @ @ @ . @ . . . @ . . @ . @ @ @ @ . . @ . . @ . . @ . . @ @ . @ . @ . @ @ . @ . @ @ @ @ @ @ . @ . . @ @ @ . @ . @ @ @ . @ . @ . @ . @ . @ . . @ @ . @ . @ . @ . . . @ . . . @ . . @ . . . @ 
@ @ @ @ @ @ @ @ . . . . @ @ . @ . . . . . @ @ . @ . @ . @ @ . @ . @ . @ @ . . @ @ . . @ . @ . . . . @ @ @ . @ . @ . @ . . @ @ @ . . . @ @ . . @ . . . @ . . . . . . @ . . @ . @ @ @ . @ @ . @ . @ . @ @ 
@ @ . . . @ . @ @ @ @ . @ . . . @ @ @ . @ @ . . . . . . . . . . . . . . @ @ . . . . @ . . . . @ @ @ . @ . . @ . @ . . . @ @ @ . @ . @ . @ . @ . @ @ @ . . @ @ . @ @ . . @ . . . @ . . . . . . . . . . @ 
@ . @ @ . . . @ . . . . . @ @ . @ . . . . . . @ @ @ . @ . @ . @ . @ . @ . . . @ @ @ @ @ . @ . . . @ . @ . @ . . @ . @ @ . . . . . . . . . . . . . @ @ @ . @ . . @ . @ . . @ . @ @ @ . @ @ . @ . @ . @ @ 
@ . @ . @ @ . . @ . @ @ . . . . . @ @ . @ . @ . @ . . @ . . @ . . @ @ @ @ @ . . @ . . . . . @ . @ @ . . . . @ . @ . . . @ @ . @ . @ @ . @ @ @ . @ @ @ @ @ @ @ . @ . . . @ @ . . @ . . . . @ . . . @ @ @ 
@ . . . . . . @ . @ . . @ @ @ @ . . @ . @ @ . . @ @ @ . @ . . @ @ . . @ . . . @ . @ @ . @ . . @ . . . @ @ . @ . @ . @ @ . @ . . @ @ @ @ . . . @ @ @ @ @ @ @ . @ . @ @ . . @ . @ . @ . @ @ . @ @ . . . @ 
@ @ . @ . @ . . . . @ . . . . @ . @ @ @ @ @ @ . . @ . . . . @ . . . @ . @ @ . . . . . @ . . @ . @ @ . . @ . @ . @ . @ @ . . . @ . @ @ . @ . @ . @ . @ . @ @ . . . . . @ . . . . . . . . . . . . @ @ . @ 
@ . . . @ . @ @ @ . @ . @ . @ . . @ @ . . @ . . @ . @ . @ . . . @ . . . . @ . @ . @ @ . @ . . . @ @ . @ . @ . . . . @ . . @ . . . . . . . . . . . . . . . . . @ . @ . . . @ . @ . @ . @ @ . @ @ . . @ @ 
@ . @ @ . . . @ . . @ @ . . . @ . . . . @ @ @ . . . . @ @ . @ . @ . @ . @ . @ . . @ . . . . @ . . . . . . . @ @ . @ . @ @ . . @ . @ @ . @ . @ . @ @ @ . @ . @ . @ @ @ @ @ @ @ . @ . . . @ . . . @ . @ @ 
@ @ . . @ . @ . @ . @ . @ . @ . . @ . @ @ . . . @ @ @ @ @ @ @ @ . . . @ . . @ @ . @ @ . @ . . @ @ . @ . @ @ . . . . . . @ @ . @ @ @ . . @ . @ @ . . . . @ . . . . . . . . @ . . @ @ . @ @ . @ @ . . . @ 
@ @ @ . . . . . . . . . . . . @ . . @ . @ . @ . . @ . @ @ . @ . @ . @ . @ . @ @ @ . @ @ . . @ . . @ . @ . . @ @ . @ . @ . @ . @ . @ . @ . @ . @ @ . @ . @ . @ . @ @ . @ . . . @ . . @ . . @ . . . @ . @ 
@ . . . @ . @ . @ . @ . @ @ . . . @ . . . @ . . @ . . . . . . . . . . . . . @ . @ . @ . @ . . @ . . . . . @ @ @ . @ . . . . . . . . @ . . . . . @ @ @ @ . . . @ . . . . @ @ @ @ . @ . @ . @ . @ @ @ . @ 
@ . @ . @ @ . . @ . . @ . . . @ . @ @ . @ . @ . @ . @ @ @ . @ . @ . @ . @ . . . @ . . . . @ . . . @ @ @ @ . @ @ @ @ . @ . @ . @ . @ . @ . @ . @ @ @ @ . @ . @ @ @ . @ . . . . . . . . . . . . . . . @ @ 
@ @ @ @ . . . @ . . @ . . @ @ . . . . . . . . . . . . @ @ @ . @ . . @ . . @ . @ . @ @ . @ . @ @ . . . . . . . . . . . @ . . @ @ . . . . . . @ . @ @ . . . . . @ @ . @ . @ . @ . @ @ . @ . @ . @ . @ . @ 
@ @ @ @ @ . @ . @ @ . @ @ @ . @ @ . @ @ @ . @ . @ . @ . @ @ . . . @ @ . @ @ . . . . . . . . . . . @ . @ . @ @ . @ . @ . . @ @ @ @ . @ . @ . . . @ @ @ . @ . @ . . . @ . @ @ @ . . . @ @ . . @ . . . . @ 
@ @ . @ . . @ . . @ . . . . . . . . . . . @ . . . @ . . . . . @ . . @ . @ . . @ . @ @ . @ @ @ . @ . . . @ . . . . @ . @ @ @ @ @ . @ . @ . . @ @ . @ . @ . . . @ @ . @ . . . . @ @ . . . @ @ @ @ . @ . @ 
@ . . . @ . . . @ @ @ @ @ . @ . @ . @ @ . . @ . @ @ @ . @ . @ . . @ . . . @ . . @ . @ . . . . @ @ @ @ . . @ . @ . . . . @ . @ . . . . . . @ . @ . . . @ @ . @ . @ . @ . @ . @ . . . @ . @ . @ @ . . @ @ 
@ @ @ . . . @ @ @ @ @ @ @ @ . . @ . . . @ @ . @ . @ . @ . . @ @ @ . @ @ @ @ @ . . . . @ . @ @ . @ @ @ . @ . . @ @ . @ . . . . @ . @ . @ . . . @ @ . @ . @ . . . . @ . . @ . . @ @ @ @ . . . . . @ . . @ 
@ . . . @ . . . @ @ @ @ @ @ @ @ . . @ . . . . . . . . @ @ . . . @ . @ . . . . . @ . @ @ . @ . . . @ . @ @ @ . . @ . @ @ . @ . @ @ . . @ . @ . @ . . @ . . . @ @ . . @ . . @ . . . . . @ . @ . @ . . @ @ 
@ @ @ . @ @ . @ @ @ @ @ @ @ @ @ @ . . @ . @ . @ . @ . @ . . @ . . . . @ . @ . @ . . . . @ @ . @ @ @ . . . @ . @ @ . . @ . . @ . @ @ . @ . . @ . @ . . @ @ . . . @ . . @ @ . . @ . @ . @ . . @ @ @ . . @ 
@ @ @ @ @ . . . . @ @ @ . @ . @ @ @ @ . . @ . . @ @ @ . @ . . @ @ @ . . @ . . @ @ . @ @ . . . . @ . @ . @ . @ . @ . @ . . @ @ . . . @ . . @ . . . . @ . . . @ . . @ @ . @ . @ @ . . @ . . @ . @ @ . @ @ 
@ @ @ @ @ @ . @ . . @ . . . . . @ . . @ @ . . @ @ @ . . . . @ @ . @ . @ @ @ . . @ . . . @ @ . @ . . . . . . . . . @ @ @ @ . . . @ @ . . @ . @ @ . @ . @ @ @ @ . @ . @ . . @ . . . @ . @ . . . . . @ @ @ 
@ @ @ @ @ . @ . . @ . . @ . @ @ . @ . @ . @ . @ @ @ @ . @ . . . . @ . . @ @ . @ @ . @ . . . . . . @ . @ . @ @ . @ @ @ @ . . @ . . . @ . . . . . . . . . @ . @ . . . . . @ @ @ @ . @ . @ . @ @ . @ . @ @ 
@ @ @ @ . . . . @ . . @ . . @ . . . . . . . . . @ @ @ . . @ . @ . . @ @ . . . . . @ . @ . @ @ . @ . . . @ @ @ @ @ @ @ . . @ . . @ @ . @ . @ @ . @ . @ . . . @ @ . @ @ . . . . . @ @ . . . . . @ . . . @ 
@ @ @ @ @ . @ . . . @ . @ @ . @ . @ @ . @ @ . @ . @ @ @ @ . . . @ . . . @ . @ . @ @ . . . . . @ . @ . @ . . @ @ @ @ @ . @ . @ . . @ . @ @ . . @ . . . @ @ . @ . @ . . @ . @ . @ . @ . @ . @ . . . @ . @ 
@ @ @ @ @ . @ . @ . . . . . . @ . @ . @ . . . . . . @ @ . . @ . . @ @ @ . . @ . @ . @ @ . @ . @ . . . @ . @ . @ . @ . @ @ . . . @ @ . @ @ . @ . @ . @ @ . . . . . . @ @ . . @ . . @ . . @ . @ . @ @ . @ 
@ @ @ @ @ @ . . . @ @ . @ @ . @ @ . . . . @ . @ . @ @ . @ . @ . @ . . @ @ . @ . . . . @ . @ . . @ @ . . . . . . . . . . . @ @ . . . . . . . . . . . . @ @ @ . @ . @ . . . @ . . @ . @ @ @ . . . @ . @ @ 
@ @ @ @ @ @ @ . @ . @ . . . @ @ @ @ . @ . . @ . . . @ . . . @ . @ . @ . . . @ . @ . @ . @ . . @ @ . . @ . @ . @ @ . @ . @ @ @ @ . @ . @ . @ . @ . @ . . . . @ . . @ @ @ . @ . @ . . @ . . @ @ . . . . @ 
@ @ @ @ @ @ @ . . . . @ . @ @ @ @ @ @ . . @ @ . @ . @ @ @ . @ . . . . @ @ . . @ . . . . @ . @ @ @ @ . . @ @ . . . @ @ . @ @ @ . . @ @ . . . @ . . @ . @ . @ @ @ . . @ @ . . . . . @ . @ . @ @ @ @ . @ @ 
@ @ @ @ @ @ @ . @ . @ @ @ @ @ @ @ @ @ @ . . . @ @ . @ @ . . @ . @ . @ . . . @ @ @ . @ . . @ . @ @ @ @ @ . . . @ . . . @ @ @ @ @ @ . . . @ . . @ . @ . . @ @ @ @ @ . @ @ . @ . @ . . . . . . @ @ . . . @ 
@ @ @ @ @ @ @ @ @ @ @ @ @ @ @ @ @ @ @ @ . @ . @ @ @ @ @ @ . @ . @ . @ . @ . @ @ @ @ @ @ . . . . @ @ @ @ @ @ . . @ . @ @ @ @ @ @ @ @ @ . @ . @ @ @ @ . @ @ @ @ @ @ . . @ . . @ @ @ @ @ . @ @ @ @ @ . @ @ 
@ @ @ @ @ @ @ @ @ @ @ @ @ @ @ @ @ @ @ @ @ @ @ @ @ @ @ @ @ @ @ @ @ @ @ @ @ @ @ @ @ @ @ @ @ @ @ @ @ @ @ @ @ @ @ @ @ @ @ @ @ @ @ @ @ @ @ @ @ @ @ @ @ @ @ @ @ @ @ @ @ @ @ @ @ @ @ @ @ @ @ @ @ @ @ @ @ @ @ @ 
3
33 66 14 80
27 61 4 29
43 63 55 31
