12 12
@ @ @ @ @ @ @ @ @ @ @ @ 
@ . . . . @ @ @ . . @ @ 
@ @ @ @ . @ @ . @ . @ @ 
@ @ . . . . . . . . @ @ 
@ . @ @ . @ @ @ @ . @ @ 
@ . @ @ . @ @ . @ @ @ @ 
@ . . . . @ . . . . @ @ 
@ @ . @ . . . @ @ . @ @ 
@ . . @ @ @ @ @ . . . @ 
@ @ . . @ @ @ @ @ @ @ @ 
@ . . @ @ @ @ @ @ @ @ @ 
@ @ @ @ @ @ @ @ @ @ @ @ 
3
1 2 4 4
1 3 5 1
3 4 3 2
