20 20
@ @ @ @ @ @ @ @ @ @ @ @ @ @ @ @ @ @ @ @ 
@ @ @ @ @ @ @ @ . @ . @ . . @ . . . @ @ 
@ @ @ @ @ @ @ . . . . . . @ . . @ . . @ 
@ @ @ @ @ @ . @ @ @ @ @ . . . @ . . @ @ 
@ @ @ @ @ . . . . . . . . @ . . @ @ @ @ 
@ @ @ @ @ @ . @ . @ . @ . . @ . @ . @ @ 
@ @ @ @ . @ @ . @ @ @ . . @ @ . . . . @ 
@ @ @ @ . @ . . @ @ @ @ . . . @ . @ . @ 
@ @ @ . . @ . @ . @ . . . @ . . @ . . @ 
@ @ @ @ . . . . . @ . @ . . @ @ . . @ @ 
@ @ @ . . @ . @ . . . @ . @ . . @ . . @ 
@ @ . @ @ . @ . @ . @ . . . . @ . @ @ @ 
@ . . . . . . . . . @ @ . @ . . . . . @ 
@ . @ . @ . @ @ . @ . . . . @ @ . @ . @ 
@ . . @ . . @ . @ . . @ . @ @ @ @ . . @ 
@ . @ @ @ @ . . . . @ . . . @ @ . @ . @ 
@ . @ @ @ @ @ . @ . @ @ . @ @ . . . . @ 
@ @ @ @ @ @ @ @ @ @ . . . @ . . @ . @ @ 
@ @ @ @ @ @ @ @ @ . . @ . @ . @ . . . @ 
@ @ @ @ @ @ @ @ @ @ @ @ @ @ @ @ @ @ @ @ 
3
8 4 10 15
8 10 12 2
2 17 9 8
