50 50
@ @ @ @ @ @ @ @ @ @ @ @ @ @ @ @ @ @ @ @ @ @ @ @ @ @ @ @ @ @ @ @ @ @ @ @ @ @ @ @ @ @ @ @ @ @ @ @ @ @ 
@ @ @ @ @ . . . @ . . . @ . . . @ . . . . . @ . . @ . @ . . @ . @ . . . @ @ @ @ @ @ . . @ @ . . . @ 
@ @ @ . @ @ @ . . @ @ . . . @ @ . . @ . @ @ . @ . . . @ . @ . . @ @ @ . . @ . @ . . . @ . @ . @ . @ 
@ @ @ . @ . . @ . @ . @ . @ @ . @ . @ @ . . . . . @ @ . . . . @ @ @ . @ . . . . . @ @ . . . @ . . @ 
@ @ . . @ . @ . . . . . . . . . . . . @ . @ . @ . . . @ . @ @ . @ . . . . @ . @ . @ . @ . @ . @ . @ 
@ . . @ . . @ @ . @ @ . @ . @ . @ . @ . @ @ @ . . @ @ . . . @ . . @ . @ . . @ . . @ . @ . . . . . @ 
@ @ . @ @ . . . . . . @ . . . @ . . . . . . . @ . . @ @ . @ . . @ @ @ . . @ . . @ . . . . @ . @ . @ 
@ . . . @ @ @ . @ . @ . . @ . . @ . @ . @ . @ @ @ . . @ . . . @ . @ . @ . @ . @ @ @ @ . @ @ @ @ @ @ 
@ . @ . . . @ . . @ @ @ . @ . @ . . . @ @ @ @ @ @ . @ . . @ . @ . . . . . . @ @ @ . . . @ @ @ . . @ 
@ @ . . @ @ . @ @ @ @ @ @ . @ . @ . @ @ @ @ @ @ . . . @ . @ @ . @ @ . @ . @ . @ @ @ @ . . @ . . @ @ 
@ @ @ . . @ . . @ @ @ @ @ . . . . . @ . @ @ @ . @ . @ . . . . . . . @ . . @ . . @ . @ . @ . @ . . @ 
@ @ @ @ . . . @ @ @ @ @ @ @ @ @ @ . . . . @ . . . . . . @ . @ @ . @ @ @ . . . @ . . . . . . . . @ @ 
@ @ @ @ @ @ . @ @ @ @ @ @ @ @ @ . @ @ @ . . @ . @ . @ @ @ @ @ . @ @ @ @ . @ @ . . @ . @ . @ @ . . @ 
@ @ @ @ . . . . @ @ @ @ @ @ @ . . @ @ . . @ . . . @ @ @ . @ . . . . @ @ . . @ . @ @ . . @ . . . @ @ 
@ @ @ @ . @ . @ @ @ @ @ @ @ . @ . . . @ . . . @ @ . @ . . . @ . @ @ . @ . @ @ . @ @ . @ . @ @ . @ @ 
@ @ @ . @ . . . @ @ @ @ @ . . . . @ @ . . @ @ @ . . . @ @ . . . . . . . . . . . . @ . @ . @ @ @ . @ 
@ @ . . @ @ . @ @ . @ @ @ @ . @ . @ . @ . . @ . @ . @ . . . @ . @ @ . @ . @ . @ @ . @ @ . @ . @ . @ 
@ . @ . @ . . . . . @ . @ . @ . . . . . . @ . . . . . . @ . . @ . @ @ . @ @ @ @ @ . @ @ . . . . . @ 
@ . . . . . @ @ @ . . . . . . . @ . @ @ . . @ . @ . @ @ . @ . . . . . . @ @ . @ . . . @ . @ . @ . @ 
@ @ @ @ @ @ . . . . @ . @ . @ . @ @ @ @ @ . @ @ . . . . . . @ . @ @ @ @ . . . . @ . @ @ . @ . . @ @ 
@ . . . . . . @ . @ . . . @ @ @ . . @ @ @ . @ . @ . @ . @ . . @ @ @ @ . @ . @ . . . @ . @ @ @ . . @ 
@ . @ . @ . @ . . @ @ @ @ @ @ . @ . @ @ . . . . . . . @ @ @ @ @ @ @ . . . . @ . @ @ @ . . @ . . @ @ 
@ . . @ . @ . @ @ . @ . @ @ . . @ . @ @ @ . @ @ . @ . . . . @ @ @ . @ . @ @ @ @ @ @ . . @ . @ . . @ 
@ . @ @ . . . . . . . . . . @ . @ . @ . @ . . @ . @ . @ . @ . @ . . . . . @ @ @ @ @ . @ . . . . @ @ 
@ . . . @ @ . @ . @ . @ . @ @ . . . . . . . @ . @ @ @ . . . . . . @ @ . @ . @ @ @ . . . @ @ @ . @ @ 
@ . @ . . @ @ . @ . . . @ @ . @ . @ . @ @ @ . . . . . @ . @ @ @ . . . @ @ . . @ . @ . @ @ . . . . @ 
@ . . @ @ @ . . . . @ . . . . . . . @ . . . @ @ . @ . @ . . . @ . @ . . @ . @ . . . . . @ . @ . @ @ 
@ . @ @ @ . @ . @ . . @ . @ @ @ . @ . @ . @ . . @ . . . @ . @ @ . @ . @ @ . . @ . @ . @ @ . @ . . @ 
@ @ . @ . . . @ . . @ . . @ @ @ . . . . . . . @ @ @ . @ . . . . @ @ @ . . @ . @ @ @ . @ . @ . . @ @ 
@ . . . . @ . @ @ @ . . @ . . . . @ . @ . @ . . @ @ . @ @ . @ @ . @ . @ . . . . . . . . . . . @ @ @ 
@ @ . @ @ . @ @ @ . . @ @ @ . @ . . @ @ . . @ @ . . . . . . . . . . . . @ @ . @ . @ @ @ . @ . @ . @ 
@ . . . . . . @ . @ . @ @ @ @ . . @ . @ . @ . . @ . @ . @ . @ @ . @ . @ @ @ @ . @ @ @ @ @ . . . . @ 
@ @ @ @ @ @ . . . @ . @ . @ . @ . . . @ . @ @ . @ . . @ . . . . @ @ . @ @ @ @ . @ @ @ @ @ @ . @ . @ 
@ . . . . . . @ . . . @ . . . . . @ @ . @ . . . . . @ . @ . @ . . . @ @ @ @ @ . . . @ @ @ @ @ . . @ 
@ . @ . @ . @ @ @ . @ . . @ . @ . . . . @ . @ @ @ @ . . . . . @ . @ . @ . @ @ . @ @ . @ @ @ . @ . @ 
@ @ . @ . . @ @ . . . @ @ @ @ . . @ . @ . . . @ . . . @ @ . @ @ . . . . . . . . . . . . @ . . @ . @ 
@ . . . @ . . . @ . @ @ @ . @ @ . @ @ @ . @ @ . @ . @ . . . . @ . @ @ @ . @ . @ . @ . @ . @ . . . @ 
@ @ . @ . @ @ @ @ . . @ . . . . . . . . @ . . . . . . @ . @ . . @ . . @ . . @ @ @ . . @ . . @ @ . @ 
@ . . . . . . . . . @ . @ . @ @ . @ . @ @ . @ . @ . @ . @ @ . @ @ . @ @ . @ . @ . @ . @ . @ . @ . @ 
@ @ . @ @ . @ . @ . . . @ @ . . . @ . . @ @ @ @ . . . . . @ . . . . . . @ @ . @ . @ . . . . . . . @ 
@ . . @ @ @ . . @ . @ @ @ @ @ @ . . @ . @ . @ . @ . @ . @ . @ @ . @ . @ @ @ . @ . . . @ . @ @ @ @ @ 
@ @ . . @ . . @ . . . . @ @ . @ @ @ . @ . . . . . . . @ @ . . . . . @ @ @ . . @ @ . @ @ . @ @ @ @ @ 
@ @ @ @ . @ . @ . @ . @ . . . . . . . . . @ . @ . @ . . @ . @ @ . @ . @ . @ . @ . . @ @ . . . @ @ @ 
@ . . . . @ @ . . . @ . . @ . @ . @ . @ . @ @ . . @ . @ @ @ @ @ . . . . . . . . @ @ . . . @ . . . @ 
@ @ . @ . . . . @ @ @ @ . . @ . . . @ @ @ . . . @ . . . @ @ . @ . @ . @ . @ . @ . . . @ . @ @ . @ @ 
@ @ @ @ @ . @ . . . @ . . @ @ @ . @ . @ . . @ . . @ . @ . @ . @ . . @ . . . @ . . @ @ . . . @ . . @ 
@ @ @ @ @ @ . . @ @ . @ . . @ . @ . . . . @ . . @ . . @ . . . . . @ . @ @ . . @ @ . . . @ @ @ . @ @ 
@ @ @ @ @ . @ . . . . . @ @ . . . . @ . @ @ @ @ @ @ . @ @ . @ @ . . . . . @ @ @ . . @ . . . @ . . @ 
@ @ @ @ . . . . @ . @ @ @ @ @ . @ . . @ @ @ @ @ @ @ @ @ . . . @ . @ . @ . . . . @ @ . . @ . @ . @ @ 
@ @ @ @ @ @ @ @ @ @ @ @ @ @ @ @ @ @ @ @ @ @ @ @ @ @ @ @ @ @ @ @ @ @ @ @ @ @ @ @ @ @ @ @ @ @ @ @ @ @ 
3
27 29 28 22
6 7 34 30
32 48 4 42
