100 100
@ @ @ @ @ @ @ @ @ @ @ @ @ @ @ @ @ @ @ @ @ @ @ @ @ @ @ @ @ @ @ @ @ @ @ @ @ @ @ @ @ @ @ @ @ @ @ @ @ @ @ @ @ @ @ @ @ @ @ @ @ @ @ @ @ @ @ @ @ @ @ @ @ @ @ @ @ @ @ @ @ @ @ @ @ @ @ @ @ @ @ @ @ @ @ @ @ @ @ @ 
@ @ @ @ . . @ @ @ . @ @ @ . . . . @ @ . @ . @ . @ @ . . . @ . . @ . . . . @ @ @ @ . . . . . . @ @ @ . . . . @ . . @ @ @ . . @ . . @ . . . @ @ . . @ @ @ . @ @ @ . @ . @ @ @ . @ @ @ @ @ @ @ @ @ @ @ @ @ 
@ @ @ @ @ . . . . . . . . . @ . @ . . . . . . . @ . . @ . . @ . . @ . @ @ @ @ @ . @ . @ @ . @ @ @ . @ @ . @ @ @ . @ @ . @ . . . @ . @ @ . . . @ . . @ . . . @ . . . . . @ . . @ @ @ @ @ . . @ @ @ @ @ @ 
@ @ @ @ @ @ . @ . @ . @ . @ . . . . @ . @ . @ . . @ . . @ . . @ . . . . . @ @ . . @ . @ . . . @ . . . . . . @ . . . . . . . @ . . . . @ @ . @ . . @ . @ @ . . @ . @ @ . @ . @ . @ @ @ . . @ . @ @ @ @ @ 
@ @ @ @ @ @ @ @ @ . . . @ . . @ . @ . . . @ . @ . @ . @ @ @ . . @ . @ . @ @ @ . @ @ @ . @ . @ . @ . @ @ . @ @ @ @ . @ . @ . @ . @ @ @ . . . . @ . . . @ . @ . @ . . . @ . . . . . . @ @ . . . @ @ @ @ @ 
@ @ @ @ @ @ @ @ @ @ @ @ @ @ . . @ @ . @ @ . . . . . @ . @ . @ . @ @ . . . @ . . . @ . . . . @ . . @ . . . @ . . @ . . @ . @ . . . @ @ @ @ . @ . @ @ . . . . . . . @ @ . @ . @ @ @ @ . . @ @ . . @ @ @ @ 
@ @ @ @ @ @ @ @ @ @ . @ . . . @ . @ @ @ . . @ @ . @ . . . . . . . . @ . @ . @ . @ . @ @ @ . @ . @ . @ @ . @ . @ @ @ @ . . . @ @ . . @ @ . . . . . . @ . @ . @ @ . . . . @ . . @ . @ . @ . . . @ @ @ @ @ 
@ @ @ @ @ @ @ @ @ . . . . @ . . . . . . @ . @ . . . . @ . @ . @ @ . . . . . . . @ . @ @ . . . . . . @ @ . . . @ @ @ . . @ . @ . @ . . @ @ . @ . @ @ @ . . @ . . @ @ @ . . . @ . . . . . . @ . @ @ @ @ @ 
@ @ @ @ @ @ @ @ @ @ . @ . . @ . @ . @ @ @ @ . @ . @ . . @ @ @ . @ @ . @ . @ @ . . . . . @ @ . @ @ . @ . @ . @ . @ . @ . . @ . . . . @ @ @ . @ . . . @ @ @ . . @ . . . @ @ . . . @ . @ . @ . @ . @ @ @ @ 
@ @ @ @ @ @ @ @ @ @ @ . . @ . . . @ . . . @ . . @ . . @ @ . @ . @ . @ . @ . @ . @ . @ . . @ . @ . . . . @ . . . . . . . @ . @ . @ . . @ @ . . @ . @ @ @ . @ . . @ . @ . . . @ @ . @ . . . . . . . @ @ @ 
@ @ @ @ @ @ @ @ @ @ @ @ . . @ . @ . @ . @ . @ . . @ . . . . @ . . . . . . . . @ . @ . . @ . @ . @ @ . @ . @ . @ @ . @ . . . . @ @ . @ . @ . @ . @ @ @ . . . . @ . . . . @ @ . . . . @ @ @ . @ . @ @ @ @ 
@ @ @ @ . @ @ @ @ @ . . . @ @ . . . . . @ . @ @ . . @ . @ . . @ . @ @ @ @ @ . . . . @ . . . . . . . . . . @ @ . . @ . @ @ @ . @ @ . . . . . . . . @ . @ . @ . . . @ . @ . . . @ . @ . @ @ @ . . @ @ @ @ 
@ @ @ . . @ @ @ @ @ . @ . . @ @ . @ @ . . . @ @ . @ @ . @ @ @ @ @ . . . . . . @ @ . . . @ . @ . @ . @ @ . . . . @ . . . @ . . . . . @ . @ . @ . @ . . @ @ . . @ . . @ @ . @ @ . @ @ . . . . . @ @ @ @ @ 
@ @ . @ . . @ @ . . @ . . @ @ @ @ @ . . @ @ . . . . . @ . @ @ @ @ . @ . @ @ @ @ @ @ @ . @ @ @ . @ . @ . @ @ . @ . @ . @ . . @ . @ . . @ @ @ . @ @ . @ @ @ @ . . @ @ . . . . . . . . @ @ . @ @ @ @ @ @ @ 
@ . . . . @ . @ . @ . @ @ @ @ @ @ @ @ . @ . @ @ @ . @ . . . @ @ . @ @ @ @ . . . @ @ . . @ . @ . @ @ . . @ @ . . . . . . @ @ . @ . . @ @ @ @ . . @ . . @ . @ . @ . @ @ . @ . @ @ . @ . @ . . @ @ @ @ @ @ 
@ @ . @ . @ . @ . @ . @ @ @ @ @ @ @ @ . @ . @ @ @ . . @ . @ @ . . @ . @ . @ . @ . . @ @ . . . @ @ . @ . @ . @ . @ . @ . . @ . . @ . . @ . . @ . . . @ . . . . . . . . . . @ . @ @ . . . . @ @ @ @ @ @ @ 
@ @ @ . . . . . . @ . . @ . @ . @ @ . @ . . . @ . . @ . . . . @ . . . . . . . . . @ @ @ @ . @ @ . . . . . . @ @ . @ . @ . . . @ . . @ . @ . . . @ @ . @ @ . @ . @ . @ . @ . . . @ . @ . @ @ @ @ @ @ @ @ 
@ . . @ . @ . @ . . . @ . . . . . . . . . @ . . @ . @ . @ @ @ @ @ @ @ @ @ . @ . @ . @ . . . @ . . @ . @ @ . . . . . . . . @ . . @ . . . . . @ @ . . . . . . . @ @ @ . . . . @ @ @ @ . . . @ @ @ @ @ @ @ 
@ @ . @ @ . @ . @ . @ @ @ . @ @ . @ . @ . . @ . . . @ . . @ @ @ @ . . . . @ . . . . . . @ . . . @ . . . . @ . @ . @ . @ . . @ @ . . @ @ . @ @ @ @ . @ . @ . @ @ @ @ @ . @ @ . @ @ @ @ . @ . @ @ @ @ @ @ 
@ . . . . . . . . . @ @ @ @ . . @ . @ . . @ @ . @ . . . @ . . @ @ @ . @ . . . @ . @ @ . . @ @ @ @ @ . @ @ @ @ @ @ . @ . . @ . . . @ . . . . @ @ . . @ @ . . . @ @ @ @ @ . . . . @ @ @ @ @ . . @ . @ . @ 
@ @ @ @ . @ @ . @ . @ @ @ @ @ . . . @ @ . @ . @ . @ . @ . @ . . @ . . . @ . @ . @ @ @ . @ . @ @ @ @ @ @ @ @ @ @ . . . . @ . @ @ . . @ @ . @ @ @ @ . @ . @ . @ . @ . @ @ @ . @ . @ @ @ . . . @ . . . . @ 
@ . . @ @ . . @ . . . @ @ @ . . @ . . . @ . . . . . . . . . . @ . @ . @ @ . . . . @ . . . . . . . . . @ @ @ @ . @ @ @ . . . @ . . @ @ @ @ @ @ @ @ @ . . . . . . . . . . @ @ . . . @ @ . @ @ . . @ @ . @ 
@ @ . @ @ . @ @ . @ . @ @ . @ @ . . @ @ . . @ . @ . @ . @ @ . . . . . @ . . @ . @ . @ . @ . @ . @ . @ . @ @ . . . . . . @ . . @ . . @ @ @ @ @ @ @ @ . @ . @ . @ . @ . @ . @ @ @ . @ . . . @ . @ . . @ @ 
@ . . @ . . . . @ . . . . . . . @ . @ . @ . . @ . . . @ . . . @ . @ . . @ . @ @ . . . . @ @ @ . . @ . . @ @ @ . @ @ . @ @ @ . . . @ @ @ @ @ . @ @ @ . . @ @ @ @ . . @ @ . . @ . . . @ . @ @ . @ . @ . @ 
@ @ . @ @ . @ . @ @ @ @ . @ @ . . . . . . . @ . @ . @ @ @ @ . @ . . @ @ . . @ . @ . @ . . . . @ . . . @ . @ @ @ . . @ . @ . @ @ . . @ @ @ @ . . @ . . @ @ . . @ @ . @ @ . @ . @ . @ . . . . . . . . . @ 
@ @ . @ @ @ . . @ @ @ . @ . . @ . @ . @ . @ . . @ @ @ @ @ @ . . @ @ . @ @ . @ . . . . @ . @ . . @ . @ @ . . @ . @ . @ . . . . . . @ @ @ . @ . @ . @ . @ . . @ @ @ @ . . . . . . . . . @ . @ @ @ . @ . @ 
@ . . . @ . @ . . @ @ . . . @ . @ @ . @ . @ . @ . @ @ @ @ . @ . . . . . . @ . @ @ @ @ . . . @ . @ . . @ . @ . . . . . @ @ @ . @ . . @ . . @ . . . . . . . @ . @ @ @ . @ . @ . @ @ @ . @ . @ . . @ @ @ @ 
@ . @ . . . . @ . . . . @ @ @ . @ . @ . . . . . . . @ @ @ . . @ . @ . @ @ . . . . . @ @ . @ @ @ . . @ @ . @ @ . @ @ . @ @ @ @ @ . @ . @ . @ @ . @ @ . @ . . . . @ . . . @ . @ @ . @ . @ @ . @ . @ @ @ @ 
@ @ . @ . @ . . @ @ @ . . @ . . . . . @ . @ @ @ . @ @ @ . . @ @ . . @ @ @ @ . @ @ . . . @ @ @ @ @ . @ @ . . . @ . . . . @ . . . . . . . . . . . . . @ @ . @ . @ . @ . @ . . . . . . @ . @ . . . . @ . @ 
@ . . . . @ @ . . . @ . @ @ @ . @ . @ . @ . . . . . @ @ @ . . . @ @ @ . @ @ . @ . . @ @ @ @ @ @ @ @ . . . @ @ . @ @ . @ . @ . @ . @ @ . @ . @ . @ . . . @ @ . . . . . . @ . @ @ . @ @ . @ . @ . @ . . @ 
@ . @ @ @ @ . @ . @ @ . . @ . . . @ . . . @ . @ . @ @ @ . . @ . . @ . . @ . @ . . @ . @ @ @ @ @ @ . @ @ . @ @ . . . . . . . . . @ . . . @ @ . . . @ . @ @ . @ . @ . @ . . . . . @ . . . . . . @ @ @ . @ 
@ . @ @ . . . . . . . . @ . @ . @ . @ . @ . @ . @ @ @ . . @ . @ . . @ . . . @ @ . . . . . @ @ @ @ . . . . . . . @ . @ @ . @ . @ @ . @ . @ . @ . @ . @ @ . . . . . @ @ . @ . @ . . . @ . @ . @ @ @ . . @ 
@ @ . . . @ @ @ . @ @ . . . . . . . . . . . . . . . . . @ . . . @ @ . . @ . @ . @ @ . @ @ @ @ @ @ @ @ . @ . @ . @ @ . . . @ @ . . . . @ . . . . @ . . @ . @ @ . @ . . . . @ . . @ . @ . . @ @ @ . @ . @ 
@ . @ @ @ . . @ @ @ @ @ @ @ . @ @ . @ . @ @ . @ . @ @ . . . @ . . . . @ . @ . . . @ . . @ @ @ @ @ @ @ @ . @ . . @ @ @ . @ . . . @ . @ @ @ . @ . . . @ . @ . . . @ @ @ . @ @ @ . . @ @ @ . . @ @ . . . @ 
@ . . . . @ . . @ @ . . . . @ . . @ @ . @ @ @ . . @ . . @ @ . @ @ @ . @ . @ @ @ . . . @ @ @ @ @ @ @ @ @ . @ . @ . @ @ @ . . @ . @ @ @ @ . @ . . @ @ . . . . @ . @ . @ @ . @ @ . @ @ @ . @ . @ . @ @ . @ 
@ @ @ . @ . @ . @ . @ @ . @ @ . @ . . @ . @ . . @ . @ . . . . @ @ @ @ . . . . @ @ @ . . . @ . @ @ @ . . . . . . . . @ . @ . . @ @ . @ . . @ @ . . . @ @ @ . @ . . . . . . . . @ @ @ . . . . . . . . . @ 
@ . . . . . . . . . . . . . . . . . @ . . @ @ @ . . . . @ . @ @ @ @ . @ . @ @ . . . @ @ . . . . @ @ @ @ . @ . @ . @ . . . @ . . . . . @ . @ . . @ . . . @ . @ . @ . @ . @ . @ @ @ @ . @ @ @ . @ . @ . @ 
@ @ @ . @ . @ . @ . @ @ @ . @ . @ . . @ . . . . @ @ @ . . @ @ . @ . . . . @ . @ @ . @ . @ @ . @ . . @ @ @ . . . @ . @ @ . . . @ @ . @ . . @ @ . . @ @ . @ @ . . . @ . . . @ @ @ @ @ . . . . @ . . @ . @ 
@ @ @ @ @ @ . @ . @ . @ . . . @ . . @ . . @ @ @ . . . @ . . . . @ . @ @ . . . . . . . . . . . . . @ . @ . @ . @ . . . . . @ . @ @ . . . @ . . . @ @ @ @ . . @ . @ . @ @ @ @ @ @ @ . @ . @ . . @ . . @ @ 
@ @ @ @ @ . . . . . . . @ . @ . @ . @ . @ @ @ . @ . @ . @ @ @ . . . . . @ . @ . @ @ . @ @ @ . @ . . . . . . . @ . @ . @ @ . . . . @ @ @ . . @ . @ @ @ @ @ . @ . . . . . . @ @ @ . . . @ . . @ . @ . . @ 
@ @ @ @ @ @ @ @ @ . @ . @ @ . . . . . . . . . . . . . . . . . . @ . @ . @ @ @ @ @ . @ @ . @ @ @ . @ . @ . @ @ . @ . . . @ @ . @ . @ @ @ @ @ . . . @ @ @ @ . . . @ @ . @ . . @ @ @ . @ . @ @ . . . . @ @ 
@ @ @ @ @ @ . . . @ . . . . . @ . @ @ . @ @ . @ . @ . @ . @ . @ . . @ @ . @ . . . . . . . . . . . . @ . . . . . . @ . @ . . . . @ . @ @ @ @ @ . @ @ . . . @ @ . . . @ @ . @ . @ . . . . @ @ @ . @ @ @ @ 
@ @ @ @ @ @ @ . @ . @ . @ . @ . . . . @ . . . @ . . @ . . . @ . @ @ . @ . . @ @ . @ @ . @ . @ @ @ @ @ @ . @ @ @ @ . @ . @ . @ . @ . @ @ @ @ @ . @ . @ . @ . @ @ . @ @ . . . . . . @ @ @ @ @ . . . . @ @ 
@ @ @ @ @ . . . . . . . @ . @ @ . @ . . @ . @ . . @ @ @ . @ . . . . . . . @ . . . @ @ @ . . . @ @ . @ . @ @ . . . . @ . . . @ @ . . . @ @ . @ . . . @ . . . . . . @ . @ . @ . @ . . . . @ @ @ . @ @ @ @ 
@ @ @ @ @ @ @ . @ @ . @ . @ . . . . @ . @ @ @ @ . . @ @ @ @ @ @ . @ . @ . . . @ . . . . @ . @ . . . . . . . . @ @ . . . @ . @ . @ @ . . . . . . @ . . @ @ . @ @ . . . . @ . . . @ . @ . . @ . . @ . @ @ 
@ @ @ @ . . @ . . . @ . . . . @ . @ @ @ @ . @ . . @ @ . @ @ . @ @ . @ @ @ . @ . . @ . @ . . . @ . @ . @ . @ @ @ @ @ @ . . @ @ . . . . @ . @ . @ . . @ @ @ @ . . . @ @ . @ @ . @ @ . . @ . @ @ . . . . @ 
@ @ @ . @ . . . @ @ @ . @ . @ . @ @ @ @ . . . . @ . @ . . @ . . @ . . . . . @ @ . . @ @ . @ . @ . @ @ @ . . @ @ @ @ . . @ @ . @ . @ . . @ @ . . @ @ @ @ @ . @ . @ @ . . . . @ . @ . @ . @ @ @ @ . @ . @ 
@ . . . . @ @ @ @ . @ . @ . . . . . @ @ . @ @ . . . . . @ . . @ . @ . @ . @ . . . @ @ @ . @ . @ . . @ . . @ . @ @ @ @ @ @ . . . . @ . @ @ @ @ . . . @ . . . @ . . . @ . @ . . . . @ @ . . @ @ @ @ @ @ @ 
@ @ @ . @ @ @ . . . . . @ . @ @ . @ . . @ . . . @ . @ . @ @ . . . . @ . . @ @ . @ @ @ @ . . @ . . @ @ @ @ . . @ @ @ @ @ @ @ . @ . . @ @ @ @ . . @ . @ . @ . . . @ @ . @ @ . @ . @ @ @ . @ @ @ @ @ @ @ @ 
@ . . . . @ . @ . @ @ @ @ . . . @ . @ . . @ @ . . @ . . @ . . @ @ . . @ . @ . . . @ @ . . @ . @ . . @ @ . @ . . @ @ @ @ @ . @ . . @ @ . @ @ @ . . @ @ . . @ @ . . . . . @ . . @ @ @ . . . . @ @ @ @ @ @ 
@ @ @ . @ @ . . @ . . . . . @ @ . . . . @ @ . . @ @ @ . @ @ . . @ . @ . . . @ . @ @ . @ . . . @ . @ @ . . . @ . . @ . @ . . . . @ @ . . . @ . @ . . . @ @ . . . @ . @ . @ . @ @ @ . @ . @ . . @ @ . @ @ 
@ . . . . . . @ . @ . @ @ . . . @ . @ . @ . @ . . . . @ @ . . @ . @ . @ . @ @ . @ . . . . @ . . @ . . @ @ . . @ . . . . . @ @ . . . . @ @ . . . . @ @ . . . @ . @ . . @ . . . @ . . . . @ . @ @ . . . @ 
@ @ . @ . @ . . . . . . @ . @ . @ @ . . . . . . @ . @ . . @ . . . . . @ @ @ . @ @ @ @ @ . @ . @ . @ . . . . @ . . @ . @ . @ @ . @ . @ @ . @ @ @ . . @ @ . @ . . . @ . . @ . @ . @ @ . @ . . . . @ . @ @ 
@ . . @ . @ @ @ @ @ . @ . @ @ @ . @ @ . @ . @ . . @ . @ . @ . @ . @ . @ . . . . . . . . . . @ . . . @ . @ . . . @ . . @ @ . . . . @ @ . . . . . . @ . . . @ @ . @ . @ . @ @ @ . . . @ . @ . @ @ . . . @ 
@ . @ @ . . . . . @ . . . . @ @ . . @ . . @ . . @ @ . . . . @ @ @ . . . @ @ . @ . @ . @ . @ @ @ . @ . @ . @ . @ @ @ . . . @ @ . @ @ . @ . @ . @ . . @ . @ . . . . . @ @ . @ . . @ @ . . . . . . . @ @ @ 
@ . @ . . @ . @ . @ . @ . @ . . @ . . . @ . @ . @ @ . @ @ . @ @ . @ . @ . . @ . . . @ @ @ @ @ . . . . @ . . . . @ . . @ . . . @ . . . . . . @ @ @ @ . @ @ @ @ . @ @ @ @ . . @ . . @ . @ . @ . @ . . @ @ 
@ . @ @ . . @ @ @ @ @ . . . . @ . @ @ . @ . @ . . . . . . @ @ . . . . @ . @ @ @ . @ @ @ @ @ @ @ . @ . @ . @ . @ @ @ . . @ @ @ . . @ @ @ . @ @ @ . @ . . . @ . . . . @ . . @ . . @ . . . @ @ . . @ @ . @ 
@ @ . . . @ @ @ @ . . . @ @ @ . . . @ . @ . . . @ . @ . @ . . @ @ @ . @ . . @ . @ @ @ . @ @ @ @ @ . . . @ . . @ @ . @ . @ . . . @ . . . . . @ . . . @ @ . @ @ . @ . @ @ . . . @ . . @ @ . @ @ . . . . @ 
@ . . @ @ @ @ @ @ @ @ . . . . @ . @ @ @ . . @ . . @ @ @ . @ . . @ . . @ . @ . . @ @ . . . @ @ @ . @ . @ . @ . @ @ . . @ @ @ . @ . . @ @ . @ . . @ . . . . . . . . @ @ @ . @ . @ . @ @ . . . @ @ . @ @ @ 
@ . @ . @ @ . @ . @ . . @ . @ @ . . @ . @ . @ @ . @ @ . . . . @ . @ . @ . . @ . @ . . @ . . @ . . . . . . . . @ @ . @ @ @ @ @ . . @ . . . . @ @ @ @ . @ . @ . @ @ @ @ . . . @ @ . . . @ @ . . . . @ @ @ 
@ . . . . . . . . . @ . . @ @ . @ . . . . . @ . . . @ . @ @ . . . . . @ . @ . . . @ @ . @ . @ @ . @ . @ @ . @ . @ . . @ @ . @ @ . . @ . @ . @ . @ . . . @ . . @ . @ . @ . @ . @ . @ . @ @ @ @ @ @ @ @ @ 
@ . @ @ @ . @ . @ @ . . @ @ . . . . @ . @ . @ @ . @ . . . . @ @ . @ . . . @ . @ . @ . . . . . . . . @ . . . . . . . @ @ . . @ . . @ @ @ @ . @ . @ @ . @ . @ . . . . . . . . . . . @ . . @ @ . . . @ @ @ 
@ @ @ @ @ @ . @ @ @ @ . . @ @ . @ . . @ . . @ . . @ @ . @ @ @ @ @ . @ . @ . @ . . . . @ @ . @ . @ @ . @ @ . @ . @ . @ . @ . . @ . @ @ . . . . . . . @ . . . . @ . @ @ . @ . @ . @ . @ @ . @ @ @ . . @ @ 
@ @ @ @ @ . . @ @ @ . . @ @ @ @ . . @ . @ @ @ @ . . @ . . . . @ . . . . @ . @ @ . @ . @ @ . . @ . . . . . . . @ @ @ . . . . @ @ . @ @ @ . @ . @ @ @ . . @ @ . . @ . . . . @ @ . . . . . . . . . . @ @ @ 
@ @ . @ . @ . . @ @ @ @ . @ . @ @ . @ . @ @ @ . . @ @ . @ @ . @ @ . @ . . . . . . . @ . . . @ @ @ . @ . @ . @ @ @ . . @ @ . . @ . . . . @ . . . . . @ . @ @ . @ . @ @ . @ @ . . @ . @ . @ . @ . @ @ @ @ 
@ . . . . @ . @ . @ . . . . . . @ . . . . . . @ @ . @ @ . . . . . @ . . @ . @ @ . @ . @ . @ @ @ @ . . @ . . . @ @ @ . . . @ . . . @ . @ @ @ . @ . @ @ @ . . . . . . . @ @ @ @ . . @ . . . @ . . @ . @ @ 
@ @ @ @ . . . . . . . @ @ @ @ . . . @ . @ . @ @ . . . @ . @ @ . @ @ @ . . @ @ @ @ . . . . @ @ @ . . @ @ @ . @ . @ . . @ @ @ . @ . . @ @ @ . . @ . . @ . @ . @ . @ @ . . . @ . . @ . @ @ @ . @ . . . . @ 
@ @ @ . @ . @ . @ . @ . . . . . @ . . @ . @ @ . @ . @ . . @ . . . . @ @ @ @ @ @ @ . @ . @ . . . . @ . . . . . . @ . @ . @ . @ . . @ @ @ @ . @ . . @ . . . . @ . @ @ . @ . @ @ . . . . . @ . . . @ . @ @ 
@ @ @ . . @ @ . . @ . . @ . @ @ . . @ @ . . . . . . . . @ @ @ @ . @ @ @ @ @ @ . . . @ @ . . @ . @ . . @ @ . @ @ @ . . . . . @ @ . . @ @ . . . @ . . @ . @ . @ . . . @ . @ @ . . @ . @ @ . . @ . . @ . @ 
@ @ . @ . @ . @ @ . @ . @ . @ . @ . @ @ . @ . @ . @ . @ @ . . . . @ . @ @ @ . @ @ . @ . @ . . @ . . @ . . . @ . . @ @ @ . @ @ @ . @ @ @ @ . @ . . @ @ . @ . @ . @ . . . @ @ @ @ @ @ @ . @ @ @ . @ . . @ 
@ . . . . . . . @ . @ @ . . @ . @ . . . @ @ . @ @ . . . . @ . @ . . . . . . . . . @ . . . . @ @ . @ . . @ . @ . @ @ . @ . @ . . . . . @ . @ @ @ @ @ @ @ . . @ . @ . @ . . . . . . . . . @ . @ . @ . @ @ 
@ @ @ . @ @ . @ . . . @ @ . @ . @ @ . @ . . . @ . @ . @ @ . @ @ @ . @ @ @ . @ . @ @ @ . @ . . @ . @ . @ . . . . @ . . @ @ . @ . @ @ @ @ . @ @ @ @ @ @ @ @ . . @ @ @ . . @ . @ @ . @ @ . . . @ . . . . @ 
@ @ @ @ . @ . . @ . @ @ @ . . . . @ @ @ @ . @ . . . . . . . @ @ @ @ @ @ . . . @ @ @ @ @ . . @ @ @ @ @ . . @ . @ . @ . . . . . . @ @ . @ . . @ @ @ @ @ @ @ @ @ @ @ @ @ . . @ . . @ @ @ . @ . . @ . @ . @ 
@ . @ . . . @ . . . . . . . @ . @ . @ @ @ @ @ @ . @ . @ . @ @ @ @ . @ . @ @ @ . . @ @ . . @ @ @ . @ @ @ . @ . @ . . . @ @ @ @ . . . . . . @ . @ @ @ @ @ @ @ @ @ @ @ @ @ . @ . @ @ @ @ . . @ . . @ . . @ 
@ . . @ . @ . @ . @ @ . @ . . @ @ . . . . . . . . @ @ . @ . @ . . . . . . @ . @ . . @ @ @ . . . . . @ @ @ . . . @ @ . @ . . . . @ @ . @ . . . . . @ @ @ . @ @ @ . @ . @ . . . . @ . . . @ . . @ . @ @ @ 
@ @ . . . . . . . . . @ @ . @ @ . @ @ . @ . @ . @ . . . . . @ @ @ @ @ . @ . . . . @ @ . @ @ . @ . @ . . . @ . @ @ . @ . . @ . @ . . . . @ . @ . @ @ @ . . . @ . . . . . . @ @ . . @ . @ @ @ . . . . . @ 
@ . @ @ . @ . @ . @ . @ . . . . . . . @ . . @ . . @ @ . @ @ @ . . @ . . @ . @ @ . . . . . . @ . . . @ . @ . @ . . . @ @ . @ . . @ @ . @ . . . @ . @ . @ . @ @ @ . @ @ @ . . @ . @ . @ . @ . . @ @ @ . @ 
@ . @ @ . @ @ . . . @ @ @ . @ @ . @ @ . . @ . . @ . . . . @ . . @ . @ . . @ @ @ @ . @ . @ @ . @ @ . . . . . . . @ . . . @ . . @ @ @ . @ @ . @ @ . . . . . @ . . @ . . . . @ . . . . . . . @ @ . @ @ @ @ 
@ . . @ @ . . . @ . . @ @ . @ @ . . . @ @ . . @ . @ @ . @ . @ . @ . @ @ . @ . @ . @ . . . . . . . . @ . @ . @ @ . . @ . . . @ @ @ . . . . @ . . @ @ . @ . . @ . . @ . @ @ @ @ . @ . @ . @ @ . . @ @ @ @ 
@ @ . @ . @ @ . @ . @ @ @ . . . @ . @ . . @ @ . . . . . . . . . . . . . . . . . . . . @ . @ . @ @ @ @ . @ @ @ . @ @ @ . @ . . . . @ @ @ . . . @ . @ @ . @ . . . @ . . . . @ . . . @ . . . . @ . . . @ @ 
@ . . . . . . . @ . . @ . @ . @ . . . @ . @ @ @ . @ . @ . @ . @ . @ . @ . @ . @ . @ . . @ . @ . . . . @ . @ . . . . . . @ @ . @ . . @ . . @ . @ . @ @ . @ . @ @ . @ . @ . . @ . @ . @ . @ . . . @ @ @ @ 
@ . @ . @ . @ . @ . @ . . @ . @ . @ @ . . . @ @ @ . . . @ @ @ . . . @ . . . @ . . @ . @ . . . @ @ @ . . . . . @ @ . @ . . . @ . @ @ @ @ . @ . . . @ . . . . . . . . . . @ @ . . . . . @ @ . @ . . . @ @ 
@ . @ . . @ . . @ . . @ . @ . . @ . . @ @ . @ @ . @ . @ . @ @ @ . @ . . @ @ @ @ . . @ . @ . @ . . . . @ @ . @ . @ . . @ . @ . . @ . @ . . . @ . @ @ @ . @ . @ . @ . @ @ @ . @ . @ . @ @ . @ @ . @ . . @ 
@ . . @ . @ @ . @ . @ @ . @ . @ @ @ . . . . . . . . . . . . @ . . . @ . . . @ . . @ . . . . @ @ . @ . . . @ . . . . @ @ . . @ . . . . @ . @ . @ @ . @ @ . @ @ @ . . . . @ . @ . . @ . . . . . @ @ . @ @ 
@ . @ . . @ . @ @ @ . @ . . . @ . . . @ . @ . @ . @ . @ . @ @ @ . @ . . @ . . @ . . . @ @ @ @ . @ @ . @ . . @ . @ . . . @ . @ @ . @ . @ . . . @ . . . . . @ @ @ @ . @ . @ . . . @ . @ . @ @ @ . . . @ @ 
@ . @ . @ @ . . @ @ . . . @ . @ . @ . @ . . @ . . @ . . @ @ @ @ @ . . @ @ . @ . @ . @ . . . . . . . . . @ @ @ @ . . @ @ . . @ . @ . . . @ . @ @ . @ . @ @ @ @ . . . . @ . @ . @ . . . . . . . @ @ . @ @ 
@ . @ . @ . @ . @ . @ . @ . . . @ @ . @ . @ . . @ . . @ . @ @ @ @ @ @ . . @ . . . @ . . @ . @ . @ . @ . . @ @ . @ . . @ @ @ . . . @ @ . @ . . . @ . . @ . @ . @ @ . @ . . . . . . @ . @ . @ @ @ @ . . @ 
@ . @ . @ . . . . . . . @ @ . @ @ @ @ . . . @ . @ @ . . . . @ @ @ . @ . @ . @ . @ . @ . . @ . . . @ . . @ @ . . . . @ @ . @ . @ . . @ . . . @ . . . @ @ . . . . . @ . . @ . @ @ @ . . @ . . . @ @ . @ @ 
@ @ . . @ . @ . @ . @ @ . . . @ @ @ @ @ . @ . @ . . . @ . @ . @ . . . . . . . . . . . . @ . @ @ . . @ . . @ @ . @ . . . . . @ @ @ . . . @ . . @ @ . . @ @ . @ @ . @ . @ . . . @ @ @ . . @ . @ @ @ @ @ @ 
@ . . @ @ @ . . @ @ . . . @ . . @ @ . . . . . . @ . @ . . . . @ @ . @ . @ . @ . @ . @ . . . @ . . @ . . @ @ . @ . . @ . @ . . . . @ . @ . . @ . . . @ . . . @ . . . . . @ . @ @ @ @ @ . . @ . . @ @ @ @ 
@ @ . @ @ @ @ @ @ @ @ . @ @ . @ . . . @ . @ . @ @ . . @ . @ . @ . @ . @ . . @ @ . . . @ . @ . @ @ . . @ @ . . . . @ . . @ . @ . @ . @ @ . @ . @ . @ @ @ @ . @ . @ . @ . . @ @ @ . @ @ . @ . . @ @ @ @ @ 
@ @ @ @ @ @ . . @ @ @ @ . . . @ . @ @ . . . @ @ . @ @ @ @ @ . @ . @ . . . @ . . @ . @ @ @ @ . @ @ @ . . . @ . @ . . @ . @ . . @ . . . . . . . @ . @ @ @ @ @ . . . @ @ @ . . @ @ . . . . . @ . . @ @ @ @ 
@ @ @ @ @ @ @ . . . . . . @ . @ . . @ @ . @ @ . . @ @ @ . . @ . . @ . @ . @ . @ . . @ @ @ . . . . . . @ . @ @ @ . @ . . . @ . @ . @ . @ . @ @ . . . @ . @ . @ . @ . @ . @ . . . @ . @ . @ . . @ . @ @ @ 
@ @ @ @ @ @ . @ . @ . @ . . @ . . @ . @ . @ . @ . @ @ @ . @ . @ . @ @ . @ @ . @ @ . . . . @ . @ . @ . . @ . @ . . . @ . @ . @ @ @ . . . @ @ @ @ . @ @ . @ . . . . . @ . . . @ . . @ . . @ . @ . . . . @ 
@ @ @ @ @ . . . . . @ . . @ . . @ . . . . @ . . . . . . . . . . . . . . . . . @ @ @ . @ @ @ @ . . . @ @ @ . . @ . @ . . . . . @ . . @ @ @ @ @ @ @ . . . . . @ . @ . @ . @ . . @ . @ @ . . . . . @ . @ @ 
@ @ @ @ @ @ . @ . @ @ @ . . @ . . @ . @ . . @ . @ . @ . @ @ . @ . @ . @ . @ . @ . . . . @ @ . @ @ @ . @ . @ . @ . @ @ @ . @ . @ @ . . @ @ @ @ @ @ @ . @ @ @ . . . @ . @ . . @ @ @ . . . @ @ @ @ @ @ @ @ 
@ @ @ @ @ @ @ . . . @ . . @ . . @ @ . . @ . @ . . @ @ @ . . . @ @ . . @ . @ . . . @ . @ @ @ . . . . . . . . . . . . . @ . . @ . . . @ @ @ @ @ @ @ @ @ . . . . @ @ . . . . @ . . . . @ @ . @ . . . . @ @ 
@ @ @ @ @ @ @ @ . @ @ @ . . @ . @ . . @ @ @ . . @ @ @ @ @ . @ . . . @ @ @ . @ . @ . . . . . @ . @ @ . @ . @ . @ @ . @ @ @ @ @ @ @ . @ . @ @ @ @ @ @ @ @ . @ . . @ . @ . @ . @ . @ . . . . . . @ . @ @ @ 
@ @ @ @ @ @ @ @ . . . @ @ @ @ @ . . @ @ @ @ @ . . @ @ @ . . . @ . @ @ @ . . . . . @ . @ . @ @ . . @ @ @ @ @ @ . . . @ @ @ @ @ @ . . . . . . @ @ @ @ @ @ @ @ @ . @ . @ . . . @ . . @ . @ . @ . @ . @ @ @ 
@ @ @ @ @ @ @ @ @ @ @ @ @ @ @ @ @ @ @ @ @ @ @ @ @ @ @ @ @ @ @ @ @ @ @ @ @ @ @ @ @ @ @ @ @ @ @ @ @ @ @ @ @ @ @ @ @ @ @ @ @ @ @ @ @ @ @ @ @ @ @ @ @ @ @ @ @ @ @ @ @ @ @ @ @ @ @ @ @ @ @ @ @ @ @ @ @ @ @ @ 
3
70 85 31 78
22 92 60 69
9 50 54 23
