20 20
@ @ @ @ @ @ @ @ @ @ @ @ @ @ @ @ @ @ @ @ 
@ . @ @ @ @ . @ @ @ @ @ . @ . . . . @ @ 
@ . . @ @ . . . @ @ . . . . @ . @ @ . @ 
@ . @ . @ . @ . . . @ . @ @ . . . @ . @ 
@ . . . . @ . . @ . @ . . @ . @ @ . . @ 
@ . @ @ @ . @ . @ @ . . @ . . . @ . @ @ 
@ . @ . @ . . . . @ . @ . @ . @ . . . @ 
@ . @ . . . @ @ . . . . . . . . . @ . @ 
@ . . . @ @ @ @ @ . @ . @ . @ . @ @ @ @ 
@ . @ . . @ @ @ @ @ @ @ @ . . @ @ @ @ @ 
@ . . @ @ . @ . @ . @ . . . @ @ @ @ @ @ 
@ . @ . . . . . . . . @ . @ @ @ @ @ @ @ 
@ . . . @ . @ . @ @ . . @ @ @ @ @ @ @ @ 
@ . @ . . @ . @ . . . @ @ @ @ @ @ @ @ @ 
@ . . @ . . . . @ @ @ @ @ @ @ @ @ @ @ @ 
@ . @ @ . @ @ . . @ @ @ @ @ @ @ @ @ @ @ 
@ . . . @ . . . @ @ @ @ @ @ @ @ @ @ @ @ 
@ . @ . @ @ @ . . @ @ @ @ @ @ @ @ @ @ @ 
@ . . @ . . . . @ @ @ @ @ @ @ @ @ @ @ @ 
@ @ @ @ @ @ @ @ @ @ @ @ @ @ @ @ @ @ @ @ 
3
3 9 1 17
14 6 17 1
3 1 18 6
