50 50
@ @ @ @ @ @ @ @ @ @ @ @ @ @ @ @ @ @ @ @ @ @ @ @ @ @ @ @ @ @ @ @ @ @ @ @ @ @ @ @ @ @ @ @ @ @ @ @ @ @ 
@ @ @ . . . @ . . @ . . . . . . . . @ . . . @ . . . . . @ @ @ . . . . . . . . @ @ . @ @ @ @ @ @ @ @ 
@ @ . @ @ . @ . @ . @ . @ @ . @ . @ . @ . @ . @ . @ @ @ . @ . @ . @ . @ @ @ . . @ . @ @ @ @ @ @ @ @ 
@ . . . . . . . @ . . @ . . @ . . . . . . . . . . . . . . . . @ @ @ @ . @ . . @ . . . @ @ @ @ @ @ @ 
@ @ . @ . @ @ . @ . @ @ @ . . . @ . @ . @ . @ @ . @ . @ . @ . . . @ . . @ @ . . @ . @ . @ @ @ @ @ @ 
@ @ @ . . . @ . . . . . . @ @ . @ @ . @ . . . . @ @ . . @ . . @ @ . @ . @ . @ . @ . . . . . . @ @ @ 
@ @ @ @ . @ . @ @ @ . @ . @ . . . . . @ @ . @ . @ @ @ @ . @ . . . . . . . . . . . . @ . @ . @ . @ @ 
@ @ @ @ @ . . . @ . . . @ @ @ . @ @ @ @ @ @ @ @ . @ . . . @ @ . @ . @ . @ . @ . @ . . @ @ . . . . @ 
@ @ @ @ . @ . @ . @ . @ @ @ . . @ . . @ @ @ @ . . . @ @ . . . @ @ @ @ @ . @ @ @ . . @ @ @ . @ . @ @ 
@ @ . . . . . . . . . . @ . . @ . . @ . @ . . @ @ . . . @ . @ @ @ . @ . . . @ . @ . . @ . . . @ @ @ 
@ . @ @ . @ . @ . @ . @ . @ @ . @ . . . @ @ . @ @ @ . @ . . . @ . . . @ . @ . . . . @ . @ @ @ @ @ @ 
@ . . . . @ @ . @ . . . . . . . . . @ . . . . . . @ . . @ . @ . @ @ . . . . @ . @ . . . . . @ @ @ @ 
@ @ . @ . @ @ . . @ . @ . @ . @ . @ @ @ . @ . @ @ @ . @ . . . . @ . @ . @ . . @ @ . @ @ . @ @ @ @ @ 
@ @ @ @ @ @ . . @ . . @ . . @ . . @ @ @ . . @ @ . . . . @ . @ @ . . @ @ . . @ . . . . @ @ @ @ @ @ @ 
@ @ @ @ . . @ . . . @ @ @ . . @ . @ @ . @ @ . @ @ . @ . . . . . @ . @ . @ . @ . @ @ . . . . @ @ @ @ 
@ @ @ . @ . . @ @ . @ . . @ @ . . . . . . . . @ @ . @ . @ . @ @ . . . . . . . . . . @ @ . @ . @ @ @ 
@ . @ . . @ . . @ . @ . @ . @ @ . @ @ . @ . @ @ @ @ . . . @ @ @ @ . @ . @ @ . @ . @ @ @ . . . . @ @ 
@ . . @ . . . @ . . . . . . . @ . @ . @ . @ . @ @ @ . @ @ . @ . . @ @ @ . . . @ @ . @ . . @ @ @ . @ 
@ @ . . @ @ . . @ @ . @ @ @ . @ @ . . . . . . . @ . . . . . . . @ @ @ @ @ . @ . . . . @ . . . . . @ 
@ . @ . @ . @ . . @ @ @ . . . . @ @ @ @ . @ . @ . @ . @ . @ . @ @ @ @ @ @ @ . @ @ . @ @ . @ @ @ . @ 
@ . . . . . . . @ @ @ . @ . @ . . . @ @ @ . . . . . . . @ @ @ @ @ @ @ @ @ @ . . . . . @ . @ @ . . @ 
@ . @ . @ @ @ . @ @ @ . @ @ . @ @ . . . @ @ . @ . @ . @ . . @ @ @ @ @ @ @ . . @ @ @ @ . . @ @ @ . @ 
@ @ @ @ . . @ . . . . . . . . . . @ @ . @ . . . @ . . @ . @ . @ . @ . @ . @ . . . @ . @ . . @ . . @ 
@ . . . @ . @ @ . @ @ @ . @ @ @ . . . . @ @ @ @ @ @ . . . . . . . . . @ . . @ @ . . . @ . @ . @ . @ 
@ . @ @ . . . . @ . @ @ @ . . . . @ @ . @ . . . @ . @ . @ @ . @ @ . @ . @ . @ . . @ . . . @ . . . @ 
@ . . @ @ . @ @ . . . @ . . @ @ @ . . . . @ @ . . . . . . . @ @ @ @ . . . . . @ . . @ . @ . . @ . @ 
@ . @ . @ . @ . @ . @ . @ @ . . . @ . @ . . . . @ . @ . @ . . @ @ . . @ . @ . @ . @ . @ . @ @ . . @ 
@ . . . . . . . . . . . @ . @ . @ . @ . @ . @ . . @ . . @ . @ . @ @ . @ @ . . . . . . . . . @ . @ @ 
@ @ . @ @ @ . @ . @ @ . . . . . . . . . . . @ . @ . @ . . @ . . . @ @ . . @ . @ @ . @ . @ . @ @ @ @ 
@ . . . @ @ @ . . @ @ . @ @ . @ @ . @ . @ . . @ . . @ . @ . @ . @ . @ @ . @ . @ @ @ . . . @ @ @ @ @ 
@ @ . @ @ @ . @ @ @ . . @ . . @ @ @ @ @ @ @ . @ @ . . . . . . . . . @ . . . . . @ . @ . @ @ @ . @ @ 
@ . . . @ . . . . . . @ . . @ @ @ @ @ @ @ @ @ @ @ @ . @ . @ @ . @ @ . @ @ . @ @ . . . . . @ @ . @ @ 
@ @ . @ @ @ . @ . @ @ . . @ @ @ @ @ @ @ @ @ . . . . . . @ @ . . . @ . . @ @ . . . @ @ . @ . @ . . @ 
@ @ . . @ . @ . . . . @ @ . @ @ @ @ @ . . . . @ . @ . @ @ . @ @ . @ . @ . . @ . @ @ . . . . @ . @ @ 
@ . . @ @ . . @ . @ . . @ . . @ @ @ @ @ @ @ . . @ @ . @ . . . . . . . . . @ . @ . . @ . @ @ . . . @ 
@ @ . @ @ @ . . . . @ . @ . @ . @ @ @ . . . @ @ . . @ @ . @ . @ . @ . @ . . . . . @ . . . . . @ @ @ 
@ @ @ @ @ @ . @ . @ . . . . . . . . . @ @ . . . @ . @ . @ . . . @ . @ @ @ @ . @ . . @ . @ . @ . . @ 
@ . @ @ @ @ . @ . . @ . @ . @ . @ @ @ . . . @ . . . . . @ . @ @ . . . @ . @ @ @ @ . . . @ @ . @ . @ 
@ . . @ @ @ @ . . @ . @ @ . . @ @ @ @ . @ . . @ @ @ @ . . . . @ . @ . @ . @ . @ . @ . @ . . . @ . @ 
@ @ . @ @ @ . . @ @ . . . . @ @ @ @ . @ . @ @ . . . . . @ . @ . @ . . . . . . . . . . . . @ . . . @ 
@ . . @ @ @ @ . . @ @ . @ @ @ . @ . . . . . . . @ @ . @ . . . . . @ . @ . @ . @ . @ . @ . @ . @ @ @ 
@ . @ . @ @ . . @ . @ @ . @ . . . @ @ . @ . @ @ @ . . . @ . @ . @ @ @ . . . @ . @ . @ . . . @ . . @ 
@ . . . @ . . @ . . @ . . @ . @ . @ @ @ . . @ @ @ @ . @ @ . . @ @ @ @ @ . @ @ . . . . @ . @ . @ . @ 
@ . @ @ . @ . . @ . . . @ . . @ . @ @ @ @ @ @ @ @ @ . . @ . @ . @ @ @ . . . . @ @ @ . . . . . . . @ 
@ . @ . . . . @ . @ @ . . @ . @ @ . . . @ . @ @ @ . @ . @ @ . . . @ @ @ . @ . . @ . @ . @ @ @ . @ @ 
@ . . . @ @ . . . . @ . @ . . . . . @ . . . @ @ . . . . . . @ . @ @ @ @ . . @ @ . . . . @ @ . . @ @ 
@ @ . @ . . . @ . @ . . . . @ @ @ @ . . @ . . @ . @ @ . @ . . . . . @ @ . @ @ @ @ . @ . @ . @ . @ @ 
@ @ . @ @ @ . @ @ . @ . @ . . . . @ @ . . @ . . @ @ @ @ @ @ . @ . @ @ @ @ @ @ @ @ . @ . . . @ . . @ 
@ @ @ . . . . . . . . . . @ . @ . . @ . @ @ @ . . . @ @ @ @ @ @ @ @ @ @ @ @ @ @ @ @ . . @ @ @ . @ @ 
@ @ @ @ @ @ @ @ @ @ @ @ @ @ @ @ @ @ @ @ @ @ @ @ @ @ @ @ @ @ @ @ @ @ @ @ @ @ @ @ @ @ @ @ @ @ @ @ @ @ 
3
40 34 29 38
1 33 36 22
27 3 28 28
