25 25
@ @ @ @ @ @ @ @ @ @ @ @ @ @ @ @ @ @ @ @ @ @ @ @ @ 
@ . @ . . . . . . . @ @ . . @ @ @ @ . @ @ @ . @ @ 
@ . @ . @ @ . @ @ . . @ @ . . . @ . . . @ . . . @ 
@ . . . @ . . @ . @ . . . . @ @ . @ @ . . @ . @ @ 
@ . @ @ . . @ . . . @ . @ . . . . @ . @ . . . @ @ 
@ @ . . . @ . @ @ . @ @ . @ . @ . . . . . @ @ . @ 
@ @ @ @ @ . . . . . . . . . @ . @ . @ @ . . . . @ 
@ @ @ @ @ @ . @ @ @ @ . @ . . . @ @ . . . @ @ . @ 
@ @ . @ @ @ . . . @ @ @ . @ @ . @ . @ @ . . . @ @ 
@ . . . . . @ @ @ . . . . . . . @ . @ . @ . @ . @ 
@ . @ . @ . @ @ . . @ . @ . @ . . . . . . . . . @ 
@ @ . @ . . . . . @ . . @ . @ @ . @ . @ @ . @ @ @ 
@ . . . . @ @ . @ . . @ . . @ . @ . . . @ . . . @ 
@ @ @ @ . . . @ . . @ . . @ . . . . @ @ . . @ . @ 
@ @ . @ . @ @ . . @ . @ @ @ . @ . @ . . @ . . @ @ 
@ . . . . @ . . @ . . . . . . . @ . @ . . . @ . @ 
@ @ . @ . @ @ . . @ . @ . @ . @ . . . @ @ . . . @ 
@ . . @ @ . . . @ @ @ . . . @ . . @ @ . @ . @ . @ 
@ @ @ . @ @ @ @ @ . @ @ . @ . @ . . . . . . . @ @ 
@ . . . . . . . . . . . . . . @ . @ . @ . @ . @ @ 
@ . @ . @ . @ @ . @ . @ . @ . @ @ @ . . @ . @ . @ 
@ @ @ @ . . @ @ @ . . @ . @ @ @ @ @ @ . . . . . @ 
@ @ @ @ @ . @ @ . . @ . . @ @ @ @ @ @ . @ . @ . @ 
@ @ @ @ @ @ . . . @ . . @ @ @ @ @ @ @ . . @ . . @ 
@ @ @ @ @ @ @ @ @ @ @ @ @ @ @ @ @ @ @ @ @ @ @ @ @ 
3
12 12 9 5
21 21 6 12
12 3 1 3
