25 25
@ @ @ @ @ @ @ @ @ @ @ @ @ @ @ @ @ @ @ @ @ @ @ @ @ 
@ . . . . . @ . @ . @ @ . @ @ @ . @ . . . . . @ @ 
@ @ @ @ @ . . . . . . . . . @ . . @ @ @ . @ . . @ 
@ . . . . . @ @ . @ . @ @ . @ . @ . @ @ . @ . @ @ 
@ @ @ . @ @ . . . . @ @ @ . . . . . . . . . @ . @ 
@ @ @ @ @ . . @ . @ @ @ @ @ . @ . @ . @ . @ @ . @ 
@ @ @ @ @ . @ . . . @ @ @ . @ . . @ @ . . @ . . @ 
@ @ @ @ . . . @ . @ @ @ @ . . @ . @ . @ . . . @ @ 
@ @ @ @ @ . @ . . @ @ @ . @ . @ @ . . . . @ . . @ 
@ @ . . @ @ . @ . @ @ @ . @ . @ . @ . @ . @ . @ @ 
@ @ @ . @ . . . @ . . . . . . . . @ @ . . @ @ @ @ 
@ @ . . . . @ . . . @ . @ @ . @ . . @ @ . . @ @ @ 
@ . . @ . @ @ @ . @ . . . . @ @ @ . . . . @ @ @ @ 
@ . @ . . @ @ @ . @ @ . @ . . @ . @ . @ . . @ @ @ 
@ . @ @ . @ @ @ @ . . . . @ . @ . . @ . . @ . @ @ 
@ @ . . . @ @ @ . @ . @ . @ . @ . @ . @ . . . . @ 
@ @ @ @ @ @ @ @ . @ @ . @ . @ . . . . . . @ @ . @ 
@ @ @ @ @ @ @ . . . . . . . . . @ @ . @ . . . @ @ 
@ @ @ @ @ @ @ . @ . @ . @ . @ . . . @ . . @ . . @ 
@ @ @ @ @ @ @ @ . . @ @ @ . @ . @ @ . @ . . @ @ @ 
@ @ @ @ @ @ @ @ @ @ . . . . @ . @ . . . . @ @ @ @ 
@ @ @ @ @ @ @ @ @ @ @ . @ . . @ . . @ . @ @ @ @ @ 
@ @ @ @ @ @ @ @ @ @ @ @ . . @ @ @ @ . . @ @ @ @ @ 
@ @ @ @ @ @ @ @ @ @ @ @ @ @ @ @ @ @ @ . . @ @ @ @ 
@ @ @ @ @ @ @ @ @ @ @ @ @ @ @ @ @ @ @ @ @ @ @ @ @ 
3
16 13 10 16
15 12 13 1
20 12 17 22
