25 25
@ @ @ @ @ @ @ @ @ @ @ @ @ @ @ @ @ @ @ @ @ @ @ @ @ 
@ . @ @ . @ @ @ @ @ @ @ . . @ . @ . @ @ . . . @ @ 
@ . . . . . @ @ @ @ @ . . @ . . . . . . . @ . . @ 
@ @ . @ . @ @ @ @ @ @ @ . . . @ . @ . @ . . @ @ @ 
@ @ @ . . . @ @ @ . @ @ . @ @ . @ . . . @ . . . @ 
@ . . @ . @ @ @ . . . . . . . . . @ @ . . @ @ @ @ 
@ @ . . . . . . @ . @ . @ @ . @ . @ . @ @ . @ . @ 
@ @ @ . @ @ @ . . . @ . . . @ @ @ . . . . . . . @ 
@ @ @ . @ @ @ @ @ . . @ @ @ . . . @ . @ . @ @ . @ 
@ @ @ . . . @ @ . . @ @ @ @ . @ . . . . @ . . @ @ 
@ . . @ @ . @ . @ . . @ @ . . . @ @ . @ @ . @ @ @ 
@ . @ . . @ . . . . @ . @ . @ . @ . . . @ . . . @ 
@ . . . @ . @ . @ @ . . . @ . @ . @ . @ . . @ . @ 
@ . @ @ . . . . . . . @ @ . . . . . . @ . @ . @ @ 
@ . . . @ . @ . @ @ . . @ . @ . @ . @ . . . . . @ 
@ @ @ . @ @ . . . @ . @ . . . @ . . @ @ . @ @ . @ 
@ . @ . @ . @ . @ . @ . @ . @ @ @ . @ . . . . @ @ 
@ . . . . . . . . . . . . . . @ @ @ . @ @ @ . . @ 
@ @ . @ . @ @ . @ . @ . @ . @ . @ @ . @ . . . @ @ 
@ @ @ . . @ . . . @ . @ @ . @ . . . . . . @ . . @ 
@ @ . @ @ . @ . @ . . @ @ . . . @ @ @ . @ @ @ @ @ 
@ . . . . . . . @ . @ . @ . @ . . . . @ @ @ @ @ @ 
@ . @ . @ . @ . . . . . @ @ . . @ . @ . @ @ @ @ @ 
@ @ . . . @ . . @ @ . @ @ @ @ @ . . . . . @ @ @ @ 
@ @ @ @ @ @ @ @ @ @ @ @ @ @ @ @ @ @ @ @ @ @ @ @ @ 
3
9 19 6 21
2 5 20 2
18 15 17 7
