12 12
@ @ @ @ @ @ @ @ @ @ @ @ 
@ @ . . @ . @ . @ . . @ 
@ @ . @ . . . . . . @ @ 
@ . . . . @ . @ . @ @ @ 
@ @ . @ @ . . . @ . @ @ 
@ . . . @ @ . @ @ . . @ 
@ @ . @ . . @ @ . . @ @ 
@ @ . . . @ @ . @ . @ @ 
@ . . @ . . . . . . . @ 
@ @ . . @ @ . @ . @ . @ 
@ . . @ @ @ @ @ @ . . @ 
@ @ @ @ @ @ @ @ @ @ @ @ 
3
10 1 2 5
9 10 4 7
7 3 1 7
