100 100
@ @ @ @ @ @ @ @ @ @ @ @ @ @ @ @ @ @ @ @ @ @ @ @ @ @ @ @ @ @ @ @ @ @ @ @ @ @ @ @ @ @ @ @ @ @ @ @ @ @ @ @ @ @ @ @ @ @ @ @ @ @ @ @ @ @ @ @ @ @ @ @ @ @ @ @ @ @ @ @ @ @ @ @ @ @ @ @ @ @ @ @ @ @ @ @ @ @ @ @ 
@ . @ . . . . @ @ . @ . @ . @ @ @ @ . @ . @ . @ . @ . @ . @ . @ @ @ . . . . . @ @ @ @ @ @ . . @ . . . . @ . . . . . @ @ . . . . . . @ @ @ . @ @ @ . . . @ @ @ @ @ . @ . . @ . . . . . @ @ @ @ @ @ @ @ @ 
@ . . . @ @ . @ . . . . @ . . @ @ . . . . . . . . . . . . . . . . . . @ . @ . . @ @ @ @ @ . @ . . @ @ @ @ @ @ . @ . @ . @ . @ . @ . . @ . . . @ @ @ . @ . @ @ @ @ . . . @ . @ @ @ @ . @ @ @ @ @ @ @ @ @ 
@ . @ . @ . @ @ @ . @ . . . @ @ @ @ . @ . @ . @ @ . @ . @ . @ . @ @ . @ @ . . @ . @ @ @ . . @ @ . @ . . . . . @ . . @ . @ @ @ @ . . @ @ @ . @ . . . . . . . . @ . @ @ . . . . @ @ . . . . @ @ @ @ @ @ @ 
@ @ @ . . . . @ @ @ . @ . @ . @ @ @ @ . . . @ @ @ @ . . @ @ . . @ . @ . @ @ . . . . . . . @ . . . . . @ . @ @ . @ . @ . @ . @ . @ . . @ . . . . @ . @ . @ . @ . . . @ . @ . @ @ . . @ . @ . @ @ @ @ @ @ 
@ @ . . @ . @ @ @ . . . . . . . @ @ . . @ . @ @ @ . . @ . . @ . @ . . . . @ @ . @ . @ @ . . . @ . @ . @ . . . . . . . . . . . . . . @ . @ . @ @ . @ . . . @ @ @ . @ @ . . @ . . @ @ . . . . . @ @ @ @ @ 
@ . @ . . @ @ @ . . @ . @ . @ @ @ @ @ . @ . @ @ . @ . . @ . . . @ @ . @ . @ . @ . . . @ . @ . . @ . . @ @ @ . @ @ . @ @ . @ . @ @ . @ . . . . . . . @ . @ . @ . . . @ . @ @ @ . . . . @ . @ @ @ @ @ @ @ 
@ . . . @ @ @ @ @ . . @ @ @ . . @ . . @ . . @ . . . . @ . @ @ . @ @ @ . . . . . . @ @ @ . @ @ @ @ @ . @ . . @ . . . . @ . . @ . . . . . @ . @ . @ @ @ @ . . @ . @ . @ . . . . . @ @ . @ @ @ @ @ @ @ @ @ 
@ . @ . . @ @ . . . @ @ . . . @ . @ . . @ . . @ . @ . . . @ @ @ @ @ @ @ . @ @ @ @ @ . @ @ . . . . . . . @ . . . @ . @ @ @ . @ . @ . @ @ . . . @ @ @ @ @ . @ @ @ . . . . @ @ . @ @ @ @ @ @ @ @ @ @ @ @ @ 
@ @ . @ . . @ . @ . . @ . @ . . . . . @ . @ @ . . @ . @ @ . @ . @ @ @ @ @ . . . . . . . . . @ @ . @ . @ @ . @ . . @ . @ . @ @ @ . . @ . @ . @ @ @ . . . . . @ . @ @ @ . . @ @ @ . @ @ @ @ @ @ @ @ @ @ @ 
@ . . . . @ . @ . . @ @ @ . @ . @ . @ @ . @ . @ @ . . . . . . . . @ @ @ @ @ . @ @ . @ . @ . @ @ @ @ @ @ @ @ . . @ . . @ . . . . @ . @ . @ . . . . @ @ . @ . . . . @ . . @ @ . . . . @ @ @ @ @ @ @ @ @ @ 
@ @ . @ . @ . . @ . . @ . . . @ . . . @ . . . @ @ @ . @ @ . @ @ @ @ @ . @ @ @ . . . . @ . . @ @ . @ . @ @ . @ . . . @ @ @ @ @ . @ @ . . . . @ . @ @ . . @ @ @ . @ . @ . @ @ @ @ . @ @ @ @ @ @ @ @ @ @ @ 
@ @ @ . . . . @ . . @ . @ . @ . @ . @ . @ @ . @ @ . . . @ @ . @ . @ . . . @ . @ @ . @ . @ . @ . . . . . . . . . @ . . @ . . . . . @ @ . @ . . @ . . @ @ . . . . . . . . . @ . . . . @ @ @ @ @ @ @ @ . @ 
@ @ . @ @ @ . . . @ . . . . . . . . . . . . . . . . @ @ @ @ . . . . @ . @ . . @ . @ . . . . @ @ . @ @ . @ . @ . . @ . @ @ . @ . @ @ . . . @ @ . . @ . . . @ @ @ @ . @ . @ @ @ . @ . . @ @ @ @ @ @ . . @ 
@ . . . . . . @ . . . @ . @ . @ . @ . @ . @ . @ . @ . @ @ @ @ . @ . . . @ . @ . . . . @ . @ . @ . . @ @ . . @ . @ @ . . . @ . . @ @ @ . @ . @ . @ . . @ @ . . @ . . . @ @ @ . . . @ . @ @ @ @ . . . @ @ 
@ @ . @ . @ @ @ @ . @ . . @ @ @ @ . . . @ . . . @ . . . @ @ @ . @ . @ . . . . . @ . @ . . @ . . @ . . . @ . @ @ . . . @ @ . @ . . @ . . . . . . . . @ @ @ @ . . @ . @ @ @ @ @ . @ . . . @ @ @ @ @ . @ @ 
@ . @ @ @ . @ @ . @ @ @ @ . @ . . @ @ @ . @ @ @ . @ . @ . @ . @ @ . @ @ . @ . @ . . @ . @ @ @ . @ . @ @ @ @ . . . @ . @ . . @ . @ . @ . @ . @ @ @ . @ @ @ . @ . . . @ @ @ @ @ @ . . @ @ . @ @ . @ . @ @ 
@ . . @ . . . . . . @ . @ . @ @ . @ . . . @ . @ . @ . . . . . . . . . . @ . . . @ . @ @ . . . . . . . @ . . . @ . . @ . . @ . . . . . . . @ . . . . . @ @ . . @ . @ . . @ @ @ . @ . . . . @ . . . . . @ 
@ @ . . . @ @ . @ . . . . . . . . . . @ @ . . . . . . @ . @ @ . @ . @ . . @ . @ @ @ @ . @ @ @ . @ . @ . @ . @ . . @ @ . @ @ @ . @ @ . @ . . @ . @ . @ @ @ . @ . @ @ . @ . @ . . . . @ . @ @ @ . @ @ . @ 
@ @ @ @ @ @ @ @ @ @ . @ @ @ @ @ @ @ . . . . @ @ . @ . @ @ . . . @ @ . . @ . @ @ @ . . . @ . . @ . . . . . @ @ @ . @ . . . @ . @ . . . @ . @ . @ . . . . . . . . . . . . . . . @ . @ . . . @ . . . . @ @ 
@ @ @ . . @ @ . @ . @ . . . . . . . . @ @ . @ @ @ . @ @ . @ @ @ . . @ . @ . @ @ . @ @ . . @ . . @ . @ @ @ . @ . @ . @ . @ . . @ @ @ . @ . . . . @ @ . @ . @ . @ . @ . @ @ @ @ . . @ . @ . @ @ . @ . . @ 
@ @ @ @ . . . . . . . . @ @ @ . @ @ @ . . @ @ @ . . . . . @ @ @ . @ . @ . . . @ . @ . @ . @ . @ . @ @ @ @ . @ . . . . . . @ . @ . . . @ . @ . @ @ @ @ . . . @ . . . @ . @ . @ @ . @ @ . @ . @ . @ . @ @ 
@ @ @ . @ . @ . @ . @ . . . . @ @ . @ . @ . @ . @ @ @ @ . . . . . . . . . @ . . . . . . . . . . . . @ @ . . @ @ @ @ @ @ . . . . . @ . @ . . @ . . @ @ @ . @ . . @ . . . . . . @ . . . . . . . @ . . . @ 
@ @ . . @ @ @ @ . @ @ . @ @ . . @ . . . . . . . . . . . . @ . @ . @ . @ . @ @ . @ . @ @ @ . @ @ @ . @ . @ . @ . @ . . . . @ @ . @ . . @ . @ @ . @ @ @ @ @ . @ . @ . @ . @ . @ @ @ . @ . @ . @ @ @ @ . @ 
@ . @ . . . @ . . . . . @ . @ @ @ . @ . @ @ @ . @ . @ . @ . . . @ . . @ @ . @ . . @ @ . @ @ . . @ . . . . . . . . . @ . @ . . . . @ . @ . . . . . . @ @ . . . . @ . @ . . @ . @ . @ . . @ . . @ @ . . @ 
@ . . @ . @ . . @ . @ . . . . @ . . @ . . . @ @ @ @ . . . @ . @ . . @ . . . . . @ . @ . . . @ . . . @ . @ @ . @ . @ @ . @ @ . @ @ . . @ . @ . @ . @ @ @ @ . @ . @ . . @ . . . . . @ @ @ . . @ @ . @ . @ 
@ @ . @ . @ @ @ . . @ . @ . @ @ @ . . @ @ @ @ @ @ @ @ . @ @ . @ @ . @ @ . @ . @ . . . @ @ . @ @ . @ . . . . @ @ @ . . . @ . @ . @ . @ @ . . @ . . . @ @ @ @ @ @ . . @ . . @ . @ . . . . @ @ @ @ . . . @ 
@ . . . . . . . . @ . @ @ @ . @ . @ . . . . @ @ @ @ @ @ @ @ @ . . . @ @ @ . . @ @ @ . @ . . . . @ . @ . @ @ @ . . . @ . . . @ . . @ . . . @ . @ . @ @ @ . @ . @ @ . . @ @ . . . @ @ @ . . @ @ . . @ @ @ 
@ . @ . @ @ . @ @ . . . . . . . . . . @ . @ @ @ @ @ @ @ @ @ @ @ @ @ . @ . @ . . . . . @ . @ @ . @ . @ . . . @ @ . @ . . @ @ @ . @ . @ @ . . . . @ . @ . . . . . @ . @ @ . @ . @ . @ @ @ @ @ @ @ . @ @ @ 
@ @ @ @ . . . @ @ @ @ . @ @ . @ . @ . . @ @ @ @ @ @ @ . @ . @ . . . . . . . . @ . @ . . @ @ . . . . . . @ @ . . @ @ @ . @ . . . . . . . . @ . @ @ . . @ . @ @ . . . . @ . @ . . . . . . . @ @ . . . @ @ 
@ @ @ . . @ . . @ @ @ . @ . . . @ @ . @ @ @ @ @ @ @ . . . . . . @ @ . @ . @ @ . . @ . @ @ @ @ . @ . @ . . @ . @ @ @ . . . @ . @ . @ . @ . . @ . . . @ . @ . @ @ @ . @ . . . . @ . @ . @ . . @ @ . @ . @ 
@ . @ . @ . . @ . @ @ @ @ @ @ @ @ @ @ @ @ @ @ @ @ @ @ . @ . @ . . . @ . . . . @ . . @ @ @ @ @ @ @ @ @ . @ @ . @ @ @ @ . @ @ @ . . @ @ . . @ . @ . @ . . . . . . @ . @ @ . @ . . @ . . . @ . . . . . . @ 
@ . . . @ @ . . . . @ . @ @ @ . . @ . @ @ . @ . @ . . . @ @ @ . @ @ . @ . @ . @ @ @ @ @ @ @ @ @ @ @ . @ . . . . . . . . @ @ . @ . . . @ . . . . . . . @ @ . @ @ @ @ @ . . . @ @ . @ . @ @ . @ . @ . @ @ 
@ @ . @ . . . @ . @ . . . @ . . @ . . . . . . . . . @ . @ . @ @ @ @ . @ . . @ @ @ . @ @ @ @ @ @ @ . . . . @ . @ . @ @ . . . . . @ @ @ . . @ . @ . @ . . . @ . . @ . . @ . @ . . . . . . . @ @ @ . . @ @ 
@ @ @ @ @ @ . . @ @ . @ @ . @ . . . @ . @ @ . @ . @ . . . . @ @ @ . . . . @ . . . . @ @ @ @ @ @ @ @ . @ . . @ @ @ . . . @ . @ @ . . @ @ . . @ . . @ @ . @ . @ . @ . @ @ @ @ . @ . @ . @ @ @ @ @ @ . @ @ 
@ @ . @ . . @ . . . . . . . . @ . @ . . . . @ @ . . @ . @ . @ @ @ @ . @ . . @ . @ . . @ @ @ @ @ @ . @ . . @ . @ . @ @ . . @ @ . @ . . @ . @ . @ . . . @ . . . . . . @ . . @ @ @ @ @ . . . @ . @ . . . @ 
@ . . . @ . @ . @ @ @ . @ . @ . . @ @ . @ @ . . . @ @ . . @ @ @ @ . @ . . @ @ @ . . @ . @ @ @ @ . . . @ . . . . . @ . . @ @ . . @ @ . . @ @ . . . @ . . . @ . @ @ @ . @ . . @ @ @ @ @ . @ . . . @ . @ @ 
@ @ . @ . . . . . . @ . . @ . . @ @ @ . . . @ @ @ . . . @ . @ @ . . . . @ @ . . @ . @ . . @ @ @ @ @ . . . @ . @ @ @ @ . . . @ . @ . @ . @ . @ @ . . @ . @ . . . . . . . . @ @ @ @ @ @ @ . . @ . . . . @ 
@ . . . @ . @ . @ . . @ @ @ @ . . @ . . @ . . @ . @ @ . . . . . @ . @ . . . @ . . . . . @ . @ @ . . . @ . . @ @ @ @ . . @ . . . . . . . . . . . @ . . @ . . @ . @ . @ . @ @ @ @ @ @ @ @ @ . . @ . @ . @ 
@ @ . @ @ @ . . @ @ @ @ @ @ @ @ . . @ . . @ @ . . . . . @ @ . @ @ @ . . @ . @ . @ @ @ . @ . . @ @ . @ . . @ . @ @ @ @ @ . . @ . @ @ . @ @ @ . @ . @ @ . @ . . @ @ @ . . @ @ @ @ @ @ @ @ @ . @ . . . @ @ 
@ . . . . . . @ . @ @ @ @ @ @ @ @ @ @ @ @ @ . . @ . @ . @ . . . @ . @ . @ . @ . @ @ @ @ . . @ @ @ @ . . @ . . . @ @ @ . @ . @ . . @ @ . . . . @ . . . . @ . @ . @ @ @ . . @ . . @ @ @ . @ . . @ . @ @ @ 
@ @ . @ @ @ . . . . @ @ @ @ @ @ . . . . . . . @ . @ . @ . . @ . . . . @ . . . . @ @ @ . . @ @ @ @ @ @ @ @ @ . @ @ @ . . @ . . @ . @ . @ @ @ . . @ @ @ . . . . . . @ @ . @ @ . @ . @ @ . @ . @ . @ @ @ @ 
@ @ @ @ @ @ . @ . @ @ @ @ @ @ @ @ @ @ . @ @ . . . . . . @ . @ . @ . @ . . @ . @ . @ . @ . . @ @ @ @ @ @ @ . . . @ . @ . . . @ . @ . . @ . . . @ @ . . @ . @ . @ @ @ . . @ @ . . . . . . @ . . . . @ . @ 
@ @ @ @ @ . . . @ @ @ . @ @ @ @ . . @ @ . . @ @ . @ @ @ @ . @ . . @ @ @ . . @ @ . @ . . . @ . @ . @ @ @ . @ . @ . . . . @ . @ . @ . @ . . @ . @ . . @ . . @ . . . . @ . . @ . @ @ @ @ @ @ @ . @ . @ . @ 
@ @ @ @ @ @ . @ @ @ . . . @ @ . @ . . . @ . . . . @ . . . @ @ . @ @ @ @ @ . . . . . @ @ . . . @ . . @ . . . . @ @ . @ . @ @ . . . . . @ @ @ . . . @ . @ . @ . @ . @ . . @ . . . @ @ @ . . @ @ . . . . @ 
@ @ @ @ @ @ . . @ . @ . @ . . . . . @ . @ . @ @ . . . @ @ . . . . @ @ @ . . @ @ . @ @ . @ . @ . . @ @ @ @ @ . @ . . @ . . . . @ . @ . @ @ . . @ @ @ . @ . @ . . @ . . @ . . @ @ . @ . @ . . . @ @ @ @ @ 
@ @ @ @ @ @ @ @ . . . . . @ . @ @ @ . @ . . @ . . @ @ . . . @ . @ . @ @ @ . . @ @ @ @ . @ . @ . @ @ @ . @ . . . . @ . . @ . @ . @ . @ @ @ @ . @ . . . . . @ . @ @ @ . @ @ . @ @ . . . . . @ . . . . . @ 
@ @ @ @ @ . . . . @ . @ . . . . . . . . . @ . . @ . . . @ @ . . . . . @ . . @ . . . . . . . . . @ @ . . . . @ @ . . @ . @ . . . . . . . @ . . @ . @ . @ . @ . . @ @ . . . . . . . @ @ . @ . @ . @ . @ @ 
@ @ @ @ @ @ . @ . . @ . . @ . @ . @ @ . @ . @ . @ @ . @ @ @ @ . @ . @ @ . @ . @ . @ @ . @ . @ . . @ @ @ . @ . . . @ @ . . @ @ @ @ . @ . . @ . @ . @ @ @ @ @ @ . . . @ . @ . @ . @ . @ @ . . . @ . . @ @ 
@ @ @ @ @ @ @ . . @ . @ @ . . @ . . . @ . . . . . @ . @ @ @ @ . @ . . . @ . . @ @ . . . @ @ . . @ . @ . @ . . @ @ @ . @ . . . . @ . . @ @ . . @ . @ @ @ . @ @ . @ . . @ . . @ . . . . . . @ @ @ @ . @ @ 
@ @ @ @ @ @ @ @ . . . . . @ . . @ @ @ @ @ . @ . @ @ @ . . . . . . @ . @ . @ . . . @ @ . @ . @ . . . . . @ @ . @ . . . . . @ . @ . . @ . . . @ . . . @ . . . . @ . . @ . @ . . @ . @ . @ . . . @ . . . @ 
@ @ @ @ @ @ @ @ @ . @ . @ @ @ @ . . . @ @ . @ . . @ . . @ . @ . @ @ . @ . . . @ . @ @ @ . . . @ . @ @ . . . . @ . @ . @ . . @ @ @ . . @ @ . @ . @ @ . @ . @ . . @ . . . . @ . . @ . . . @ . @ . @ . @ @ 
@ @ @ . @ @ . @ . . . @ . @ . . . @ @ @ @ @ . . @ . @ @ . @ . . . . @ . @ @ . . @ . . @ @ . @ @ @ . . . @ @ @ @ . @ @ . . @ . @ . . @ . . @ . . . . . . . . @ @ @ . @ @ . @ @ . @ . @ . . @ . . . @ @ @ 
@ @ . . . . . . . @ . . . @ . @ . @ @ @ . . @ . . . . @ . . @ . @ @ . . @ . . @ . @ . . . . . . . . @ . . @ . . . . . @ . . . @ @ @ @ . @ @ @ . @ . @ . @ . . . @ . . . @ @ @ @ @ @ @ . @ . @ . @ . @ @ 
@ @ @ . @ . @ @ . . @ . @ @ @ . . . @ . . @ . . @ . @ . . @ . @ @ @ . @ . @ . @ . . @ @ . @ @ @ . @ . . @ . @ @ . @ @ . . @ @ @ . . . . @ @ . . @ . . @ @ . @ @ @ . @ @ @ @ @ @ @ @ @ . . . . . . . . @ 
@ @ @ @ . . . @ . @ . . @ @ . @ . @ . @ . . @ . @ @ . @ . . . . @ . . . . . . @ . @ . @ . . . @ . @ . @ @ . . . . . . @ . . @ . . @ . @ . @ @ . . @ . . . @ . @ @ @ @ @ @ @ . . . @ . . @ . @ . @ . @ @ 
@ @ . . . @ @ . . . @ . @ . . . . . . . . @ . @ . . . . @ @ . @ . @ . @ @ . @ @ . @ . @ @ . @ @ . @ . @ . . @ @ @ . @ @ @ . @ . @ . . . . . . . @ . @ . @ @ . . @ . @ . @ . @ . @ @ . @ . . . @ . @ . @ 
@ @ @ . @ . . . @ . . @ . . @ @ . @ @ @ . . . . @ @ @ . . . . . . . . . . @ . @ . . . . . . @ @ . @ . . @ . . @ . . . @ . @ @ . . @ . @ . @ . @ . . @ @ @ @ . @ . . . . @ . . . . . . . @ . @ @ . . . @ 
@ @ @ @ . . @ . @ . @ @ @ @ . @ @ . . . @ @ . @ . @ . @ . @ @ @ @ @ @ @ . . . . . @ . @ @ . @ . @ . . @ @ . @ @ . @ . . . . @ . @ . @ . . @ . . @ . . . @ . . @ @ . @ . . @ . @ . @ . @ . . . . @ . @ @ 
@ @ @ @ @ @ @ . @ . . @ @ . . . . @ @ . . . . . . . . . . . . @ . . . . . @ . @ . @ . @ . @ . . . @ . @ @ @ . @ . @ . @ . @ . @ . . . . @ . . @ . @ . @ . @ . . . @ . . @ @ @ @ @ . . . @ @ . @ . . . @ 
@ @ @ @ . . . . @ . @ . @ @ . @ @ . . . @ . @ . @ . @ . @ @ . @ . @ . @ @ @ @ . . @ @ @ . . . @ . . . . @ . . . . @ @ . . @ . @ @ @ @ . . @ . . . . . . . . . @ . . . @ . @ . @ . @ . @ @ . . @ @ . @ @ 
@ @ @ @ @ . @ . . @ @ . @ . . . . . @ . @ @ . . @ @ . @ @ . @ . @ @ . @ . @ @ @ . . @ @ @ @ . . @ @ . @ @ @ . @ . . . @ . . . . . @ . @ . @ . @ . @ @ . @ . @ . . @ . @ . . . . . . . . . @ . . . . . @ 
@ @ @ . . @ @ @ @ . . . @ . @ . @ . . @ . . . @ . @ . . . . . . . . . . . . @ @ . @ . @ . @ . @ . . . @ @ . @ . . @ . . @ . @ . @ @ . . . . @ . . . . @ . . @ @ . @ . @ . @ . @ . @ @ @ . @ @ . @ @ @ @ 
@ @ . . @ . @ . @ @ @ . @ . @ . @ . @ @ @ . @ . . . . @ . @ . @ @ . @ @ . @ . @ @ . . . . . . . @ @ @ . . . . . @ . . @ . . . @ . . @ . @ . . @ @ . @ @ @ . . @ @ @ . . @ . . @ . @ . @ @ . @ @ . . @ @ 
@ . @ . . . . . . . . . . . . @ @ @ . . . . @ @ . @ @ . . . @ @ . . . @ . . . . @ @ . @ . @ @ . @ . @ @ @ . @ . . @ . . @ . @ . . @ . . @ . @ . . . . . @ @ . . @ @ @ . @ . @ . . . . . . . @ @ . @ . @ 
@ . . @ . @ . @ . @ . @ . @ . . @ . @ . @ @ @ @ @ @ @ @ . @ @ @ . @ . @ . @ . @ @ @ @ . . @ . . @ . . . . . . @ . @ . @ . @ . @ . @ @ . . @ @ @ . @ . @ . @ . @ @ @ @ @ . . . @ . @ . @ . @ . . . . . @ 
@ @ . . . . @ . . . @ . . @ . @ . . . . @ @ @ @ @ @ @ @ . @ @ . . @ . . @ . . . @ @ . @ . @ . @ . . @ . @ . @ . . @ . . . . . . . . . @ @ @ @ . . @ . . . . @ @ @ @ @ . @ . @ @ . . @ @ . . . @ @ @ @ @ 
@ . . @ . @ . @ . @ @ @ . @ @ . @ . @ @ @ @ @ @ @ @ @ . @ . . . @ . . @ @ @ . @ . . . . . @ . @ @ . . @ . . @ . @ @ . @ . @ . @ @ . @ @ . @ . @ . @ @ @ . @ . @ @ @ @ . . . . . @ . . . @ . @ . . . . @ 
@ @ . @ @ . . . . . @ @ . @ . . . . . . @ @ @ @ @ . . . . . @ . . @ . . . . @ . . @ . @ . . @ . . . @ . @ . @ . @ @ @ @ . . @ @ @ @ . @ . @ . @ @ @ @ @ . . . @ @ @ @ . @ . @ @ @ . @ . . @ @ @ . @ . @ 
@ . . @ . @ . @ . @ @ @ @ . . @ @ . @ . . . @ @ @ @ . @ . @ . . @ @ @ . @ . @ @ . . @ . . @ . @ @ . @ . @ . . @ . . @ @ . @ @ @ @ @ . @ . . . @ . @ . @ @ . @ . @ @ @ @ . . @ . . . @ . @ @ @ @ . . @ @ 
@ @ . . . . @ . . @ @ @ . @ @ . . . @ @ . @ . @ @ @ @ . . @ @ . . @ @ @ . . @ . . @ @ @ . . . . . @ . . . . @ . @ . . . . @ @ @ @ . . . . @ . . . . . . . . . . . @ @ . . @ @ . @ . . @ @ @ @ @ . @ . @ 
@ . . @ . @ . @ @ . . . . . . . @ . @ @ . . . . @ . @ @ . . @ @ . @ @ @ @ @ . . @ @ @ . . @ . @ . . @ . @ . @ . @ . @ . @ . . @ @ @ . @ @ . @ . @ @ . @ . @ . @ @ @ @ @ . @ @ @ . . @ . @ . @ @ . . . @ 
@ @ . . @ . . . . @ . @ . @ @ . @ . . . @ . @ @ @ . . @ . @ . . . @ @ @ @ @ @ . @ @ . @ . . @ . . @ . @ . . . . . @ . @ . @ . @ @ @ @ . . . . . @ . @ . . @ . . . . @ . . . @ . @ . . . . . . . . @ . @ 
@ . . @ . @ @ . @ . @ . . @ @ . . @ . @ . . . @ . . @ . @ . @ . @ @ @ @ . @ . @ . . . . . @ . @ . @ . . . @ . @ . . . . . . . . @ @ @ @ . @ . @ . . . . @ . . @ . @ @ @ . @ @ . . . @ @ @ . @ . @ @ @ @ 
@ . @ . . . . . . . . . @ . . . @ @ @ . @ . @ . @ . . . . . . . @ @ @ . . . . . . @ . @ . @ . . @ . . @ . . @ . . @ . @ . @ . @ @ . @ @ @ . . . @ @ @ . . @ . @ . . @ @ . . @ . @ . . @ . . @ @ @ @ @ @ 
@ @ @ @ @ @ @ . @ . @ @ @ . @ . . @ . . @ . @ . . . @ . @ @ . @ @ @ . . @ . @ @ . . @ . . . @ . @ @ . @ . @ @ @ . . @ . . . @ . @ . @ @ . @ . @ . @ @ @ @ . . . @ . . . @ @ @ @ . . @ . @ @ @ @ @ @ @ @ 
@ . @ @ . @ . @ . . . @ @ @ . . @ . . @ @ . @ . @ @ . . @ . . . . . @ . . @ @ . . @ @ @ . @ . . . . @ @ . . . @ . @ . @ @ . . . . . . . . @ @ . . @ @ @ @ @ . @ . . @ @ @ . @ . @ . . . . @ @ @ @ . @ @ 
@ . . . . . . @ @ . @ . @ @ @ . @ . @ . . . @ @ . . . @ @ @ . @ . @ . @ . . . @ . @ . @ . . . @ @ . . . @ @ . @ . . . . . @ . @ . @ @ . @ . @ . @ . @ @ @ . . @ @ . . . . . . . @ @ . @ @ . . @ . . . @ 
@ @ . @ @ @ . . @ @ . . . . . . . . @ . @ . . . @ @ . . @ . . . @ . . . . @ . . @ @ . . . @ @ . . . @ . . . @ . @ . @ . @ . . . @ @ @ . @ . @ . @ . . @ @ @ . . @ . @ . @ . @ @ . @ . . . . @ @ @ . @ @ 
@ . . @ @ . . @ . . . @ . @ @ . @ . . @ @ . @ @ @ @ . @ . @ . @ @ @ . @ . @ @ @ @ @ . @ . . . @ @ . @ . @ @ . . . . . @ . @ . @ @ @ . . . . . . . . @ @ @ @ @ @ . . @ . . @ @ . . . . @ @ @ @ @ . . . @ 
@ . @ . . . @ . . @ . . @ . . . . @ @ @ . . @ . @ . @ . . . . @ @ @ @ . . @ . @ @ @ @ . . @ @ @ . . . @ . . @ . @ . @ @ . . . @ @ . @ . @ @ . @ . @ . @ @ @ @ @ @ . . @ . . . @ . @ @ . @ . @ . @ . @ @ 
@ @ . @ . @ . @ . @ . @ . @ . @ @ . . . . @ . . . . . . @ @ . @ @ @ @ @ . @ . @ @ @ @ @ @ @ @ @ @ . @ @ @ . . @ . . . @ @ @ @ @ . . . . . . @ @ @ @ . . @ . @ @ . . @ . . @ @ . . . . . . . . . . . . @ 
@ . . . . . . . . @ @ . . . . @ . . @ @ . @ @ @ @ . @ . . @ @ @ @ @ @ @ @ . . . @ @ @ @ . @ @ . . . . @ @ . @ @ @ . @ . . @ . . @ . @ . @ @ @ @ @ . @ . . . . @ @ @ @ @ @ @ @ @ . @ . @ . @ . @ . @ @ @ 
@ . @ @ . @ . @ @ . . . @ @ . @ . @ . . . . . . @ @ . . @ @ @ @ @ @ @ @ . . @ . . @ . . . . @ @ @ . @ @ . . @ . . @ @ . @ @ @ . . @ . . . @ @ @ @ . . @ . @ @ . @ . @ . @ . . . . . @ . . . @ @ @ @ @ @ 
@ @ . . . . @ @ . @ . @ . . . @ @ . . @ . @ @ @ @ @ @ @ @ @ @ . . @ . . . @ @ . @ . @ @ . @ . @ . @ @ . @ . @ . @ @ . . . @ . . @ . @ . @ . @ @ . @ . . . . . . . . . . . @ . @ . @ . @ . @ @ @ @ @ @ @ 
@ @ @ @ . @ . @ . . . @ @ . @ . @ @ . @ . . . . @ @ . . @ @ @ . @ . @ @ . @ . @ . . . . . . . . . . . . . . . . . . @ . @ . @ . . . . . . . . . . @ @ @ @ @ @ @ @ @ @ @ . . . @ . . . . @ . @ @ @ @ @ @ 
@ @ . . . . . @ @ . @ . . . . . . . @ . . @ . @ . . . @ . @ . . . . . . . . . . . @ . @ @ @ @ . @ @ . @ . @ . @ @ . . . . . . @ . @ . @ . @ @ . @ . . . . . . . . . . . . @ . . @ . @ @ . . . @ @ . . @ 
@ @ . @ . @ @ . . @ . . @ . @ @ @ . @ @ . . @ @ @ @ . . . . @ @ . @ . @ . @ . @ . . @ . @ . . @ . @ . @ @ . . @ . . @ @ @ . @ . @ . . @ . . . @ . . @ . @ @ . @ . @ @ . @ @ . @ . . . @ @ . @ . @ @ . @ 
@ @ @ . . . . @ . . @ . . @ @ @ . @ . . . @ . @ . . . @ . @ . @ . . @ . . @ @ . . @ @ . . @ . @ . @ . @ @ @ @ . @ . . @ . . . . @ @ @ . @ . @ @ . @ . . . . @ . . @ @ @ . . . . @ . @ . . . . . . . . @ 
@ @ . @ . @ @ @ @ . . . @ @ . . . . . @ . . . . @ @ . . @ . . @ . @ @ @ @ @ @ @ . . . @ . . . . . . . . . @ . . . . @ . @ @ @ . . @ . . . . @ @ @ . . @ @ . @ @ . . . . @ @ . @ @ . . @ . @ . @ . @ . @ 
@ . . . . . @ @ @ @ @ . . @ @ @ . @ . . @ . @ . @ . . @ . . @ . @ @ @ . . . @ @ . @ @ . . @ . @ . @ . @ @ . @ @ @ . . . . . . @ @ . . @ @ @ @ @ . @ @ . . @ . @ . @ . @ @ @ @ @ @ @ . . . @ . . @ @ . @ 
@ . @ . @ @ . @ . . . . @ . @ @ @ . . @ . . @ . @ . @ . @ . . . . @ @ . @ @ @ . . @ @ @ . . @ . . . @ @ . . . @ . @ @ . @ @ @ @ @ @ . @ . @ . . . @ @ @ . . . . . @ @ @ @ @ @ @ @ @ @ . @ @ . @ @ . . @ 
@ . @ . . @ . . . @ . @ @ . @ @ @ @ . @ . @ . @ @ . @ . @ . @ . @ . . . . @ . @ . @ @ @ @ @ @ @ . @ . . @ @ . . . . . . . @ . . . . . @ . . @ @ . . @ @ @ . @ . @ @ @ @ @ @ @ @ @ @ . @ . . @ . @ @ . @ 
@ . . @ @ . @ @ . . @ . . . . @ . . . @ . . . . . . . . . . @ @ @ . @ @ @ . . . . . @ @ . . @ . . . . @ @ . @ . @ . @ @ . . . @ . @ . . . @ . @ . @ . @ . @ . . . @ @ @ @ @ @ @ @ . . . . @ @ . . . . @ 
@ . @ @ . . . . . @ . . @ @ @ @ . @ . @ @ @ . @ . @ . @ . @ @ . @ . . @ @ @ . @ . @ @ . . @ . . @ @ . . . . @ . . @ . . @ . @ . . @ . @ . . . . . . . . . . @ . @ @ @ @ @ @ @ @ @ @ @ @ . . . . @ . @ @ 
@ @ . . . @ . @ . . . @ . @ . @ @ . . . . @ . @ . . @ @ . . . . . . @ @ @ @ @ . . . . @ . @ . @ . . . @ @ @ @ @ . @ @ . . . @ @ @ . . . @ @ . @ @ . @ . @ . . @ @ @ @ @ @ @ @ @ @ @ @ @ @ . @ @ . . . @ 
@ @ @ . @ @ @ @ @ . @ . . . . @ . @ @ . @ . . . @ . . @ . @ . @ . @ @ @ @ @ . @ . @ . . . @ . . @ . @ @ @ @ @ @ @ @ @ @ . @ . . . . @ @ @ . . @ . . . @ . . @ . @ @ @ @ @ @ @ @ @ @ @ @ . . . . @ . @ @ 
@ @ @ @ @ @ @ @ @ @ @ @ @ @ . . . . . . @ @ . @ @ . @ @ @ . . @ @ @ @ @ @ . . . . . @ . @ . @ @ @ @ @ @ @ @ @ @ @ @ @ @ . . @ . @ . . . @ . @ @ @ . @ @ @ . . . @ @ @ @ @ @ @ @ @ @ @ @ @ . @ . @ . @ @ 
@ @ @ @ @ @ @ @ @ @ @ @ @ @ . @ . @ @ . . @ . . . @ . . . . @ @ @ @ @ @ @ @ . @ . @ . . . . . @ @ @ @ @ @ @ @ @ @ @ @ . . @ @ @ @ @ . @ @ @ @ @ @ @ @ @ @ . @ . . @ @ @ @ @ @ @ @ @ @ @ @ @ . . @ . @ @ 
@ @ @ @ @ @ @ @ @ @ @ @ @ @ @ @ @ @ @ @ @ @ @ @ @ @ @ @ @ @ @ @ @ @ @ @ @ @ @ @ @ @ @ @ @ @ @ @ @ @ @ @ @ @ @ @ @ @ @ @ @ @ @ @ @ @ @ @ @ @ @ @ @ @ @ @ @ @ @ @ @ @ @ @ @ @ @ @ @ @ @ @ @ @ @ @ @ @ @ @ 
3
76 65 83 11
39 39 60 80
91 77 1 50
