50 50
@ @ @ @ @ @ @ @ @ @ @ @ @ @ @ @ @ @ @ @ @ @ @ @ @ @ @ @ @ @ @ @ @ @ @ @ @ @ @ @ @ @ @ @ @ @ @ @ @ @ 
@ . @ . . . . @ @ . @ . @ . @ @ . @ @ @ @ @ @ @ @ @ @ @ . . @ . @ @ @ . @ . @ @ @ @ @ . @ . @ . @ @ 
@ . @ . @ . @ . . . . . . . . @ . @ @ @ @ @ @ @ @ @ @ @ @ . . . . @ . . . . . @ @ @ . . . . . . . @ 
@ . . . . @ @ @ @ . @ @ @ . @ . . . @ . . @ @ @ @ @ @ @ @ @ @ . @ . . @ @ @ . . . . . @ @ . @ . @ @ 
@ @ @ . @ . @ . @ @ . @ . . . . @ @ @ . @ . @ @ @ @ @ @ @ . . . . @ . @ . . . @ . @ @ @ . . . @ @ @ 
@ . . . . . . . @ . . . . @ @ . . @ . . . . . @ @ @ @ @ @ @ . @ . . . @ . @ . . @ . @ . @ . @ . . @ 
@ . @ . @ . @ . @ @ @ . @ @ . @ . . @ . @ @ @ @ @ @ @ @ @ @ @ . @ @ . . @ @ . @ . . . . . @ . . @ @ 
@ @ . . . @ @ @ @ . . @ @ @ . . @ . . . @ @ @ @ @ @ @ @ @ @ . . @ . @ . . @ . . . @ @ @ . @ @ . . @ 
@ . @ . @ @ @ . . . @ . . . @ . . @ @ . . @ @ @ @ @ @ @ @ @ @ . . . . . @ @ . @ @ @ @ @ . . @ . @ @ 
@ . @ . @ @ . . @ @ . @ . @ . @ . @ . . @ @ @ @ @ @ @ @ @ . . @ . @ @ . @ . @ . @ @ @ @ @ . . . . @ 
@ . @ . . @ @ . . . . . . . . . . . @ . . @ @ @ @ @ @ @ @ . @ . @ . . . . . @ . . @ @ @ @ @ . @ . @ 
@ . . . @ @ . @ @ . @ . @ . @ @ @ . . . @ . @ . @ @ @ @ . . . . . @ @ . @ . @ . @ @ @ @ @ . @ @ . @ 
@ @ @ . . @ . @ @ @ @ @ @ @ . . . . @ . . . . . @ @ @ . . @ . @ . @ . @ . . @ . . @ @ . . . . . @ @ 
@ @ . . @ . . . @ @ . . . . . @ . @ . @ @ . @ . . @ . @ . . @ . . . . . @ . @ . @ . @ . @ . @ @ . @ 
@ . @ . . @ . @ @ @ @ . @ . @ . . @ . @ . . @ . @ . . . @ . @ . @ . @ . . . . . @ . . @ . . @ . . @ 
@ . @ . @ . . . @ @ @ @ . @ @ @ @ . . . @ . @ @ . @ @ . @ . . @ . @ . @ . @ . @ . . @ . @ . . . @ @ 
@ . . . @ @ . @ @ @ @ . . @ @ . . @ @ . . . . . . . . . . . @ @ . . . . . @ . . . @ . . @ . @ @ @ @ 
@ @ @ . . . . . @ @ . @ . . . @ . . @ . @ @ . @ . @ . @ . @ @ @ @ . @ . @ . . @ @ . @ . @ . . @ @ @ 
@ . @ . @ . @ . @ . . . . @ @ . @ . . @ @ @ @ @ @ . . @ @ . @ @ . . @ . . @ . . @ . . . . . @ . @ @ 
@ . @ @ . . @ @ @ @ . @ . . . . . . @ @ @ @ @ . . . @ . @ . . . @ @ @ . @ . . @ . @ @ @ @ . . . . @ 
@ . @ . @ . . . @ @ @ . @ @ @ . @ . . @ . @ . @ . @ . . . . @ . . @ . @ . @ . . . . @ @ . . @ . @ @ 
@ . . . . . @ . @ @ . . @ . @ . . @ . @ . . . . @ . @ . @ . . @ @ . . . . . . @ @ @ @ @ @ @ . . . @ 
@ . @ . @ . . @ . . @ . . . @ . @ @ . . . @ . @ @ . @ @ . @ . @ . @ . @ . @ . @ @ . @ . . . @ . @ @ 
@ @ . . @ @ . . @ . @ . @ @ @ @ . . @ @ . @ . @ . . . . . . . . . . . . @ . . @ . . . @ @ . @ . . @ 
@ @ @ . @ . @ . @ . @ . @ . @ . @ . @ . . . @ @ @ . @ @ . @ . @ . @ . @ . @ . . @ . @ @ . . @ . @ @ 
@ @ @ @ . . . . . . . . . . . . . . . @ @ . . @ @ . @ . . . @ . . . @ . . . @ . . . @ . @ . @ . . @ 
@ @ @ @ @ . @ @ . @ . @ . @ . @ . @ . . . @ . . . @ . @ @ . . @ . @ . @ @ . @ . @ . @ . . . . @ . @ 
@ . @ @ . @ . @ @ . . . @ . . @ . @ . @ . . . @ @ . . . . @ @ @ @ . . @ . . . @ . . . @ . @ . . . @ 
@ . . . . . . . @ @ . @ . @ @ . @ . @ . @ @ . @ . @ . @ @ @ . @ . @ . @ @ . @ . @ . @ @ @ . . @ @ @ 
@ @ . @ . @ . @ @ . @ . . . . . . . . . . . . . . . . . @ . . . . . . . . . . . . . @ . . @ . . @ @ 
@ @ @ @ @ @ . . . . . . @ . @ . @ . @ . @ @ . @ . @ . @ . @ @ @ . @ . @ . @ . @ @ . @ @ . @ @ . . @ 
@ @ @ @ @ @ @ . @ . @ . . @ @ @ @ . . @ . . @ @ . . @ @ . @ @ @ @ . . . @ . @ . . . @ . . . . . @ @ 
@ @ @ @ @ @ @ @ @ @ @ @ . @ @ . . @ @ . @ . . @ @ . @ @ . . . @ . @ . @ . . . . @ . @ . @ . @ . . @ 
@ @ @ @ @ @ @ @ @ @ @ @ @ . . @ . . . . @ . @ @ . . . . . @ @ . . @ . @ . @ @ @ . . . @ . @ . @ . @ 
@ @ @ @ @ @ @ @ @ @ @ @ @ . @ . @ . @ . . . . . . @ . @ . @ . @ . . @ . @ . @ . @ . @ . . . . . . @ 
@ @ @ @ @ @ @ @ @ @ . @ . . . . . . . @ . @ . @ . @ @ . . . . . . @ @ . . . @ . . . . . @ . @ @ . @ 
@ @ @ @ @ @ @ @ @ . . . . @ . @ @ @ @ . @ . . @ . . . @ @ @ @ @ . @ . @ . @ . @ . @ @ . . @ @ @ @ @ 
@ @ @ @ @ @ @ @ @ @ . @ . . @ . . . . . . . @ . . @ @ @ . @ @ . . . . . . . . . . @ @ . @ @ @ @ @ @ 
@ @ @ @ @ @ @ @ @ @ @ . . @ . . @ . @ . @ . . @ . . @ . . . . . @ @ . @ @ . @ . @ . . . @ @ @ @ @ @ 
@ @ @ @ @ @ @ @ . @ . @ @ . @ . . @ . . @ . @ @ @ . . @ @ . @ . @ . . @ @ @ . . . @ . @ @ . . . @ @ 
@ @ @ @ @ @ @ @ . . . . . . . . @ @ @ . @ . @ @ @ @ . . @ . @ . @ @ . @ @ @ @ . @ . @ . . . @ @ . @ 
@ @ @ @ @ @ @ @ @ . @ . @ . @ @ . . . . @ . . @ @ @ @ . @ @ . . @ @ @ @ @ @ . . @ . @ . @ @ . @ . @ 
@ @ @ @ @ @ @ . . . . @ . . @ . . @ . @ . . @ @ @ @ . @ . @ @ . @ @ @ @ @ @ @ . . . . . . . . . . @ 
@ @ @ @ . @ . @ . @ @ . @ . . @ . @ @ . . @ . . . . . . . . . @ @ @ @ @ . @ . . @ @ . @ . @ . @ . @ 
@ @ @ @ . . . . . @ . . . . @ . @ . . . @ . . @ . @ @ @ @ . @ . @ @ @ . . . . @ . @ . . @ . . @ . @ 
@ @ @ @ . @ . @ . . @ . @ @ . . . . @ . . @ . . @ . @ . @ . . . . @ . . @ . @ . . . @ . . @ . @ . @ 
@ @ @ @ . . @ . . @ @ @ . . . @ @ . @ . @ @ @ @ . . . . . . @ . @ . @ @ . . . @ . @ . . @ @ . . @ @ 
@ @ @ @ @ @ . . @ @ @ . @ @ . . @ @ . @ . @ . @ @ . @ . @ . @ . . . . . . @ . . . . @ . @ @ . @ @ @ 
@ @ @ @ @ @ @ . . @ . . . . . @ @ @ . . . . . . . . . @ . . @ @ . @ . @ @ @ . @ . @ . . . . @ @ @ @ 
@ @ @ @ @ @ @ @ @ @ @ @ @ @ @ @ @ @ @ @ @ @ @ @ @ @ @ @ @ @ @ @ @ @ @ @ @ @ @ @ @ @ @ @ @ @ @ @ @ @ 
3
27 11 36 32
16 11 19 14
25 6 28 7
