50 50
@ @ @ @ @ @ @ @ @ @ @ @ @ @ @ @ @ @ @ @ @ @ @ @ @ @ @ @ @ @ @ @ @ @ @ @ @ @ @ @ @ @ @ @ @ @ @ @ @ @ 
@ @ @ @ @ @ . @ @ @ . @ . @ @ @ @ @ @ @ . . . . . . . @ @ @ @ @ @ @ . @ @ . . . @ . @ . @ . . @ . @ 
@ @ @ . @ . . . @ . . . . @ . @ . @ . @ @ . @ . @ @ . . @ . . @ @ @ . . . . @ . . . . . . . @ . . @ 
@ @ @ . . @ @ . . @ . @ @ . . . . . . . @ . . @ @ @ . @ @ @ . . . . @ @ @ . . @ @ . @ . @ . @ . @ @ 
@ @ . @ . @ . @ . @ . @ . @ @ @ @ @ @ . . . @ @ @ @ . . @ . . @ @ @ . . . . @ . . @ @ @ . . . . . @ 
@ . . . . . . . . . . . . . . . . . . . @ @ @ . @ . . @ @ @ . . . . . @ . @ @ . @ @ @ . @ . @ @ . @ 
@ @ . @ . @ . @ . @ . @ . @ . @ @ . @ @ . . . . . . @ . @ . . @ . @ . @ @ . . . . @ . . @ . @ @ @ @ 
@ . . . @ . . @ . @ @ @ @ . . . @ . . @ @ . @ . @ . . . . @ . . @ . . . . . @ . @ . @ . . @ @ @ @ @ 
@ @ . @ @ @ . . @ . . . . . @ @ . . @ @ . . . @ @ @ . @ . . . @ . . @ . @ . @ . @ . . . @ @ @ @ @ @ 
@ . @ . @ . . @ . @ . @ @ . @ . @ . . . @ . @ @ @ . . . @ @ . . @ . @ . @ . @ @ . @ . @ . @ @ . @ @ 
@ . . . . . @ . . @ . . @ @ . . . . @ . @ . . @ . @ . @ @ @ . @ . @ . . @ @ . . . . . . . . . . . @ 
@ . @ . @ . @ . @ . . @ . @ @ . @ . . @ . . @ . . . . . . . @ @ . @ @ . . . . @ @ @ @ @ . @ . @ . @ 
@ . @ @ . . @ . . . @ . . . . . @ @ @ . . @ @ @ . @ . @ . @ . . . . @ @ . @ . . . . . . @ . . . @ @ 
@ . @ @ @ . . @ . @ . . @ . @ . . @ . . @ @ @ . @ . @ . . . . @ @ @ . @ . @ . @ . @ . @ @ @ . @ @ @ 
@ . . @ . . @ @ @ @ @ @ @ @ . . @ @ @ . . . @ . @ . @ @ . @ . . . . . . @ . . . @ @ . . @ . . @ @ @ 
@ . @ . . @ @ @ @ . . @ @ . @ . . @ @ . @ . . . . . . @ . . @ . @ @ . @ @ @ . @ @ @ @ @ . @ . @ @ @ 
@ . @ @ . @ @ @ . @ . . @ . . . @ @ . . . @ @ . @ . @ . @ . . @ @ @ . . . @ @ @ @ @ . . . @ . @ @ @ 
@ @ . . . . . . . @ . @ . . @ . . . @ . @ . @ @ @ @ @ . @ @ . . . . @ . @ . @ @ @ . . @ . @ @ @ @ @ 
@ . @ @ . @ . @ @ . . @ . @ . . @ @ . . . . . @ @ . . . . . . @ . @ . . . . . @ . @ . @ . . . @ . @ 
@ . . . . . @ . . @ . . @ . . @ @ . @ . @ . @ . . . @ . @ @ . . @ @ @ @ . @ . . . . . . @ @ . . . @ 
@ . @ @ @ . . @ . . . @ . . @ . . . . . . @ @ . @ . . @ . . . @ . @ @ . . . @ . @ . @ . . . @ . @ @ 
@ . @ . . . @ . . @ . @ . @ . . @ . @ @ . @ . @ @ . @ @ . @ . . . . @ @ . @ . . . @ . . @ @ . . . @ 
@ . . @ @ . @ . @ . . . . @ . @ . . . @ . . . . @ . . @ @ . . @ . @ . . . . @ @ . @ @ . . . @ @ . @ 
@ . @ @ . @ @ . . @ . @ . . @ @ @ . @ . . @ . @ . . @ @ @ . @ . @ @ @ @ . @ @ @ . @ @ . @ . @ . . @ 
@ . . @ . . . . @ . . @ . @ . @ . @ @ @ . . @ @ . @ @ @ @ . . . . . . . @ . @ . . . . @ . @ . @ . @ 
@ . @ . @ . @ . . @ @ . . . . . . . @ . @ . . . @ @ @ . . . @ . @ . @ . . . @ @ . @ . . . . . . @ @ 
@ . . . @ @ . . @ @ @ @ . @ . @ @ @ @ . . @ . @ . @ . @ . @ @ . . @ . . @ . . @ . . @ . @ . @ @ @ @ 
@ . @ @ @ . @ . . . . . @ @ @ . @ @ . . @ . . @ . @ . @ . . @ . @ . @ . . @ . @ . @ @ @ . . . . @ @ 
@ . . @ . . . . @ . @ . . . @ . . . @ . @ @ . . . . . @ . @ . . . . . @ . . @ @ @ @ @ . . @ . @ . @ 
@ . @ @ @ . @ . . @ @ . @ . . @ @ . . . . @ . @ . @ @ . . . @ . @ . @ . . @ . @ . @ @ @ . @ . . . @ 
@ . . @ . @ . . @ @ @ . . @ @ @ . . @ . @ . @ . . @ . @ . @ @ . . @ . @ . . . . . . . . @ . . @ . @ 
@ @ . . . @ @ . . . . @ . . . @ . @ . . . . . . @ . . . . . @ . @ . . @ @ . @ . @ . @ . @ . @ . . @ 
@ . . @ @ . . . @ @ . @ . @ . @ @ . @ . @ . @ . @ . @ . @ . @ @ @ @ . . . . . @ . @ @ @ . . . @ @ @ 
@ @ . . . @ @ . . . @ . @ @ . @ . . . @ @ @ . . . @ . . @ . . @ @ . @ . @ . @ @ . @ . . . @ . . . @ 
@ @ @ @ @ @ @ @ . @ . . @ . . . . @ . @ . . @ . @ @ @ . @ . @ . @ . @ @ @ @ . . . @ . @ . @ . @ . @ 
@ @ . @ @ @ . . . . . @ @ @ . @ . @ @ . @ . . @ . . . . @ . . . . . . . @ . @ . @ . @ . . @ . . @ @ 
@ . . . @ . @ @ . @ . @ . . @ . . . . . . @ . @ @ @ @ . @ @ . @ . @ . @ . . . . . . . @ . . @ @ @ @ 
@ @ . @ . . . . . . @ @ @ . @ @ . @ @ . @ . . . . @ . . @ . . . @ @ . . . @ . @ . @ . @ . @ @ @ @ @ 
@ . . @ . @ . @ . @ . @ . . @ . @ . . . @ . @ @ @ @ . @ @ @ . @ . . . @ . . @ . @ . @ @ . . . @ @ @ 
@ . @ . @ . . @ . . . . @ . . . . . @ . . . . . . . @ . @ @ @ @ @ @ . . @ . . . . . . . @ . @ @ @ @ 
@ . @ . . . @ . . @ . @ @ @ . @ . @ . . @ . @ . @ @ @ . . @ @ @ @ @ @ @ . . @ . @ . @ @ . @ @ @ @ @ 
@ . . . @ . @ . @ @ @ . @ . . @ @ . . @ . @ @ @ @ . @ . @ . @ . @ . @ . @ . . @ . . . . . @ @ @ @ @ 
@ . @ . @ @ . @ . @ . . . . @ . . @ . . . @ . . . . . . . . . . . . . . . . @ . @ . @ . @ @ @ . @ @ 
@ . @ @ . . . . . . . @ @ . . . @ @ . @ . . @ . @ . @ . @ . @ @ . @ @ . @ . . . @ . . @ . @ . . . @ 
@ @ @ @ . @ . @ . @ . @ . . @ . @ @ @ @ . @ @ . . @ . . @ . @ @ . . @ . . @ . @ . . @ . . . . @ . @ 
@ . @ @ @ . . @ @ @ . . @ . . @ . . . . . @ . . @ @ @ . @ @ . . . @ @ @ @ . @ @ @ . @ . @ @ . @ . @ 
@ . @ . . @ @ . . . . @ @ @ . . @ . @ @ . . @ . . . . @ @ @ @ . @ . . . . . . . . . . . . . @ . @ @ 
@ . . @ . @ . @ @ . @ . @ @ @ @ . . @ @ . @ @ . @ . @ @ @ @ @ @ @ . @ . @ . @ @ @ . @ . @ . . . . @ 
@ @ . . . . . . . . . . . @ . . . @ . . . @ . . . @ @ @ @ @ @ . . . . @ . . @ . . . @ . @ . @ . @ @ 
@ @ @ @ @ @ @ @ @ @ @ @ @ @ @ @ @ @ @ @ @ @ @ @ @ @ @ @ @ @ @ @ @ @ @ @ @ @ @ @ @ @ @ @ @ @ @ @ @ @ 
3
13 40 44 24
11 15 17 32
9 21 17 44
