50 50
@ @ @ @ @ @ @ @ @ @ @ @ @ @ @ @ @ @ @ @ @ @ @ @ @ @ @ @ @ @ @ @ @ @ @ @ @ @ @ @ @ @ @ @ @ @ @ @ @ @ 
@ @ . . @ @ @ @ @ @ @ @ . @ . . @ . @ . . . . . @ . @ @ @ . . @ . . . . . . @ @ @ @ . . @ . @ @ @ @ 
@ . @ . @ @ @ @ @ @ @ . . . . @ @ . . . @ @ . @ @ . @ . @ . @ . @ . @ . @ @ @ @ @ . @ . @ . . @ @ @ 
@ . . . @ @ @ @ . @ . @ . @ . @ . @ @ . . . @ @ . . . . . . . . . . . @ @ . @ @ . . . . . . @ @ @ @ 
@ . @ . @ @ @ . . . . . . . @ . . @ . @ . @ . . . @ @ @ @ . @ . @ @ . @ . . . . @ . @ @ . @ @ @ @ @ 
@ . @ . . @ . @ . @ . @ . @ @ @ . . . . . . . @ . . . . . @ @ . @ @ @ . @ . @ . . . @ . . . @ @ @ @ 
@ @ . . @ . . . @ . @ . . . @ @ @ @ . @ . @ . @ @ . @ . @ . . . @ @ . . . @ . . @ @ . @ . @ @ @ @ @ 
@ . @ . . @ . @ . . @ @ @ . . @ . @ . @ . . @ @ . . . @ . . @ . . @ @ . @ . @ . @ . . @ . . @ @ @ @ 
@ . . @ . . . . . @ . . . . @ . . . @ . . @ . @ @ . @ @ @ @ . . @ . . . . . @ @ . @ . . @ . . @ @ @ 
@ @ . . @ @ . @ . . @ . @ . . . @ @ @ @ . . . . @ . @ @ @ @ . @ . . @ . @ . @ . . . . @ . . @ . @ @ 
@ . @ . @ . . . @ . @ @ . . @ @ @ @ @ @ @ . @ . . @ . @ @ @ @ . @ . . @ @ @ . @ @ @ . . @ . . . @ @ 
@ . . . . @ . @ . @ . . @ . . @ @ @ @ @ @ @ . . @ . . . . @ @ . . @ . . @ . . . @ . . @ . @ . @ . @ 
@ @ @ @ . . . . . . @ . @ . @ @ @ @ @ @ @ . @ . . . @ @ @ @ . . @ . . @ . @ . @ . @ . . . . . . . @ 
@ . . @ @ . @ . @ . . . . . @ @ . @ . @ . . . . @ . . . . . @ . . @ . . . . . . . . . @ . @ . @ @ @ 
@ @ . . @ @ . @ @ @ @ . @ . . . . . . . @ . @ . @ . @ @ . @ . . @ . . @ . @ @ @ . @ . @ @ @ @ @ @ @ 
@ @ . @ . @ . . @ . @ . . @ . @ @ . @ . . . . @ . @ @ @ @ . @ . . . @ . @ . . . . @ . . . @ @ @ @ @ 
@ . . . . . @ . . . @ @ @ @ @ @ @ @ . . @ @ @ . . @ @ @ @ . . @ @ . . . . @ . @ . @ . @ @ . @ @ @ @ 
@ . @ . @ . . @ @ . . @ @ @ . @ @ . @ . . @ . . @ . . . . . @ . @ . @ @ @ @ @ . . @ . . . . . @ @ @ 
@ . . @ . @ . @ @ . @ @ . . . . . . . . @ @ @ . @ . @ . @ . @ . . . . @ @ @ . @ . . @ @ @ . @ @ @ @ 
@ @ @ . . . . . . . . . . @ . @ . @ @ . . @ . . . @ @ @ . . @ . @ . @ . @ . . . . @ . @ . @ . . @ @ 
@ @ @ @ . @ @ . @ . @ . @ . . . @ @ . . @ . @ @ . @ . @ . @ . . . @ @ . . @ . @ . . . @ . @ . @ . @ 
@ @ @ @ @ . @ . . @ . . . @ . @ @ . @ . . . @ @ . . . . . . @ . @ . @ . @ @ . @ . @ @ @ . . . . . @ 
@ @ @ @ . . . . @ @ @ . @ @ . . @ . . @ @ . . @ @ . @ . @ @ . . . . . . . . @ . . . . @ . @ @ . @ @ 
@ @ @ @ @ . @ . @ @ . @ . . . @ @ @ . @ . @ . . . @ @ . . @ @ . @ . @ . @ . . @ . @ @ @ . . . @ @ @ 
@ @ @ @ . . @ . @ . . . @ . @ . @ . . . . . @ . @ . @ . @ . . . . @ @ . . @ @ . . @ . @ . @ . @ @ @ 
@ @ @ @ @ @ . . . @ . @ . @ . . @ . @ . @ . . . . . . . . @ . @ . . @ @ . . . @ @ . . . . @ @ . . @ 
@ @ @ @ @ . @ @ @ . . . . . @ . @ @ @ . @ . @ . @ . @ @ . . . . @ @ . @ . @ . . . @ @ @ . . @ @ . @ 
@ @ . . @ . . . . . @ . @ . . . . @ . . . @ . @ @ @ @ @ . @ @ . . @ . @ . @ . @ @ @ . . . @ . @ . @ 
@ @ . @ . . @ . @ . . @ . @ @ . @ . @ . @ @ . . @ . @ @ . @ . @ @ @ . . @ . @ . @ . . @ @ . . . . @ 
@ . . . . @ . . @ . @ . . . . . . . . @ . @ @ . . . . @ . . . @ @ . . @ . . @ . . @ . . . . @ . @ @ 
@ . @ . @ . @ . @ @ . @ . @ @ @ . @ . . . . @ @ @ . @ . @ @ . . @ @ . . . @ . @ . . . @ . @ . @ @ @ 
@ @ . @ @ . . . . @ . . @ . . . . @ . @ . @ @ @ . . . . . . . @ . @ . @ @ . . @ @ @ . . @ . . @ . @ 
@ @ . . @ @ @ . @ . @ . @ @ . @ . @ @ . . . . . @ @ . @ . @ . . . . . . . . @ @ @ . . @ @ @ . . . @ 
@ . @ . @ . . @ . . @ . @ . @ . @ @ . . @ @ . @ . @ . . @ . . @ . @ . @ . @ @ @ . @ . @ @ . . @ . @ 
@ . . . @ . @ . @ . . . . . . . . . @ . @ . . . . . . @ @ @ . . @ @ . @ @ @ @ . . @ . @ . @ . . @ @ 
@ . @ . . . . . . . @ . @ . @ . @ . @ . @ . @ . @ @ . . @ . @ . . . @ . @ @ . @ . @ . . . . @ . . @ 
@ . @ . @ @ @ @ . @ . . . @ . @ . . . . . @ . . . @ . @ . . . . @ . @ . @ @ . . . . . @ @ . . . @ @ 
@ @ . @ @ . . . @ . . @ . @ . . @ . @ . @ @ @ . @ @ . . @ . @ . @ . . . . . . @ @ . @ . @ . @ @ . @ 
@ . . . . @ @ . @ @ @ . @ . @ . @ . @ . @ . . . . . @ . . @ @ @ . . @ . @ . @ . . . @ . @ @ . @ . @ 
@ . @ @ @ . @ . . . . . . . . . . @ . @ . @ @ . @ . . @ . . @ . @ . . @ . . @ . @ . . . . . . . . @ 
@ . @ . . . . . @ . @ @ . @ . @ . . . . . . . . . @ @ @ @ @ . . . . @ @ @ . @ @ . . @ . @ . @ . @ @ 
@ . . . @ . @ @ @ @ . . . . @ @ @ . @ . @ @ @ . @ @ @ @ @ @ @ . @ . . . . @ @ . @ . . @ . . . @ @ @ 
@ @ . @ . . . @ @ @ @ . @ @ . @ @ @ . . @ . . . @ . . @ @ @ @ @ . . @ @ @ @ . . . . @ . @ . @ . . @ 
@ . . @ @ . @ @ @ @ . . @ @ . . @ @ . @ . . @ . . @ . . . . @ . . @ @ . @ . @ . @ . . . . @ @ . @ @ 
@ . @ . . . . @ @ @ @ . . . . @ . @ @ . . @ . . @ . . @ @ . . . @ . @ . . . @ @ . . @ . @ @ @ . . @ 
@ . . @ @ . @ @ @ @ . . @ @ . . . . . @ . . @ . . @ @ . . . @ . . . @ @ @ . . . @ . @ @ . @ @ @ . @ 
@ . @ @ . . . . @ . . @ . @ . @ . @ . . @ @ @ @ @ @ . @ . @ . . @ @ . @ . @ . @ @ . . . . . . . . @ 
@ . @ . @ @ @ . @ @ . . . . @ . . . @ . . @ @ . . . . . . . @ . . . . . . . . . @ . @ . @ . @ @ . @ 
@ . @ . . . . . . . @ . @ . . @ . @ . . @ @ @ @ . @ . @ . @ @ @ @ @ . @ . @ . @ . . @ @ . . . @ . @ 
@ @ @ @ @ @ @ @ @ @ @ @ @ @ @ @ @ @ @ @ @ @ @ @ @ @ @ @ @ @ @ @ @ @ @ @ @ @ @ @ @ @ @ @ @ @ @ @ @ @ 
3
13 38 42 33
45 48 29 33
18 34 47 11
