10 10
@ @ @ @ @ @ @ @ @ @ 
@ . . . . . . @ . @ 
@ @ . @ . @ . . . @ 
@ @ @ @ @ . . @ . @ 
@ @ @ @ @ @ . . @ @ 
@ @ @ @ @ @ . @ @ @ 
@ @ @ @ @ @ . @ . @ 
@ @ @ @ @ . . . . @ 
@ @ @ @ @ @ . @ @ @ 
@ @ @ @ @ @ @ @ @ @ 
3
4 6 1 4
7 6 2 7
8 6 1 2
