10 10
@ @ @ @ @ @ @ @ @ @ 
@ . @ . @ . @ @ @ @ 
@ . . . . . . @ @ @ 
@ . @ . @ . @ . @ @ 
@ . . @ . . . . . @ 
@ . @ @ @ . @ . @ @ 
@ . . @ . . @ . . @ 
@ @ . . @ @ . . @ @ 
@ . . @ @ @ @ . . @ 
@ @ @ @ @ @ @ @ @ @ 
3
2 1 2 2
4 6 6 1
3 7 2 3
