50 50
@ @ @ @ @ @ @ @ @ @ @ @ @ @ @ @ @ @ @ @ @ @ @ @ @ @ @ @ @ @ @ @ @ @ @ @ @ @ @ @ @ @ @ @ @ @ @ @ @ @ 
@ @ . . @ . . . @ @ @ . @ . @ . @ . . . . . @ @ . . @ @ @ . . @ . . . @ . . @ . . . . @ @ @ @ @ @ @ 
@ . . @ . @ @ . . @ @ . . . . . @ @ @ . @ . @ . @ . . @ . @ . . . @ @ . @ . . . @ . @ . @ @ @ @ @ @ 
@ @ . . . . . . @ @ . @ . @ @ . . . . @ . . . . . @ . . . . . @ . @ . . . . @ @ . . . . . . . . @ @ 
@ @ . @ @ . @ . @ . . @ . @ . . @ . @ . @ @ . @ . . . @ @ . @ @ @ . @ . @ @ . . @ . @ @ . @ @ . . @ 
@ . @ . @ @ . . . @ . . @ . @ . . @ . . . . @ . @ @ . . @ . @ . @ . @ . . . . @ . @ . . . . . @ . @ 
@ . . . . @ . @ . . @ . @ . @ . @ . @ . @ @ . . @ @ @ . . @ . . @ . @ . @ . @ . . @ @ . @ . @ @ . @ 
@ . @ . @ . @ . @ . . . . . . . . . . . . . @ . . @ @ . @ . @ . . . . . @ @ @ . @ . . . @ . . . @ @ 
@ @ . . . . . . . . @ . @ . @ . @ . @ . @ @ . @ . @ . . . . @ . @ . @ . . @ @ . . @ @ . @ . @ @ @ @ 
@ @ @ @ . @ . @ . @ @ @ . . @ @ . @ . . . . . . . . @ @ @ . . @ @ @ @ . @ @ . . @ . @ . @ . @ @ @ @ 
@ @ . . . . @ . . @ . @ @ . . . . . @ @ . @ . @ @ . @ . @ . @ . . @ . . . . @ . @ . . @ @ @ @ @ @ @ 
@ . . @ . @ . . @ . . . . . @ . @ @ @ @ @ @ @ @ . . @ . . . . . @ . @ . @ @ . . . . @ . @ . @ @ @ @ 
@ @ . @ @ . . @ @ . @ . @ . . @ @ @ @ @ @ @ . . @ . . @ @ . @ . . . . . @ . . @ . @ @ . . . . @ @ @ 
@ @ . . @ @ @ . . . . @ . . @ . @ @ . @ @ . @ . . @ . . @ @ . @ @ . @ @ . @ . . @ @ @ . @ . @ @ @ @ 
@ @ . @ @ . @ . @ . @ . @ . . . @ . . @ . . . @ . @ . @ @ . . . @ . @ . . . . @ . @ . @ . . . @ @ @ 
@ . @ . . . . . . @ . . . . @ . . . @ @ . @ . . . . . @ . @ . @ @ . . @ . @ @ . . . . . @ . @ . @ @ 
@ . . . @ @ . @ . . @ . @ . @ . @ . . . @ @ . @ . @ . . . . . . . . @ . . . . . @ @ @ @ . . . . . @ 
@ @ . @ @ @ @ . . @ . . . @ . . . @ . @ @ @ @ @ @ . . @ . @ @ . @ . . . @ @ @ @ . @ @ @ . @ @ @ . @ 
@ . . . . . . @ @ . @ @ @ . @ . @ . . . @ @ . @ @ . @ . . @ @ @ . . @ @ . . @ . . . @ . . @ . @ . @ 
@ @ . @ . @ . @ @ . . . . . . . @ . @ . @ . . . . @ . . @ . @ . . @ . @ . @ . @ . @ . @ . . . @ @ @ 
@ . . @ @ @ @ . @ . @ @ . @ @ . @ . . @ . @ . @ @ @ @ . . . . @ . @ . . . . . . . . . . . @ @ . @ @ 
@ @ . . . @ @ . @ . . @ . . @ @ @ . @ . . . . . . . . . @ @ @ @ . . . @ . @ . @ . @ . @ . . . . . @ 
@ . . @ @ . . . . . @ @ . @ @ @ @ . @ @ . @ . @ . @ . @ . . @ . . @ @ . @ . @ . @ @ @ . . @ . @ . @ 
@ @ . @ . @ . @ @ . . . @ @ @ @ @ @ . . . . @ @ @ . . @ . @ @ @ . . . . . . . . . @ @ @ . . @ @ . @ 
@ @ @ . . @ @ . . . @ @ . @ @ @ @ @ . @ . @ @ @ @ @ @ @ . . @ . . @ . @ . @ . @ @ . @ @ . @ @ @ . @ 
@ @ @ @ . . . @ @ . @ . . . @ . . . . @ . . @ @ @ . . @ . @ @ @ @ @ . @ . . @ @ @ . . @ @ . . . . @ 
@ @ . @ . @ @ . @ @ . @ @ . @ . @ . @ . . @ @ @ . @ . . . . @ . . . . . @ @ @ @ . . @ . @ @ . @ . @ 
@ . . . . . . . @ . . . . . . . . @ . . @ @ @ . . . @ . @ . . @ @ @ . @ @ . @ . @ . @ . @ . . . @ @ 
@ . @ . @ . @ . . @ @ . @ . @ . @ . @ . @ @ @ @ @ . @ @ @ @ . @ . @ . @ . . . . . . . . @ @ . @ . @ 
@ @ . . @ @ . . @ . . . . @ . @ @ . . . . @ @ . @ . . . . @ . . . . . @ . @ . @ . @ @ @ . . @ . . @ 
@ . @ . @ @ @ @ @ @ @ . @ . . @ @ @ @ . @ @ . . . . @ . @ . . @ . @ . . @ . . . @ @ . @ . @ . . @ @ 
@ . . . @ @ @ @ @ . @ . . . @ . @ @ @ @ @ @ @ . @ . @ . . . @ . . @ . @ @ @ . @ . @ . @ . @ . @ . @ 
@ . @ . . @ @ . . . . . @ . . . @ @ @ . @ . . @ . . @ . @ . . @ @ . . . . . . . . . . . . . . . . @ 
@ @ @ @ . . . @ . @ . @ @ @ @ @ . @ . . . . @ . @ . . @ . . @ . . . @ . @ . @ . @ . @ @ @ . @ . @ @ 
@ @ @ @ @ . @ @ @ . . . . @ . @ . . . @ @ @ . . . . @ . . @ @ . @ @ . . @ . . @ . . . . . @ @ . . @ 
@ @ @ . . . . @ . @ . @ @ . . . @ @ . . . @ @ . @ . @ . @ @ @ . . . @ . . @ . . @ @ . @ . . . @ @ @ 
@ . . @ @ . @ . . . . . . @ @ . . . @ @ . . . @ . @ . . . @ @ @ . @ @ . @ . @ . . @ . @ . @ . . . @ 
@ @ . @ . . . @ . @ . @ @ . . . @ . . . @ . @ . . . . @ @ . . . . . . @ . . @ . @ . . @ . @ . @ @ @ 
@ . . . @ . @ @ @ @ @ . . @ . @ . . @ @ . . . @ . @ . . . @ . @ . @ . . @ . @ . @ @ . . @ . . . . @ 
@ @ @ . . . @ . @ @ @ . @ @ @ . @ . . . @ . @ @ @ . . @ @ . @ . . . @ . @ . . . @ . . @ . @ @ @ . @ 
@ . . . @ . . . . @ . . @ @ . . @ . @ @ . . . @ . @ . @ . . . . @ . . @ . . @ . @ @ . . . . . . @ @ 
@ @ . @ . @ @ . @ . @ . . . @ . @ . . . @ . @ . . . . @ . @ @ . @ . @ . . @ . . . . @ . @ . @ . . @ 
@ . . @ . @ . . . . . . @ . . . . . @ . . . . . @ @ . @ . . @ . @ . @ @ . @ @ . @ . . @ @ . @ . @ @ 
@ @ @ @ . . . @ @ @ . @ . . @ . @ . @ @ . @ @ . . . @ . . @ . @ . . . . @ . . . . @ . @ @ @ . . . @ 
@ @ @ @ @ @ @ . @ . @ . @ @ . @ @ @ @ @ . . @ @ . @ . @ . @ . . @ @ . @ . . @ . @ . . . @ @ . @ . @ 
@ @ @ @ @ @ . . . . . . . . . . . . . . . @ . . . . . . @ @ @ . . . . @ @ . . @ @ @ . @ @ @ . @ . @ 
@ @ @ @ @ @ @ . @ . @ . @ . @ . @ @ @ . @ @ . @ . @ . @ @ @ @ @ . @ . @ . . @ . . . @ . @ . @ . . @ 
@ @ @ @ @ @ @ @ . . . @ . . . @ . . . . . . @ . . . @ @ @ @ @ @ @ . . . @ @ @ @ @ . . . . . . @ . @ 
@ @ @ @ @ @ @ @ @ . @ @ @ . @ @ @ . @ . @ . . @ . @ @ @ @ @ @ @ @ @ . @ @ @ @ @ @ @ . @ . @ . . . @ 
@ @ @ @ @ @ @ @ @ @ @ @ @ @ @ @ @ @ @ @ @ @ @ @ @ @ @ @ @ @ @ @ @ @ @ @ @ @ @ @ @ @ @ @ @ @ @ @ @ @ 
3
37 31 12 34
42 1 31 2
35 31 47 18
