20 20
@ @ @ @ @ @ @ @ @ @ @ @ @ @ @ @ @ @ @ @ 
@ @ . . . . @ @ @ @ @ @ . . @ . . . . @ 
@ @ . @ . @ . @ @ @ @ . @ . @ . @ . @ @ 
@ . @ . . @ . . @ @ . . . . @ . . @ @ @ 
@ . . @ . @ . @ . . @ @ @ . . @ . @ @ @ 
@ . @ . . @ . @ @ . . . . @ . . . . @ @ 
@ . . @ . @ . @ . . @ @ @ @ @ . @ @ . @ 
@ @ . . . @ . . @ . @ . @ @ . . . @ . @ 
@ . @ @ . . . @ . . @ . . @ @ . @ . . @ 
@ . @ . @ . @ . @ . @ @ . . . . . . @ @ 
@ . . . . . @ . . . . @ . @ . @ @ @ . @ 
@ . @ @ @ . . . @ @ @ . . . @ @ . . . @ 
@ @ . @ . @ @ . @ . @ . @ . . . . @ . @ 
@ . . . . . . . . . . . @ . @ . @ . . @ 
@ @ @ @ . @ . @ @ . @ . . @ . @ @ . @ @ 
@ . . . @ . @ . . . . @ . . . . . @ . @ 
@ . @ . . . . . @ . @ . . @ . @ . @ . @ 
@ . @ . @ . @ . . @ @ @ . . @ . . . . @ 
@ @ . . @ @ . . @ . . . . @ @ @ . @ . @ 
@ @ @ @ @ @ @ @ @ @ @ @ @ @ @ @ @ @ @ @ 
3
15 16 7 4
18 7 10 10
3 1 12 9
