20 20
@ @ @ @ @ @ @ @ @ @ @ @ @ @ @ @ @ @ @ @ 
@ @ @ @ @ @ @ @ . . . . . @ . . . . . @ 
@ @ @ @ @ @ @ @ . @ . @ . @ @ . @ . @ @ 
@ @ @ @ @ @ . . . . @ . . . . . @ . @ @ 
@ @ @ @ @ @ . @ @ . . @ . @ . @ . . . @ 
@ @ @ @ @ @ @ . @ @ @ . . . @ . . @ . @ 
@ @ . @ @ @ @ . . @ . @ . @ . @ @ . @ @ 
@ . . . . @ . . @ . . . . @ . . . . @ @ 
@ @ . @ . @ . @ @ @ . @ . . . @ . @ . @ 
@ . . @ @ . . . @ @ @ . . @ @ . @ . . @ 
@ @ . @ . @ @ . . @ . @ . . @ . . @ . @ 
@ . . . . . . . @ @ . . . @ @ . @ . . @ 
@ . @ @ @ . @ . . . @ @ . . . . . . @ @ 
@ . @ . . . @ . @ . @ . . @ . @ @ @ @ @ 
@ . @ @ . @ @ . @ @ . . @ @ @ @ @ @ @ @ 
@ @ . . . @ . . . @ @ . @ @ @ @ @ @ @ @ 
@ @ @ . @ . @ . @ . . . . @ @ @ @ @ @ @ 
@ @ @ @ . . . . . . @ . @ @ @ @ @ @ @ @ 
@ @ @ @ @ . @ @ @ . . @ @ @ @ @ @ @ @ @ 
@ @ @ @ @ @ @ @ @ @ @ @ @ @ @ @ @ @ @ @ 
3
12 17 8 13
7 11 15 4
7 6 5 18
