12 12
@ @ @ @ @ @ @ @ @ @ @ @ 
@ . . . . . . . @ . @ @ 
@ @ @ . @ . @ . @ . . @ 
@ . . . @ @ . . . . @ @ 
@ . @ @ . . @ @ . @ . @ 
@ . @ . @ . @ . . . . @ 
@ . @ . . . . @ . @ . @ 
@ . @ @ @ @ . . . . @ @ 
@ . @ . . . @ @ . @ . @ 
@ @ . @ . @ . . . . . @ 
@ . . . . . . @ . @ @ @ 
@ @ @ @ @ @ @ @ @ @ @ @ 
3
3 7 10 2
4 10 2 7
8 5 5 5
