50 50
@ @ @ @ @ @ @ @ @ @ @ @ @ @ @ @ @ @ @ @ @ @ @ @ @ @ @ @ @ @ @ @ @ @ @ @ @ @ @ @ @ @ @ @ @ @ @ @ @ @ 
@ @ @ @ . . . @ . . @ @ @ @ @ @ @ @ @ . . @ @ @ . @ . @ @ . @ @ . @ @ @ . @ . . @ @ @ @ @ . . . . @ 
@ @ @ @ @ . @ @ @ . . @ @ @ . @ . @ . @ . . @ . . . . . . . . @ . . @ @ . @ . @ . @ @ @ . . @ @ . @ 
@ @ @ @ . . . @ . . @ . @ . . . . . . . . @ . @ . @ @ . @ . @ . . @ . . . . . . . @ . . . @ @ @ @ @ 
@ @ @ @ @ . @ . @ . . . . @ . @ . @ . @ . . . . . . . @ @ @ @ @ . @ . @ . @ @ . @ . . @ . @ @ @ @ @ 
@ @ @ . @ . @ . @ . @ . @ @ @ @ @ @ @ . . @ @ . @ . @ . @ @ . . . . . . @ @ . @ @ @ . @ . . @ @ @ @ 
@ @ . . @ . . . . . . @ @ . @ @ @ @ @ @ . . @ . @ @ . . @ @ . @ @ . @ . . . . . . @ @ . . @ @ @ @ @ 
@ . @ . . @ . @ . @ . @ @ . . @ @ @ @ . @ . @ . @ . . @ @ . . @ . . . @ . @ . @ @ . . @ . @ . @ @ @ 
@ . @ @ . . . . @ . . . @ . @ @ @ . @ . @ . . @ . . @ . . . @ @ . @ . @ . . @ . . . @ . . . . @ @ @ 
@ . @ . . @ . @ . @ . @ @ . @ @ @ . . . . . @ . @ . . @ . @ . @ @ @ @ . @ . @ . @ . @ @ . @ @ . @ @ 
@ . . @ . . @ @ . . . @ . . . @ . . @ . @ @ . . @ @ . . . . . . @ @ . . @ . . @ @ . . . . . . . . @ 
@ @ . . . @ @ @ @ . @ . @ . @ . @ . . @ . @ . @ . . @ @ . @ . @ . . . @ . @ @ . @ . @ @ . @ @ . @ @ 
@ . . @ . @ @ @ . . @ . . . . . . . @ . . @ . . . @ . @ . . @ @ . @ @ . . . @ . . @ . . . @ . @ . @ 
@ @ . . @ @ @ . @ . @ . @ . @ @ . @ . @ . @ . @ @ . . . . @ @ . . . @ . @ @ . . @ . @ @ . . . . . @ 
@ . @ . . @ . . . @ . . . @ @ . @ . . @ . @ . . @ . @ @ . @ . @ . @ . . @ @ . @ . . @ . . @ . @ . @ 
@ . @ . @ . @ . @ . @ . @ . . . @ @ . @ . @ . @ . . @ @ . . . @ . . @ . . . . . @ . . @ . @ . @ . @ 
@ . . . . . . . . . @ . . . @ @ . . . @ . . . . . @ @ @ . @ . @ @ . . . @ . @ @ . . @ @ @ . . @ . @ 
@ @ . @ . @ @ . @ . . . @ @ . @ . @ @ . @ . @ @ . . @ . @ . @ . @ @ @ . . @ @ . @ . . @ . @ @ . . @ 
@ . . @ . . @ . . @ @ . . . . . . . . . . . @ . . @ . . . . @ . . . . @ . . . . . @ . . . . . @ . @ 
@ . @ @ . @ @ . @ @ @ . @ . @ @ . @ . @ . @ . @ . . . @ @ @ @ @ . @ . . . @ . @ . @ . @ . @ . @ . @ 
@ @ . . . . @ @ . @ . @ . . . . @ . . . @ @ . . . @ . . . . @ . @ . @ @ . @ . . @ . @ . @ . . . . @ 
@ @ . @ @ . . . . . . @ @ @ @ @ . @ . @ . @ @ @ . . @ . @ @ . . . . . . . . @ . . . . . . @ . @ . @ 
@ @ . @ . . @ . @ @ @ . @ . @ . . . . . . . @ @ @ @ . . @ . . @ @ . @ . @ . @ @ @ . @ @ @ @ @ @ . @ 
@ . . @ . @ . . . . @ . . . . @ . @ . @ . @ . @ . . @ @ @ @ @ . . . . @ @ @ . . . @ @ . . @ @ . . @ 
@ @ . . @ @ @ . @ . . @ @ @ . . @ . . @ . . . . . @ @ @ @ @ @ @ . @ . @ @ . @ @ . . @ . @ . @ . @ @ 
@ @ @ @ . . . . . @ @ @ @ . . @ . @ . . @ @ . @ . . @ . @ . @ . . @ . . . . . . . @ . . . . . . . @ 
@ @ @ @ @ . @ . @ @ . @ . @ . @ . . . @ . @ @ . @ . @ . . . @ . @ . @ . @ @ . @ . @ . @ . @ . @ @ @ 
@ . . @ @ @ . . . @ . . . . . . . @ . . . . . . . @ . . @ . . @ . . . @ @ @ . @ . . . @ . . @ . . @ 
@ @ . . . @ @ . @ . . @ . @ . @ @ . . @ . @ . @ @ @ @ @ @ . @ . @ . @ . @ . @ . @ . @ . . @ . . @ @ 
@ . . @ . . @ . . @ @ . . . @ . . @ . . @ . . . . . . . . . . . . . . . . . . . . . . @ @ @ @ . . @ 
@ @ @ . . @ @ @ . . . @ . @ @ @ . @ . @ @ @ . @ . @ @ . @ . @ . @ . @ . @ @ . @ . @ . @ @ @ . @ . @ 
@ @ @ @ . . @ @ @ . @ . . @ @ . . . . . @ @ @ @ . . . @ @ . . @ @ . . @ . @ . . @ @ . . . @ . . . @ 
@ @ @ @ @ . . @ . @ . . @ . . . @ . @ . . . . . @ @ . . . @ . . . @ . . . @ @ . @ . . @ . . . @ @ @ 
@ @ . @ @ @ . . . . @ . . @ . @ . . @ . @ . @ @ . . . @ . . @ . @ @ . @ . . . @ @ @ . . @ . @ . @ @ 
@ . . . @ . @ @ @ . . @ @ . @ @ . @ . . . @ . . . @ . @ . @ @ . @ @ . . @ @ . @ @ @ . @ . . . . . @ 
@ . @ . . . . @ . . @ @ @ . . . @ . @ . @ @ @ @ @ . . @ @ @ . . . . @ . @ . . . . . @ . @ . @ . @ @ 
@ @ . . @ . @ @ @ . . @ . @ . @ . . . . . @ . . @ . @ @ @ @ @ . @ . . @ @ @ . @ @ . . . @ . . @ . @ 
@ . . @ . . . . . . @ . . . . . . @ @ . @ . @ . . @ @ . @ . . . @ @ . . @ . . . . @ . @ @ . @ @ . @ 
@ . @ . @ . @ . @ . . . @ . @ . @ . . . . . . . @ . @ . . . @ . . . @ @ . @ . @ . . @ . . . @ . . @ 
@ @ @ . . . @ . . @ @ @ @ @ . . @ . @ . @ @ . @ @ . . @ @ @ . . @ . . . . . @ @ . @ . @ . @ @ @ . @ 
@ . @ @ . @ . . @ @ @ @ @ @ . @ @ @ . . . . @ @ @ . @ . . @ @ . . @ . @ @ . . . @ . . . . @ @ . . @ 
@ . . . @ @ @ . . @ @ @ @ @ . . . @ @ . @ . . @ . . . . @ . . . @ . . . . @ . @ . . @ . @ @ . @ . @ 
@ . @ . @ @ . . @ @ @ @ @ @ . @ @ @ @ @ . . @ . @ . @ @ . @ . @ . @ . @ @ . . . @ . @ . . . . . . @ 
@ @ . . @ . @ @ @ @ @ @ @ . @ @ . @ @ . @ . . . . . . @ . . . . . . @ @ @ . @ @ . . . @ . @ . @ @ @ 
@ . . @ . . . . . @ . @ . . . @ . . @ . . . @ @ . @ . @ @ @ . @ @ . @ @ . @ . . . @ @ . . . @ @ @ @ 
@ @ . . . @ . @ @ . . . . @ @ @ @ . . . @ . @ . . @ @ . @ . . . . @ . . . . . @ . . @ @ . @ @ @ @ @ 
@ . . @ @ @ @ . . @ . @ . . @ @ . . @ . . @ . . @ @ @ . @ @ . @ @ @ @ . @ . @ . . @ . . . . @ @ @ @ 
@ @ . @ . @ . @ . @ @ . @ . @ . . @ @ @ . . @ . . . . . . . @ @ @ @ @ @ @ @ . . @ @ . @ . @ @ @ @ @ 
@ . . . . . . . . . . . . . . . @ @ @ @ . @ . . @ @ @ . @ . . @ @ @ @ @ @ @ @ . @ @ . @ . . @ @ @ @ 
@ @ @ @ @ @ @ @ @ @ @ @ @ @ @ @ @ @ @ @ @ @ @ @ @ @ @ @ @ @ @ @ @ @ @ @ @ @ @ @ @ @ @ @ @ @ @ @ @ @ 
3
43 19 14 40
2 30 28 39
36 45 35 15
