12 12
@ @ @ @ @ @ @ @ @ @ @ @ 
@ @ @ @ @ @ @ . @ @ . @ 
@ . @ @ @ @ . . . @ . @ 
@ . . @ . . @ . @ . . @ 
@ . @ . @ . . . @ . @ @ 
@ . . . . @ @ . @ . . @ 
@ . @ @ . . . . . . @ @ 
@ . . @ @ . @ @ . @ . @ 
@ . @ @ @ @ . . . . . @ 
@ . @ @ @ @ @ . @ @ . @ 
@ @ @ @ @ @ @ @ . . . @ 
@ @ @ @ @ @ @ @ @ @ @ @ 
3
1 10 2 7
8 8 5 7
10 8 5 1
