25 25
@ @ @ @ @ @ @ @ @ @ @ @ @ @ @ @ @ @ @ @ @ @ @ @ @ 
@ @ @ @ @ @ @ @ @ @ . . @ . . . . @ @ @ @ @ @ @ @ 
@ @ @ @ @ @ @ @ . @ . @ . @ @ . @ @ @ @ @ @ @ @ @ 
@ @ @ @ @ @ . . . . . . . @ . . . . @ @ @ @ @ @ @ 
@ @ @ @ @ @ @ . @ . @ @ . . @ @ . @ . @ @ @ @ @ @ 
@ @ @ . @ @ @ @ . . @ @ @ . @ . . . . @ @ @ @ @ @ 
@ @ . . . @ . . . @ . . . . . @ . @ @ @ @ @ @ @ @ 
@ . @ . @ . . @ . . @ @ @ @ . . . @ . @ @ @ @ @ @ 
@ . . . . . @ . . @ . . . . . @ . @ . @ @ @ @ @ @ 
@ . @ . @ @ . . @ @ @ . @ . @ @ . @ . . @ @ @ @ @ 
@ @ . . @ . . @ . @ . @ @ @ . . . @ . @ . @ @ . @ 
@ @ @ @ . . @ @ . . . @ @ . . @ . . . . . . . . @ 
@ @ @ . @ . @ . @ @ . . . @ . . @ . @ @ . @ . @ @ 
@ . @ . . @ . . @ . @ . @ . . @ . . . . @ . . . @ 
@ . . . @ . @ . @ . @ . @ . @ . @ . @ @ @ @ . @ @ 
@ . @ . . . . . . . . . . . @ . . . @ @ @ @ . . @ 
@ @ @ @ . @ @ @ @ @ @ . @ . . @ @ . . . @ . @ @ @ 
@ @ @ @ @ . @ . @ . @ @ . . @ @ @ @ . @ . . @ . @ 
@ @ @ @ . . . . . . . @ . @ . @ . @ . @ @ . . . @ 
@ @ @ . @ . @ @ @ . @ @ @ . . . . . . . @ . @ . @ 
@ @ @ . . @ . @ . . . . . . @ . @ . @ . . . . @ @ 
@ @ @ . @ . . . . @ @ . @ @ @ . . @ . . @ . @ @ @ 
@ @ . . . . @ . @ . . . @ . @ . @ @ @ . . @ @ @ @ 
@ @ @ . @ @ @ @ . . @ . @ . . . . @ . . @ @ @ @ @ 
@ @ @ @ @ @ @ @ @ @ @ @ @ @ @ @ @ @ @ @ @ @ @ @ @ 
3
22 20 4 18
3 6 17 12
11 22 18 16
