25 25
@ @ @ @ @ @ @ @ @ @ @ @ @ @ @ @ @ @ @ @ @ @ @ @ @ 
@ @ @ . @ . . @ . @ . @ . @ . . @ @ . . @ . . @ @ 
@ . . . . . @ @ . . . @ . @ . @ . @ . @ . @ . . @ 
@ @ @ . @ @ . . . @ @ . . . . . . . . . . . . @ @ 
@ @ . . . @ @ . @ @ @ . @ . @ . @ . @ @ . @ . . @ 
@ . . @ . @ . . . . . . . @ @ @ @ . @ . . . @ . @ 
@ @ . . @ @ @ . @ . @ . @ . . @ . @ . @ @ . . @ @ 
@ . @ . . @ . . . @ . . . @ . @ . . . . @ @ . . @ 
@ . . . @ . @ . @ . @ . @ @ . @ . @ . @ . @ . @ @ 
@ . @ . @ . . . . . . @ @ @ . . @ . . . . . @ @ @ 
@ . @ . . . @ @ . @ @ . @ @ . @ . @ . @ @ @ . . @ 
@ @ . . @ @ . @ . @ . . . @ . . . . . . . . . @ @ 
@ . @ . @ @ . . @ . . @ . @ . @ @ @ @ @ @ @ . . @ 
@ . . . . @ . @ . @ . @ @ . . . . @ . @ . . @ . @ 
@ @ @ . @ . . . . . . . @ . @ @ . . . . . @ . . @ 
@ . . . . . @ . @ . @ . . . . . @ . @ . @ @ @ . @ 
@ @ . @ . @ . . . @ @ @ . @ @ @ . . @ . . @ . . @ 
@ . . @ @ @ @ . @ . @ . @ . @ @ @ . . @ @ . . @ @ 
@ @ . @ . . . . . . . . @ . . @ @ @ . @ @ @ . . @ 
@ . . . @ @ . @ . @ . @ @ . @ . @ . @ @ @ @ . @ @ 
@ @ . @ . . . @ . @ . . . . . . . . . @ @ . . . @ 
@ . @ . . @ . @ . @ . @ . @ @ . @ . @ @ @ @ @ @ @ 
@ . . . @ . . @ . . @ . . . . @ . . . @ @ @ @ @ @ 
@ . @ . . @ . @ . @ @ @ . @ @ @ @ . @ @ @ @ @ @ @ 
@ @ @ @ @ @ @ @ @ @ @ @ @ @ @ @ @ @ @ @ @ @ @ @ @ 
3
9 8 5 17
5 10 9 17
4 2 9 18
