50 50
@ @ @ @ @ @ @ @ @ @ @ @ @ @ @ @ @ @ @ @ @ @ @ @ @ @ @ @ @ @ @ @ @ @ @ @ @ @ @ @ @ @ @ @ @ @ @ @ @ @ 
@ . @ . . @ . @ . . . @ . . . . @ @ @ . @ . @ @ @ . @ . . . @ . . @ . . @ . . @ . @ . . @ . @ . @ @ 
@ . . @ . . . . @ . @ . . @ . @ . . . . . . @ @ . . . @ . @ @ . @ @ @ . . @ . . . . . @ . . . . @ @ 
@ . @ @ @ @ . @ @ . @ . @ . @ @ @ @ . @ @ . . . @ . @ . . . . . . @ @ @ . @ @ . @ . @ . . @ @ @ . @ 
@ . . @ . @ . . . . . . . . . . . . @ . . . @ . . . . @ . @ . @ @ . . . . . @ . @ . . . @ . . . . @ 
@ . @ . . . . @ @ @ @ @ . @ . @ . @ @ @ . @ . . @ . @ . . . @ @ @ @ . @ . @ . @ . . @ . . @ . @ . @ 
@ . @ @ . @ . . . . . . @ . . @ @ . . . @ . @ @ . . . . @ . @ @ @ . @ . . . . . @ . . @ @ . @ . . @ 
@ . . . . . @ @ . @ . @ @ @ @ . . . @ @ @ . @ @ @ . @ . . @ @ . . . . . @ . @ . . . @ . @ . . . @ @ 
@ @ . @ @ . . . @ @ @ @ @ @ @ . @ @ @ @ . . . @ . @ . @ . . . . @ . @ . . @ . @ @ . @ . @ . @ . . @ 
@ @ @ . . . @ @ @ @ @ @ @ @ @ . @ . @ @ @ . @ . . . . . . @ . @ @ @ . . @ @ . @ . . . . @ . . @ . @ 
@ . . . @ @ . . @ @ @ @ @ @ . . . . . . . . . . @ . @ . @ . . . @ @ @ @ @ . . . @ . @ @ . . @ . @ @ 
@ . @ . . . . @ . . @ @ @ @ @ . @ @ . @ . @ . @ . . @ @ . . @ . . @ @ . @ @ @ . . . @ . @ . . . . @ 
@ @ . . @ . @ . @ . @ . @ @ @ @ . . . . @ . . @ @ . . . @ @ . @ @ . @ . . @ . . @ . . . @ . @ . @ @ 
@ . . @ . @ @ . @ . . . @ @ @ @ @ . @ . . @ . @ . . @ . @ . . . @ . @ . @ . . @ . . @ @ . . @ . . @ 
@ @ . . . @ . . . . @ @ @ @ @ @ . . . @ . @ @ . . @ @ @ @ @ . @ . . @ . . . @ . @ . . @ @ . . @ . @ 
@ @ @ . @ . @ @ . @ @ @ @ . . . @ . @ . . @ . @ . @ . @ . . . . @ . . @ @ . @ . . @ . . . . @ @ . @ 
@ @ @ . . . . . . . @ @ . @ . @ . @ @ @ . . . . @ . . . @ @ . @ @ . @ @ @ @ . . @ . . @ @ @ . . @ @ 
@ @ . . @ . @ . @ @ . @ . . . . . . . @ @ . @ . . @ . @ . @ . . . . @ @ @ . @ . . @ . . . @ . @ . @ 
@ . . @ @ @ . . @ @ . . @ @ . @ @ . @ @ . @ . . @ . . . . . . @ . @ @ @ . . . . @ . . @ @ . . . . @ 
@ @ . . . @ . @ @ . . @ . @ . @ . @ @ . . . @ . @ @ . @ @ . @ . @ . @ @ @ @ @ . . @ . . @ . @ . @ @ 
@ @ . @ @ . @ . . @ . . . . . @ . . . . @ . . @ . @ @ @ @ . @ . . . . @ . . . . @ @ . @ . . . @ . @ 
@ . . @ . . . @ . . . @ . @ @ . @ . @ @ . . @ @ . . . @ . . . . @ . @ @ @ . @ . @ . . @ . @ @ . . @ 
@ . @ @ @ . @ @ . @ . . @ @ . . . . . . @ . . @ . @ @ . . @ . @ . @ @ @ . @ . . . @ . . . . . . @ @ 
@ . . . . . . . @ . . @ . . @ . @ . @ @ . . @ . . . @ . @ . . . . . @ . . . . @ @ . . @ . @ @ . . @ 
@ @ @ . @ . @ @ . @ . . . @ @ @ . . @ @ @ . . @ @ . . @ . @ . @ . @ . @ . @ . . . @ . @ . . . @ . @ 
@ . . . @ . @ . . . . @ . . . . @ . . @ . @ . @ @ . @ . . @ @ . . . . . . . @ . @ . . . @ . @ . . @ 
@ @ . @ . . . . @ . @ . . @ . @ @ @ @ . . . . . . . . . @ @ @ . @ @ @ . @ @ @ @ @ @ . @ . @ @ @ . @ 
@ . . . @ . @ @ . @ @ @ . . @ . @ . . . @ . @ @ . @ . @ @ @ . @ . . @ . . . @ @ . . . . . @ @ @ @ @ 
@ @ . @ . . . . . . @ . @ . . . @ @ . @ @ @ . @ @ @ . . @ . . . @ . . @ @ . . @ . @ @ @ . . . . @ @ 
@ . . . @ . @ . @ . @ . . @ . @ . @ . @ @ @ . . . . @ . @ @ . @ . . @ @ @ . @ . @ . @ . . @ @ @ . @ 
@ @ . @ @ @ @ . @ . . . @ @ @ . . @ . . @ @ . @ . @ @ . @ . . @ . @ . @ . . . . . . . @ . . @ . . @ 
@ @ . . @ @ @ @ . @ . @ . @ . @ . @ @ @ . . . . @ @ @ . @ @ . . . . . . . @ . @ @ . @ @ . @ . @ . @ 
@ . . @ . . @ . . . . . . . . . . . . . @ @ @ . . @ . . @ . . @ @ @ . @ @ . @ . . @ . . . . . . . @ 
@ @ @ . . @ . . @ . @ . @ . @ . @ . @ . @ . @ . @ . @ . . @ . @ . . @ . @ . . @ . . @ @ . @ . @ @ @ 
@ @ @ @ . @ @ . . @ . . . @ @ @ @ @ . . . . . . . . . . @ . . . @ . @ . . . @ @ . @ . . . . @ . . @ 
@ @ . . . . @ . @ @ @ @ @ . @ . @ . @ @ . @ . @ . @ @ . @ . @ . . . . @ @ . . @ . . @ @ . @ @ @ . @ 
@ . . @ @ . . @ . @ . . @ . . . . . . . . @ @ . . @ @ . . @ . @ . @ @ @ @ . @ @ @ . @ @ . . @ . . @ 
@ . @ . @ . @ . . . @ . @ . @ . @ . @ . @ @ @ @ . . @ . @ . . @ . . . @ . . . @ . . . @ . @ . @ . @ 
@ . . . . @ @ @ @ . . . . . @ @ . . @ . @ @ . @ . @ . . . @ . @ . @ @ . @ @ . . @ @ . . . . . . . @ 
@ . @ . @ @ @ . . . @ @ . @ . . . @ . @ . . . . . . @ @ . . . . . . . . . @ . @ . @ . @ . @ @ @ . @ 
@ . . @ . @ . @ . @ @ @ @ . . @ . @ . . . @ . @ . @ . @ @ . @ . @ . @ @ . . . . . . . . @ . . . . @ 
@ @ . . . . . . . . @ @ . @ . @ . . @ . @ . . @ . . . @ @ @ . . . @ @ . . @ . @ . @ . @ @ @ @ . @ @ 
@ . . @ . @ . @ . @ . @ . @ @ . . @ . @ @ @ . @ . @ . @ . . @ . @ . . @ . @ . . @ . . . @ . @ . @ @ 
@ @ @ . . . @ . . . . @ . . @ . @ . . . . . . @ @ . . . @ . . . . . @ . . @ . @ @ @ . @ @ . . @ @ @ 
@ @ @ @ . @ @ @ . @ @ . . @ . . . @ . @ . @ @ @ . @ . @ @ @ @ @ . @ . @ @ @ . @ @ . . @ . . @ @ . @ 
@ @ @ @ @ @ @ @ @ @ @ @ . @ @ . @ . . @ . @ @ @ . @ . . @ @ @ . . . . . . . @ . @ @ @ @ @ . . . . @ 
@ @ @ @ @ @ @ @ @ @ @ . . . . . @ @ . . @ . . . . . . @ @ @ . . @ . @ . @ . . . . . . . . . @ @ @ @ 
@ @ @ @ @ @ @ @ @ @ . . @ . @ . . @ . @ . @ . @ @ . @ @ @ @ @ . @ . @ @ @ . @ . @ . @ . @ . . . . @ 
@ @ @ @ @ @ @ @ @ @ @ . . @ . . @ . . @ . . . . @ . @ @ @ @ @ . @ . . . @ . . @ @ . @ . . @ @ @ . @ 
@ @ @ @ @ @ @ @ @ @ @ @ @ @ @ @ @ @ @ @ @ @ @ @ @ @ @ @ @ @ @ @ @ @ @ @ @ @ @ @ @ @ @ @ @ @ @ @ @ @ 
3
43 10 20 19
16 33 4 39
34 25 10 38
