100 100
@ @ @ @ @ @ @ @ @ @ @ @ @ @ @ @ @ @ @ @ @ @ @ @ @ @ @ @ @ @ @ @ @ @ @ @ @ @ @ @ @ @ @ @ @ @ @ @ @ @ @ @ @ @ @ @ @ @ @ @ @ @ @ @ @ @ @ @ @ @ @ @ @ @ @ @ @ @ @ @ @ @ @ @ @ @ @ @ @ @ @ @ @ @ @ @ @ @ @ @ 
@ @ @ @ @ @ . @ . @ . . @ . . @ @ @ @ @ @ @ @ @ @ @ @ . . . . . . @ @ @ . . . . . . . @ . . @ . . @ @ @ @ @ @ . . @ . . . . @ @ @ @ @ @ @ @ @ . . . . @ @ @ @ . . @ . . . . . @ @ @ . . @ @ @ @ @ @ @ @ 
@ @ @ @ . . . . . . @ . . @ . . @ . @ @ @ @ @ @ @ @ . @ @ . @ . @ @ @ . . @ . @ . @ @ . @ . @ . @ @ @ @ @ @ @ @ . @ . @ . @ @ @ @ @ @ @ @ @ @ @ . @ . @ . @ . . @ . @ . @ . @ @ @ . . @ . @ @ @ @ @ @ @ 
@ @ @ @ @ . @ . @ . @ . @ . @ . @ . . @ @ @ @ @ . . . . . . @ . . @ @ @ . . @ . @ @ @ . . . . . . @ @ @ @ @ . . . @ . . @ @ @ @ @ @ @ @ @ @ @ @ @ . . . . . @ . . . . . . @ @ . . @ . . . @ @ @ @ @ @ @ 
@ @ @ @ . . @ @ . . . . . . . . @ . @ @ @ @ @ @ @ @ . @ . @ . . @ . . @ . @ . . . @ . . @ @ . @ . . @ @ @ . . @ . . . @ . @ @ @ @ @ @ @ @ @ @ @ . @ . @ . @ @ . @ @ . @ . . . @ . @ @ @ . . @ @ @ @ @ @ 
@ @ @ @ @ . . . @ @ @ . @ . @ @ . . . @ @ @ @ @ @ . . . @ @ @ . @ @ . . . . @ . @ . @ @ @ . @ @ . @ @ . @ @ @ @ @ @ . . . @ @ @ . @ @ @ @ @ . @ . @ @ . . @ . . @ @ @ . . @ @ . . . . . . @ . @ @ @ @ @ 
@ @ @ @ @ @ @ @ . . @ . . @ @ @ @ . @ . @ @ @ @ @ @ . @ @ @ @ . @ . @ . @ . . . . . . @ . . . . . @ . . @ @ @ @ @ . . @ . . @ . . . @ @ @ . . . . . . @ . @ @ . @ @ @ @ . . @ @ . @ @ . @ . . @ @ @ @ @ 
@ @ @ @ @ @ @ . @ . . . @ . . @ . . @ . . @ @ . . . . @ @ @ . . . . . @ @ @ @ @ . @ @ . @ @ . @ . . @ . . @ @ @ . @ . . @ . @ @ . @ @ @ @ . @ @ . @ . . . @ . . . @ . . . @ . . . @ . . . . @ @ @ @ @ @ 
@ @ @ @ @ @ . . . @ . @ . @ . . . @ . . @ . @ . @ @ . . @ . @ @ @ @ . . @ . . . . . . . . @ @ . @ . @ . @ @ @ . . . . @ . @ . @ . @ . @ @ @ @ @ @ . @ @ . . @ @ @ . @ @ . @ . @ @ . @ . @ @ . @ @ @ @ @ 
@ @ @ @ . . @ @ . . . . . . . @ @ . @ . . . . @ . . . @ . . @ . @ . @ . . @ . @ . @ . @ . @ @ . . . . . @ . @ @ . @ . . . . . @ . . . . @ . . @ . . . @ . @ @ @ . . @ . . . @ . . . . . . . . . . @ @ @ 
@ @ @ @ @ . . . @ @ @ . @ . @ . . . @ . @ . @ . @ . @ @ @ . . . . . . . @ @ @ . . @ @ @ @ . . @ @ @ @ . . . @ . @ . . @ . @ . @ @ . @ @ @ . @ @ @ . @ @ . @ . . @ . . @ . @ . @ . @ @ . @ @ @ . @ . @ @ 
@ @ @ @ . @ . @ @ @ . . @ @ . @ . @ . . . @ . . . . @ . @ @ @ @ . @ @ . . @ @ @ . . . @ . @ . @ . @ . . @ . @ . @ @ @ @ . . @ . . . . @ . . . @ . . @ . . . . @ . . @ . . . . @ @ . . . . . . @ @ . . @ 
@ @ . @ . @ . . @ @ @ . . @ . . . . . @ @ @ @ @ . @ . . @ . . @ @ . . . @ . @ . . @ @ @ . . . . . . @ @ . . . . . @ . . . @ . @ . @ @ @ @ . @ . @ . . @ . @ . . @ . @ @ . @ . . @ @ @ . @ . @ @ @ . @ @ 
@ @ . . . . . @ . @ . . @ . @ @ . @ . . . @ @ @ . @ @ . . @ . . . @ @ . @ . @ @ . . @ . @ @ . @ . @ . . @ . @ . @ @ @ . @ @ . @ . . . @ . . . . . . @ @ @ . @ . . . . @ @ @ . @ . @ . . . @ @ @ . . . @ 
@ . @ . @ @ . . . . @ . . . @ . . @ @ . @ @ @ . . @ . @ . @ . @ @ . @ . . . . @ . @ . . . @ @ . . . . @ . . . @ . . . . . @ . . . @ . @ . @ . @ . @ . . . . . @ @ . @ @ @ . . . . @ @ . @ @ @ . @ . @ @ 
@ . . @ @ . . @ . @ . . @ . . @ . . @ . . @ @ @ @ . . . . . . . . . . . @ . @ . . . . @ @ . @ @ . @ @ . @ @ . @ . @ @ . @ . . @ @ . @ . . . @ . . @ @ . @ @ . . . . . @ . . @ @ @ . . . @ @ . . . . . @ 
@ . @ . . . @ . . @ @ . @ @ @ . . @ @ . @ @ @ . @ . @ . @ . @ . @ @ . @ . . . . @ . @ . . . . . . . . . . . . . @ . @ . . . @ . @ . @ @ . @ . @ . . @ @ @ . @ . @ . @ . @ . @ @ @ @ @ . . @ @ . @ . @ @ 
@ . . @ . @ . @ . @ . . . . . @ . @ @ @ . @ . . . . . @ @ @ . . . . @ @ @ . @ . @ . . @ @ @ @ . @ . @ @ . @ @ . @ . . . @ @ . . . . . @ . . . . @ . . @ . . . @ . . . . . . . @ @ @ . @ . . @ @ . . . @ 
@ . @ @ @ . . . . . . @ . @ @ @ . @ @ @ . . @ . @ . @ . @ @ . @ . @ . @ @ @ . . . @ @ . . @ @ . . @ @ . @ . . . . @ @ . @ @ . @ . @ @ . . @ . @ . . @ @ @ . @ @ @ . @ . @ . @ . @ @ . . . @ . . @ . @ @ 
@ . . @ . @ . @ . @ . . @ . @ . . . @ . @ . . @ . . . . @ . @ . @ . . @ @ . @ . @ . @ . @ @ . @ . @ . . . @ . @ . . . . . . . @ . @ . @ . . @ @ @ . . @ . . . @ @ @ @ @ . . . . . . @ @ . @ . @ . . . @ 
@ @ . . . . @ . @ @ . @ . . . @ @ . . . . @ . @ @ . @ . . . . . . @ . @ . . . . . . . . . . . @ @ @ @ . @ . . @ @ . @ . @ @ . . @ . . . . @ . @ . @ @ . @ . @ . @ @ @ . @ . @ . @ @ @ . . . . . @ . @ @ 
@ @ . @ @ . . . . . . . @ . @ @ . @ . @ . . . . . . @ @ . @ . @ @ . . @ . @ @ @ . @ . @ . @ . . @ @ . . . @ . . . @ . . . @ @ @ @ @ . @ . @ . . . . . . @ . . . . @ . . . . . @ @ @ . . @ . @ . . . . @ 
@ . @ . . . @ . @ @ @ . . . . @ . . @ . @ @ . @ @ . . . @ @ @ @ . @ . @ @ . @ . . . @ . . . @ . . @ . @ . @ . @ @ . @ @ . . @ . @ @ @ . . . @ @ . @ @ . @ . @ . @ . @ . @ . @ @ @ . @ . . @ . @ . @ @ @ 
@ . . . @ . @ @ @ . . . @ . @ @ . @ . . @ @ @ . . . @ @ @ . @ . . . . . . . . . @ @ @ @ @ @ . . @ @ @ . . . . @ . . . . . @ . . . @ . @ . @ @ @ . @ . . . @ @ . . . . @ . . @ . . . . . @ @ . . @ @ @ @ 
@ @ @ @ . @ . . . . @ . @ . @ . . . @ . @ @ @ . @ . . @ . . @ . @ . @ . @ . @ . . . . @ @ @ @ . @ @ @ @ @ . @ . . @ @ @ @ . @ @ . . . @ . @ . . @ . @ . @ . . @ @ . @ . @ . @ . @ @ . @ . @ . @ @ @ @ @ 
@ . . . . . . @ . @ @ @ . . . . @ . @ . . @ @ @ . @ @ . @ . . @ @ @ . . @ . . @ @ @ . . @ @ @ @ . @ @ @ @ @ . . @ . @ . . . . . @ @ . . . @ . @ . . . . . . @ @ . . . . . . . @ . . . . . @ . . @ @ @ @ 
@ . @ . @ . @ . @ . @ . . @ . @ . @ . . @ @ @ . . . . . @ @ . . @ @ @ . @ . @ @ . @ . @ . @ . @ . . . @ @ @ @ . . . . @ @ @ @ . @ . @ . @ . . @ @ . @ . @ . @ . . @ . @ @ . @ . . @ . @ @ . . @ @ @ @ @ 
@ @ @ @ @ @ . . @ . @ @ @ . . . . . . @ . @ . @ @ . @ . . @ . @ @ @ @ @ . . @ . . . . . . . . . . @ . @ @ @ . @ . @ @ . @ @ . . . . @ . @ @ . @ @ . . @ . @ . @ . @ . @ . @ . @ . . @ @ . . @ . @ @ @ @ 
@ @ @ @ @ @ @ . . . . . . @ . @ . @ . . . . . @ @ @ @ . @ . . . @ . @ . @ @ @ @ @ @ @ . @ . @ . @ . @ . @ . . . . . @ . . @ @ . @ . . . . . . . . @ . @ . @ . . . . @ . . . . . . @ . . @ . . . @ @ @ @ 
@ @ @ @ @ @ . @ . @ @ @ . @ @ . . @ @ @ . @ @ . @ . @ . . @ . @ . . . . . @ @ @ . @ @ @ @ @ . . . . . . . @ @ @ . @ . @ . @ @ . . @ . @ . @ . @ . . . . . @ . @ . @ @ @ . @ @ @ . @ . @ . . @ @ @ @ @ @ 
@ @ @ @ @ . . . @ @ . . . . @ @ . . @ . . @ @ . . . . @ . . . @ @ . @ . @ . @ @ . . . . @ @ @ . @ @ . @ . @ . . . . . . . . @ . @ @ @ . . . @ . @ . @ . @ . @ . . . @ @ @ . . . . . . @ @ . @ @ @ @ @ @ 
@ . @ @ . @ . @ @ @ @ . @ . . . . @ @ @ . . . . @ . @ @ @ @ . @ @ @ . . . . @ . . @ @ . . . @ . . . @ @ . . @ @ . @ . @ . @ @ @ @ @ @ @ . @ . . . @ . . . . . @ . @ @ @ @ @ . @ . @ @ . . . . . @ @ @ @ 
@ . @ . . . . . . @ . @ . @ . @ . @ @ . . @ . @ . . . @ . . . . @ . @ @ . @ . @ . . @ @ @ @ . . @ @ @ @ @ . @ . . . @ @ @ @ @ @ @ @ @ @ @ . @ . @ . @ . @ . @ . . . @ . @ @ @ . . . @ . @ @ . @ . @ . @ 
@ . . . @ . @ . @ @ . @ . . . . @ . . . @ . . @ @ @ @ . . @ . @ . . . . . . . . . @ . @ @ . @ . @ . @ . @ . @ @ . @ . @ . . @ @ @ @ @ . @ . . . . . . . @ . . @ . @ . . @ @ . @ . @ . @ . . . . . . . @ 
@ @ @ . @ @ @ . @ . . . . @ . @ @ . @ . . @ @ @ @ @ . @ @ . . @ . @ @ @ @ @ . @ . . . . . . . . . . . . . @ . . . @ . . . @ . @ @ @ . . . . @ . @ . @ . . @ @ . . . @ . . . . . . @ . . . @ . @ . @ @ @ 
@ @ . . . . @ @ @ @ . @ . . @ @ @ . @ . @ @ @ @ @ @ . @ . @ . . @ @ . @ . . @ @ @ . @ . @ . @ @ @ . @ . @ . @ @ . @ . @ @ . . . @ @ @ . @ @ . . . @ . . @ @ . @ . @ . . @ . @ . @ @ @ @ . @ @ . @ . . @ 
@ @ @ . @ @ . @ @ . @ . . @ @ @ @ @ . . . . @ @ @ @ . @ . . . @ @ @ . . @ . . @ . @ . . @ . @ . @ @ . . . . . . . . . . @ @ @ . . @ . . @ . @ . @ @ @ . . @ . @ . . @ . @ . . @ @ @ @ . . . @ . . @ . @ 
@ @ . . . @ . @ . . . . @ @ @ @ @ @ @ @ @ . . . . . . . . @ . . @ . @ . . @ . . . @ @ @ @ . . . . @ @ . @ . @ @ @ . @ @ . . . . @ @ . @ . . . . @ @ . @ . . . . @ . @ . . @ . @ . . @ @ . @ @ . @ . . @ 
@ . @ . @ . . . @ @ . @ . @ @ @ @ @ @ @ . @ @ . @ @ @ @ @ . @ . @ . . @ . . @ @ . . . @ . . @ @ @ @ @ @ . . . @ @ . @ @ @ @ @ . . . @ . @ . @ . @ . . . @ @ . @ . . . . @ . @ . . @ . . . @ . . @ . @ @ 
@ . . . . . @ . . . @ . . . @ . @ @ @ . . @ . @ . . . . . . . . . . @ . @ . @ @ . @ @ . @ . . . . @ @ . . @ . @ @ . . @ . . . . @ @ . . @ . @ @ . @ . @ . @ . @ @ . @ . . . . . @ . @ @ . . @ . . . . @ 
@ . @ . @ . . @ . @ . . @ @ . . @ @ @ @ . @ . @ @ @ @ . @ @ . @ @ . . . . . . . . . . . . @ @ @ @ . . . @ . . @ . . @ . @ . @ . @ @ @ . . . @ . . . . . . . . . @ @ . . @ @ @ @ . . @ . . @ @ . @ . @ @ 
@ @ . . . @ . . @ @ @ . . . . @ . . @ . . . . @ @ . . @ @ . @ . . . @ . @ @ . @ . @ . @ @ @ @ @ @ @ @ . . @ @ @ @ . . . @ . . @ . . . @ . @ . @ . @ . @ . @ . @ . . @ . . . @ @ . @ . @ . . @ . . @ @ @ 
@ @ @ . @ @ . @ @ @ @ . @ . @ . @ . @ @ . @ . @ . @ . @ . . . . @ . @ @ @ @ . @ . . @ @ @ @ @ @ @ . @ . @ @ @ @ . . @ @ . . @ . @ @ . . @ @ . . . @ . . @ . . . . @ . . @ @ . @ . . . . . @ @ @ . . @ @ 
@ @ . . @ . . . @ . @ . . @ . . . . . . @ . . . . . . . @ @ @ . @ . . @ @ @ @ @ . @ . @ @ @ @ . @ . @ . @ @ @ . @ . . @ . @ . . . . . @ . @ . @ . @ . @ @ . @ . @ @ @ . @ . . . @ . @ . @ @ @ . . @ . @ 
@ @ @ . . @ . @ . . . @ . @ . @ @ @ @ @ . @ . @ . @ @ . . @ . @ . @ @ . . @ . . . . . . @ @ . . . . . @ @ @ . . . . @ . . . . @ . @ . . . . @ @ @ . @ . @ . @ . . @ . . . @ @ . . @ . . . @ . . @ . . @ 
@ @ . . @ . @ . @ . @ . . @ . @ . . @ . . . @ . . . @ . @ . . . . . . . @ . @ . @ @ . @ . . . @ @ @ . @ @ . @ . @ . . @ @ . @ . . @ . @ . @ . @ . . . . . @ . . @ . @ . @ . . . @ @ @ . @ . @ . . . @ @ 
@ . @ . @ . @ . @ . . . @ . . . . @ . @ . @ . @ . @ @ . . . @ . @ . @ . . . . @ @ @ . . . @ @ @ @ @ . @ . . . @ . . @ . @ @ @ @ @ @ @ . . @ . . @ @ @ @ . . @ . . . . . @ . @ . @ @ . . . . @ . @ . @ @ 
@ . . . . . . . . @ @ . . @ @ @ . . . . . . . . . @ . @ . @ . . . @ . @ . @ . . @ . @ @ . . . @ @ @ @ . @ . @ . @ . . . . . @ @ @ @ . . @ @ . @ . . @ . @ . @ @ @ . @ @ . . @ . . @ @ . @ @ @ . @ . . @ 
@ @ . @ . @ . @ . @ . @ . . @ . @ @ . @ . @ . @ . @ . @ @ @ @ . @ @ . @ @ . @ . . . . . . @ . . . @ . . . . . . . @ @ . @ @ @ @ @ . @ . @ . . . . @ . . . . @ . . . . @ @ . @ . @ . . . . . . . . @ . @ 
@ . . @ @ . . @ . . . . @ . . . . @ @ . . . @ @ @ . . @ . . @ @ @ . . @ @ . . @ @ @ . @ . . @ @ @ . @ @ @ . @ @ . @ . . . . @ @ . . . . . @ . @ @ . . @ @ @ . @ @ . @ @ @ @ . . . @ @ . @ . @ . @ . . @ 
@ . @ . @ @ @ . @ . @ . . . @ . @ @ @ @ . @ . @ . @ . . @ . @ @ . @ . . . @ . . . . @ . . @ . . . . . . . @ . . . . @ . @ @ . @ @ . @ . @ . . . . . @ . . . . @ . . . @ @ . . @ @ . . . . @ . @ . . @ @ 
@ @ . . . @ . . . . . @ @ . . @ @ @ @ @ . . . . . . @ . . . . @ . . . @ @ . @ . @ @ . @ . @ @ . @ . @ . @ . . @ @ . . . . @ . @ @ @ @ . . @ . @ . @ @ @ . @ @ . @ . @ . . @ . . @ . @ @ . @ . @ @ @ @ @ 
@ @ @ . @ . @ . @ @ @ . . . @ . @ @ @ . @ @ @ @ . @ @ . @ . @ @ @ @ . @ . . . . . . . . . . . @ @ @ . . . @ @ @ @ . @ . @ . . . @ . . . @ . . . @ . . . . . @ . . . . @ . @ . @ . . . @ . . . . . @ @ @ 
@ @ @ . @ . . . @ . @ @ @ . . . . . . . @ . @ . @ @ . @ . . . @ . . . . . @ . @ . @ . @ . @ @ . @ . @ . @ . @ @ . @ . . . @ . @ . @ @ . . @ . @ @ @ . @ . @ . @ @ . @ @ . . . @ . @ @ . . @ . @ @ . @ @ 
@ @ . . . @ . @ . . . @ . . @ . @ . @ . . . . . . . . . @ . @ @ @ @ . @ @ . . . @ . . @ . . . . . . . . . . . . . . . @ . . . . . . . . @ @ . @ @ . . . @ . . . . . @ @ . @ . . . . @ @ . @ . . . . . @ 
@ . @ . @ . @ . @ . @ . @ . . @ . . . @ @ . @ . @ . @ @ . . . @ @ . . . . @ @ @ . @ . . @ . @ . @ @ . @ . @ . @ . @ @ . @ @ . @ . @ @ . @ @ . @ . @ . @ . @ . @ . @ . . . @ . @ . @ . @ @ . . @ . @ . @ 
@ . . . . . . . . . . . . . @ . . @ . . . @ . . @ . . . @ . @ . . @ @ @ . @ . . . @ . @ . @ . @ . . @ . . . @ . @ @ . . . @ . @ . @ . . . @ . . . . . . . . . . @ . @ . @ . . . @ . . . @ @ . . @ . . @ 
@ . @ . @ @ . @ . @ . @ @ @ @ @ . @ @ . @ @ @ . @ . @ . . . . @ . @ @ . @ . @ @ . @ @ . . . . . @ . . . @ @ . . . @ @ . @ . @ . @ . @ . @ . @ @ . @ . @ . @ . @ . . . @ . @ . @ . @ . @ . @ . @ @ @ . @ 
@ . @ @ . @ . . @ . . . . . . @ @ . . @ @ @ @ @ . @ @ @ . @ . . . . . . . . . . . . . . @ . @ . . @ @ . @ . @ . @ . . . . . . . . . . . . . . . @ @ . . @ @ . @ @ . @ @ . . . . . . . . . . @ . . @ . @ 
@ @ . . . . . @ @ @ . @ @ @ . @ @ @ . @ . . @ . . . . . . @ . @ . @ . @ @ . @ . @ . @ . @ @ . . @ @ @ @ . . . . . @ . @ @ . @ @ . @ . @ . @ @ . . . @ . @ . . @ . . . @ @ @ . @ . @ . @ @ @ . @ . . . @ 
@ . @ @ . @ . @ @ @ @ . . . @ @ @ . . @ . @ . . @ . @ . @ @ . . @ . . . . @ . . . @ . . @ . @ . . . @ . @ @ . @ . @ . . @ @ . @ @ . @ . . @ . @ . @ . @ . @ . . . @ @ . @ . . . @ @ @ @ @ . . @ @ @ . @ 
@ . . . . . @ @ @ @ . . @ . . @ @ @ . . . . @ . . @ . . . @ . @ @ @ . @ @ @ @ . @ @ @ @ . . . . @ @ @ . @ @ @ . . @ @ @ @ @ . . @ . . @ @ . . . . . . . . . @ . @ . @ . . @ . @ . @ . @ . . @ @ @ @ . @ 
@ . @ . @ . @ @ @ @ @ . @ . @ . @ . @ @ @ . . . @ @ @ . @ @ @ . @ @ @ @ @ @ @ @ @ @ @ @ @ . @ . . @ . . . @ @ @ . . . . @ . . @ . @ . @ . @ . @ . @ . @ @ . . . . . . . @ . . . . @ . @ @ . . . . @ . @ 
@ @ @ @ @ . @ . . @ . @ . . . . . . . . . . @ . . @ @ . . . @ . . @ . @ . @ @ @ @ @ @ @ @ @ . . @ . @ . @ . @ . @ @ . @ . @ . . . . . . . . . @ @ @ . . @ . @ . @ . @ . @ . @ @ . . . @ . @ . @ . @ . @ 
@ . . @ . @ . @ . @ . @ . @ . @ . @ @ @ @ @ . . @ . . . @ . @ . @ . . . . @ @ @ @ @ @ @ @ @ @ . . . . . . . . . . . . . . . . @ @ . @ . @ . @ . . . . @ . . . @ . . . @ . . @ . @ . @ . . . @ . . . . @ 
@ @ . . . . . . . . . . . @ @ . . . . @ @ @ @ . . @ @ . . @ . . . @ . @ @ . @ @ @ @ @ @ @ @ @ @ @ . @ @ . @ . @ . @ . @ . @ . @ @ @ . . . @ . . @ . @ . . @ . @ . @ @ @ @ @ @ . . . . @ . @ . . @ @ . @ 
@ . . @ . @ . @ . @ @ . @ @ @ . @ . @ @ @ @ . @ @ . @ @ @ @ @ @ . @ . @ @ . @ @ @ . @ @ @ . . . . . . @ . . @ . . @ @ . . @ . @ @ . @ . @ @ @ . . @ . @ . @ @ . @ . @ @ @ @ @ . @ @ . . . . @ . . @ . @ 
@ @ . . @ . . . @ . . . . @ @ . @ . @ @ @ . . @ @ . @ @ @ @ @ . . . . . @ . . @ . . . @ @ @ . @ . @ . . @ . @ @ . @ . @ . @ @ . . . . . @ @ @ . @ . . . . . . . . . . @ @ @ . . . @ . @ . @ @ @ @ . @ @ 
@ . . @ @ @ @ . @ . @ @ @ . . . @ . @ @ @ @ . . . . . @ . . . . @ @ @ . @ . @ . @ . @ . @ . @ . . @ @ @ . @ . @ . . . @ . . . @ . @ . @ @ . . . @ . @ . @ . @ . @ . @ . @ . @ . @ . @ @ . . @ . . . . @ 
@ . @ @ @ @ . @ . @ . . @ . @ . @ . @ @ @ . @ . @ @ . . @ . @ . @ @ . . . . . . . . . . . . . . @ . . . . . . . . @ . . @ @ @ . @ @ @ @ . @ . @ . @ . @ . . . @ @ . . . . . . . . . . @ . @ @ @ . @ . @ 
@ . . . @ . . . . . @ . @ . . @ . . @ @ . . . . . @ . @ @ @ . . . . @ @ . @ . @ . @ @ . @ . @ . @ @ . @ . @ . @ . @ @ @ . @ . . . @ . . . . . . . . . . @ @ @ . . . @ @ @ @ @ @ @ @ @ @ . . . . . . @ @ 
@ . @ @ @ @ @ . @ . . . . @ @ @ @ . @ . @ . @ . @ . . @ @ . @ . @ @ @ @ . @ @ . . @ . @ . . @ @ . . . @ @ . . . @ @ @ @ . . . @ . . . @ . @ . @ @ @ . @ @ . . . @ . . . . . . . . . . @ . @ @ @ . @ . @ 
@ @ @ @ @ @ @ . @ @ @ @ . . . @ @ @ . . . @ . . . @ . @ . . . . @ @ @ . @ . . . @ . . . . @ . . . @ . @ . @ . @ @ @ @ @ . @ @ . @ . @ . . . @ . . @ . @ @ @ . @ . . @ @ @ . @ . @ . @ . @ @ . @ @ . . @ 
@ @ @ @ @ @ @ @ . . . @ . @ @ . @ . @ . @ . @ . @ . @ . . @ . @ @ @ . . . . @ . . @ . @ . . @ @ . . @ . . . . @ @ . . . . . @ . . @ . @ . @ . @ . . . . . . @ . . @ @ @ @ . @ @ . . . . . . . . @ . @ @ 
@ @ @ . @ @ @ . @ . @ . . . . . . . . . . . . . . . . . @ @ @ . @ . @ . @ @ @ . @ @ @ . . @ @ . @ . . @ . @ . @ . @ . @ . @ . @ . @ . @ . . . . @ @ . @ @ @ @ @ . . . @ @ . @ @ @ @ @ . @ . @ . . . . @ 
@ . @ . . @ . . . . . . @ @ @ . @ @ . @ . @ . @ . @ @ . . @ . . . . . . @ @ @ @ . . . . @ @ . . . . @ @ . . @ @ . @ @ . . @ . . . . . . . @ . @ @ @ @ @ . . @ . . @ . . @ . . . . @ . . . @ . . @ @ . @ 
@ . @ . @ @ @ . @ . @ . . @ @ . . . @ @ @ . . . @ . . . @ @ @ . @ . @ . @ . @ . @ @ . @ @ @ @ @ @ . @ . . @ . . . . . @ . . @ . @ @ . @ . . @ @ @ @ . . . @ . @ . . @ . @ . @ . @ . @ . @ @ @ . @ . . @ 
@ . . . . . . . . @ . . @ @ . @ . @ . @ . . @ @ @ @ . @ @ . . @ . @ @ @ . . . . . . . @ @ @ . . . . . @ . @ . @ @ @ . . . @ . @ . @ . @ . @ @ @ @ . @ . @ . . . . @ @ . @ . . @ . . . . . @ @ @ . . @ @ 
@ . @ . @ . @ . @ @ @ . @ . . . . . . . @ @ @ . @ @ . @ . @ . @ . @ . @ @ . @ @ . @ . @ @ @ @ . @ . @ . . . @ @ . . . @ . . . @ . @ @ . @ @ @ @ . . . . . @ . @ . . . @ . @ @ . @ . @ . @ @ @ . . @ @ @ 
@ @ . . @ @ @ @ . . . . . @ . @ . @ . @ . . . . . . @ . . . . . . . . . . . @ . @ . . @ @ @ . @ . . . @ . @ . @ @ . @ @ @ . @ . . . . . @ @ @ . @ . @ . @ @ @ . . @ . . . @ . . . . @ . @ @ @ @ @ @ @ @ 
@ . . @ @ . @ . @ . @ . @ . . @ . . @ @ @ . @ . @ . . . @ . @ @ . @ . @ . @ . . . . @ @ @ @ . @ @ . @ . . @ . . . . @ . . . @ . @ . @ . . . . . . . . @ @ . . @ . . @ . @ . @ . @ @ . . . . @ . @ @ @ @ 
@ . @ . . . . . . . @ @ . . @ . . @ @ @ @ @ @ . @ @ . @ . . @ . @ @ @ . @ . . @ . @ @ @ . . . @ . @ @ @ . . @ . @ . @ . @ . . @ @ @ @ @ @ @ @ . @ . @ . . . @ . @ . @ . . . . @ . @ @ . @ . . . . @ @ @ 
@ @ . @ . @ . @ . @ @ @ @ . @ . @ . @ @ @ @ @ @ . . . @ @ . . . . . @ . @ . @ . . . @ . . @ @ . . @ . @ . @ . @ . . @ @ . . @ . @ . @ . . . . @ . . . @ . @ . . . . . @ . @ . . . . . @ . . @ . @ . @ @ 
@ . . . @ . @ . . . . @ @ @ . . . . . . . @ @ @ @ . @ . . . @ @ . @ . . . . . @ @ @ . @ . @ . @ . . . . . . . . @ @ . . @ . @ . . . . . @ . @ . @ @ . . . @ . @ @ . @ . . @ @ . @ . @ . @ . . @ . . . @ 
@ . @ . @ . . @ . @ . @ @ . @ . @ @ . @ . . . @ . . . @ @ . @ . @ . . @ @ . @ @ @ . . . . . . @ @ . @ @ . @ @ . @ . . @ @ @ @ @ . @ . @ . . . . . . . @ . . @ . . . @ @ @ . . . . @ @ . . . @ @ @ . @ @ 
@ . . @ . . @ @ . @ @ . @ . @ . @ @ @ . . @ @ @ @ . @ @ @ @ . . . . @ . . . @ @ @ @ . @ . @ . . @ @ . @ . @ . . @ @ . . @ . @ . . . @ . . @ . @ . @ . @ . @ . @ . @ @ . . . @ . @ @ @ @ . @ . @ . . . @ 
@ . @ . @ . @ . . @ @ . . . . . . @ @ @ . . @ @ @ @ @ @ @ @ @ . @ . . @ . @ . . @ . @ . @ . . @ . . . . @ . @ @ @ @ . @ . . . @ . @ @ @ . @ @ . . . @ @ . . . . . @ @ . @ . . @ . . @ . . . . . @ . @ @ 
@ . @ . . . . @ . @ . . @ . @ . @ . . @ . @ . @ @ @ @ @ @ . . . @ . @ @ @ @ . @ . . . . . @ . @ . @ . @ . . . . @ . . . @ . @ . . @ @ . . @ @ @ . @ . . . @ . @ . . @ @ . . @ . @ . @ @ . @ . @ . . . @ 
@ . . @ . @ . @ @ . . @ @ @ . . . . @ . . . . . . @ @ @ @ @ @ @ . @ @ @ @ . . . . @ @ . @ . . @ @ . . . . @ @ . @ @ @ . . . . @ . @ . @ . . @ @ @ @ . @ . . @ . . @ . . @ . . . . . . @ @ . . . @ . @ @ 
@ @ . @ @ . . @ @ @ . . @ @ @ . @ @ @ @ . @ . @ . @ @ @ . . @ . . . @ . . @ . @ . @ . @ . @ . . . @ . @ @ . . @ @ @ . @ . @ . @ . @ . @ @ @ . @ @ . . @ . @ @ @ . . @ . . . @ . @ . @ @ . . @ . . . . @ 
@ @ . . . @ . @ @ @ . @ . @ . @ . @ @ . . @ . . @ @ @ . . @ . @ . @ . @ . . @ . . . . . . . @ . @ . . . @ @ . . @ . . . @ . . . @ . . @ . @ . . @ . @ . . . . @ . @ @ . @ . . @ . . . . @ . @ . @ @ . @ 
@ . @ @ . . . . . . . . . . . . . . @ @ @ . . @ @ @ @ @ . . . . . @ . @ . @ . @ . @ @ . @ . . . . @ . @ . @ . @ . @ . @ . @ @ . @ . @ . . . @ . . . . @ @ @ . . @ @ @ . @ . @ @ . @ . @ . . . @ . . . @ 
@ . @ . @ . @ @ . @ . @ @ . @ . @ @ @ @ . @ . . @ @ @ @ @ @ . @ . @ . . . . . . . . . @ @ @ . @ . . . . . . . . . . . . . . . . . . . . @ . . . @ . @ @ . @ . @ . @ . @ . . @ @ . @ @ @ @ . @ @ @ @ . @ 
@ . @ . . . . @ @ . . . . @ . . @ . . . . . . @ @ @ @ @ @ @ @ . . . . @ . @ @ . @ . @ . . . . @ . @ . @ . @ . @ @ . @ . @ . @ . @ . @ . @ . @ . . @ . . . . . . . . . . @ . . . @ . . @ . . @ @ @ @ . @ 
@ . . . @ . @ . @ @ . @ @ . @ . . @ @ . @ . @ @ @ . @ @ @ @ @ @ . @ . . @ . . . @ . . @ . @ . @ @ . . . @ . . @ . @ . . @ . @ @ . . . @ . @ . . @ . @ . @ @ . @ @ . @ . @ @ . @ . @ . @ . @ @ @ @ @ . @ 
@ @ . @ . . . . . . @ @ . . . . @ @ . @ . . . . . . @ . . . @ . @ . . @ @ @ . @ . . @ . . . @ . . @ . @ . @ @ . . . . @ . @ . . . @ @ . . @ @ . . . @ @ @ . . . . @ @ . . @ . . . . . . @ @ @ @ @ @ @ @ 
@ @ . . @ @ . @ . @ @ . . @ @ . . . . @ @ . @ . @ @ . . @ . . . . . @ . @ @ @ @ @ . @ @ @ @ . @ . . . @ . . . . @ . @ . . . . @ . . @ . @ . @ . @ @ . @ . @ . @ . . . @ @ . . @ . @ . @ . . @ @ @ @ @ @ 
@ . . @ @ @ . . @ @ @ @ . @ @ . @ . @ @ @ @ @ @ @ @ @ . @ . @ . @ . . . . . @ @ @ @ . . . . . . . @ . . @ . @ . . @ @ @ . @ . @ . @ . . . . . . . @ . . . . . . @ @ . . @ @ . . @ . . . . @ @ @ @ @ @ @ 
@ @ . @ @ @ . @ @ @ @ @ @ . . . . @ @ @ @ @ @ @ @ @ @ @ @ . . @ . . @ . @ . @ @ @ @ @ . @ . @ . @ . . @ @ @ . . @ @ @ @ @ . . @ . . @ . @ @ . @ . . @ . @ . @ . . . @ @ @ . . @ @ @ . @ . @ @ @ @ @ @ @ 
@ @ @ @ @ @ @ @ @ @ @ @ @ @ @ @ @ @ @ @ @ @ @ @ @ @ @ @ @ @ @ @ @ @ @ @ @ @ @ @ @ @ @ @ @ @ @ @ @ @ @ @ @ @ @ @ @ @ @ @ @ @ @ @ @ @ @ @ @ @ @ @ @ @ @ @ @ @ @ @ @ @ @ @ @ @ @ @ @ @ @ @ @ @ @ @ @ @ @ @ 
3
16 23 24 35
53 47 93 74
20 42 38 91
