12 12
@ @ @ @ @ @ @ @ @ @ @ @ 
@ . @ . . . @ . . @ @ @ 
@ . @ . @ @ @ @ . @ @ @ 
@ . . . . . @ . . . @ @ 
@ @ @ . @ @ . @ . @ . @ 
@ . . . . . . . . . . @ 
@ . @ . @ . @ . @ . @ @ 
@ @ . . . @ @ . @ . . @ 
@ . . @ . . . @ . @ . @ 
@ @ . @ . @ . . . . @ @ 
@ @ . @ . @ . @ . @ @ @ 
@ @ @ @ @ @ @ @ @ @ @ @ 
3
4 6 5 10
9 6 5 4
4 8 4 10
