12 12
@ @ @ @ @ @ @ @ @ @ @ @ 
@ @ @ @ @ @ @ @ @ @ @ @ 
@ @ @ @ @ @ . @ . @ . @ 
@ @ @ @ @ . . @ . . . @ 
@ @ @ @ @ . @ . . @ @ @ 
@ @ @ . . . . . @ . . @ 
@ . . . @ . @ @ @ . @ @ 
@ . @ @ . . . @ . . . @ 
@ . @ . @ @ . . . @ . @ 
@ . . . . . @ . @ @ . @ 
@ . @ . @ . @ . @ @ . @ 
@ @ @ @ @ @ @ @ @ @ @ @ 
3
8 10 8 3
3 8 4 5
8 7 7 5
