100 100
@ @ @ @ @ @ @ @ @ @ @ @ @ @ @ @ @ @ @ @ @ @ @ @ @ @ @ @ @ @ @ @ @ @ @ @ @ @ @ @ @ @ @ @ @ @ @ @ @ @ @ @ @ @ @ @ @ @ @ @ @ @ @ @ @ @ @ @ @ @ @ @ @ @ @ @ @ @ @ @ @ @ @ @ @ @ @ @ @ @ @ @ @ @ @ @ @ @ @ @ 
@ @ @ @ . @ @ @ @ . . . . @ @ @ @ . @ @ @ @ @ @ @ @ @ @ @ @ @ @ @ @ @ @ @ @ @ @ @ @ @ @ @ @ @ @ @ @ @ @ . . @ . . . @ @ . . @ . . . @ @ @ @ . . @ . . . . . . @ . @ . @ . @ . . @ @ @ @ @ . @ . . @ @ @ 
@ @ @ @ . . @ @ @ @ @ . @ . @ @ . . @ . @ @ @ @ @ @ @ @ @ @ @ @ @ @ @ @ @ @ @ @ . @ @ @ @ @ @ @ @ @ @ . . @ . @ . @ . . @ . . . @ . . @ @ . . @ . @ @ . @ @ . . . . . . . . @ . @ @ @ @ . . @ . @ . . @ 
@ @ @ @ . @ . @ @ @ . . @ . . . @ . . . . @ @ @ @ @ @ @ @ @ @ @ @ @ @ @ @ @ @ . . . . @ @ @ @ @ @ @ . @ . . . . . . . @ . @ @ . @ @ . @ @ @ . . . . @ . . @ . @ . @ . @ @ . @ . . @ @ @ @ . @ . . . @ @ 
@ @ @ @ . . . . @ . @ . . . @ @ @ . @ . @ @ @ @ @ @ @ @ @ @ @ @ @ @ @ @ @ @ @ @ . @ @ @ @ @ @ @ @ @ . . @ @ . @ . @ . . . . . . . . @ @ @ . . @ . @ . . @ @ @ . . . @ @ @ . @ @ . . @ @ . . @ . @ @ . @ 
@ @ @ @ . @ . @ . . . @ @ . . . . . . @ @ @ @ @ @ @ @ @ @ @ @ @ @ @ @ @ @ @ @ . . . . @ @ @ @ @ @ @ @ . @ . @ @ @ . . @ . @ . @ . @ @ @ . @ . @ @ @ . @ @ @ . @ . @ . @ @ . @ @ @ . . . @ . . . . @ . @ 
@ . . @ . . @ . @ @ . @ @ . @ @ . @ @ @ @ @ @ @ @ @ @ @ @ @ @ @ @ @ @ @ @ . . . @ . @ . @ @ @ @ @ @ . . . . . . . @ . @ @ . . . @ @ @ @ . . . . . . . . @ . . . . . . . . @ @ @ @ @ @ . . @ . @ @ . . @ 
@ @ . . . @ . . . @ . . . . @ . . . @ @ @ @ @ @ @ @ @ . @ @ @ @ @ @ @ @ . . @ @ @ @ . . . @ @ @ @ @ @ @ . @ @ . @ . . @ @ @ . @ @ @ @ @ . @ @ @ . @ @ . @ @ . @ . @ @ . @ @ . @ . @ . @ . . . . @ . @ @ 
@ @ @ . @ . @ . @ @ @ . @ . . @ @ @ . @ . @ @ @ @ @ @ . @ @ . . @ @ @ . @ . . @ @ . @ . @ @ @ @ @ @ @ . . . @ @ . @ . @ @ @ @ @ @ @ @ @ . @ @ @ @ @ @ @ @ @ @ @ @ @ @ @ . . . . . . . @ @ @ . @ . . @ @ 
@ @ @ . . . . . . @ . @ . @ . . @ @ . . . @ @ @ @ @ . . . . @ . . @ . . . . @ @ . . @ . . @ @ @ @ @ . @ . @ . @ . . . @ @ @ . . . @ @ . . . @ @ @ @ @ @ @ @ @ @ @ @ @ . @ . @ @ . @ . @ . . . . . @ . @ 
@ . . @ @ @ @ . @ . . . . . @ . @ @ . @ @ . @ @ @ . @ @ . @ . . @ . @ . @ . @ . @ . @ . @ @ @ @ @ . . . . . . @ . @ . . @ . @ . @ @ . @ . @ . @ @ @ @ @ @ @ @ @ @ @ . . . . . @ @ . . @ . @ . @ . @ . @ 
@ @ . . . . @ . . @ @ . @ . . . . . . . . . . . . . @ . . . @ . . . . @ . . . . . . . . . . @ @ . @ @ @ . @ . @ @ . . @ . . . . . . . . . . . . . @ @ @ @ @ @ @ @ . @ @ . @ @ @ @ . @ . @ . . . @ . . @ 
@ @ @ @ . @ . . @ . . @ . @ @ . @ . @ . @ . @ . @ . @ . @ @ . @ . @ @ . @ . @ @ @ @ @ @ . @ . @ . . @ . @ . . @ . @ . @ @ . @ . @ . @ . @ . @ @ . @ @ @ @ . @ @ . . . @ . . . @ . . @ . . . @ . . . @ @ 
@ @ @ . . . @ . . . @ @ . . . @ . @ @ @ . . . @ . . . . . . . . . . @ . . @ . @ . @ . . . . . . . @ . . . @ . . . . . . . @ . @ . . @ . @ @ @ . @ . @ @ @ . . @ @ . @ @ @ . @ @ @ . @ . @ @ . @ @ . @ @ 
@ @ . @ . @ . @ @ . . . @ . @ . . . . . @ . @ . @ . @ . @ @ . @ . @ . . @ . . . . @ @ . @ @ . @ . . @ @ . . @ @ . @ . @ @ . . . . @ . . . @ @ . . . . . . . @ @ . . @ . . @ @ @ @ . . @ . . . . . . . @ 
@ @ . . . . . . . . @ . . . . . @ @ . @ @ @ . . . . . @ . @ . . @ . @ . @ @ . @ . . @ @ . . @ . @ . @ . @ . @ @ @ . . @ @ @ . @ @ . @ . @ . @ . @ . @ @ @ @ . . @ . . . @ . @ . . . @ @ @ . @ @ @ . @ @ 
@ @ @ @ . @ . @ @ @ @ @ . @ @ . . . @ @ @ . @ @ . @ . . . . @ @ . . . . . . @ . . @ . . @ . . . . . . . . . . @ . @ . . @ . . . @ . . . . . . . . @ @ . @ . . @ @ @ @ . . . . @ @ . @ @ . @ @ @ @ . . @ 
@ @ . @ @ . . @ @ @ @ @ . @ . @ . @ . @ . . @ @ @ . @ @ . @ @ @ @ @ . @ . @ . @ . @ . @ @ @ @ . @ @ @ . @ . @ . . . . @ . @ @ @ . . @ . @ . @ @ . @ . . @ @ . . . . . . @ . @ @ @ . @ @ . . @ @ . . @ @ 
@ . . . @ . @ . @ . @ @ @ . . . . . . . @ . . @ . . @ . . . @ . . @ @ . . . . . . . . . @ . @ . . . @ @ . . . @ . @ . . . . @ @ @ @ . . @ . . . @ @ @ . . . @ . @ . @ . @ @ . @ . . @ . . @ . . @ . . @ 
@ @ . @ . @ @ . . . . @ . @ @ . @ . @ . . . @ . @ . @ @ . @ . @ . @ . @ . @ . @ @ @ . @ . . . @ . @ @ . @ @ . @ @ . @ @ @ . . @ @ @ @ . . @ . @ @ @ @ @ @ . . . . @ . @ . @ . . @ . . @ . . @ . . . @ @ 
@ . . . . @ . . @ . @ . . . . @ . @ . @ @ . . . . . . . . . . . . . . @ @ . @ . . @ . . @ @ . . @ @ @ . @ . . . @ . @ . . . @ . @ @ . . @ . . . @ @ . @ . . @ @ . . . . . . . @ . . @ . . @ . . @ . . @ 
@ @ . @ @ @ @ . . @ @ @ . @ . . . . . . . . @ @ . @ @ . @ . @ @ . @ . . . . . . @ . @ . @ . @ . . @ . . . @ . @ . . . @ @ . @ . . @ @ . @ @ @ . @ . . . . @ . @ . @ @ @ @ @ @ . @ . . . @ . @ . @ . @ @ 
@ @ . @ . @ @ . @ . @ @ @ . . @ . @ @ @ @ @ @ . @ @ . @ @ @ . . @ . @ . @ . @ . . . . . . . . . @ . @ @ . . . . @ @ . @ . . . . @ . @ . . . . @ . @ . @ . . . . @ @ . @ . @ @ . . . @ . . . . @ @ . . @ 
@ . . . . . . . . . . @ . @ . @ @ . . . . . . . . . . . . . . @ . . @ . @ . @ @ @ @ @ @ @ @ @ . . . . . . @ @ . @ . . . @ . @ . @ . . . @ @ . @ . . @ . . @ . @ . @ . . . . @ . @ . @ . @ @ @ . @ . @ @ 
@ . @ . @ . @ . @ @ @ . . . @ @ . @ . @ . @ . @ . @ . @ . @ . . . @ . @ . @ . . . . . . . . . . @ . @ . @ @ . . . @ @ . @ . @ @ . @ . @ @ . @ . . @ @ @ . . @ @ . . @ . @ . @ . . @ . @ . . . . . . . @ 
@ @ . . @ @ @ . @ . @ @ @ . . . . . . . @ . @ . . . @ @ @ @ @ @ . . . . . . . @ . @ . @ . @ . @ @ @ . . . . @ @ . . . . . . . . . . . . . . . @ . . @ . . @ . @ . @ . @ . . . . @ . . . @ @ @ . @ . @ @ 
@ . . @ . . . . . . . @ . @ . @ . @ . @ @ . . . @ . . @ @ @ @ . . @ . @ @ @ . @ . @ . . @ . . @ @ . @ . @ @ . . . @ @ . @ . @ . @ . @ @ @ . @ @ . @ . @ . @ . . . . . @ . @ @ . . . @ . . @ . . . @ @ @ 
@ @ . . @ . @ @ . @ . . . . . . @ @ @ . . . @ @ . @ . . @ @ . . @ . . @ . . . . @ @ @ @ . . @ . . . . . @ . @ . @ . @ @ . @ . . @ . @ @ . . . . . . . . . . . @ . @ . @ @ . . . @ @ . @ @ . @ . @ . @ @ 
@ . . @ . @ . . . @ . @ . @ @ @ . . . @ @ . @ @ . @ @ . . . @ . @ . @ . . @ . @ @ @ @ . . @ . . @ . @ . @ . . @ . . . . . . . @ . . @ . @ . @ . @ . @ . @ @ . @ . . @ @ . @ . @ . @ . . . . . . . . . @ 
@ . @ . . . @ . @ @ @ . . . @ @ . @ . . . . @ . . . @ . @ . . @ @ @ @ @ . @ . @ . @ . @ . . @ . @ @ . . @ @ . @ @ @ . @ @ . @ . . @ . . . . . @ . . @ . . . @ . . @ @ . . . . . . . . @ . @ . @ @ . @ @ 
@ @ . @ . @ . @ . @ . @ . @ . . . . @ . @ . @ @ . @ @ . @ . @ . @ . @ . . . @ . . . . . @ @ . @ . @ . @ . . . . . . @ . . . . @ . . @ . @ . @ @ @ @ @ @ . @ . @ @ @ @ @ . @ . @ . @ . @ . @ . @ . @ @ @ 
@ . . . . . . . . . . . . @ . @ . @ @ . . @ . . . . . @ @ @ . . . . . . @ . @ @ . @ @ . . . . . . . @ @ @ . @ . @ @ . . @ . @ @ @ @ . . @ . @ . @ @ @ @ . @ . @ . @ @ . . @ @ . . . @ . @ . @ . . @ @ @ 
@ . @ . @ . @ . @ . @ @ . . @ . . @ . @ . . @ @ . @ @ . @ . . @ @ . @ . @ . . . @ . . @ . @ @ . @ . @ @ . @ @ . @ . @ . . @ @ @ @ @ @ . @ . . . . . . . @ @ . . . . . @ . . . @ @ . @ . . . @ @ . . @ @ 
@ . @ . @ . @ @ . . @ . . @ @ @ . @ . . . @ . . . . . . . . @ @ @ @ . . @ . @ . . @ . . . @ . . @ . . . . . . . . . . . @ . @ @ @ @ . @ . . @ . @ . @ @ . . @ @ . @ . @ . @ @ . @ . @ . @ @ . @ . @ . @ 
@ @ . @ . @ . . . @ . . @ . . . . . @ @ . @ . @ . @ . @ @ . . @ @ . @ . @ . . @ @ @ @ . @ . . @ . . @ . @ . @ . @ @ . @ @ . . @ @ . . . . @ . . . @ . . . @ . . . . @ @ . . @ . . @ . . . . . . . . . @ 
@ . . . . . . @ . . @ . . @ . @ . @ . @ . . @ @ @ . . @ . . @ . @ . . . @ . @ @ @ @ @ . @ @ @ . . @ @ @ . . . @ . . . @ @ . @ . @ . @ @ . . @ . @ . @ . @ . . @ . @ . . . @ . . @ . @ . @ . @ @ . @ @ @ 
@ . @ . @ . @ . . @ @ . @ . . @ @ . . . . @ @ @ @ @ @ . . @ . . . . @ . @ . . @ . @ . @ . @ . @ . . @ . @ . @ @ @ . @ . . . . . . . @ . . @ . . @ . . . @ . @ . . . @ @ . . . @ . . . . @ . . @ . . . @ 
@ @ . . @ . @ @ @ . . . @ . @ . . . @ @ . @ . @ @ @ . @ . @ . @ . @ . . @ . @ . . . . . . . . . . @ . . . . . @ @ . @ @ @ . @ . @ @ . @ . . @ . . . @ . . @ . @ . @ @ . . @ . . . @ . @ . @ . . @ @ . @ 
@ @ . @ @ @ . . . . @ . . @ . . @ . @ @ . @ . . @ . . . . . @ . @ @ . @ . @ . @ . @ . @ . @ . @ . @ . @ . @ . @ @ @ . @ @ @ . . @ @ . @ . @ . . @ . @ . @ . . . . . @ @ . @ . @ @ @ @ . . . . @ . . @ @ 
@ @ @ . @ @ . @ . @ . . @ @ @ . . @ . . . @ . @ @ @ @ @ @ @ . . . . @ . . @ . . . @ @ . . @ . . @ @ @ . . . @ . . @ . . . . . @ . . . . . . @ . . @ . . . . @ . @ @ @ . . @ . @ . @ @ @ . @ . . . @ . @ 
@ @ . . . . . @ . . @ . . @ . . @ @ @ . @ @ . @ . . . . . . . @ @ . @ . @ . @ @ . @ . . @ . . @ . @ @ @ . @ @ @ . . . @ @ . @ . . @ . @ . @ @ . @ . @ @ @ @ . @ . @ . @ . @ @ . . . . @ @ . . @ . . . @ 
@ @ @ @ @ @ @ . @ @ . @ @ . @ @ . @ . @ . . . @ @ . @ . @ @ . . @ . . . . . . . . . @ . . @ . . . . @ @ @ . @ . @ @ . . . @ . @ @ . . . @ @ . . . . . . . . . . . . . . . . @ . @ . @ @ . @ . @ @ . @ @ 
@ @ . . . . . . . . . . . . . . . . . . . @ . @ . . @ @ . . . @ . @ . @ . @ . @ . @ . . @ @ . @ . @ . @ . . . . @ @ . @ @ . . @ . @ . @ . . . @ . @ @ . @ @ . @ @ . @ . @ . . . . @ . . . . . . . @ @ @ 
@ @ . @ . @ . @ . @ . @ . @ . @ . @ . @ . @ . . . @ . . . @ . . . @ . @ @ . . @ @ . . @ . . . . @ . . . . @ @ @ . . @ @ . @ . @ . . . @ @ @ . @ . . . @ . @ . . . @ . @ . . @ . @ . @ . @ . @ . @ @ @ @ 
@ . @ . . @ . . @ . . @ . . @ . . @ . @ . @ @ @ . @ @ . @ . . @ @ . @ . . . @ . . . @ . . @ . @ . @ @ @ . @ . . . @ . . . . . . . @ . . @ . . @ . @ . . . . @ @ @ @ . @ @ . . @ . . . . @ @ . . . @ @ @ 
@ . . @ @ @ @ @ . @ . . @ . @ . @ . . @ @ . @ . @ . . . . @ . . . . . @ . @ . . @ . @ . @ . . . . . @ . . . . @ @ @ @ @ . @ . @ . @ . @ @ @ . . @ . . @ @ . @ . @ @ . . . . @ . @ @ . @ . @ @ . @ @ @ @ 
@ . @ . @ @ . . . . . @ @ @ @ @ @ @ @ . @ . . . . @ @ . @ @ . @ . @ . @ @ @ @ . . @ . . . @ @ . @ . . . @ . @ @ @ @ . . @ . . @ . . @ @ @ . @ . . @ . @ @ @ . . @ . @ @ @ . . . . @ . @ . . . . . @ @ @ 
@ . . . . . . @ @ @ . . @ @ @ @ @ . . . . @ . @ @ . . . @ . . . @ . . @ . . . . @ . @ . @ @ @ @ . . @ . @ @ . @ @ . . @ . @ . @ . @ . . . . @ @ @ . . @ @ @ @ . . . . . . . @ . @ . . . @ . @ . @ . @ @ 
@ . @ . @ . @ . . . . @ . @ . @ @ @ . @ . . . . . . @ . @ @ . @ @ @ . . @ @ . @ . . . . @ @ @ . @ . @ . @ @ . . @ @ . . . . @ @ @ . . @ . @ @ . . @ . @ @ @ . @ . @ . @ @ . . @ @ @ . @ . @ . @ . . . @ 
@ @ . . @ @ . . @ . @ @ . @ . @ @ . . . @ . @ . @ . @ @ . . . @ @ @ @ @ . . . . @ . @ . . @ . . . . . @ . . @ . @ . @ @ . @ . @ . . @ . . . @ @ . . @ . @ . . @ . @ . @ . . @ @ . @ @ @ . . . . . @ . @ 
@ . . @ . . . @ . . @ . . . . . . . @ . . @ @ @ . @ . . @ @ @ @ @ @ @ . . @ . @ . . @ . @ @ @ . @ . @ . @ . @ . . . @ . . . . . . @ . . @ @ . . @ . . . . @ . . @ . . @ @ . . . . . . @ . @ . @ . . @ @ 
@ . @ . . @ . @ @ . . @ . @ @ . @ . @ . @ @ @ @ . . . @ . @ . @ @ @ . @ . . @ . . @ . . @ . @ @ . . . . . . . . @ @ @ @ . @ . @ . @ @ . . . . @ . . @ @ . . . @ . @ @ . . . @ @ . @ @ . @ . @ @ . @ . @ 
@ . @ @ . @ @ . . . @ @ @ @ . @ . . @ . . @ @ @ @ @ . . . . . . . . . . . @ . @ . . @ . @ . @ @ @ . @ . @ @ @ . . . @ @ @ . @ . . . . @ . @ . @ . @ @ . @ . @ @ . . @ @ @ @ . . . . @ . . . @ . . . . @ 
@ . . @ @ . . . @ . . @ . . . @ @ . @ . @ @ @ @ . . . @ . @ . @ . @ . @ . . . . @ @ @ . . . . @ . . @ . . @ . . @ . . @ @ . @ . @ . @ @ @ . . . . . . . @ @ @ . @ . . @ @ . . @ . @ . . @ @ . @ . @ @ @ 
@ @ @ . . @ . @ . . @ @ @ @ . @ @ @ . . @ @ @ @ @ . @ . . . @ @ @ . . @ . @ . @ @ @ . @ . @ . @ @ @ . . @ . @ @ . . @ . . . . . @ @ . . . @ . @ . @ . @ @ @ . . . . @ @ @ @ . . @ . @ . @ @ . . . . . @ 
@ . . @ . . . @ @ . @ . . . . . @ @ @ . . @ @ @ @ @ . . @ . . @ . @ . . @ . @ @ @ . . @ . @ . . @ @ @ . . . . @ . @ @ @ @ . @ . . . . @ @ . . . @ @ @ @ @ . @ . @ @ . @ @ @ @ . . . . . . . . @ . @ . @ 
@ @ . . @ . @ . . . . . @ @ @ @ @ @ @ @ . @ @ @ @ @ @ . @ . @ . . . . @ . . @ @ . @ . @ . @ @ . . @ . @ @ . @ . @ . @ . @ @ . . @ . @ @ . @ @ . @ @ . . . . . . . . . . @ . . . @ . @ . @ . @ . . . @ @ 
@ . @ . . . @ . @ . @ . . . . @ @ @ . @ . @ @ @ @ @ . . . @ @ @ . @ . @ . @ @ @ . . . . . . . @ . . . @ @ . . . . . . . . @ . @ . @ . . . . . . . . . @ . @ . @ @ . @ . . @ @ . . @ @ . @ @ @ @ . @ . @ 
@ . . . @ . @ @ . . . @ . @ . . @ . . . @ . @ . @ . @ . @ @ @ @ @ . . @ . @ . . @ @ . @ . @ . @ @ . @ . . . @ . @ . @ . @ . @ @ . @ @ . @ . @ @ @ . @ @ @ . . @ @ . @ . @ . @ . @ . @ @ @ @ @ . @ @ . @ 
@ @ . @ @ @ . . . @ . . @ . . @ . @ . @ . . . . . . . . . @ @ @ @ @ . . . . @ . . . @ . . . @ . . . @ . @ . @ . . @ @ @ . . . . . . . . . @ @ @ . @ . . . @ . . . @ . . . . . . . . . . @ @ . . . . . @ 
@ @ @ @ @ @ @ . @ . @ . @ . @ . . . . . . @ . @ . @ . @ @ @ @ @ @ @ . @ @ @ . @ . @ . @ . @ . @ @ . @ @ @ . . @ . @ @ @ @ . @ @ @ . @ . @ . . . . . @ @ . . . @ . . @ . @ . @ @ . @ . @ @ . . @ . @ . @ 
@ @ @ @ @ @ . . @ . @ @ . . @ @ . @ . @ . @ @ . . . @ @ @ @ @ @ . . . @ . . . . . . . . . . . . @ @ . . . . @ @ . @ @ @ . . . . @ . @ . . @ . @ . @ . . . @ @ @ . @ . @ . . @ . . . @ @ . @ . @ @ @ . @ 
@ @ . @ @ @ @ . @ . . . @ . @ @ @ . . . @ . . . @ . . @ . . @ @ @ . @ . . @ . @ . @ . @ . @ @ . . @ . @ @ . . . @ @ @ . @ . @ . . @ . . @ @ @ . . . . @ . . @ . @ . . . . @ . . @ . . . . . . . . @ . @ 
@ . . . @ @ @ @ . @ . @ . @ . @ . @ . @ @ @ . @ . . @ @ . @ . . @ @ @ @ . . @ . @ . . . @ . . @ . . @ @ @ @ @ @ @ @ . . @ . . @ . . @ . @ @ . . @ @ . @ @ @ . . . . @ . @ . @ . @ . @ @ . @ @ . @ @ . @ 
@ @ . @ @ @ @ . . . . . . . . . . . . . @ @ @ . . @ . . . . . @ . @ @ @ @ . . . . @ . @ . @ . . . @ @ @ @ @ @ . . . @ . . . @ . . @ @ @ . . . @ . @ @ @ @ . @ . @ . @ @ @ . @ . . @ . . . . . @ . @ @ @ 
@ . . . @ @ @ @ . @ . @ . @ . @ @ @ . @ . @ @ . @ . @ @ . @ @ . . . @ @ . @ @ . @ @ . . . . @ @ . . @ @ @ @ . @ . @ . . @ . @ @ . @ @ @ @ . @ @ . @ . @ . . . . @ . @ . . . . . @ @ @ . @ . @ . . . . @ 
@ @ . @ . @ @ @ . . @ . . . @ . @ . . . . . . @ . . @ @ . @ . @ . @ . @ . @ . @ @ . @ . @ . . @ . @ @ @ @ @ . . . . . @ . . . . @ @ @ @ @ @ . . . . . . @ . @ . @ @ @ @ @ . @ . . @ . . @ . . . @ . @ @ 
@ . . . . . . . . @ . . @ @ @ . @ @ . @ . @ @ . @ . . . . . . . . . . . . . . . . . . . . @ @ . . . . @ . @ @ . @ . @ @ @ @ . @ . @ @ @ @ @ @ @ @ @ @ . . . . @ @ . @ @ . @ . . @ @ @ . @ . @ . @ . @ @ 
@ @ @ . @ . @ . @ . . @ @ . . . . @ @ @ @ . . . . . @ . @ . @ . @ . @ . @ . @ @ . @ . @ . . . @ . @ . . . @ @ @ . . @ @ . . @ . . @ @ @ @ @ @ . . . . . @ . @ . . . . . . . . @ @ . . @ . . . @ . @ . @ 
@ @ . @ . @ . . @ @ @ . . @ @ . @ @ @ . . @ . @ . @ . . . @ . . . @ . . . @ . . . @ . @ . @ . . @ . . @ @ . . . @ @ . . . @ . . @ . @ @ @ @ . @ @ . @ . @ . . @ @ @ . @ . @ . @ @ @ . . . @ . . . . . @ 
@ . . . . . . @ . . @ . @ . @ . . @ @ @ . . @ . . @ @ . @ . @ . @ @ @ . @ @ @ @ . . @ @ . . @ . . @ . @ . @ @ . . . . @ . . @ . . . . @ . . . @ @ @ . . @ . @ . . . @ . . @ . @ @ . @ @ . @ . @ @ . @ @ 
@ . @ . @ @ . . . @ . . . . . . @ . @ . @ . @ @ . . . @ . . . . . @ . . @ @ . . . @ . @ . @ . . @ . . . . . . @ @ . @ . . @ @ @ . @ . . @ . @ @ @ @ . @ . . . @ @ . @ . @ . . . . . @ @ . @ . @ . . . @ 
@ @ . . @ . . @ @ @ @ . @ . @ . . . . . . . . . . @ @ . @ . @ . @ @ @ . . . @ @ . . . @ . @ . @ @ @ . @ . @ . . @ . . @ . . @ . . @ @ @ . . . @ @ . @ . @ . @ . . . . . @ @ . @ @ . . @ . @ . @ @ . @ @ 
@ @ @ . . @ . @ . @ . @ . @ @ . @ . @ . @ . @ . @ @ . . . . . @ . @ . @ . @ . @ . @ . @ @ . . @ @ . . @ . @ . @ . . @ . . @ . @ . . . @ . @ @ . . . . . . . . @ . @ . @ . . . . . @ . @ . @ . . @ @ @ @ 
@ @ . . @ . @ . . . . . . . . . @ @ . . @ @ . @ . . . @ . @ . . . . . @ . @ . . @ . . . . @ . . . @ . . @ . . . @ @ . @ . . . @ . @ . . . . . . @ . @ @ @ . @ . . @ . . @ . @ . @ @ . . @ . . @ . @ . @ 
@ . . @ . . . . @ . @ @ . @ . @ @ . @ . . . . . @ . @ . . @ . @ . @ . @ @ @ . @ . @ . @ @ @ @ . @ . . @ . . @ . . . . . . @ . . @ @ @ . @ . @ . @ @ . . . . @ . @ @ @ @ . . @ . . @ . @ . @ . . . . . @ 
@ @ . @ . @ @ . . @ . @ . . @ @ . . . . @ . @ . @ . @ @ . @ . . @ @ @ . . . . . . . @ @ . @ @ @ @ @ . . @ @ . . @ . @ . @ . . @ . @ . . @ @ . . @ @ @ . @ . @ . @ @ @ . @ . @ . @ @ . . . @ . @ . @ . @ 
@ . @ @ @ . . . @ . . . . @ @ @ @ . @ . . @ . . . @ . . . @ . @ @ @ . . @ . @ . @ . @ . . . @ @ @ . . @ . @ @ . @ . . @ . @ @ . . . . @ . . . @ . @ . @ . . . @ . . . . . . @ @ . . . @ . . @ @ . @ . @ 
@ . @ @ @ @ @ . . @ . @ . . . @ @ @ . . @ . @ . @ @ @ @ @ . . . . . @ @ . . @ @ @ . @ @ . @ . @ . @ . . . . . @ . . @ @ . @ @ . @ . @ . . @ . . . . . . @ . @ . @ . @ . @ . @ @ @ @ . . @ . . @ . . @ @ 
@ . . . @ . @ . @ @ @ . . @ @ . @ . @ . . . . @ . @ @ @ . @ . @ . @ @ . . @ @ . . . . . . . . . . . . @ . @ @ . @ . . . . . . @ . . . @ . . @ . @ . @ . @ . @ . . . @ @ . . . . . @ . @ @ . @ @ @ @ @ @ 
@ @ @ . . . . . . @ . . @ . . . @ . . . @ @ . . . . @ . . . . . @ . . @ @ @ @ . @ . @ @ . @ . @ . @ . . @ @ . . . . @ @ . @ . @ @ . @ . . @ @ . . @ . @ . . @ . @ . . @ @ . @ @ . @ . . . @ @ @ @ . @ @ 
@ . . . @ . @ . @ @ @ . @ . @ . . . @ . . . @ . @ . @ @ . @ . @ . @ . @ . @ . @ . . @ . . . @ . @ @ @ . . @ @ @ . @ . . . @ @ . @ . . @ . @ @ @ . . . . @ . @ . @ @ @ . @ @ . . . . @ @ @ . @ @ . . @ @ 
@ @ @ . @ @ . . @ @ . @ . @ @ . @ . @ . @ . . @ . . @ . @ . . . . . . . . . . . @ @ @ @ @ . . . @ @ . @ . . . . @ . . @ . . @ . . . @ @ . @ @ . . @ . @ . . @ . . . . . . @ . @ @ . . @ @ . . . @ . . @ 
@ @ . @ . . . @ . . . . . . . . . @ @ @ . . @ . @ . @ . . @ . @ @ @ . @ . @ @ . @ @ @ . @ . @ @ . . . @ . @ . @ . . @ . . @ @ . @ @ . . . . @ @ . . @ @ @ . . @ . @ . @ . @ . . @ . @ @ @ . @ . @ . @ @ 
@ . . . . @ . . @ . @ @ . @ @ . @ @ @ @ @ . @ . . . . . @ @ . @ . . . @ . . . @ @ . . . . . . @ . @ . . . @ . . @ . . @ . . . @ . . . @ . @ . . . @ . . . @ . @ @ @ @ @ @ @ @ @ @ @ . . . . @ . @ . . @ 
@ @ . @ . @ . @ @ . . @ @ . . . . @ . . . . . @ . @ @ . @ . . . @ @ . . @ @ . @ . . @ . @ . @ @ @ @ @ . @ @ . @ . . @ @ @ . @ @ @ . @ @ . @ @ @ . @ @ . @ @ @ @ . @ . @ @ @ @ @ . @ @ . @ . @ . @ . @ @ 
@ . . . @ . . . @ @ @ . . @ . @ . @ . @ @ @ @ . @ @ @ . @ @ . @ . . . @ @ . @ @ @ . . @ . . . @ @ @ . @ . . . . @ . . @ @ . . @ . . . @ . . . @ . . . . . @ . . . . . @ . . @ . . . . @ . . . @ . . . @ 
@ . @ @ @ @ . @ . @ . @ . @ . @ . @ . @ . @ @ . @ @ @ @ @ . @ @ . @ . . @ . @ . . . @ @ @ . @ @ @ . . . . @ . @ . . @ . . . @ @ @ . @ . . @ . . @ @ @ @ @ @ . @ . @ . . . @ @ . @ . @ . . @ @ @ @ . @ @ 
@ . @ . @ . @ . . . . . . . . @ . @ . . . . @ . @ @ @ @ . . . . . @ . @ . . . . @ @ @ @ @ @ . . . . @ . @ . @ @ @ . . @ . @ . @ @ @ . @ . @ . @ @ @ @ @ . . . . @ @ . @ . @ . @ . . . @ . . . @ . . . @ 
@ @ . . . . . . @ . @ @ . @ . @ . . @ @ . @ . . . @ @ @ @ . @ . @ @ . . @ . @ @ @ . . @ @ . @ @ . @ . . . . . @ @ @ @ . . . . @ . . . . . . @ @ @ @ @ . @ . @ . @ . . . @ @ . . @ . @ @ @ . @ . . @ . @ 
@ @ . @ . @ . @ . . @ @ . @ @ . . @ . . @ . . @ @ . @ @ . . . @ . . . @ @ . . @ . @ . . . . . @ . @ @ . @ . @ @ @ @ . @ . @ @ . . @ @ @ . @ @ @ . @ . . . . . @ . @ . @ . . . @ . . . @ . . . . @ . . @ 
@ . . @ @ @ . . @ @ . . . . @ @ . @ . @ . @ . . . . . . @ . @ @ . @ . . . @ . . . . @ . @ @ . . @ . . . . @ @ @ . . . . @ . . @ . . . @ . . @ . . . @ . @ . @ . . . . . . @ . . . @ @ . @ . @ @ @ @ . @ 
@ . @ . . . . @ @ . @ . @ @ . . . . . . . . . @ @ @ @ @ @ @ @ @ @ . . @ @ . . @ . @ . . . @ @ . . . @ . @ @ @ . @ @ . @ . . @ @ . @ @ @ . @ . @ . @ . @ . @ . @ @ @ . @ @ @ @ @ . . @ . . . . @ . @ . @ 
@ @ . . @ @ @ . . . . . @ . . @ . @ . @ . @ . . . . . . @ . @ @ . @ . @ @ @ . @ @ . @ . @ @ . @ @ . . @ @ @ . . . . . . . @ . . . @ . @ . . . @ . @ . . . . . . . @ . @ . @ @ . . @ . . @ . @ . . . . @ 
@ @ @ @ @ @ @ @ @ . @ . @ . @ . . . @ @ @ @ . @ . @ . @ @ . . . . . . . @ . . . . . . @ . . . . @ . @ . @ . @ . @ . @ @ . . @ . @ . . . . @ @ . . . . @ @ . @ @ . . @ . . @ @ @ . . . @ . @ @ @ . @ . @ 
@ @ . . . . @ . . @ . . . @ . @ . @ . . @ @ . . @ @ @ @ @ @ . @ . @ . @ . @ . @ @ . @ @ @ @ . @ . . @ . . . . . @ . @ . @ . . . . @ . @ . . . @ . @ @ . . @ @ @ @ . . @ . @ . @ . @ @ . . . . @ @ . . @ 
@ @ @ . @ @ @ . @ . @ . @ @ . @ . . . @ . @ . @ @ @ @ @ @ . . . @ . . . . . @ @ @ @ @ @ @ @ . . . @ . . @ . @ @ @ @ . . . . @ @ . @ @ . . @ . . . . . @ . . . . . . @ . . . . . . . . . @ @ @ . . . @ @ 
@ . . . . . . . . . . . @ . . . . @ . . . . @ @ @ @ @ @ @ @ . @ . @ . @ . @ @ @ @ @ @ @ @ @ @ . @ @ @ @ . . @ @ @ @ @ . @ . . @ . . @ @ @ . . @ . @ . @ @ . @ . @ . . @ . @ . @ . @ . @ @ @ . @ . @ @ @ 
@ . @ . @ . @ . @ . @ . @ @ . @ . . @ . @ @ @ @ @ @ @ @ @ @ . . . @ . . @ @ @ @ @ @ @ @ @ @ @ @ @ @ @ @ @ . . @ @ @ @ @ . . @ . . @ @ @ @ @ . @ . . @ @ @ @ @ . . @ . . . . @ @ . . @ @ @ . . . . . . @ 
@ @ @ @ @ @ @ @ @ @ @ @ @ @ @ @ @ @ @ @ @ @ @ @ @ @ @ @ @ @ @ @ @ @ @ @ @ @ @ @ @ @ @ @ @ @ @ @ @ @ @ @ @ @ @ @ @ @ @ @ @ @ @ @ @ @ @ @ @ @ @ @ @ @ @ @ @ @ @ @ @ @ @ @ @ @ @ @ @ @ @ @ @ @ @ @ @ @ @ @ 
3
73 85 71 29
22 98 36 51
58 77 98 7
