100 100
@ @ @ @ @ @ @ @ @ @ @ @ @ @ @ @ @ @ @ @ @ @ @ @ @ @ @ @ @ @ @ @ @ @ @ @ @ @ @ @ @ @ @ @ @ @ @ @ @ @ @ @ @ @ @ @ @ @ @ @ @ @ @ @ @ @ @ @ @ @ @ @ @ @ @ @ @ @ @ @ @ @ @ @ @ @ @ @ @ @ @ @ @ @ @ @ @ @ @ @ 
@ . . . . . . @ . @ @ @ @ @ . @ @ . @ @ @ . @ . @ . . . . @ @ @ . . . . @ . . @ @ @ . . . . . . @ @ . . @ @ . @ @ @ @ @ @ @ @ @ @ @ @ @ @ @ @ @ @ @ @ @ @ . @ . @ @ @ . @ @ @ @ @ @ @ @ @ @ @ . @ . . @ 
@ @ . @ @ . @ . . . @ . @ . . . @ . . @ . . @ . . . @ @ @ . . . . @ @ @ . . @ . @ . @ @ . @ . @ . . @ . . . . @ @ @ @ @ @ @ @ @ @ @ @ @ @ @ @ @ @ @ @ @ . . . . . @ . . . @ @ @ @ @ @ @ @ @ . . . . @ @ 
@ . . @ . . . @ . @ . . @ @ . @ . . @ . @ . @ . @ . . . @ . @ @ . . @ @ . @ . . . . . . @ . . @ . @ . @ @ @ . . @ @ @ @ @ @ @ @ @ @ @ @ @ @ @ @ @ @ @ @ @ . @ . @ . @ . @ . . @ @ @ @ @ . @ @ @ @ . @ @ 
@ @ . . @ @ @ . . . @ . . . . . . @ . . @ . . . @ . @ @ @ @ . @ . @ . @ . @ . @ . @ . @ . @ . @ . @ . @ @ . . @ @ @ @ @ @ @ @ @ @ @ @ @ @ @ @ @ @ @ @ @ . . @ . . . @ . . @ . . @ @ @ @ . @ @ @ . . . @ 
@ . . @ @ . . @ @ . . . @ . @ @ @ @ @ . . @ . @ . @ . @ . . . . . . . . . . @ @ @ . . . . . . . . . . . @ @ . . @ @ @ @ @ @ @ @ @ @ @ . . . @ @ @ @ @ . . @ @ . @ @ . @ . . . @ . @ @ . . . @ . @ . @ @ 
@ @ . . . @ . @ . . @ . @ . . @ . @ . @ . @ . . . . . . @ . @ @ . @ . @ @ @ @ @ @ @ . @ @ . @ . @ . @ . . . . @ @ @ @ @ @ @ @ @ @ @ @ . @ @ . @ @ @ @ . @ @ @ @ @ @ . @ @ @ . . . @ . @ . @ . . @ . . @ 
@ . @ @ . . . @ . @ . . @ . @ . . . . . . @ . @ . @ . @ @ @ . . . . @ @ @ @ @ @ @ . . @ @ @ . . . @ @ . @ . @ . @ @ . @ . @ @ @ @ @ @ . @ . . . @ @ @ . . @ @ @ @ . . . @ . . @ . . . @ . . @ . . . @ @ 
@ . . . @ @ . . @ @ @ . @ @ . @ . @ . @ . @ . @ @ @ @ . . . . @ . @ . @ @ @ @ @ @ @ @ . @ @ @ . @ . . . @ @ @ . @ . . . . @ @ @ @ @ . . . @ . @ . @ . . @ . @ @ @ @ . @ . @ . . @ . @ . . @ . @ . @ . @ 
@ @ @ . @ . @ . . @ . . . @ . . . @ . . @ @ . . . @ @ @ . @ . . @ . . @ . . @ @ @ . . . . @ . . . @ @ @ . @ . . @ . @ @ . @ @ @ @ @ . @ . . . . . . @ . . . . @ @ . . . . . . @ . @ @ @ . @ . . . . . @ 
@ . . . . . . . @ @ @ . @ . @ @ . . @ @ @ . . @ @ . @ . @ . . @ . . @ . @ . . @ . @ @ . @ . @ . @ @ . . . . @ . . @ @ . . . @ @ @ @ @ . . @ . @ @ @ . . @ . @ @ . @ . @ . @ . . . . . . . . . @ . @ . @ 
@ @ . @ @ . @ . @ @ . . . . @ . . @ . @ @ @ . . @ . @ . . @ . . @ . @ . . @ . . . . . . . . . . . @ @ . @ . @ . @ . . @ . @ @ . @ @ . @ . @ @ @ . @ . @ . @ @ . . . @ @ @ . . @ . @ . @ . @ . @ . . @ @ 
@ . . . . @ @ . . . @ . @ @ . . @ . . . @ . . @ . . . @ . . . @ . . @ . @ @ @ . @ . @ . @ . @ . @ . . @ . . . . @ . @ . . . @ . @ . . . . . . . . . . . . . . @ . @ . @ . @ . @ . . @ @ @ . @ . @ . . @ 
@ @ . @ . . . @ @ . . . . . @ . . . @ @ . @ . . . @ @ @ @ @ . . . @ @ . @ @ @ @ @ @ @ . . @ . . @ . @ . @ @ @ . . . . . @ @ . . @ @ . @ . @ . @ . @ @ . @ @ @ . . . . . . . . . @ . . @ @ . . . . @ @ @ 
@ @ . @ . @ . @ . @ @ . @ . @ . @ @ . @ . @ . @ @ . @ . . @ . @ @ . @ . . @ . @ . . @ . @ @ @ . . . . . . . @ @ . @ . @ . @ . @ . @ @ . . . @ . . @ @ @ . . @ . @ . @ . @ . @ . @ . @ @ @ . @ . @ @ . @ 
@ . . . @ @ . . . . . @ . . @ . . @ . . . @ . . . . . . @ . . . @ . . . @ . . . . @ . @ . . @ . @ @ @ . @ @ @ @ . . @ @ . . . . . @ . @ . @ . @ @ . . @ . @ . . . @ . . @ . . @ . @ @ @ . @ . . @ . . @ 
@ @ @ . . . @ @ . @ . . @ . . . @ . . @ @ @ . @ @ @ . @ . @ . @ . . @ @ . @ . @ @ . . . . @ . . . . @ @ @ . @ . . @ . @ . @ . @ . . . . . . . @ @ @ . . . @ @ . @ . . @ @ . @ . . . . @ . . . @ . @ . @ 
@ @ @ @ @ . . @ . @ . @ . @ . @ . . @ @ . . . . @ @ @ . . @ . . . @ . . . . . . @ @ @ @ . . @ . @ @ . . . . . . @ @ . . . . @ . . @ . @ . @ . . . . . @ @ @ . . @ @ . . @ . . @ . @ . . @ . @ . . . . @ 
@ @ @ @ @ @ . @ @ @ @ . . @ . . . @ . . . @ . @ . @ . @ . . . @ @ @ @ . @ . @ . . . . @ @ . . . @ @ @ . @ . @ . @ . . @ . @ @ . @ @ @ @ @ . . @ @ . @ . . . @ . . @ . @ . . @ @ @ . . @ . . . @ . @ @ @ 
@ @ @ @ @ . @ . . @ . @ . @ . @ . @ @ . @ . . . . . . @ . @ . . . @ @ @ @ @ . @ @ @ . @ @ @ @ . . . @ . . @ . . . @ . @ . @ . . . . . @ @ @ . @ @ . . @ . @ . . @ . @ . . @ @ @ @ . @ . . @ . @ . . . @ 
@ @ @ @ . . @ . @ . . . . @ . . @ @ @ @ . @ . @ . @ @ @ @ . . @ @ . @ @ @ @ . @ . . . . @ @ . @ @ . @ @ @ . @ . @ . . . @ @ @ . @ @ @ . . @ @ . @ @ @ . . . @ . . . . @ @ . @ @ . . . @ . . @ . . @ . @ 
@ @ @ . @ . . . . @ . @ . @ . @ @ @ @ . . . . . @ @ . . @ @ . @ . . . @ . . . . . @ . @ @ . . . . . . . @ . @ . . . @ @ . @ @ @ @ @ @ @ . . . . . @ . . @ @ . . @ . @ . @ . @ . @ . @ @ . @ @ . @ . @ @ 
@ @ @ . . . @ @ @ . . @ . @ . @ . @ . @ . @ . @ . @ . @ @ . . . . @ . . @ @ . @ . @ . . @ @ . @ @ . @ . @ . . . @ @ @ . . @ @ . . @ . @ @ . @ . @ . @ . . . . @ . @ @ . . . . . . . . @ . . . . . . . @ 
@ . . . @ . . . . @ @ . . @ . @ . . . . . . @ . . . . @ . . @ . @ . . @ @ . . . @ @ . @ @ @ @ @ . . . @ . . @ @ . @ @ @ . . . . @ @ . @ . . @ . @ . . . @ . @ . . . @ . @ . @ . @ @ . @ @ . @ . @ @ . @ 
@ . @ . . @ . @ @ @ @ . @ . . @ . @ @ . @ . . . @ @ . @ @ . . @ . @ . . . @ . @ . . @ @ @ @ @ @ @ . @ . @ . @ . . . @ @ . @ . @ . . . . . @ . . . @ . @ @ . . . @ @ . . . @ @ @ @ . . @ . . @ @ . . . @ 
@ @ . . @ . @ @ @ @ . . . @ . @ . . @ . . @ . @ . . . . . @ @ . . . . @ . @ . @ . @ . @ @ @ @ @ . . @ . @ . . @ . @ . @ . @ @ . . @ . @ . . @ . @ @ @ . . . @ @ . @ . @ @ . . @ @ @ . . @ . . . @ @ . @ 
@ . @ . . . . @ . @ @ @ . @ . @ @ . . @ . . @ . . @ . @ . . @ . @ @ . . @ . . . . @ . . @ @ @ . . @ . . @ . @ . . . . . . . . @ . @ . @ . @ . . . @ . . @ @ . @ . . . . @ @ . . @ @ . @ @ . @ @ . @ . @ 
@ . . . @ . @ @ . . @ . . . . . @ . @ . . @ . @ @ . . . @ . . @ @ @ . @ . @ @ @ . . . @ . @ @ @ . . @ . . . . . @ . @ @ . @ @ . @ . @ . @ . @ . @ . . @ . @ . . . @ . @ @ . . @ . @ . . @ . . . . . @ @ 
@ . @ . . @ . . . @ . @ . @ . @ @ . @ @ . . . @ @ @ . @ @ @ @ @ . . . . . @ @ @ . @ . @ . . . . @ . . . @ . @ @ . @ . . @ @ . . . . . . . . . . @ @ . . . . . @ @ . . . @ . @ . . @ . @ . . @ @ @ @ . @ 
@ . @ . @ . @ . @ . . @ . @ @ @ . . . @ . @ @ @ @ @ @ @ @ @ @ . @ @ . @ @ . @ . . . @ . @ . @ @ . @ @ . . @ @ . . @ @ . @ @ . @ @ . @ @ . @ . @ . . . @ . @ @ . . @ . @ . . @ @ . @ @ @ @ . . @ . . . @ 
@ @ . . . . . . @ @ . . . . @ . @ . @ . . @ @ @ @ @ . @ @ @ . . @ . . . @ . @ . @ . . . . . . @ . @ . @ . @ . . @ . . . . . . . . @ @ @ @ . @ @ . @ . @ . . . @ . . @ . @ . . @ . . . @ . . @ . @ @ . @ 
@ . @ . @ . @ . @ . @ @ @ . @ . . . . @ . . . @ @ @ . . @ . @ . . @ @ . . . . @ . . @ . @ . @ . . . . . . . @ . . . @ . @ . @ . @ . @ @ . . . . @ @ . . @ . @ . . @ . . . . @ . @ . @ . @ . @ . . . . @ 
@ . . @ . . . @ . . . @ . . . @ . @ . @ . @ @ . @ . @ . @ . . @ . . . @ @ . @ @ . @ . @ . @ . . @ @ @ @ . @ . @ @ @ @ @ . . @ . . . . . . @ . @ @ @ @ . . @ . @ . . . @ @ @ . . . . . . . . . . @ @ @ @ 
@ . @ @ @ . @ . @ . @ . @ . @ . @ . . @ . @ . . @ . . . @ @ . . @ @ . @ . . . . . . . . . @ @ @ @ . . . . . . . . @ @ . @ . @ . @ @ . @ . @ @ @ @ @ . . @ . . . . @ . . . @ . @ @ . @ @ . @ . @ . @ @ @ 
@ . . @ . . . . @ . . . . . . . @ . @ . @ @ @ . @ @ @ . . . @ . @ @ . @ . @ . @ . @ . @ . . @ @ @ @ . @ @ . @ . @ . @ . . . @ . . . @ @ @ . @ . @ . @ . . . @ . @ . @ . @ . . . @ . . @ . . @ @ . @ @ @ 
@ . @ . @ . @ . @ . @ . @ . @ . . . . . . @ . . @ . . @ . @ . . . . . @ @ @ @ @ @ @ @ . @ . . @ @ @ . . . @ . . . . . . @ @ @ . @ @ @ @ . . . . . . . . @ @ . @ . . @ @ . @ . @ @ @ @ @ @ @ . . . . @ @ 
@ . . . . . . @ @ @ @ @ @ @ . . @ @ @ . @ . @ . . . @ . . . @ @ . @ . . . . . @ @ @ . . . . @ . @ @ @ . @ @ @ . @ . @ . . . . @ . @ @ @ . @ . @ . @ @ . . @ . . @ . . @ . . . . @ . . @ . @ @ @ . @ . @ 
@ . @ . @ . @ @ @ . @ . @ . @ . . @ . @ . . @ . @ @ . . @ @ @ @ @ @ @ . @ @ @ @ @ @ @ . @ . . . . @ . . . . @ . . @ . . @ . @ . . . @ @ @ . @ @ @ . . . @ . . @ . . @ . @ @ . @ . @ . . . . . . . . . @ 
@ . . @ @ . . @ . . . . . . . . @ . . @ @ . . . . . @ . @ . . @ . @ @ . @ . @ . @ . @ @ . @ . @ @ . . @ @ @ @ . @ . . @ @ . . . @ . @ . . . . @ . @ @ . . . @ . @ . . . . . . . . . . @ . @ . @ . @ . @ 
@ . @ @ . . @ @ @ . @ . @ . @ . . @ . . @ . @ . @ . . . . . @ @ . . . . . . . . . . . . . . . . . . @ . . . . @ @ . @ . . @ . @ . @ . . @ @ . @ . . @ . @ @ @ . . . @ . @ . @ . @ . @ @ @ . @ @ . . @ @ 
@ @ @ . @ . . @ @ . . @ . . @ . @ . . @ . @ @ @ . @ @ . @ . . . @ . @ . @ @ . @ . @ . @ . @ . @ . @ . @ . @ @ @ @ @ @ @ . . @ . . @ @ . . . @ @ @ . @ . @ . . . @ . . @ @ @ . . @ . . . . . . @ . @ @ @ 
@ . . . . . @ @ @ . @ @ @ @ @ . . @ . . . @ @ . . . @ . @ . @ . . @ . . @ . @ @ @ . . . @ . . . @ . . @ . . @ @ @ @ @ . . @ . @ . . . @ @ . . @ @ . . . @ . @ . @ @ . . @ . . @ @ @ @ @ . @ @ . . @ @ @ 
@ . @ . @ . . @ @ @ @ @ @ @ . @ . . @ @ . @ . . @ . . @ . . . @ @ @ @ @ . . . . @ @ . @ . @ . @ . @ . . @ . . @ @ @ @ @ . . . . . @ @ . . . @ . . . @ @ . . . @ @ @ . @ . @ . . @ . . . . . @ @ . @ . @ 
@ . @ @ . . @ . @ @ @ . . . . . @ . . . . . @ . @ . @ . @ . @ . . @ @ . @ @ . @ . @ @ . . . . . . . . @ @ . @ . . . . . @ @ . @ . . @ @ @ . . @ . @ . @ . @ @ . @ . . @ . . . @ @ @ . @ . @ . @ @ @ . @ 
@ . . . @ . . . . @ . @ @ . @ @ . @ . @ . @ @ @ . . . . . . . . @ . . . . @ . . . @ @ @ . @ . @ . @ @ . . . . . @ @ @ . . @ @ . . @ . @ . . @ . . . . . . . @ . @ @ . . @ @ . . . @ @ . . . . . . . . @ 
@ . @ @ . . @ . @ . . . . . . . . . @ . . . @ . . @ . @ . @ @ . . @ @ . @ @ . @ . . @ . . . @ . @ @ @ . @ . @ . . . . @ . . . @ . . . . @ . . @ . @ @ . @ @ . . . @ . @ @ @ @ . @ @ @ @ . @ . @ . @ . @ 
@ . . @ @ . . @ . @ . @ . @ . @ . @ . @ . @ . @ . . @ @ @ . . @ . @ . . @ . . @ . @ @ @ . @ @ . . @ . . @ @ . @ . @ @ @ . @ . . . @ . @ . @ . . . . @ @ @ . . @ . . @ @ @ @ . @ . . . @ . @ . @ . . @ @ 
@ . @ . . . @ . . . @ . . . @ . . . . . . . . . @ @ @ @ . @ . . . . @ . @ . @ . @ @ . . . . @ . @ . . @ . . . . . @ . @ . . @ . @ @ @ . . . . @ @ @ @ . . . @ . @ @ @ @ @ @ . @ @ . @ . . . @ @ . @ . @ 
@ @ . @ . @ @ . @ @ @ @ @ @ . @ . @ @ . @ @ @ . . @ @ @ . . @ @ . @ @ . . . . . @ . @ . @ . @ . @ . @ . . @ . @ . @ . . @ . @ @ . @ . @ . @ . @ @ @ @ @ @ . . . . . @ @ @ . . . . . . @ . @ @ . . . . @ 
@ . . @ . . . . . @ @ @ @ . . . . . @ @ . . . . @ @ @ @ @ . @ . . . . @ . @ . @ @ . @ . . @ @ . @ . @ . @ . . @ . . . @ . @ . . . . . . . . @ @ @ . @ . @ . @ @ @ @ . . @ . @ . @ @ . @ @ @ . @ . @ . @ 
@ @ . @ . @ @ @ . @ @ @ @ @ . @ . @ . @ @ @ . @ @ @ @ @ @ . . @ . @ . . . @ . . @ . . . @ . . . @ . . @ @ @ @ . . @ . . . . @ . @ . @ . @ @ . @ . . . . . . . @ . @ . @ . @ @ @ . @ . . . . . . . . @ @ 
@ @ . . . @ . @ . @ @ @ @ . @ . . @ . . @ @ @ @ @ @ @ . . @ . . @ . . @ . @ . @ @ @ @ . @ @ @ . @ . @ . @ @ @ @ . . @ @ . @ @ @ @ @ . . . . . . @ . @ @ @ @ @ . . . . . . . @ . . . . @ @ @ . @ . @ @ @ 
@ . @ . @ . . @ . @ @ @ . . @ @ . @ . @ . @ @ @ @ @ . @ . @ . @ . @ . . @ . . . @ @ . . . @ . . . . . . . @ @ @ @ . @ @ @ @ @ @ @ @ @ . @ . @ @ . . . . . . . @ @ . @ . @ @ . @ @ . @ . @ . . . @ @ @ @ 
@ . @ . @ @ . . @ . . . @ . . @ . . . . . @ @ @ @ . . . . . . . . . . @ . @ @ . @ . @ . @ . @ @ . @ . @ @ . @ @ . @ . @ @ @ @ @ @ @ @ . @ . . @ . @ . @ . @ @ . @ . @ . . . . . @ . @ . . @ @ . . . . @ 
@ . . . . . . @ . @ . @ . . @ . . @ @ @ @ @ @ . . . @ . @ . @ . @ @ . . . . @ @ @ . . . . . . . . . @ @ @ . @ . . . . . . @ @ @ @ @ . . @ @ @ . . @ @ . @ @ @ . . . . @ @ . @ . . @ @ . @ . . @ . @ @ @ 
@ . @ . @ @ . . . . . . @ . . @ . . . @ @ @ . . @ . @ . . @ @ @ @ . . @ @ . . @ . @ @ . @ . @ @ @ . . . @ . @ @ . @ . @ @ . @ . @ @ @ . . . @ @ . . @ . . @ . . @ . @ . . @ @ . @ . . . . @ . . @ @ . @ 
@ . @ @ @ @ @ @ @ . @ . @ . @ . . @ . @ . @ . @ . . @ . @ @ @ @ . . @ @ @ . @ . . @ . . . @ . . . . @ @ @ . . @ @ @ . @ . . . . . @ . . @ @ . @ . @ @ @ . @ . @ @ @ @ . @ @ @ @ . @ . @ . . . @ . @ . @ 
@ @ . . @ @ @ . . @ . . . . . @ . . @ . . . @ @ @ @ . . @ @ @ . . @ . @ . @ @ @ . . @ . @ @ @ @ @ . @ . @ . @ . @ . . . . @ @ @ . . . @ . @ . . . . @ . . . . . @ . . . . @ @ @ . . @ . . @ . . . . . @ 
@ . . @ . @ . . @ . @ @ @ . @ . . @ . . @ . . @ @ @ @ . . @ . @ . @ . . . . . . @ . . . . @ @ @ @ @ . . . . . . . @ . @ . . . @ . @ @ . . @ . @ @ . @ . @ @ . @ . @ @ . @ . @ . @ . . . @ @ . @ @ . @ @ 
@ @ . @ . @ . @ . . . . . . . . @ @ @ @ . . @ . @ @ . @ @ @ . . . @ @ @ . @ . @ . @ @ . @ . @ @ @ @ @ . @ . @ @ @ . @ . . @ @ . . . @ . @ @ . . . @ @ . . @ . . . . @ . . . . . . @ . @ . . @ @ @ . @ @ 
@ . . . . . . . . @ . @ . @ @ . . @ . @ @ . . . . . . . . @ @ @ . . @ @ . @ . @ . @ . . . . . . @ @ . @ . . . . . . . @ @ @ @ @ . @ . . @ . . @ @ . @ . @ @ . @ . @ . @ @ @ @ @ . . . . @ . . @ . . . @ 
@ . @ . @ . @ @ . . @ . . . @ . @ . . . @ . @ . @ . @ @ @ . . @ . @ . . . . @ . . . @ . @ . @ . @ . . . @ . @ @ . @ @ . . @ @ @ . @ . @ . @ . . . . . . . . @ . @ . . . . . . @ @ @ @ . . . @ . @ . @ @ 
@ @ . . @ @ . . . @ @ @ . @ . . . @ . @ . . . @ @ . @ . @ @ . . . . @ @ . @ . @ @ . . . . @ . @ . . @ @ . . @ . @ @ @ . @ . @ . . . . . . . . @ @ @ . @ . @ @ . . . @ . @ . @ . . . . . @ . . . . @ @ @ 
@ . . @ @ @ @ @ . . @ . @ . @ . @ . . @ @ . @ . . @ @ . . . . @ @ @ @ . . @ . @ . @ @ . @ . . @ @ . . . . @ . . . . . . . . . . @ @ @ @ @ @ . . . @ @ . @ @ . . @ @ . @ . @ . @ . @ . @ . . @ . @ @ @ @ 
@ . @ @ @ @ @ @ @ . @ . @ . . . . @ . @ . . @ . @ . . @ . @ . . @ @ . @ . . . @ . . . . . @ . . . . @ . @ . @ . @ . @ . @ . @ @ . . . . . . @ . @ @ . . . . . @ . @ . @ . . . . @ . . . @ . @ @ @ @ @ @ 
@ . @ . @ @ . . . . . . @ . @ @ . . . . @ . . . . . @ . . . @ @ . . . . @ @ . . @ . @ . @ . @ @ @ . . @ . . . . @ . . @ @ . @ . . @ . @ . @ . . . . @ @ . @ @ . . . . . @ . @ @ . @ @ . @ . . @ @ @ @ @ 
@ @ . . . . @ @ . @ @ . . @ . @ . @ . @ . . @ @ . @ @ . @ @ @ @ @ @ @ . @ . @ . @ @ . . @ . @ . @ . @ . @ . @ @ @ @ @ @ . @ . . @ . @ . @ @ @ . @ . . . . . . . @ . @ . . . . . . . @ @ . . @ . @ @ @ @ 
@ @ @ . @ . . @ @ . @ . @ . . . . . @ . . @ . @ . @ @ . . . @ @ @ . @ . @ . . . @ . @ . . . . . . . . . . . . . @ @ . . . . @ . . . . . . @ @ . . @ . @ @ . @ @ @ . . @ @ . @ @ @ . @ @ @ . . . . @ @ @ 
@ @ @ . . @ . . . . . @ . @ . @ . @ . @ . . . @ @ . . . @ @ . @ . . . . . @ @ . @ . @ . @ . @ . @ . @ . @ . @ . . @ @ @ . @ . . @ . @ . @ . . . @ . . . . @ @ @ @ . @ . . . . @ . @ @ @ . . @ . @ @ @ @ 
@ . . @ @ . @ @ @ . @ @ . . . . @ . . . . @ @ . @ . @ . @ @ . . @ @ . @ . . . . . . . . . @ . . @ . @ . @ @ . @ @ . @ @ . . . @ . @ . @ @ . @ . @ @ . @ @ . . @ @ @ . @ @ . @ . . @ @ @ . @ . @ @ @ @ @ 
@ @ . @ . . . . . . . @ . @ @ . . @ . @ . . @ . @ . . @ . . . @ @ . @ . . @ . @ . @ @ . @ . @ . @ . @ @ . . . . @ . @ . . @ . . . . . . @ @ . . . . @ . @ . @ . . . . . . @ @ . @ . . . . . . . @ @ @ @ 
@ . . . @ . @ @ . @ . . . @ . @ @ . . . @ . @ . @ . @ . @ . @ . @ . . @ @ . . . @ . . . @ . @ @ @ @ . . . @ @ @ . . . @ . . @ . @ . @ . @ @ @ . @ . . . . . . . @ @ . @ . @ @ . . @ . @ . @ . @ @ @ @ @ 
@ @ @ . @ @ . @ . . @ @ . . . . @ @ . @ . @ . . . . . . . . . . . . @ @ @ @ . @ . @ @ . @ . . @ @ @ @ @ . . @ @ . @ @ . . @ . . . @ @ @ @ @ @ . @ . @ . @ . @ . @ . . . @ @ . . @ . . . @ . . . @ @ @ @ 
@ . . . . @ . @ . @ . @ . @ . @ . @ . . . . . @ . @ . @ . @ . @ @ @ @ @ @ @ . @ . @ . . . . @ . @ . @ . . @ . @ . . . . @ . @ . @ @ @ @ @ . @ . . @ @ . . @ . @ . @ . @ @ @ . @ . @ . @ . @ . @ @ @ @ @ 
@ @ . @ . @ . @ . @ . . @ . . . . . . @ . @ . . @ . . . @ @ @ . . @ @ @ . . @ . . . @ . @ @ . . . . . @ . . . . . @ @ . . . . @ @ @ @ @ . . . . @ . . . @ @ . . . @ @ @ @ @ . . . . @ . . @ . @ @ @ @ @ 
@ . . . @ . . . @ . . @ . @ . @ . @ @ @ @ @ @ @ . . @ @ @ @ . . @ . @ . @ . @ . @ . @ . . @ @ . @ @ . . . @ . @ @ . . @ @ . @ @ @ @ @ @ @ @ . @ @ . @ . . . @ @ . . . . . . . @ . @ . @ . @ . . . @ . @ 
@ @ . @ . @ . @ . @ . . . . . . @ @ @ @ @ @ @ @ @ . . . @ . . @ . . . . . . . @ . . . . @ @ @ @ @ . @ @ . . @ @ @ @ . . . @ @ @ @ @ @ @ @ @ . @ . @ @ . @ . . @ . @ . @ . @ @ . . . . . . . . @ . . . @ 
@ . . . . . . . . . . @ @ . @ . . @ @ @ @ @ @ @ @ @ . @ . @ . . . @ . @ . @ . . @ @ @ . . @ @ . . . . . . @ . @ @ @ . @ @ . @ @ @ @ @ @ @ . . . . . @ . . @ @ @ . . @ . @ @ . @ . @ . @ . @ . @ . @ . @ 
@ @ . @ . @ . @ . @ . @ . @ . . @ . @ @ @ @ @ @ @ @ @ . . @ @ . @ . @ . @ . . @ @ . . . @ . @ . @ . @ @ . @ . . @ . . . . . . @ @ @ @ @ @ @ . @ @ @ . . @ . @ @ . @ @ . . . . . @ @ @ . . . @ . @ @ . @ 
@ @ @ . . . @ @ @ . @ . . @ @ . . . . @ @ @ @ . @ @ @ . @ . @ . . . . . . @ . . . @ @ . . . . @ @ @ @ . . @ . @ . @ . @ . @ . . @ @ @ @ @ @ @ . . . . @ . . @ . . . @ . @ @ . @ . @ . @ . @ . . . @ . @ 
@ @ @ @ . @ @ @ . . . @ . . . . @ . @ . @ @ . . @ @ @ . . . . . @ . @ . @ . @ . @ @ . . @ @ . @ @ . . . @ @ . . . . . . @ @ . @ @ . @ @ @ @ @ @ . @ . . . @ . . @ . . . . @ @ @ . . . . @ . @ . @ . @ @ 
@ @ @ @ @ @ @ @ . @ @ . . @ . @ . . . . @ @ . @ @ @ @ @ @ . @ . . @ @ . . . @ . . . @ . . . @ @ . @ . @ @ . . @ . @ . @ . @ @ @ @ . . @ @ @ @ @ @ . . @ @ . @ . . @ @ . @ @ @ . . @ @ . @ . @ . . . . @ 
@ @ @ . . @ @ @ . . . . @ . @ . @ . @ . . . . @ @ @ @ . . . @ @ . @ . . @ . @ @ . @ . . @ . . . . . . . . @ . . @ @ @ . . . . @ . . @ . @ @ @ @ @ @ @ @ . . . . @ . @ . . @ @ . @ . @ @ . . . . @ @ @ @ 
@ . . @ . @ @ @ @ @ @ . @ . . . @ @ . . @ @ @ @ @ @ @ @ . @ . @ . @ @ . @ @ . . . . . @ . @ @ . @ @ @ . @ . . @ . . . . @ . @ . @ . . . . @ . @ . @ @ @ @ . @ . @ . . @ . . . . . . . @ . @ @ @ @ @ @ @ 
@ @ . . . . . @ . . . @ . . @ . @ . @ . . @ . @ @ @ @ . . . . @ . . @ . . . @ . @ @ . . . . @ @ @ . . @ . . @ . . @ . @ . @ @ . @ . @ @ . . . @ . @ . @ . @ . . . . @ . . @ . @ . @ . . . . . @ @ @ @ @ 
@ @ @ . @ @ . . . @ . @ . @ . . . . . @ . @ . @ @ @ @ @ . @ @ . . @ @ . @ @ @ @ . @ . @ @ @ . @ @ @ . . @ . . . @ . @ @ . . . . . . . @ @ @ . . . @ . . . . @ . @ . . @ . @ . . @ @ . @ . @ @ . @ @ @ @ 
@ @ . @ . . @ . @ . . . @ . . @ . @ . . . @ . @ . @ @ @ @ @ . @ . . . @ . @ . . . . . . . @ . . @ @ @ . . . @ @ . . @ @ . @ . @ . @ . . . @ . @ @ . . @ @ . . @ . . @ . . . @ . . . @ @ . . . . . @ @ @ 
@ . . . @ . . . . @ . @ . @ . . @ . . @ . @ . . . . . @ . . . . . @ . @ . . . @ @ @ @ . @ @ . @ . @ . . @ @ . @ . @ . @ . @ @ @ . . @ . @ . @ @ @ @ . . . @ . @ @ . @ @ . @ . . @ . . . @ . @ . @ . @ @ 
@ @ @ . . . @ . @ . . . . . @ @ @ @ . @ . . . @ @ . @ @ @ . @ . @ @ @ . . @ . @ . @ . @ . @ . @ . @ . @ . . . . . . . . . . . . @ @ @ . . . . @ . . @ . @ . @ . . . . @ @ @ . @ @ . @ . . @ . . . . . @ 
@ . . @ @ . @ . . @ @ @ @ . . . @ @ . . @ . @ . @ . . @ . . @ . @ @ . @ . . @ . . . . . . . . . . . . . . @ @ . @ . @ @ . @ . @ . . @ . @ . @ . @ . . . . . . @ @ . @ . . . @ @ @ . . @ . . @ . @ . @ @ 
@ . @ . @ @ . @ @ @ . . . . @ . . . . @ . . @ . . @ @ @ @ @ . @ . . . @ . @ . @ . @ . @ @ . @ @ . @ . @ . . . @ @ @ @ @ . @ . . @ . . @ . @ @ . . . @ . @ @ . @ . . @ . @ @ @ . . . @ @ . @ @ @ . . . @ 
@ . . . . . . @ . @ @ . @ . @ @ . @ . . @ . . . @ . . @ @ . . . @ . @ . . . . . . . @ @ . @ . @ . . @ @ . @ . . @ . @ . . . @ . . . @ . . @ . . @ . . @ . @ . @ @ . . . . . . @ @ @ . . . @ @ @ @ . @ @ 
@ . @ @ . @ . . . . . @ . . . @ @ @ @ @ . @ . @ . . @ @ @ . @ . . . . . @ . @ . @ . . . . @ . . @ @ @ @ @ . . @ @ . . @ . @ . @ @ . @ . @ . @ . . @ . @ . @ @ . @ . @ . @ . @ @ @ . . @ . @ @ @ . . . @ 
@ . . @ @ . . @ @ @ @ . @ . @ . . @ @ . . . . . . @ . @ . @ . @ @ . @ @ . @ . . @ @ @ . @ @ @ . @ @ @ @ @ @ @ . @ . @ @ @ . . . . . . . . . . . @ @ @ . . . . . . . . @ @ . @ @ @ . @ . . . . @ @ @ . @ 
@ . @ . . @ . . . . . . . . @ . @ . @ @ @ . @ @ . . . . . . . . . . . . . @ @ . . @ . . . . . . . . @ . . . . . . . . @ . @ @ . @ . @ @ . @ @ . @ @ . . @ . @ . @ . @ . . . @ @ . @ . @ . @ . . . . @ @ 
@ . @ . @ . @ . @ . @ . @ . . . . . . @ @ @ . @ . @ . @ @ @ . @ @ . @ . @ @ . . @ . @ . @ . @ . @ . . . @ @ @ @ . @ . . . . @ @ . @ . . . . . @ . @ . @ . . . @ @ @ @ @ @ . @ . . . . . . @ . @ . @ . @ 
@ . . . . . @ @ @ @ @ . @ . @ . @ . @ @ @ . . . . . @ @ @ @ . . @ . @ . . . @ . @ . @ . . @ . . . @ @ . . @ . . . @ . @ . @ . @ . . @ @ . @ . . . . . . @ . @ @ @ @ @ . . @ . . @ @ . @ . . @ . . . . @ 
@ . @ @ @ @ @ @ @ @ @ @ . . . @ @ @ @ @ @ @ . @ . @ . @ @ @ @ @ . . @ @ . @ . . . . . @ @ @ @ . @ @ . @ @ . . @ . . @ @ . . . . . @ @ @ @ . . @ . @ @ @ . . . @ . @ @ . @ . @ . . @ @ . . @ . @ @ . @ @ 
@ . . . @ @ @ @ @ @ @ @ @ . @ @ @ @ @ @ @ @ @ @ . . . . . @ @ @ @ . . . @ . . @ . @ . . . @ @ @ . . . . . . @ . . @ @ . . @ @ . @ @ @ @ @ @ . . @ . . . . @ . . . . . . . . . @ . . . @ . . . . . @ @ @ 
@ @ @ @ @ @ @ @ @ @ @ @ @ @ @ @ @ @ @ @ @ @ @ @ @ @ @ @ @ @ @ @ @ @ @ @ @ @ @ @ @ @ @ @ @ @ @ @ @ @ @ @ @ @ @ @ @ @ @ @ @ @ @ @ @ @ @ @ @ @ @ @ @ @ @ @ @ @ @ @ @ @ @ @ @ @ @ @ @ @ @ @ @ @ @ @ @ @ @ @ 
3
38 46 77 81
33 61 13 5
47 12 16 64
