12 12
@ @ @ @ @ @ @ @ @ @ @ @ 
@ @ @ @ @ . . . . . . @ 
@ @ @ @ . @ @ . @ . @ @ 
@ @ @ @ . . . . @ . . @ 
@ @ @ . @ @ @ . @ . @ @ 
@ @ @ . . . . . . @ @ @ 
@ @ @ @ . @ @ . @ . @ @ 
@ @ @ @ @ @ @ . . . . @ 
@ @ @ @ @ @ @ @ @ . @ @ 
@ @ @ @ @ @ @ @ @ . . @ 
@ @ @ @ @ @ @ @ . . @ @ 
@ @ @ @ @ @ @ @ @ @ @ @ 
3
5 3 7 10
3 9 3 5
4 7 1 5
