12 12
@ @ @ @ @ @ @ @ @ @ @ @ 
@ @ @ . @ @ @ @ @ @ @ @ 
@ @ . . . @ @ @ @ @ @ @ 
@ . @ . @ . @ @ . . @ @ 
@ . . . . . . . @ . . @ 
@ . @ @ @ @ . @ @ . @ @ 
@ . @ @ @ @ @ @ . . . @ 
@ . @ @ @ . @ . @ . @ @ 
@ . @ @ . . . . @ . . @ 
@ . @ . @ @ . @ @ @ . @ 
@ . . . . . . . . . . @ 
@ @ @ @ @ @ @ @ @ @ @ @ 
3
8 6 2 2
8 5 6 10
9 6 3 3
