50 50
@ @ @ @ @ @ @ @ @ @ @ @ @ @ @ @ @ @ @ @ @ @ @ @ @ @ @ @ @ @ @ @ @ @ @ @ @ @ @ @ @ @ @ @ @ @ @ @ @ @ 
@ @ @ @ @ @ @ @ . . @ @ . @ @ . @ @ . . . @ @ @ . . @ @ . @ @ . . . @ @ @ @ . @ . @ . @ @ @ @ @ @ @ 
@ @ @ @ @ . @ . @ . . @ . . . . . . @ @ . . @ . @ . @ . . . @ @ . @ . @ @ . . . . . . @ @ @ @ @ @ @ 
@ @ . @ . . . . . . @ . @ . @ . @ @ . @ . @ . . . . . @ . @ . . . . . . @ . @ @ @ . @ @ @ @ @ @ @ @ 
@ . . . @ @ . @ @ . . . @ @ . . . @ . . . . . @ . @ . . . . . @ @ . @ . . . . @ . @ . @ @ @ @ @ @ @ 
@ . @ . @ . . @ . . @ @ . @ @ . @ . . @ . @ @ . . . @ . @ @ . . . @ . . @ @ . . . . . @ @ . @ @ . @ 
@ @ . . . @ @ . @ . . @ . . @ . . @ . . @ . . . @ . . @ @ . . @ @ @ @ . . . @ . @ . @ @ . . . . . @ 
@ . @ . @ . . . . . @ . . @ . @ . . . @ . @ @ @ . . @ . @ @ . . . @ @ @ . @ @ . @ . @ . @ . @ . @ @ 
@ . @ . . @ @ . @ . . . @ . . @ . @ . . . . @ @ @ . . . @ . . @ . @ @ @ . . . @ @ . . . . . . @ . @ 
@ . . @ . . . @ . . @ @ @ @ . . @ . . @ . @ @ @ @ @ @ @ @ @ @ . @ @ @ @ @ @ . . . @ @ . @ @ . . . @ 
@ @ . @ . @ @ . @ . . @ . @ . @ . @ . . @ @ @ @ @ . . . @ . . . . @ . @ @ . @ . @ . @ . @ @ @ @ @ @ 
@ . . . . . . . . . @ . . @ . . . . . @ . @ @ @ . @ . @ . @ . @ . . . . . . . @ . . . . . @ @ @ @ @ 
@ . @ . @ @ @ . @ . . . @ . @ @ @ @ . . . . @ . . @ . . . . . . @ @ @ . @ . @ . @ @ @ . @ . @ . @ @ 
@ . . @ . @ . . @ . @ . . . . @ . . . @ . @ . @ . . . @ @ . @ . @ . @ . @ @ . . @ @ . @ . . . . . @ 
@ @ @ . . . @ @ . @ @ . @ . @ . @ @ . . @ . . . @ @ . @ @ @ @ . . . . @ . @ . @ . @ . . @ . @ . @ @ 
@ . . . @ . . . . . . . . @ . . . . . @ @ @ . @ . @ . . @ . . . @ @ @ . . . . . . . @ . @ . . @ @ @ 
@ @ @ @ @ . @ . @ . @ . @ @ @ . @ @ . . @ . . . . @ . @ . @ @ . @ @ @ . @ . @ . @ . @ . . . @ . @ @ 
@ . . . . @ . . @ @ @ @ . @ . . @ . . @ . @ . @ . @ . . . . @ @ . @ . . . @ . @ @ . @ . @ . . . . @ 
@ @ . @ . . @ . . . @ . . . @ . . @ . . . . . . @ . @ @ @ . . . . . @ . @ . . . @ . . @ . . @ @ @ @ 
@ @ @ . @ . . . @ . @ . @ . @ . @ . . @ . @ @ . . . . @ . . @ . @ . . . . . @ @ . . @ . @ . @ . @ @ 
@ . . . . . @ . @ . . . . @ . @ @ . @ . @ . . . @ . @ . @ . @ @ @ . @ . @ @ @ @ @ . . . . . . . . @ 
@ . @ . @ . . @ @ @ . @ . . . . . . . . . @ . @ . . . . . . @ . @ @ . @ @ @ @ @ . @ . @ @ . @ . @ @ 
@ @ . . . @ @ . . @ . . @ . @ @ . @ . @ @ . @ @ @ . @ . @ . . . . . . . . @ @ . . . . . . @ . . . @ 
@ . . @ . . . @ . . . @ . . . . @ . . . . . . . @ . . @ . . @ @ @ . @ . @ . . @ @ @ . @ @ . @ . @ @ 
@ @ . @ . @ . @ @ . @ @ @ . @ . . @ . @ . @ . @ . . @ @ @ . @ . @ . @ @ @ . @ @ @ . @ . . . . . . @ 
@ @ @ . . . @ @ @ . . . @ . . @ . . @ . . . @ @ @ @ . . . . . . . @ @ @ @ . @ @ @ . @ . @ . @ . @ @ 
@ @ @ @ . @ @ @ @ @ @ @ @ . @ . . @ . @ . @ @ @ @ @ @ . @ . @ . @ . . @ . . . . @ . . @ @ . @ @ @ @ 
@ @ @ @ . . @ @ @ @ @ @ . @ . . @ @ . . @ @ @ @ @ @ @ @ . . . @ . . @ . @ . @ . @ . @ . . @ @ . @ @ 
@ @ @ @ . @ . @ @ @ @ @ . . . @ @ @ . @ @ @ @ @ . @ @ . @ . @ @ . @ . . . . . @ . . . @ . . . . . @ 
@ @ @ . . @ . . . . @ . . @ . . @ @ . . @ @ @ . . . . . . . . . . . . @ @ @ @ @ @ . @ . @ @ . @ . @ 
@ . . @ . . . @ . @ . @ . @ . @ . @ . @ . @ @ @ . @ . @ . @ @ . @ @ . . . . . @ . . . . . @ . @ . @ 
@ . @ . @ . @ . @ . . @ . @ . . . . . . . . @ . . . @ . . . @ . . . @ @ . @ . . . @ @ . @ . @ . . @ 
@ . . . . . . . . @ . @ @ . . @ @ . @ . @ . . @ . @ @ . @ . @ . @ @ @ @ . . @ . @ . . . . . . . @ @ 
@ @ . @ . @ @ @ . . . . . @ . @ @ . . @ . . @ . @ @ @ . @ . . @ . @ @ . . @ @ @ @ . @ . @ . @ . . @ 
@ . . @ . . . @ . @ . @ @ . @ @ . . @ . @ . . . . @ @ @ @ @ . . . . . @ . @ @ @ @ @ . . @ . . @ . @ 
@ . @ . . @ . @ . @ . . . . . . @ . . . . @ . @ . @ @ @ @ @ @ @ . @ . . @ . @ . @ . @ @ @ . @ @ . @ 
@ . @ @ . . @ . @ . . @ . @ @ . @ . @ . @ @ . . @ . @ @ @ @ @ . . . @ . . . . . . . . . . @ . . . @ 
@ @ . . . @ . . . . @ @ . @ . @ @ . @ . . . @ . . . . @ @ @ . @ . @ . @ . @ . @ @ @ . @ @ . . @ . @ 
@ @ @ . @ . @ . @ . . @ . . . @ . . . @ @ . . @ . @ . @ @ . . @ . . . . @ . . . @ . . @ @ @ . . @ @ 
@ @ . . @ . . . @ @ @ . . @ . . @ . @ @ . . @ @ . . @ . . @ . . . @ . @ . @ . @ @ @ . . @ @ @ @ . @ 
@ @ @ @ . . @ . . @ . . @ . . @ . . . . @ . . . @ . . @ . . . @ . @ . . . @ @ @ @ @ . @ . @ . @ . @ 
@ @ . @ @ . . @ . . @ . . @ . @ . @ . @ . @ . @ @ . @ @ @ . @ . . . @ @ . . . @ @ @ . . . . . . . @ 
@ @ . . @ @ . @ . @ . . @ . . . @ . . @ . @ . . . @ @ @ @ . @ @ . @ @ @ . @ @ . @ . @ . @ . @ @ . @ 
@ @ . @ . . . @ @ . . @ @ @ . @ @ @ . . . . @ . @ @ @ @ . @ . . . . . . @ . @ . @ . @ . @ . . . @ @ 
@ @ . . . @ . . . @ . . @ . . @ @ @ @ . @ . . @ . @ . . . . . @ @ . @ . . . . . . . . @ . . @ . . @ 
@ . . @ . @ @ @ @ @ . @ . @ . . @ . . . . @ . @ . @ . @ . @ . @ . @ . . @ . @ . @ . @ @ @ . . @ @ @ 
@ . @ @ . @ . . . . . @ . @ . @ . . @ . @ . . . . . @ @ @ . . . . @ @ . . @ . . . @ @ @ . @ . . . @ 
@ . . @ . @ . @ . @ . . . . @ . . @ . . @ @ . @ . @ @ . . @ . @ @ @ . . @ @ @ . @ @ @ . . . . @ . @ 
@ . @ @ @ @ . . @ . . @ @ @ @ @ @ @ @ . . . @ . . . @ @ . . . . . @ . @ @ @ @ @ @ @ @ @ . @ . @ . @ 
@ @ @ @ @ @ @ @ @ @ @ @ @ @ @ @ @ @ @ @ @ @ @ @ @ @ @ @ @ @ @ @ @ @ @ @ @ @ @ @ @ @ @ @ @ @ @ @ @ @ 
3
31 29 39 28
17 1 21 6
1 20 37 38
