50 50
@ @ @ @ @ @ @ @ @ @ @ @ @ @ @ @ @ @ @ @ @ @ @ @ @ @ @ @ @ @ @ @ @ @ @ @ @ @ @ @ @ @ @ @ @ @ @ @ @ @ 
@ . @ . . @ . @ @ @ . @ . @ @ . . . @ . @ . @ @ @ . @ . @ . . . . . . . @ . . . . . . . @ . @ . @ @ 
@ . . @ . . . . @ . . . . . . @ . @ @ . . . . @ . . . . @ @ . @ @ @ @ . . . @ . @ . @ . . . . . . @ 
@ . @ . @ . @ @ . @ @ . @ @ . @ . @ . . @ . @ . @ . @ @ @ . @ . . . . . @ . . @ . @ . @ . @ @ @ @ @ 
@ . . . . . . @ . @ @ . . . @ . . . @ @ @ . . . . . . . . . . @ . @ . @ . . @ . . . . . . . @ @ @ @ 
@ @ @ . @ @ @ . . . . . @ @ . @ @ . . @ . @ . @ . @ . @ . @ . @ . . @ . . @ @ @ . @ . @ . @ @ @ @ @ 
@ . @ . . . . . @ . @ . @ . . . @ . @ . . . . . @ @ @ @ @ . @ . @ . . @ . @ @ @ @ . . @ . . @ @ @ @ 
@ . . . @ . @ @ @ @ . . . @ . @ . . . @ . @ . @ @ @ @ @ . . . . @ @ . @ . @ @ @ @ @ @ . . @ . @ @ @ 
@ @ @ . . @ @ . @ . @ @ . . . . @ . @ . . @ @ @ @ @ @ . @ . @ . . . @ . @ @ @ @ @ @ . . @ @ . . @ @ 
@ @ @ @ . @ . . . . . @ @ @ @ . . . . . @ @ @ @ @ @ @ . . @ . . @ @ . . @ @ @ @ @ . @ . . @ . @ . @ 
@ . . . . @ @ @ @ @ . . . . . . @ . @ . . @ @ @ @ @ . . @ . @ . @ @ . @ @ @ @ @ @ . @ . @ . . . . @ 
@ @ . @ @ . . . . . . @ . @ . @ . . @ @ . . @ . @ @ @ . . . . . @ . . . @ @ @ @ . . . . . . @ . @ @ 
@ . . @ @ @ @ . @ . @ . @ . . . @ . @ @ . @ . . . @ . @ . @ @ . @ . @ . . @ . . . @ . @ . @ . . @ @ 
@ @ . . @ @ . . . @ . . . . @ . . @ @ . . . @ . @ @ . . @ @ . . @ @ . . @ . @ @ . . @ @ @ @ @ @ . @ 
@ . @ . @ . . @ . . @ . @ . @ . @ @ . @ . @ . . @ . . @ @ . @ . . @ . @ . . . . . @ . @ . @ . @ . @ 
@ . . . . @ . @ . @ . @ . . . @ . . . . . . . @ @ @ . . . . . @ . . . . @ @ @ @ . . . . . . . . . @ 
@ @ . @ . @ @ . . . . . @ . @ @ . @ . @ . @ . @ @ . . @ . @ . . . @ @ @ . @ @ @ . @ . @ . @ . @ @ @ 
@ . . . @ @ @ @ . @ @ . @ @ @ @ @ @ @ @ @ . . . . @ . . @ . . @ . @ @ . . . @ . . @ . @ . . @ @ @ @ 
@ @ . @ @ @ @ @ . . . @ @ @ @ @ @ @ . @ . @ . @ . . @ @ . . @ . . . @ . @ . @ . @ @ @ . @ @ @ @ @ @ 
@ . . . @ @ @ @ . @ @ @ . . @ @ @ @ . . . . @ . . @ . @ . @ . @ . @ . . @ . . . . @ . . . . @ @ @ @ 
@ @ . @ @ @ @ @ @ . . @ @ . . . @ . @ @ . @ . @ . . . @ @ . . . . . @ . @ . @ @ @ . @ . @ . @ @ @ @ 
@ @ . . @ @ @ @ @ @ . @ . @ . @ . . . . . . . . . @ @ . . . @ @ @ . @ @ . . . . . . . . . @ . @ @ @ 
@ . @ @ . @ . @ @ . . . . . . . . @ . @ . @ . @ . . . @ @ . . @ . @ @ @ @ . @ @ @ . @ @ @ . . . . @ 
@ . . . . . . . . . @ @ . @ @ . @ @ . @ . @ @ . . @ . @ @ . @ . . . @ . . . . . . @ . . . @ @ @ . @ 
@ @ @ . @ @ @ @ @ . . @ . @ @ @ @ @ @ @ @ @ @ @ @ . . . . . . @ . @ @ . @ @ . @ . . . @ @ . @ . . @ 
@ . . . @ . @ @ @ . @ . @ . @ @ @ @ . @ . @ @ . . @ @ . @ . @ . . @ . . @ . . @ . @ . . . . @ @ . @ 
@ @ . @ . . . @ . @ . . . . . . @ . . . . @ . . @ @ @ @ . . . . @ . @ . . @ . @ @ . . @ @ . . . . @ 
@ @ @ . @ . @ . . @ @ . @ @ . @ . @ . @ . @ . @ @ @ @ . @ @ @ . . . @ . @ . . . @ @ . . . @ @ . @ @ 
@ . . . . . @ @ . . @ . @ . . . . . @ . . . . . @ . . . . @ . @ @ . @ . . @ . @ . @ . @ @ . . . . @ 
@ @ . @ @ . . . @ . . @ . @ @ @ . @ @ @ @ . @ . . @ . @ . . . . . . . . @ . . . . . @ @ . @ . @ . @ 
@ . @ @ . @ . @ . . @ . . . @ . . . @ @ . . . @ @ . @ . @ @ . @ . @ @ . @ @ . @ . @ . . . . @ . . @ 
@ . . . . . . . . @ . @ . @ . @ . @ @ . @ . @ . . . . . . . . . @ @ @ . @ . @ . . . @ @ . @ . @ . @ 
@ @ . @ . @ . @ . . . . . . . . . . . . . . . . @ @ @ . @ @ . @ . @ @ . . . . @ . @ . . . . . . . @ 
@ @ @ . . @ . . @ . @ @ . @ @ . @ . @ . @ . @ . @ . @ @ . . . . . @ . @ . @ @ . . . @ @ . @ . @ @ @ 
@ @ @ . @ . . @ @ @ . . . . @ @ . . @ @ . @ . @ . . . . . @ . @ @ @ . . . . @ . @ @ @ @ . @ . . . @ 
@ . . . @ @ . @ @ @ . @ . @ . @ @ . . . . @ . . . @ . @ . @ . @ . . . @ . @ @ @ . . @ . . . @ @ @ @ 
@ @ @ @ . @ @ . @ . @ @ @ . . . . . @ @ . . @ @ . . @ . . @ @ . @ . @ . . . . @ . @ . @ . @ . @ . @ 
@ . . . . . . . . . . . . . @ . @ . . . @ @ . . @ @ . . @ @ . . . . @ @ . @ @ . . . . . . . . . . @ 
@ @ @ . @ . @ . @ . @ @ . @ @ @ . . @ @ @ . @ . @ . @ . @ @ . @ . @ . . . @ @ @ . @ . @ . @ . @ . @ 
@ @ @ @ . @ . . . @ . . . . @ . . @ . . . . . . . . . . @ . @ @ . @ @ . @ . . . @ . @ . . . @ @ @ @ 
@ . . @ . . @ . @ @ . @ . @ @ @ . @ . @ @ . @ . @ . @ . . . . @ @ . @ @ . @ . @ . . . @ @ @ @ @ @ @ 
@ . @ . @ . @ . . . @ . . . @ @ @ . . @ @ . @ @ . . @ . @ @ . @ @ . . . . . . @ . @ . @ . . @ @ @ @ 
@ . . . . . . . @ . . @ . @ . @ . @ . @ . @ . . . @ . . . . @ . @ . @ @ @ @ . @ @ . . . . @ @ @ @ @ 
@ . @ @ @ . @ . . @ @ . @ . . . . . . @ . @ @ @ . @ @ . @ . . . . . . . @ . . . . . @ . @ . @ @ @ @ 
@ . @ @ @ @ . . @ @ . . . . @ @ @ @ . @ . . . . @ . . . . @ @ @ @ @ . @ @ @ . @ . @ @ . . . @ @ @ @ 
@ . . @ @ @ @ . . @ . @ . @ . . . . . @ @ . @ @ . @ @ . @ @ @ @ @ @ . . @ . . . @ @ . @ @ @ @ @ @ @ 
@ . @ @ @ @ . @ . . @ . . @ @ . @ . @ . . . . . . . . . . @ @ @ . @ . @ . @ @ . . . . . . . @ @ @ @ 
@ . @ @ @ . . . . @ @ @ . @ @ . @ . . @ . @ . @ @ @ . @ @ @ @ . . . . . . . . @ . @ @ . @ . . . @ @ 
@ . . @ . . @ . @ @ @ @ @ . . . . @ . . @ . . @ . . . @ @ @ @ @ . @ . @ . @ . @ @ . . . . @ . @ @ @ 
@ @ @ @ @ @ @ @ @ @ @ @ @ @ @ @ @ @ @ @ @ @ @ @ @ @ @ @ @ @ @ @ @ @ @ @ @ @ @ @ @ @ @ @ @ @ @ @ @ @ 
3
7 29 36 4
3 3 42 7
32 44 26 41
