100 100
@ @ @ @ @ @ @ @ @ @ @ @ @ @ @ @ @ @ @ @ @ @ @ @ @ @ @ @ @ @ @ @ @ @ @ @ @ @ @ @ @ @ @ @ @ @ @ @ @ @ @ @ @ @ @ @ @ @ @ @ @ @ @ @ @ @ @ @ @ @ @ @ @ @ @ @ @ @ @ @ @ @ @ @ @ @ @ @ @ @ @ @ @ @ @ @ @ @ @ @ 
@ . . . . . . . . @ . . @ @ . @ @ . @ . . . @ . . . . @ . . . . @ @ @ @ . . @ . . . . @ @ . @ . . . . . @ @ . @ @ @ . @ . @ . @ @ @ . . . @ . . @ . . . . . . @ @ @ @ @ @ @ @ . @ @ . . @ @ . . . . . @ 
@ @ . @ . @ @ @ . . @ . @ . . . . . . . @ . . @ . @ . . @ . @ . . @ . @ . @ @ @ . @ . . . . @ . @ @ . @ @ @ . . @ . . . . . . . @ . @ @ . . . @ . . @ . @ @ . . @ @ @ @ @ @ @ . @ . @ . @ . . @ . @ . @ 
@ @ @ . . . . . @ . . . . @ @ . @ . @ . . @ @ . . . @ @ . @ . . @ . . . . . @ @ @ . . @ . @ . . @ @ @ @ @ @ @ . . @ . @ . @ . @ @ . @ . . @ . @ @ @ . . @ . . @ . @ @ @ @ @ . . . . . . . @ . . @ . @ @ 
@ @ @ @ . @ @ . @ . @ @ . @ @ @ @ @ . . @ . . @ . @ @ @ . @ . @ . @ @ . @ . . @ . . @ . @ @ @ . . @ @ @ @ . @ . @ . @ @ @ . . . @ . . @ . . @ @ @ @ . @ . @ . @ . @ @ . @ . @ @ . @ . @ . @ . @ . . . @ 
@ @ @ @ . . . @ @ @ @ @ . . @ . @ . @ . . @ . @ . . @ . . . . . . @ @ @ . @ . . @ . . . @ @ . . @ @ @ @ . . . . . . @ . . @ . @ . @ . @ @ . @ @ @ @ . . . @ . . . . . . . . . @ . @ @ . . @ . @ @ . @ @ 
@ @ @ . @ . @ @ @ @ @ @ . @ . . . . @ . @ . . @ . @ . @ @ . @ @ @ @ @ . . . . @ . . @ . . . @ . . @ @ @ . @ . @ @ @ . @ . . . . . . . . . . . @ @ @ . @ @ @ . @ . @ . @ . @ . @ . @ . @ . @ . . @ . . @ 
@ @ . . . @ @ @ @ @ @ . . . @ . @ . . . . @ . . . . . . . . . . @ @ . @ . @ . . @ . @ @ @ @ . @ . . @ . . . @ @ . . . @ @ @ @ . @ @ @ @ @ . @ . . . . . @ . . . @ . . . @ @ @ . @ . . . . @ . @ . . @ @ 
@ @ . @ . @ @ @ @ @ . @ @ . @ @ . @ @ . @ . @ . @ @ . @ . @ . @ @ @ . @ . . @ @ @ . @ . . . . . . @ @ @ . @ . @ @ . @ . . @ . . . @ @ . . . . @ @ . @ @ . @ @ . @ @ . @ @ @ @ . . @ . @ . @ . . @ . . @ 
@ . . . @ @ @ . @ . . @ . . . . . . . . . . . . . @ . . @ @ . . @ . . . . @ . . . . @ @ . @ . @ . . @ . . . . . @ . @ . @ @ . @ . @ . @ . @ @ . . @ @ @ . @ . . . @ . @ . . @ . @ @ . @ . @ . @ . . @ @ 
@ @ . @ . . @ . @ @ . @ @ @ . @ @ . @ . @ . @ . @ @ . @ . . @ . @ @ @ . @ . . @ . @ . . . . @ . . @ . @ . @ @ @ . . . . . @ . @ . @ . . . . . . @ . @ . . . @ . @ . @ . @ . . . . . @ . . . . @ @ . . @ 
@ . . @ . @ @ . . . . . . . @ @ @ @ . . @ . @ . @ . . . @ . . @ . @ @ . . . @ . @ . @ @ . @ . . @ . . . . . @ . . @ @ . @ . @ @ @ @ @ . @ @ . @ . . . @ . @ . . . . . . . @ @ . @ . @ . @ . @ . . . @ @ 
@ . @ . . . . @ @ . @ @ @ . . @ @ @ . @ . . @ . . @ @ @ . @ . @ . . . . @ . @ . @ . . @ @ . @ . @ @ . @ . @ . @ . @ @ . @ . @ @ @ @ . . @ . . . @ . @ @ . . . @ @ . @ @ @ . @ @ . . . @ . . . @ @ . . @ 
@ . . . @ @ @ . . @ @ @ . . @ @ . . @ . @ . @ . @ . . @ . . . . @ @ . @ . . . . . . @ . . . . . . @ . @ . . . . . . @ @ . . @ @ @ . @ @ @ @ @ . . . . @ . @ @ @ . @ @ @ @ . . . @ . @ . @ @ . . . @ . @ 
@ . @ @ @ @ . @ . . @ . @ . . . . @ @ . @ . . @ . @ . . @ @ . @ @ . . . @ . @ . @ . . @ . @ . @ . @ @ @ . @ . @ . @ . @ . @ . . @ . . @ . . . @ . @ . . . . @ . . @ @ . @ . @ . . . . . . @ . @ @ . . @ 
@ . @ @ . . . . . @ . . . @ @ @ . . . . . . @ . . . . @ . . . . . @ . @ . @ @ @ @ @ @ . . . @ . . . @ . . @ . @ . . . . . @ @ . . . @ @ @ @ . . @ @ . @ @ @ . . @ @ @ . @ . . @ . @ . @ . @ . . . @ . @ 
@ . . @ . @ . @ . . . @ . @ . . . @ @ . @ . . @ @ @ . . @ . @ @ . . . . . . @ @ @ @ . @ . @ . @ . @ @ @ . @ @ @ @ @ @ . @ . . @ @ . . . . . . @ @ @ . . . @ . @ . @ . . @ . @ . @ @ @ . . . @ @ . . . @ 
@ @ . . @ @ @ @ @ . @ . . @ . @ @ . . . . @ . @ @ @ . @ @ . @ . . @ . @ @ @ @ @ @ . . . @ . . . . . @ . . . @ @ . @ @ @ . . @ . . @ @ @ . @ . . @ . . @ . @ . . . . @ . @ . . . . . @ @ . @ . @ . @ @ @ 
@ @ . @ . . . @ @ @ @ @ . . @ @ @ . @ . @ . . . @ . . @ . @ @ @ . . @ @ . @ @ @ . @ . @ . @ @ . @ . . @ @ . . . . . @ . @ . . . @ . @ @ @ @ @ . . @ . . @ @ @ . @ . . . @ . @ . @ @ . @ . . . . . . . @ 
@ . . . @ @ . . . . @ . . @ @ @ . @ @ @ . @ . @ . @ . @ . . @ @ @ . . . . . . . . . . . . . @ @ . . @ @ @ . @ . @ @ . . . @ @ . @ . . . @ @ @ @ . . @ . . @ . . . @ . @ . . . @ . . . . @ . @ . @ @ . @ 
@ . @ . . . . @ @ @ . . @ . @ . . @ @ @ . . . . . . . . . @ . . . . @ . @ . @ . @ . @ @ . @ . . @ . . @ . . . @ @ @ @ @ . . . . . @ @ . @ @ . . @ . . . @ @ @ . @ . @ . @ . @ @ @ . @ . @ . @ @ . . . @ 
@ . . @ @ @ . @ @ @ @ . . . @ . @ . @ . @ . @ @ . @ . @ . . @ @ @ . @ @ . . @ . @ @ . . @ @ @ . . @ . @ . @ . . . . @ . @ . @ . @ . . . @ . . @ @ @ @ . . @ . . . . . . . . . @ . . . @ @ @ . @ @ . @ @ 
@ . @ @ @ . . . @ @ @ . @ @ . . . . . . . . @ @ @ . . @ . @ @ @ . . . . @ . . @ . @ @ . . @ @ @ . . . . . @ @ @ . @ . . . @ . . . . @ @ . @ . . . . @ . @ . @ . @ @ . @ @ . @ . @ . @ . @ . . . @ . @ @ 
@ . @ @ @ @ . @ @ @ . . . @ @ . @ . @ . @ @ . @ . @ @ @ . . @ . . @ . @ . @ @ @ . . @ . @ . @ . @ . @ @ . . @ . . . @ . @ @ @ . @ @ . . . . . @ . @ . . . . . . . . @ . @ @ . . . . . . @ @ . @ @ . . @ 
@ @ @ @ @ . . . @ . @ . @ . @ . . @ @ @ . . . . . . @ . . @ . @ . . @ . . . . @ . @ . . . . . . @ . @ . . @ @ @ . @ . . . . . . . . . @ . @ . . @ . @ . @ @ . @ . @ . . . . @ . @ @ . @ . . . @ . @ . @ 
@ @ @ @ @ . @ . . . . . . . . @ @ . . . . @ @ @ @ . @ @ . . . . @ . . @ . @ . . . . . @ . @ @ . @ @ . @ . . @ @ @ . @ . @ . @ @ . @ . . @ . @ . . . . . @ . . . @ @ @ . @ @ . . . . @ @ @ . @ . . @ . @ 
@ @ . . . @ . . @ . @ . @ @ . . . @ . @ @ @ . @ . . @ . @ @ . @ @ . @ . . . @ @ @ @ . . @ @ @ @ . @ . . @ . . @ @ . . . . @ . @ @ . . @ @ . @ @ @ . @ . @ @ @ @ @ @ . . . . @ . @ . @ @ . . @ . @ . . @ 
@ . @ . @ . @ . . @ . . . . @ . @ . . @ . . . . . @ . . . . . . . . . @ @ @ . . . . @ . . . @ . . @ . @ . . @ . . @ . @ @ . . @ @ @ . @ . . . @ . . . @ . . @ @ @ . . @ @ . . . @ . . . @ . . . . @ . @ 
@ . . . . . . @ . . @ . @ . . @ @ @ . . @ . @ @ . @ . @ . @ @ @ @ . @ @ @ . . @ @ @ . . @ @ @ @ . . . @ . @ . . @ . @ . . @ . . @ @ @ . @ . @ @ . @ @ @ . @ @ . . @ . . @ . @ . . @ . @ . . @ . @ . . @ 
@ @ @ . @ . @ . @ . @ . . @ . . @ . . @ @ @ . . . . . @ . @ . @ . . . @ . . @ . @ . . @ . @ @ @ . @ . . . . . @ . . @ @ . . . @ @ @ . . . . . . . . @ . . . . . @ . @ . @ @ . . @ . @ . . @ . . . @ . @ 
@ . . @ . . . . . . . @ . @ . @ @ @ @ @ . . . @ . @ . . @ . . . @ . @ . @ . . . . . @ @ . . @ . @ @ @ @ . @ . @ @ . . . . @ . @ @ @ @ . @ . @ . @ . . @ . @ @ . @ . . @ @ . @ . @ . @ . @ . @ . @ @ . @ 
@ @ . @ @ . @ @ @ @ . . @ @ . @ @ @ @ . @ @ . . @ . . @ @ @ . @ . . . . . . @ @ . @ @ @ . @ @ . . @ . . . . @ @ . . @ @ . @ @ . @ @ @ @ . . @ . @ @ @ . . . . @ . . @ . . . . . . . . . . . @ . . . @ @ 
@ . . . . . . @ . . . @ . . @ . @ . @ . . . @ . @ @ . @ . @ . @ @ . @ @ . @ . . . . @ . . @ . . @ . . @ . @ @ . @ . @ . . . @ . @ @ @ . @ . @ . @ . . . @ . @ . @ . . @ . @ @ . @ @ . @ . @ . . @ @ @ @ 
@ . @ . @ . @ . . @ . @ . @ . . . . . @ @ . . . @ . @ . . . . . @ . . @ . @ . @ . @ . @ . . . @ . . @ . . @ @ . . @ . . @ . . . . @ . . . . @ @ . . @ . . @ @ . . . @ . @ . @ . @ . . . @ @ @ @ @ @ @ @ 
@ @ . . @ @ . . @ . . . . . . @ . @ . . . @ . @ . . . @ . @ . @ . . @ . @ . @ . . . . @ @ . @ . @ . . @ @ @ . . @ . @ . . @ . @ @ @ @ . @ . @ . @ @ @ @ . @ @ @ . @ . . . . . . . @ . @ @ @ @ @ @ @ @ @ 
@ . . @ . . @ . . @ . @ . @ @ . @ @ . @ @ . @ . @ @ . . @ . . . @ . . . . . . @ . @ . @ . . . . . . @ . . . @ . . . @ . @ . @ @ @ @ @ @ . . . . @ @ @ . . . @ . . . . @ . @ @ . @ . @ @ @ @ @ @ @ @ @ @ 
@ . @ . @ . @ . @ . . @ . . @ . . @ . @ . . . . . . @ . @ @ . @ @ @ . @ . @ @ @ . . @ @ @ . @ . @ . . . @ . . . @ . . . . . . @ @ . @ . @ . @ @ . @ . @ . @ . @ . @ @ . @ @ @ . @ . . @ @ @ @ @ @ @ @ @ 
@ @ . . . . . @ . @ . . @ . @ . @ @ @ @ . @ . @ . @ . . . @ . @ @ @ @ @ . @ . . . @ . @ @ @ . . @ @ . @ @ . @ . . @ . @ . @ @ . @ . . . . . . @ . . . . . . . . . . . . . . @ . @ @ . . @ . @ @ @ @ @ @ 
@ . @ . @ @ @ . . . . @ @ @ . . . @ @ @ @ . . . @ . @ . @ . . . @ @ @ . . @ @ @ . . . . @ @ . @ @ @ @ . @ @ . @ . @ . @ @ @ . . @ @ @ . @ . @ . . @ . @ . @ . @ . @ . @ . @ @ . @ . . @ @ . @ @ @ @ @ @ 
@ . . . . . . @ @ @ . @ @ @ @ . @ . @ @ . @ . @ . . . . . . @ @ . . . . @ @ @ @ @ . @ . . . @ . . . @ . . @ . . . . @ . @ . @ . @ @ @ . @ . @ . @ . . . @ . . . @ . . . @ @ . @ @ @ . @ . . @ @ @ @ @ @ 
@ @ . @ . @ . . @ . . . . . . . . . . @ . . . . @ . @ . @ . . @ @ . @ . . . @ @ @ . . @ . @ . @ . @ . . @ . . @ . @ . . . . . . . @ @ @ . . . . @ @ . @ @ @ . @ @ . @ . . . . . @ @ . . . @ . @ @ @ . @ 
@ . @ @ @ . . @ . @ . @ @ @ . @ . @ . . @ @ . @ . @ @ @ . . @ @ @ @ @ @ . @ . @ . @ . . @ . . . . . . @ . @ . . @ . . @ . @ . @ . . @ . . @ . @ . . . . @ @ @ . . @ . . @ @ @ . . . . @ @ . . . . @ . @ 
@ . . @ . . @ . . . . . . . @ @ @ @ @ @ . . . @ . . @ . . @ . @ @ @ @ . . . . . . . @ @ @ @ . @ . @ . @ . . . @ . @ . . @ @ @ @ . @ . @ . . @ @ @ @ . @ @ . . @ . . @ . @ @ . . @ . @ @ @ . @ . @ . . @ 
@ . @ @ @ . @ . @ . @ . @ . . @ . . @ . @ @ . . . @ . @ . . . . @ @ . @ . @ . @ @ . @ @ . @ @ . . . @ . @ @ . . . . @ @ @ @ @ . . . . . . @ @ @ . @ @ @ @ @ . . @ . . @ . @ @ . . @ @ @ . . . @ @ @ . @ 
@ . . @ . . . @ @ @ @ @ @ . @ . @ . @ . @ . . @ @ . . . . @ . @ . . . . . . @ @ @ @ . . . @ . . @ . . . . . . @ . @ @ @ . @ . @ . @ . @ . @ @ . . @ . @ . @ @ . . . @ . . . . @ @ . . . . @ . @ . @ . @ 
@ . @ . @ . @ . @ . @ @ . . . . . . @ . @ @ . . . @ @ @ . . @ . . @ @ . @ . . @ @ . @ @ . . . @ @ . @ . @ . @ @ . @ . . . @ . . @ @ @ . . . @ @ . . . . . . @ . @ . . . @ . @ . @ @ . @ . . @ . . . . @ 
@ . . . . . . . . . . . @ @ . @ @ . . . . . @ @ . . . @ . @ . @ . @ @ @ @ @ . . . . @ . . @ . @ @ @ . . @ @ @ @ @ . . @ @ . . @ . @ . @ . @ . . . @ . @ . @ @ @ . . @ @ . @ @ . . @ . @ . @ . @ . @ . @ 
@ . @ . @ . @ . @ @ . @ @ @ @ @ . @ @ . @ . @ . @ @ . . . . . . . . @ @ @ . . @ . @ @ @ . @ . . @ . @ . . @ @ @ . @ . @ @ @ . . . . . . . . . @ . . @ . @ @ @ . @ . @ . . . . . @ . @ . . . . . . . @ @ 
@ . @ . . @ . @ @ @ @ @ @ @ @ @ . . @ @ . . . . . . @ @ . @ . @ . @ @ @ @ @ . . @ @ @ . @ . . @ . . . . @ . @ . . . . . @ . @ @ . @ @ @ . @ . @ . @ . . @ . @ . . . @ @ @ . @ . . . . . @ @ @ @ @ @ . @ 
@ @ . @ . @ . . @ @ @ @ @ @ @ . @ . @ . @ . @ . @ . @ @ @ @ @ . . . . @ @ @ . @ @ @ @ . . . @ @ @ . @ . . . @ @ . @ . @ . . @ . . . @ @ @ @ @ @ . . @ . . . @ @ @ . . . @ @ @ . @ . @ . . . . . . . . @ 
@ . . . . . . @ @ @ @ @ @ . . . . . . . . . . @ @ . @ @ . @ . @ . @ . @ @ @ . . @ . . . @ . . . . @ . . @ . . . @ . . . . @ . @ . @ . @ @ @ . @ @ . @ . @ . @ . @ . @ @ . . . . . @ @ . @ . @ @ . @ . @ 
@ @ . @ . @ @ @ @ @ @ @ . . @ @ . @ . @ . @ . @ . . . . . . . . . . @ @ @ . . @ . . @ @ . . @ . @ . @ . . @ @ @ . . @ @ . @ . . . @ . . @ . . . . @ @ @ . . . . @ . @ @ . @ . @ @ . @ . . @ . @ . . @ @ 
@ @ @ @ . @ . . . . @ @ @ . . . @ . . . @ . @ @ @ @ @ . @ @ . @ . @ . @ @ @ . @ @ . @ @ @ . . @ @ . . @ . . @ . @ . . @ @ . . @ . . . @ . @ . @ . . @ @ . @ @ @ @ . . . . . @ @ @ . . @ . . . . @ @ . @ 
@ . @ . . . . @ . @ @ @ @ @ @ @ . @ . @ @ . @ @ @ @ . . . @ @ . . . . . @ @ @ . @ @ @ @ . @ @ @ @ . @ . . @ @ . . @ . . . @ @ . . @ @ . . . @ . . @ . . . @ . @ . . @ . @ . @ @ . . @ @ @ . @ . . . . @ 
@ . . . @ . @ . @ . @ . @ @ . . . . . @ . . @ @ . . . @ . . @ @ . @ . @ @ @ . . @ . @ . . . @ . . . . . @ . . @ . . . @ @ . . . @ . @ . @ @ . @ . . @ . @ . . . @ . @ . . @ @ @ . @ . @ @ @ . . @ . @ @ 
@ . @ @ . @ . . . . . . @ @ @ . @ . @ . @ . . . @ . @ . . @ . . @ . . . @ . @ . . . @ @ . @ . @ . @ @ . . @ . . @ @ . . @ . @ . . . @ . . @ . @ . @ . . @ . @ @ . . . @ @ @ . . . . . . . . @ . . @ . @ 
@ . . . . @ @ . @ . @ . . @ @ . . @ . . . . @ . @ . . @ @ @ @ . @ @ . @ . . . . @ @ . . . @ . . @ @ @ @ . . . @ . . . @ @ @ . . @ @ @ . @ @ . . . . @ . . . . . @ . @ @ . . @ @ . @ . @ . @ @ @ . . . @ 
@ . @ . @ @ @ @ @ @ @ . @ . @ . @ @ @ . @ . . @ . @ . @ . . @ . @ . . . @ @ @ . . @ . @ . @ . @ @ @ . . @ @ . . @ . @ . @ @ @ . . @ @ . @ @ @ . @ . . . @ . @ @ . . . . . @ @ . . . @ . . . @ . @ . @ @ 
@ @ . . @ . . @ @ . . . . . . @ @ @ @ @ . @ . . . . @ . @ . . . . @ @ . @ @ @ . @ . @ @ . . . . @ . @ . @ . . @ . . . . . @ . . @ @ . . . @ . . @ . @ . @ . @ . . @ . @ . . . @ . @ . @ . @ . . . @ @ @ 
@ @ @ . . . @ . . . @ . @ . @ . @ @ @ @ . . @ @ . @ . . . . @ @ @ @ @ . . @ . . . . . . . @ @ @ . . . . . @ . @ @ . @ . @ . @ . . . . @ . @ @ . @ . . @ . @ . @ . . @ . . @ . @ . . . . @ @ . @ @ . @ @ 
@ @ @ @ @ . @ @ @ . . @ @ . . . . @ @ . . @ . . . . @ @ @ . . . @ . @ . @ . . @ @ . @ . @ . . @ . @ . @ . . . @ . . . @ . . . . @ @ . . @ . . . . @ . . . @ . . . @ @ . @ . . . . @ . @ . . . . . . . @ 
@ @ @ . . . . @ . . @ . . . @ @ . . . @ . . @ @ . @ @ . @ @ @ . @ . . . . @ @ . . . . @ . . @ . @ . @ @ . @ . . @ . @ . @ . @ . @ . @ @ . @ @ . @ . @ . @ @ @ . @ . @ . . @ . @ . @ . . . @ . @ @ @ @ @ 
@ . . @ . @ . @ . @ . @ @ . . @ . @ @ . . @ @ . . . . . . @ . . @ . @ . @ @ . @ . @ . . @ . . . . . . . @ . @ . . . @ . . @ . . @ . . . . . . . . . . @ @ @ @ @ . . . . @ @ @ . . . @ . @ . @ @ @ @ @ @ 
@ @ . . . @ . . . @ . . @ @ . . @ @ . @ . . . @ @ . @ @ . @ . @ . . @ . @ . . . @ . . @ . @ @ . @ . @ @ @ . . . @ @ . . @ @ @ . . . @ . @ . @ . @ @ @ @ @ @ @ . @ @ . @ @ @ @ . @ . @ @ . . @ @ @ @ @ @ 
@ . @ . @ . @ @ . @ . @ . @ @ @ @ . . . @ . @ . @ . @ . . . . . @ . . @ . @ . @ @ @ . . . . . . . @ @ @ . @ @ . . @ . @ . @ . @ . @ . @ . . @ @ @ @ @ @ @ . . . . @ @ . . @ @ . . @ @ @ . @ . @ @ @ @ @ 
@ . . . @ . . . . @ . . . . . @ . @ @ . @ . . . . @ @ @ . @ . @ . . @ . . . . . @ . . @ @ . @ . @ @ @ @ . . . . @ . . . . @ . . . @ . . @ . @ . @ @ @ . . . @ @ @ @ @ . @ . . . @ . @ . . @ . . @ @ @ @ 
@ . @ . . @ . @ . @ . @ . @ @ . . . @ . . . @ . @ @ @ @ @ . . . @ . . . @ . @ . . @ . . @ . . @ @ @ @ @ @ . @ . . . @ . @ @ . @ . . . @ . @ . . . @ . @ . @ . @ @ @ . . . @ . @ @ . @ . @ . . @ . @ @ @ 
@ . @ . @ @ @ . . @ . . @ @ . @ . @ . @ @ . . @ @ @ @ . . @ . @ @ . @ . . @ . @ @ @ @ . @ @ @ @ @ @ @ @ @ @ . . @ @ @ @ . . . @ @ @ . . . . . @ @ . . . . . . @ @ @ . @ @ . . @ . . @ . . . @ . . . @ @ 
@ @ . . @ @ . @ . @ . @ . . . . . . . . @ . @ @ . @ . . @ . . . . . . @ . @ . . . @ . . . @ @ @ @ @ @ @ @ @ @ . . @ @ . @ . @ . . @ . @ . @ . . @ . @ . @ @ @ . @ . . . @ . @ . @ . @ . @ @ . . @ @ @ @ 
@ @ @ @ . . . . . . . . @ @ @ . @ . @ . . . @ . . . . @ . . @ . @ . @ . @ . . @ @ . @ . @ @ @ @ @ @ @ @ @ @ . . @ @ . . . @ . . @ . . @ . . @ @ . . . @ . . . . . @ . @ . . . . . . . . . . . @ . . . @ 
@ . . . @ @ @ . @ . @ . @ . @ . @ @ . @ @ . . @ . @ . . @ @ . . . @ . . @ @ . . . . . . . . . @ @ @ @ @ @ . @ . @ @ @ . @ . @ . @ . @ . @ . @ . @ . @ . @ @ . @ @ . . . . @ @ . @ . @ . @ . @ . . @ @ @ 
@ . @ . @ . . @ . . . @ . . @ @ . . . @ . @ . . @ @ . @ . . @ . @ . @ . @ @ @ . @ . @ @ . @ . . @ @ @ @ . . . . . @ . . . . . . . . . . . @ . . . . . . . . . . . . @ . @ @ . . @ . . @ . . . . @ . . @ 
@ @ . . . . @ . @ @ . . . @ . @ . @ . . . . . @ @ . . . @ . . . . . . . . @ . . @ @ . . . . @ . . . @ . . @ @ . @ . @ . @ . @ . @ @ . @ @ . @ . @ @ @ . @ . @ @ . @ @ @ . . @ @ . @ @ @ @ . @ . . . @ @ 
@ @ @ . @ . . . . @ @ @ . . . @ @ . @ @ . @ . @ . @ . @ . @ . @ . @ . @ @ . @ @ . . . @ . @ . . @ @ . @ . . . @ @ . @ . . @ . . @ . @ @ @ . . . . . @ @ . . @ @ . . @ @ @ . @ . . . . @ @ @ . @ . @ . @ 
@ @ . @ . @ @ . @ . @ . @ @ . . . . @ @ @ . . . . @ . . . . @ . . . @ @ @ . @ . . @ . . @ . @ . . @ . . . @ . @ . . @ . @ . @ @ . . . @ . . @ @ . @ . @ @ @ . @ . @ . . . . . @ . @ @ . . @ . . @ . . @ 
@ . . . . . . . . . @ . @ @ @ . @ . . @ . @ . @ . . @ @ . @ @ @ . @ . @ . . . @ . @ @ @ . . . . @ . . @ @ . @ . @ . @ . @ . . . @ @ . @ @ . @ . @ @ . @ . @ . . @ . . @ . @ @ . . @ . . @ . @ . . @ . @ 
@ @ . @ . @ @ . @ . . . @ @ @ @ . . @ @ . @ @ @ @ . @ @ . @ . . . . . . . @ @ @ @ @ @ . @ @ @ . . . @ . . . . . . . @ . . . @ . @ . . . . . @ . . . . @ . . . @ . @ . . @ . @ . @ . @ . @ . @ . @ . . @ 
@ @ . @ . @ . @ . . @ . @ . @ . @ . @ . . . . @ . . . . . . . @ @ @ @ . @ @ @ @ @ @ . . . @ . . @ @ . @ @ . @ . @ . @ . @ @ @ @ . @ . @ @ @ . . @ . @ . @ @ . @ . @ . @ . . . . . . . . . . . . . . @ @ 
@ . @ . @ @ . @ @ @ . . . . . . @ . . @ . @ @ @ @ . @ . @ @ . @ @ @ . @ @ @ @ . @ . @ . @ . @ . @ . . @ @ . @ @ . . @ . . @ @ @ . . . . . . . @ . . . . . . . . . . . . . @ . @ . @ . @ . @ . @ . @ @ @ 
@ . . . @ . . . @ . @ . @ . @ . . @ . @ . @ @ @ @ @ . . @ . . . @ . . . . . . . . . . . . . . . . . @ @ . @ . . @ . @ @ . . @ @ @ . @ . @ . @ . @ . @ . @ . @ @ @ . @ @ . . @ . . . @ . @ @ . . @ . @ @ 
@ @ @ . . @ @ . . . @ @ . . . @ . . . . . . . @ . @ @ @ . @ . @ @ @ @ . @ @ @ . @ . @ . @ . @ . @ @ . @ . . @ . . . . . . @ . @ . . . @ @ @ . . . @ @ @ @ @ . . . . @ . @ @ . . @ . . . . . @ . . . . @ 
@ @ . @ . @ . @ @ . . @ . @ @ . @ @ . @ . @ . . . . . . . . . . @ @ @ @ . . . @ . . @ . @ . . @ . @ . @ @ . . @ @ . @ . @ . . . @ . @ . @ @ . @ . . @ . . @ @ . @ . @ . @ @ @ . @ . @ @ . @ . @ @ . @ @ 
@ . . . . . . . . . @ . @ . @ . . . @ @ @ . @ @ @ @ @ @ . @ . @ . @ @ . @ . @ . @ . @ . . @ . . . . . @ . @ . @ @ @ . . . . @ . . . . . . . . @ . @ . @ . . @ @ . . @ . @ @ . . @ . . . @ . . @ @ . . @ 
@ . @ @ @ @ @ @ @ . . . . . . . @ . . . . . . . . . . . @ . . . . . . . . . . . @ . @ @ @ @ @ @ . @ @ . . . . . @ . @ . @ @ @ . @ . @ . @ . @ @ @ . . . @ . . @ @ . . . . @ . @ . . @ . . . @ . @ . @ @ 
@ @ . . . . . . . . @ . @ @ @ @ @ . @ @ @ @ @ . @ @ @ . . . @ @ @ . @ . @ . @ . . . . . @ @ @ . @ @ . @ @ . @ . . . . . . @ . . . @ . @ . . @ @ @ . @ @ . @ . @ . . @ . @ . . . @ . @ . @ . . . @ . . @ 
@ @ @ @ @ @ . @ @ . . @ . @ . . @ @ . . @ . . @ . @ . @ . @ @ @ . @ @ @ . @ . @ . @ . @ . @ @ . @ . . . . . . @ . @ @ . @ @ @ . @ . . . @ . . . @ . @ . . . . @ @ . . @ . . @ @ . . . @ . . @ @ @ . @ @ 
@ @ @ @ . @ . @ @ @ . @ . . @ . @ . @ . @ . @ . . . . . @ . . . . . . . . . . . . @ . . . . @ . . @ @ @ @ . @ @ @ . . . . @ @ . . @ . @ . . @ . @ . @ . @ . @ . @ . @ . @ . . . @ . @ . @ . . . . @ @ @ 
@ @ @ @ . . . @ @ . . . @ . . . . . . . @ . . @ . @ . @ @ @ . @ . @ . @ . @ @ . @ . @ @ . @ . @ . . @ @ @ . . @ @ . @ . @ . @ . @ . . @ @ @ @ @ . . @ . @ . . . . @ . . @ @ @ . . @ . . . . @ @ . @ @ @ 
@ @ @ . @ . @ @ . @ . @ @ @ . @ . @ @ . @ . @ @ @ @ . . @ . @ . . . @ @ @ @ @ @ @ . @ . . . . . . @ @ @ @ @ @ . @ @ @ . @ . . @ @ @ . . @ . @ @ @ . . . . @ . @ @ @ @ . . . . @ @ @ @ . @ . . . @ @ @ @ 
@ @ . . . @ @ @ . . @ . @ @ @ . . . @ . . . . @ . . . @ . . . @ . @ . @ . @ @ . . . . @ @ . @ @ . . . . . @ . . . . . . @ . @ . @ . . @ . . . @ @ . @ . @ @ @ @ @ @ . @ . @ . . @ @ @ @ @ @ . @ @ @ @ @ 
@ . . @ . @ . . @ . @ . @ @ @ @ . @ . @ . @ @ . @ @ . @ @ . @ . . . . . . . . @ . @ . @ @ @ @ . . @ @ @ @ . @ . @ @ . @ @ . . . . @ . . @ @ . . @ . . @ @ @ @ @ @ . . . @ . @ . @ @ @ . @ @ @ @ @ @ @ @ 
@ . @ . . . . @ . . . . . @ . . @ . . . . . . . . . . @ @ . @ . @ . @ . @ @ @ @ . @ . . @ . . @ . . @ . . . @ . . . @ @ . . @ . @ @ @ . . @ . @ . . @ . @ @ @ @ @ @ . @ . . . . . . . . . @ @ @ @ @ @ @ 
@ @ . @ @ @ . . . @ @ @ . . . @ @ @ . @ . @ . @ . @ . @ . . . @ . @ @ . @ . @ . @ @ . @ . . @ . . @ . @ . @ . @ . @ . @ . @ . @ @ @ @ @ . . . . @ . . . . @ @ @ @ . . . . @ @ . @ . @ . @ . @ . @ @ @ @ 
@ @ . @ . . . @ . @ @ . . @ . @ . @ . @ @ . . @ @ . . . . @ @ . . . . @ . . . . @ . . . @ . . @ . . . . . . . . . . . . . . . . @ @ @ . . @ @ @ . . @ @ @ . . @ @ @ . @ @ . . . @ . @ . @ . . . . @ @ @ 
@ . . . @ . @ . . . @ @ . . @ . . . @ . . . @ @ @ @ . @ . . . . @ . @ . @ @ . @ . @ @ . . . @ @ . @ @ . @ . @ . @ . @ . @ . @ . . . @ @ . . . @ @ . @ . @ . @ . @ . . . @ . @ . . @ . @ . . @ . @ @ @ @ 
@ @ . @ . @ . @ @ . @ . @ @ . @ . @ . @ . @ @ @ @ . @ . @ . @ @ . . . . . . . . . . . @ @ . . . . @ @ . . @ . . . @ . . . @ . . @ @ @ @ @ . @ . . . . . . . . . . @ . @ . @ . . @ @ . . . @ . . . @ @ @ 
@ . . . . . . . . . . . . . . . . . . . . @ @ @ . . . . . @ . . @ . @ @ . @ . @ . @ . . . . @ . @ @ . . @ . @ . @ @ @ . @ . @ . . @ @ @ . . . . @ @ @ . @ . @ @ . . . . . . @ @ . . . @ @ . @ . @ @ . @ 
@ @ . @ . @ . @ @ . @ @ . @ . @ . @ . @ . @ @ . . @ @ . @ @ . @ . @ . . . . @ . . . @ . @ @ . . . @ @ . @ . . . . . . @ . . . . @ . @ . @ . @ . . . . @ . @ @ . @ @ . @ . @ @ . @ . @ . @ . . . . . . @ 
@ @ @ . . @ @ . . . . . @ . . @ @ @ @ . . . . @ @ . . . . . . . . . . @ . @ @ @ . @ @ @ @ @ @ . @ @ . . @ . @ . @ . @ @ @ . @ . . . . . . . . @ . @ . . . . . . @ . . @ . . . . . . . . . @ @ @ @ @ . @ 
@ @ @ @ @ @ @ @ @ @ @ @ @ @ @ @ @ @ @ @ @ @ @ @ @ @ @ @ @ @ @ @ @ @ @ @ @ @ @ @ @ @ @ @ @ @ @ @ @ @ @ @ @ @ @ @ @ @ @ @ @ @ @ @ @ @ @ @ @ @ @ @ @ @ @ @ @ @ @ @ @ @ @ @ @ @ @ @ @ @ @ @ @ @ @ @ @ @ @ @ 
3
85 59 42 30
2 91 77 47
52 32 19 84
