12 12
@ @ @ @ @ @ @ @ @ @ @ @ 
@ @ @ @ . . @ . @ @ @ @ 
@ @ @ . @ . . . . @ @ @ 
@ @ . . . . @ @ @ . @ @ 
@ @ @ . @ . . . . . . @ 
@ @ . . @ . @ @ @ . @ @ 
@ . . @ . . . . @ . . @ 
@ . @ . . @ @ . . @ . @ 
@ @ . . @ . . @ . . @ @ 
@ @ @ . . . @ . . @ @ @ 
@ @ @ @ . @ @ @ . . @ @ 
@ @ @ @ @ @ @ @ @ @ @ @ 
3
8 2 6 10
2 5 7 7
4 7 3 5
