12 12
@ @ @ @ @ @ @ @ @ @ @ @ 
@ @ @ . . @ . . @ . . @ 
@ . @ . @ . @ . . @ . @ 
@ . . . . . . @ . @ . @ 
@ . @ . @ . @ @ . . . @ 
@ . . @ . . . . . @ . @ 
@ . @ . @ . @ . @ . . @ 
@ . . . @ . . @ . . @ @ 
@ . @ . . @ . @ @ . . @ 
@ . . @ . . @ @ @ . @ @ 
@ . @ . . @ @ @ @ . . @ 
@ @ @ @ @ @ @ @ @ @ @ @ 
3
3 4 9 9
2 1 3 10
5 8 5 1
