12 12
@ @ @ @ @ @ @ @ @ @ @ @ 
@ @ @ @ . . @ @ @ @ @ @ 
@ @ @ . @ . @ @ @ @ @ @ 
@ @ . . . . @ . @ @ @ @ 
@ . @ . @ . @ . . @ @ @ 
@ . . @ . . @ . @ . @ @ 
@ @ . . @ . @ . . . . @ 
@ . @ . @ . @ . @ . @ @ 
@ . . . . . . . . @ @ @ 
@ . @ @ @ . @ . @ . @ @ 
@ . . @ @ . @ . . . . @ 
@ @ @ @ @ @ @ @ @ @ @ @ 
3
5 7 6 5
9 5 8 5
7 1 3 5
