12 12
@ @ @ @ @ @ @ @ @ @ @ @ 
@ @ . . . . . . @ . @ @ 
@ . . @ . @ . @ . . . @ 
@ @ @ . . . @ . @ . @ @ 
@ . . @ . @ . . . . . @ 
@ @ . @ . @ . @ . @ . @ 
@ . . . . . . @ . @ . @ 
@ . @ @ . @ . @ @ . . @ 
@ @ . @ . @ . @ . . @ @ 
@ @ . . . . @ @ @ . @ @ 
@ . . @ . @ @ @ @ @ @ @ 
@ @ @ @ @ @ @ @ @ @ @ @ 
3
1 5 4 9
5 6 10 4
9 3 4 4
