25 25
@ @ @ @ @ @ @ @ @ @ @ @ @ @ @ @ @ @ @ @ @ @ @ @ @ 
@ @ @ @ @ @ . . . . . . . . . . . . . . . . . . @ 
@ @ @ @ @ @ @ . @ . @ . @ . @ . @ . @ @ . @ . @ @ 
@ @ @ @ @ @ . @ @ @ . . . @ @ . . @ @ @ . @ . . @ 
@ @ @ @ @ @ . @ @ @ @ . @ . . . @ . @ . . . @ . @ 
@ @ @ @ @ . . @ @ @ @ @ . . @ . . . . @ . @ . . @ 
@ @ @ @ @ @ . . @ @ @ @ @ . . @ . @ . . @ . @ . @ 
@ @ @ @ @ . . @ . @ . @ . . @ . . @ . @ . . . . @ 
@ @ @ @ . @ . . . . . . . @ @ @ . . @ @ @ . @ . @ 
@ @ @ . . . @ @ . @ . @ @ @ . @ @ . . @ . . @ . @ 
@ @ . @ . @ @ @ @ . @ @ . . . . . . @ @ . @ . . @ 
@ . . . . . @ @ @ . @ @ @ . @ @ @ . . @ . @ @ . @ 
@ @ @ @ . @ . @ . . . . . . @ @ . @ . . @ . @ @ @ 
@ @ . . . @ . @ . @ . @ @ . @ . . . . @ . . . @ @ 
@ . @ @ . . . . . . @ . @ @ @ @ . @ . . . @ @ @ @ 
@ . @ . @ . @ . @ . @ . @ . @ @ . . @ . @ @ @ @ @ 
@ . . . . @ . . @ @ . . . . . . . @ . @ @ @ @ @ @ 
@ . @ . @ . @ . . . @ @ . @ . @ . . . @ @ @ @ @ @ 
@ @ . . . . . . @ @ @ . @ . . . @ . @ . . @ @ @ @ 
@ . @ @ . @ @ . @ . . . . . @ @ . . @ . @ . @ . @ 
@ . . . . @ . . . @ . @ . @ . . @ . . . . . . . @ 
@ @ @ . @ . @ . @ @ @ @ . @ @ . . . @ . @ @ @ . @ 
@ @ . . @ . @ . . @ . . . @ . . @ . . @ @ @ @ . @ 
@ . . @ . . . . @ @ @ @ . @ @ . . @ @ @ @ @ @ @ @ 
@ @ @ @ @ @ @ @ @ @ @ @ @ @ @ @ @ @ @ @ @ @ @ @ @ 
3
16 7 17 1
6 14 18 2
15 19 14 18
