25 25
@ @ @ @ @ @ @ @ @ @ @ @ @ @ @ @ @ @ @ @ @ @ @ @ @ 
@ @ . . @ . . @ . @ . . . @ . @ @ @ @ @ @ @ @ @ @ 
@ @ @ . . . @ . . . . @ . @ . . @ @ @ @ @ @ @ @ @ 
@ @ . . @ . . @ . @ . @ . . . @ . . . @ @ @ @ @ @ 
@ . @ . . @ @ @ @ @ @ @ . @ . . @ . @ @ @ @ @ @ @ 
@ . . . @ . . @ @ @ . . . . @ . . . @ @ @ @ @ . @ 
@ . @ . @ @ . @ @ . . @ . @ @ @ . @ @ @ @ @ . . @ 
@ @ @ . @ @ . . . . @ . . @ @ @ . @ . @ . . @ . @ 
@ @ @ . . . @ . @ . . @ . @ @ @ . . . . . @ . . @ 
@ @ . . @ @ @ @ . . @ @ . @ @ . @ . @ . @ @ . @ @ 
@ . . @ . . . @ @ . @ . @ . @ . . . . @ . . . . @ 
@ @ . @ @ . @ @ . @ @ . @ . . . @ . @ @ @ . @ @ @ 
@ . . . . . . . . . . . . . @ . @ . . . . . . @ @ 
@ @ . @ . @ @ . @ . @ . @ . . @ . . @ . @ . @ . @ 
@ . . . @ . . . @ . . @ . . @ . @ . . @ . . . . @ 
@ @ . @ . @ . @ . . @ . @ @ . . . . @ @ . @ . @ @ 
@ @ @ . . . . . @ . . . . . @ . @ . . @ @ @ . . @ 
@ @ . @ . @ . @ @ . @ @ . @ @ . . @ . . . . @ . @ 
@ . . . . . @ . . . . . @ @ @ @ . . @ . @ . . @ @ 
@ @ . @ . @ @ . @ . @ @ . . @ @ . @ @ . @ . @ @ @ 
@ . . @ @ . . . @ . . . @ . . @ . @ . . . @ @ @ @ 
@ @ . @ . . @ . . @ @ . @ . @ . . . @ . @ @ @ @ @ 
@ @ @ . . @ . . @ @ @ @ @ . . . @ . . @ @ @ @ @ @ 
@ @ @ @ . @ @ . . @ @ . . . @ . . @ . . @ @ @ @ @ 
@ @ @ @ @ @ @ @ @ @ @ @ @ @ @ @ @ @ @ @ @ @ @ @ @ 
3
3 6 17 21
6 1 12 5
14 1 17 9
