10 10
@ @ @ @ @ @ @ @ @ @ 
@ @ . @ @ @ . @ @ @ 
@ @ . . @ @ . @ . @ 
@ @ . @ . . . . . @ 
@ . . . @ . @ . @ @ 
@ . @ . . . . @ @ @ 
@ . @ . @ . @ . . @ 
@ . @ @ . . . @ . @ 
@ @ @ @ @ @ . . . @ 
@ @ @ @ @ @ @ @ @ @ 
3
6 3 7 5
4 5 3 7
2 2 6 5
