50 50
@ @ @ @ @ @ @ @ @ @ @ @ @ @ @ @ @ @ @ @ @ @ @ @ @ @ @ @ @ @ @ @ @ @ @ @ @ @ @ @ @ @ @ @ @ @ @ @ @ @ 
@ @ @ @ @ . @ @ @ @ . . . . @ @ . . . . . . . . . . . . . . . @ @ @ . . @ @ @ @ @ @ @ @ @ @ @ @ @ @ 
@ . . @ . . . @ . . @ . @ . . . . @ @ . @ . @ . @ . @ . @ . @ @ @ . @ . @ @ @ @ @ @ @ @ @ @ @ @ @ @ 
@ . @ . @ . @ . @ . . @ . @ . @ @ @ . . . @ @ . . @ . . . @ . @ . . . . @ @ @ @ @ @ @ @ @ @ @ @ . @ 
@ . . . . . . . . . @ . . . . . . @ @ @ . . . @ @ @ . @ @ . . . . @ @ . @ @ @ @ @ @ @ @ @ @ @ . . @ 
@ @ . @ @ @ @ . @ . @ @ . @ . @ @ . @ . . @ @ . . @ @ . . @ . @ @ . . . @ @ @ @ @ @ @ @ . @ @ @ . @ 
@ @ . @ . @ . @ . . . . @ . . @ . . . @ @ @ . . @ . . . @ . @ . . . @ @ . @ @ @ @ @ @ . . . @ . . @ 
@ . @ . . . . . . @ . @ . @ . . @ . @ . @ . @ . . . @ . . . . @ @ . @ @ . @ @ @ @ @ . @ . @ . @ . @ 
@ . . . @ . @ . @ . . . . . . @ . . . . @ . . @ . @ . . @ . @ . . . . . . . @ @ @ . . . . . . . . @ 
@ . @ . . @ . . @ . @ . @ @ . @ . @ . @ @ . @ . @ . @ . . @ @ . @ @ . @ @ . @ @ @ @ @ . @ @ . @ . @ 
@ @ @ @ @ . @ . @ @ @ @ . . . . . . @ . @ . @ . @ . @ . @ @ . . . @ @ @ @ @ . . . . . . . . @ . . @ 
@ @ @ @ @ . . . . @ . @ @ @ . @ @ @ . . . . . . . . . . . . . @ @ . . @ @ @ @ . @ . @ @ @ @ @ @ . @ 
@ @ @ @ @ . @ . @ @ . @ @ . . . @ . @ . @ . @ . @ . @ . @ . @ @ @ . @ @ @ @ @ @ . . @ @ @ . @ @ . @ 
@ @ @ @ . . @ @ . @ . @ . @ . @ . . . @ @ @ . . . @ . . . @ . @ . . . @ @ @ @ @ @ @ @ . @ . @ . . @ 
@ @ @ @ @ . @ . . . . . . . . . @ . @ @ @ @ . @ . @ @ . @ @ . . @ . @ . @ . . @ . . @ . @ . . @ . @ 
@ @ @ @ @ @ @ @ . @ . @ @ @ @ . . . . . . . @ . @ @ @ . @ . @ . . . . . . . @ @ @ . . . . . @ . . @ 
@ @ @ @ @ @ @ @ @ . . . @ . @ @ @ @ . @ . @ . . . @ @ . @ . . @ @ . @ @ @ . . . . . @ @ @ . . . @ @ 
@ @ @ @ @ @ @ @ @ @ @ @ . . . . @ . @ . . . @ . @ . @ . @ . @ @ @ @ . . . . @ . @ . . @ . . @ @ @ @ 
@ @ @ @ @ @ @ @ @ @ . @ @ . @ @ . . . . @ . . . . . . . . . . @ @ @ . @ . @ @ @ . . @ . @ . . @ @ @ 
@ @ @ @ @ @ @ @ . . . . . . . @ @ . @ . . @ . @ . @ . @ . @ . . @ . @ . . . @ @ @ @ . . @ . @ @ @ @ 
@ @ @ @ @ @ @ @ . @ . @ @ . @ @ @ @ . . @ @ . @ @ . @ . . . @ @ . . . @ . @ @ . @ . @ . @ . @ @ . @ 
@ @ @ @ @ @ @ @ . @ . @ @ . . @ @ @ @ . @ . @ @ . . . @ @ . @ @ @ . @ . @ @ . . @ . . . . . @ . . @ 
@ @ @ @ @ . @ . . @ @ . . . @ . @ @ @ @ . . @ @ @ @ . @ . . . @ . . @ . @ @ @ . . @ @ . @ . . @ . @ 
@ @ @ @ . . . @ . . . @ @ . . . @ @ @ . @ . . @ @ . . . @ . @ @ @ . . . . @ . . @ @ @ @ . . @ . . @ 
@ @ @ @ @ . @ . @ . @ . @ @ . @ . . . . . . @ @ . @ . @ . . . @ . . @ . @ @ . @ . . @ . @ . @ . @ @ 
@ . @ . @ . . . @ . @ . @ . . @ @ @ @ @ . @ . . . . . . @ . @ . @ . . @ . @ . . . @ . . @ . . . . @ 
@ . . . . @ @ . . . . . . @ @ . . . @ @ . @ . @ . @ @ . . . . . . . @ @ . @ . @ . . @ . . . @ @ . @ 
@ . @ . @ . @ @ . @ . @ @ . @ @ . @ @ . . . @ @ . @ . . @ . @ . @ . @ . . . . . @ . @ . @ . . @ . @ 
@ @ . . . . @ . . . @ @ . . . . . @ . @ @ . . . @ . @ @ . @ . . @ . . @ . @ . @ . . . @ . . @ . @ @ 
@ . . @ @ @ . . @ @ @ @ @ . @ @ . . . @ . @ . @ @ . @ . . @ @ @ . @ . . . @ @ . @ . @ . @ . . . . @ 
@ @ . . @ . . @ . @ @ @ . @ . @ @ @ . . . . . . . . . @ . . @ @ . @ . @ . @ . . . @ . . @ . @ . @ @ 
@ . . @ . @ . . . . @ . . . . . @ . . @ . @ . @ . @ . . . @ . . . . . . @ . @ . @ @ @ . @ . . @ @ @ 
@ @ . . . . . @ @ @ . @ . @ . @ . @ @ . . @ . @ @ @ . @ . . . @ . @ . @ @ . . . . @ . . @ . @ . @ @ 
@ @ @ @ @ @ . @ . @ . . . . @ . . @ . @ @ . @ . @ . @ . @ . @ @ @ . . @ . @ @ . @ . @ . . . @ . . @ 
@ @ @ @ @ . . @ . . . @ . @ . @ . . . @ . . . . . . . . . . @ @ . @ . @ . @ . . . . . @ . @ . . @ @ 
@ @ @ @ @ @ . . @ . @ . @ . . . . @ . @ . @ . @ @ @ @ . @ . . @ . . . @ . . @ . @ @ . @ . . . @ @ @ 
@ @ @ @ @ . . @ . . . . . @ @ . @ @ . . @ . . . @ . @ @ . @ @ . @ @ . . @ . . . @ . @ . . @ @ . @ @ 
@ @ . . @ @ . . . @ @ . @ . @ @ @ . . @ . @ . @ . . . . . @ . . @ . . @ @ @ @ . @ . @ @ . . . . . @ 
@ @ @ . . . . @ @ @ @ @ . . . @ . @ . @ . @ . @ . @ . @ @ . @ . . @ . . @ . . . @ . . . . @ . @ . @ 
@ @ . @ @ @ . . @ @ @ . @ @ . . . . . . . . @ . . . @ @ @ . . @ . . . @ . @ @ . . . @ @ @ . . . @ @ 
@ . . . . . @ . . . @ . . . . @ . @ . @ . @ @ @ . @ @ @ . @ . . @ @ . @ . @ . @ . @ @ . . @ . @ @ @ 
@ @ @ . @ . . . @ . @ . @ @ . @ @ . . . @ @ @ . . . @ . . . @ . @ . . . . . . . . @ @ . @ @ . @ @ @ 
@ @ @ @ . @ @ . @ . . . @ @ @ . . @ . @ . @ . @ . @ . . @ . . . . @ . @ . @ . @ @ @ @ . . @ @ . @ @ 
@ @ @ @ . . @ . @ . @ . . @ @ @ . . . . . . . . . . . @ @ . @ @ . . @ @ @ . . . @ @ . @ . . . . . @ 
@ @ @ @ . @ . @ . @ . . @ @ @ . @ . @ . @ . @ @ @ @ @ . . . @ . . @ . @ . @ @ . . . . . @ . @ . @ @ 
@ @ . . . . . @ . @ @ . @ @ @ . @ . @ . . @ . . . . . . @ . @ @ . @ . @ . @ @ . @ @ @ @ . @ . . . @ 
@ @ @ @ . @ . . . . @ @ . . . . . @ @ . @ . @ . @ . @ . . @ . . . . . . . . . . . @ . . . . @ . @ @ 
@ @ @ @ @ . @ @ . @ . @ @ @ @ . @ @ . @ @ . @ . . @ . . @ . @ @ . @ @ . @ . @ . @ . @ . @ . . . . @ 
@ @ @ . . . . . . . . . . . . . . . . . . . . . @ @ @ . . . @ . . @ . . . @ . . . . . . . @ . @ . @ 
@ @ @ @ @ @ @ @ @ @ @ @ @ @ @ @ @ @ @ @ @ @ @ @ @ @ @ @ @ @ @ @ @ @ @ @ @ @ @ @ @ @ @ @ @ @ @ @ @ @ 
3
12 21 1 11
8 29 15 42
14 40 43 22
