12 12
@ @ @ @ @ @ @ @ @ @ @ @ 
@ @ @ @ . . . . @ . @ @ 
@ @ @ . . @ @ . @ . . @ 
@ . @ @ . . . @ . . @ @ 
@ . . @ @ . @ . @ . . @ 
@ @ . @ . . . . . . @ @ 
@ . . @ @ @ @ . @ @ @ @ 
@ @ . . . @ . . . @ @ @ 
@ @ . @ @ . @ . @ @ @ @ 
@ . . . . . . . @ @ @ @ 
@ @ . @ . @ . @ @ @ @ @ 
@ @ @ @ @ @ @ @ @ @ @ @ 
3
2 10 6 1
1 9 1 4
1 6 9 7
