50 50
@ @ @ @ @ @ @ @ @ @ @ @ @ @ @ @ @ @ @ @ @ @ @ @ @ @ @ @ @ @ @ @ @ @ @ @ @ @ @ @ @ @ @ @ @ @ @ @ @ @ 
@ @ . @ @ . @ . @ @ @ @ @ @ @ @ @ @ @ @ @ . . . . . . @ @ @ @ @ @ @ . @ @ . @ . @ . @ . @ . @ . @ @ 
@ . . . . . . . . . @ @ @ @ @ @ @ @ @ @ . @ @ @ . @ . . @ @ @ @ @ . . @ . . . . . . . . . . . . . @ 
@ . @ . @ @ @ . @ @ . @ . @ @ @ @ @ @ . . . @ . . @ . @ @ @ . @ . . @ . . @ @ . @ . @ . @ . @ . @ @ 
@ @ . @ @ . . . . . . . . @ @ @ . @ @ . @ . . @ @ . . . @ . . . @ . . @ . @ . @ . . . @ . . . @ @ @ 
@ . . @ . @ @ @ @ @ . @ . . @ . . . . @ . . @ @ . @ . @ . @ @ . . . @ . . . . . @ . @ . @ . @ . . @ 
@ @ . . . . . . . . @ @ . @ . @ @ . @ . @ . @ . . . . . . @ . @ @ . @ . @ @ @ @ @ . . . . @ @ . @ @ 
@ . . @ . @ @ . @ . @ . . . . . . . . . . . . . @ @ . @ . . . . @ . . . . @ @ @ @ @ . @ . . . . @ @ 
@ @ . . @ @ @ @ . . . . @ . @ @ . @ . @ . @ . @ @ . . . @ . @ . . . @ . @ @ @ @ @ @ @ . . @ . @ @ @ 
@ @ . @ @ @ @ @ @ @ @ . . @ . . . . @ @ @ . @ . . @ . @ @ @ . @ @ . . @ @ @ @ @ @ @ @ @ . . @ @ @ @ 
@ . . @ @ @ . . @ @ @ . @ @ @ @ . @ . @ @ . . @ . . @ @ @ . . . . @ . . @ @ @ @ @ @ @ @ . @ @ @ @ @ 
@ @ . . . . . @ . @ . @ . @ . . . @ . . . . @ . . @ @ @ @ . @ . @ @ . @ . . . @ @ @ . . @ @ @ @ @ @ 
@ @ . @ . @ . . . . . @ . @ @ . @ . @ @ . @ . . @ . @ @ . @ . . . . . . . @ . . @ . @ . . . . . . @ 
@ . . @ . . @ @ . @ @ @ . @ . @ . . @ . . @ @ . . . . . . . . @ . @ . @ @ . . @ . . @ @ . @ . @ @ @ 
@ @ . @ . @ . . . . @ . . . . . @ . . @ . @ . . @ . @ @ . @ . @ . @ . @ . @ . @ . @ @ @ . . @ @ @ @ 
@ . . @ . @ . @ . @ @ @ . @ . @ @ @ . @ . @ . @ . . . @ @ @ . @ @ @ @ . . . . . . @ . . . @ . @ @ @ 
@ . @ @ @ @ . @ @ @ . . . . @ @ @ @ . . . . . @ @ . @ . @ . @ @ @ @ @ . @ @ @ . @ . . @ . . . . . @ 
@ @ . @ . . @ @ @ . . @ . @ . @ @ . @ . @ . @ . . . . . . . . . @ . . . . @ . . . . @ . . @ . @ . @ 
@ . . @ . @ . @ . @ . . @ . . . . . . . . @ . . @ . @ @ @ . @ . @ . @ @ @ @ @ @ @ . . @ . . @ . . @ 
@ @ . . . . . . . @ @ . . @ . @ . @ @ . @ @ @ . . @ @ . . . . @ . @ @ @ @ @ @ @ @ @ @ @ . @ @ @ . @ 
@ @ . @ . @ . @ @ @ . @ . . . @ @ . . . @ @ . @ . . . @ @ . @ @ . . @ @ @ @ @ @ @ @ . . . . . @ . @ 
@ @ . . @ . . . . . . . . @ . . . @ @ . @ . . . . @ @ . . . @ . . @ @ @ @ @ @ @ @ @ . @ . @ . . @ @ 
@ . . @ @ @ . @ . @ . @ . @ . @ . . . @ . @ . @ . . @ . @ . @ @ . . @ @ @ @ @ @ @ . . . @ . . @ @ @ 
@ @ . @ @ @ @ @ @ . . . @ . . . @ @ @ . . . . @ . @ . @ . . . @ @ . . @ @ @ @ @ @ @ @ . @ . @ . @ @ 
@ @ @ @ @ @ @ @ @ @ . @ . @ @ @ . . . . @ . @ . . . . . @ . @ @ @ . @ . @ . @ @ . @ @ . @ . . . . @ 
@ @ @ @ @ @ @ @ @ . @ . . . . . . @ . @ @ @ @ @ . @ . @ . . . . . . . . . . . @ . . . @ . . @ @ @ @ 
@ @ @ @ @ @ @ . . . . @ . @ . @ . @ . . @ @ @ . . . @ @ @ . @ . @ @ . @ @ @ . . . @ @ @ @ . . @ . @ 
@ @ @ @ @ @ . @ @ @ . . . @ . . @ . . @ @ @ . @ . @ @ @ @ @ @ . . . @ . . . . @ . . . @ . . @ . . @ 
@ @ @ @ . . . . . . . @ . . @ @ . . @ @ @ . . . . @ @ @ . @ @ . @ @ . . @ . @ @ . @ @ . @ @ . . @ @ 
@ @ @ @ @ . @ . @ . @ . . @ @ @ @ . . @ . @ @ . @ @ @ . . . . . . @ @ . . @ @ . . . @ . . @ @ . . @ 
@ @ @ @ . @ @ . @ @ . . @ . @ . . . @ . . . . @ @ @ . @ @ . @ . @ @ . . @ @ @ @ @ @ @ @ . . . . @ @ 
@ @ . . . . . . . @ . @ . . . . @ . . . @ . @ . . . . . @ . . @ @ . @ . . @ @ @ @ @ @ @ @ . @ . . @ 
@ . @ . @ . @ . @ @ . @ @ . @ . . @ . @ . @ @ @ . @ @ . @ . @ . @ . @ . @ . @ @ @ . @ @ @ @ @ . @ @ 
@ . . . @ . . @ . . . @ . @ . . @ @ . . . . . . @ @ . . . . . . . . . @ @ . . . . . @ @ @ @ . . . @ 
@ . @ @ . . @ @ . @ . . . . @ . @ . . @ @ . @ @ . . @ . @ . @ . @ . @ @ @ . @ . @ . . . . . @ . @ @ 
@ . @ . @ . . . @ . . @ . @ . @ @ @ @ . . . @ @ @ . . @ . . . @ . . . . @ . . @ @ . @ . @ . . . . @ 
@ . @ . . . @ . . @ @ . . . . @ @ @ @ . @ . @ @ . @ . @ @ . @ @ @ . @ . . . @ @ . . . @ . . @ . @ @ 
@ @ @ @ . @ @ . @ . . @ . @ . . @ @ . . @ . . . . . . . @ @ . @ @ @ . . @ @ @ . @ . @ . @ . . @ @ @ 
@ @ . @ @ @ . @ . . @ . . @ . @ . @ . @ . . @ . @ @ . @ @ . . . . . . @ . . . . . @ . . . . @ . @ @ 
@ . . . . . . @ . @ . @ . . @ . . . . @ @ . . @ . . . . @ @ . @ . @ . @ . @ . @ . @ @ . @ . . . . @ 
@ @ . @ . @ . . . . . . . @ . @ . @ @ . . . @ @ . @ . @ @ . @ . . @ . . . @ @ . @ . . @ @ . @ . @ @ 
@ . @ @ @ . @ . @ . @ . @ . . . @ . . . @ . . @ @ . . . @ . . . @ . . @ . . . . . . @ . @ @ . . @ @ 
@ . . . . . . . @ @ . . @ @ . @ @ . @ . @ . @ . @ @ . @ @ @ @ @ . @ . . @ . @ . @ . . . . . @ @ @ @ 
@ @ @ . @ @ . @ @ . . @ . . . . . . @ . @ . . . . . @ . @ @ . . . . . @ . @ @ . . @ . @ . @ @ @ @ @ 
@ . . @ . . . . @ @ . . @ . @ . @ . @ . @ . @ . @ . . . @ . . @ . @ . . . . . @ . @ . . @ @ @ @ @ @ 
@ @ . . . @ . @ . @ @ . @ . . @ . . . @ . . . @ . . @ @ @ @ . . @ . . @ . @ . . @ @ @ . . @ @ @ @ @ 
@ . @ . @ . . . . @ @ @ . . @ . @ . @ . @ . @ @ @ . @ . @ . @ @ . @ . @ @ . . @ . @ . . @ @ @ @ @ @ 
@ . . . @ @ . @ @ . . . . @ . . . . @ . . . . . . @ . . . . . . . . . . . @ @ . . . @ . @ @ @ @ @ @ 
@ @ @ @ . . . . @ . @ @ . @ @ . @ . . @ . @ @ . @ @ @ . @ @ . @ . @ . @ . . . . @ . @ . @ @ @ @ @ @ 
@ @ @ @ @ @ @ @ @ @ @ @ @ @ @ @ @ @ @ @ @ @ @ @ @ @ @ @ @ @ @ @ @ @ @ @ @ @ @ @ @ @ @ @ @ @ @ @ @ @ 
3
33 22 34 27
7 11 12 47
21 14 12 36
