50 50
@ @ @ @ @ @ @ @ @ @ @ @ @ @ @ @ @ @ @ @ @ @ @ @ @ @ @ @ @ @ @ @ @ @ @ @ @ @ @ @ @ @ @ @ @ @ @ @ @ @ 
@ . @ @ @ @ . . . @ . @ . @ @ . . . . @ . @ . @ . @ @ @ @ @ @ @ @ . @ @ . . . @ @ . . . . @ . @ @ @ 
@ . . @ @ @ . @ . . . . . . . . @ . @ @ . . . . . @ @ @ @ @ @ . . . @ . . @ . @ @ @ . @ . @ . . @ @ 
@ . @ @ @ . . . @ . @ @ @ @ @ @ . @ . . . @ . @ . . . @ @ @ . @ @ . . @ . . @ . @ . . . @ . . @ @ @ 
@ . @ @ . @ . @ @ @ . . . . . . . @ . @ . @ . . @ . @ . @ . . . . . @ @ . @ . . . @ . @ . @ . @ @ @ 
@ . . . . . . . @ . . @ . @ . @ @ @ @ . . . @ @ . @ . . . @ . @ . @ . . . . @ . @ . . . . . . . . @ 
@ . @ . @ @ @ . @ . @ . @ . . @ @ @ . @ . @ . @ . . . @ @ . . . @ . . @ @ @ @ . . . @ @ @ @ @ . @ @ 
@ . . @ . . . . . . . . . @ . . . . . . . . . . @ . @ . @ . @ @ . . @ . . @ . . @ @ . @ . . @ . . @ 
@ . @ . @ @ @ . @ . @ @ @ . . @ . @ @ . @ . @ . . . . . . . . . . @ . @ . . . @ . . . . @ . . @ . @ 
@ @ . . . . @ . . @ @ @ @ @ . @ . @ . . . @ @ . @ . @ . @ . @ . @ . . . . @ @ . . @ @ @ . . @ @ @ @ 
@ . . @ @ @ . . @ . @ @ . . . . @ @ @ . @ @ @ . . @ @ . . @ . . @ . @ @ @ . @ . @ . @ @ . @ . @ . @ 
@ @ . . . . . @ @ . . . @ @ . @ . @ @ . @ @ . . @ @ @ . @ . @ . . . . . . . . . . . . . . . . . . @ 
@ @ @ @ @ . @ . @ . @ . . @ . . . . . @ . . @ . . . . @ . . . . @ . @ @ . @ . @ . @ . @ . @ . @ @ @ 
@ . . . . . . . . . @ @ . . @ . @ . @ @ @ . . . @ . @ @ . @ . @ . . . . @ . . . @ @ . . @ @ . @ @ @ 
@ . @ . @ . @ . @ . @ . @ @ . @ . @ @ @ @ @ . @ . @ . . . . @ . @ . @ . @ @ . @ . @ . @ . . . . @ @ 
@ . . @ . . . @ . . . . . . . . . @ @ @ @ @ @ . . . . @ . @ . . . . . @ . . . . . . @ @ @ @ @ . . @ 
@ . @ . @ . @ . @ . @ . @ . @ . @ . . @ . @ . @ . @ @ . . . @ . @ . @ @ . @ . @ . @ @ @ @ . . . @ @ 
@ @ . . . . @ . . . . @ @ . . @ . @ . . . . . . . . @ @ . @ @ @ . . . @ @ . . . @ . @ @ . @ @ . . @ 
@ . . @ . @ @ @ . @ . . . @ @ . . @ @ @ . @ . @ . @ . @ . . . @ @ . @ . . @ . @ . . @ . . . . . @ @ 
@ . @ . . . @ @ @ @ @ @ . . . . @ . @ @ @ . . @ @ . . . . @ . @ @ @ @ @ . . @ @ @ . . @ @ . @ . . @ 
@ . @ @ . @ . @ @ @ . @ . @ @ . @ . . @ @ . @ . . . @ @ . . @ . @ . @ . . @ @ @ . @ . @ @ . . @ @ @ 
@ @ . . . . . . . . . @ . . . @ . @ . @ @ @ . @ . @ . . . @ . . . . . @ . . @ @ . . . @ . . @ . @ @ 
@ . . @ . @ . @ @ . @ . . @ . . . . . . @ @ . . @ . @ @ . . . @ . @ . @ . @ . @ @ @ . @ @ . . . . @ 
@ @ . @ . . @ @ @ @ @ @ . . @ . @ @ . @ . . @ . . . . . @ @ . @ . @ . . . . . @ @ @ . . @ . @ . @ @ 
@ . @ . . @ @ @ @ @ @ @ @ . @ . . @ @ @ . @ . @ @ @ . @ @ @ @ @ @ @ @ @ . @ . . @ . . @ @ . . @ @ @ 
@ . . @ . . @ @ @ @ . @ @ . . @ . . . . . . . . @ . . @ @ @ @ @ . . . . @ . . @ . @ . @ @ . @ @ @ @ 
@ @ . @ . @ @ @ @ . . . @ @ @ . . @ . @ @ . @ . @ @ . . @ @ @ . . @ . @ . @ . . . . . . . @ . . @ @ 
@ . . . . @ @ @ @ @ . @ . @ . @ . @ . . . @ @ . . @ . @ @ . . . @ . . . . . . @ @ @ . @ . . @ . @ @ 
@ @ . @ . . . . . . . . . . . @ @ @ . @ @ @ . . @ . . . @ @ @ . @ @ . @ @ . @ . @ . . . @ . . . . @ 
@ @ @ @ . @ @ . @ . @ . @ . @ @ @ . @ @ . @ @ . . @ . @ . . @ @ . . . @ @ . . . . @ . @ . . @ @ . @ 
@ @ . . . @ @ . . @ @ . . @ . . . . . . . . . . @ @ . @ . @ . . . @ . @ @ . @ . @ . @ . . @ @ . . @ 
@ @ @ @ . . . @ . . . @ . @ . @ . @ . @ @ . @ . . . . . . . @ @ . @ @ . . . . @ . . @ @ . . . @ . @ 
@ @ @ @ . @ . . @ . @ @ . @ @ @ @ @ @ . . . . @ . @ . @ . @ . . @ . . . @ . @ . @ . @ . @ @ . . @ @ 
@ . . . . . @ . . @ . . . . @ @ @ @ . @ @ . @ @ . . @ @ @ . @ . . . @ @ . . . . . . . . . . @ . . @ 
@ . @ . @ . . @ @ . . @ . @ . @ . @ . . . @ . . . @ . @ @ . . . @ . @ . @ . @ . @ . @ @ . @ @ . @ @ 
@ @ . . . @ @ @ . . @ . . . . . . . . @ . . @ @ . . . . . @ @ . . @ . . @ . @ . . @ . . . . . @ @ @ 
@ . @ . @ @ . @ @ @ . . @ . @ . @ . @ @ @ @ . . . @ . @ . . @ . @ . @ . @ . @ @ . @ . @ . @ . . @ @ 
@ . . . . . . . @ . @ . @ . @ @ @ . . @ @ @ @ @ . . @ @ . @ @ @ @ . . . . . . . @ . @ . . . @ . @ @ 
@ . @ . @ . @ @ @ . . . @ . . . . @ . @ @ . . . @ . . . @ . @ . . . @ . @ . @ . @ . . @ . @ . . . @ 
@ @ . . . @ @ . . @ @ . @ . @ @ . . @ . . @ . @ . @ . @ . . . @ @ . @ @ . . . @ . . @ . . @ . @ @ @ 
@ @ . @ . . . @ . @ @ . @ . . . @ . @ @ . . . . . . . @ @ . @ . @ @ @ @ . @ @ @ . @ . @ . . @ . @ @ 
@ . . @ . @ . . . . @ . . @ . @ . @ @ . . @ . @ . @ . . . . . . . @ @ @ @ . . . . . . . . @ @ . . @ 
@ @ . @ . . @ @ . @ . . @ @ @ @ . @ . @ @ . . . @ . . @ . @ @ . @ @ @ @ @ @ . @ . @ . @ . @ . . @ @ 
@ . @ @ . @ . @ @ @ . @ . . . . . . . . . @ . @ @ @ . . @ @ . . @ @ @ @ @ @ @ . . @ . @ @ . @ . @ @ 
@ . . . . . . . @ . @ @ . @ . @ @ @ . @ . @ . @ . . . @ . @ @ . . @ @ @ @ @ . . @ @ . . . . . . . @ 
@ . @ @ . @ @ . . . @ . . . @ @ @ @ @ @ @ . . . @ @ . . . . . @ . . @ . @ . @ . @ . . @ . @ @ . @ @ 
@ @ . . . . . @ . @ . @ . @ . @ @ @ @ @ @ @ . @ @ @ @ @ . @ @ . . @ . . . . . @ @ @ . . @ @ @ . . @ 
@ . . @ @ . @ . . . . . . . . . @ @ @ @ . @ . . @ @ @ @ @ @ @ @ . . . @ @ . @ @ @ @ . @ @ @ @ @ @ @ 
@ @ @ . . . . @ . @ . @ . @ . @ @ @ @ . . . . @ @ @ @ @ @ @ @ @ @ . @ @ @ . @ . . . . @ @ @ @ @ @ @ 
@ @ @ @ @ @ @ @ @ @ @ @ @ @ @ @ @ @ @ @ @ @ @ @ @ @ @ @ @ @ @ @ @ @ @ @ @ @ @ @ @ @ @ @ @ @ @ @ @ @ 
3
8 1 30 39
39 4 41 30
42 44 16 47
