25 25
@ @ @ @ @ @ @ @ @ @ @ @ @ @ @ @ @ @ @ @ @ @ @ @ @ 
@ @ @ @ @ . @ . . @ @ @ @ @ @ . @ @ @ @ @ @ @ @ @ 
@ @ @ @ . . . . @ . @ @ @ @ . . @ @ @ @ @ @ @ @ @ 
@ @ @ @ @ . @ . . . . . @ @ @ . . @ @ @ @ @ @ @ @ 
@ @ @ @ @ @ . @ @ . @ @ . @ @ . @ . @ @ @ @ @ @ @ 
@ @ @ . @ . . . . . . . . . . . . . . @ . . . . @ 
@ . . . . @ . @ @ @ . @ . @ . @ @ . @ . . @ . @ @ 
@ @ . @ . . . @ . @ . . @ . @ . @ @ . . @ . . @ @ 
@ @ . @ . @ . . . . @ @ . . . . . . . @ @ @ @ @ @ 
@ . . @ . @ . @ . @ @ . @ . @ @ @ @ @ . @ @ . . @ 
@ @ @ . . . @ @ . . . . . . . . . @ @ . @ . . @ @ 
@ . . . @ . . @ . @ . @ @ . @ . @ . @ . . . @ . @ 
@ . @ @ . . @ . . . @ . . . . @ . . . @ . @ . . @ 
@ @ . . @ @ . @ . @ . @ @ @ @ . @ . @ @ . @ . @ @ 
@ . . @ . @ . . . . . . . . . . . . . @ . . . @ @ 
@ @ . . . . @ @ . @ . @ . @ . @ . @ . @ . @ @ @ @ 
@ . @ @ . @ @ @ . . @ . . . @ . . . @ . . . . . @ 
@ . . . . . @ . . @ . @ . @ . . @ @ . . @ . @ @ @ 
@ @ . @ @ . . . @ . . . . @ @ @ . @ . @ . @ @ @ @ 
@ . @ . @ @ @ . @ . @ @ . . . . . . . . . . . @ @ 
@ . . . . . . . @ @ @ . . @ . @ . @ @ @ . @ @ @ @ 
@ . @ . @ @ @ . . . . @ @ . . . @ . @ . @ @ @ @ @ 
@ @ . . . @ . . @ . @ @ @ @ . @ . . . . @ @ @ @ @ 
@ @ @ . @ . . @ . . . . . @ . . . @ . @ @ @ @ @ @ 
@ @ @ @ @ @ @ @ @ @ @ @ @ @ @ @ @ @ @ @ @ @ @ @ @ 
3
5 5 6 12
15 16 15 14
12 12 14 17
