12 12
@ @ @ @ @ @ @ @ @ @ @ @ 
@ @ @ @ @ @ . @ @ @ . @ 
@ @ @ @ @ . . . . . . @ 
@ @ @ @ . @ . @ . @ @ @ 
@ @ @ . . @ @ . . . . @ 
@ @ . @ . @ @ @ . @ . @ 
@ . . . . . @ . . . @ @ 
@ @ . @ . @ . @ . @ . @ 
@ @ @ . . . . . . . . @ 
@ @ @ @ . @ . @ . @ . @ 
@ @ @ @ @ . . . @ . . @ 
@ @ @ @ @ @ @ @ @ @ @ @ 
3
9 10 2 5
7 10 4 7
4 9 8 4
