10 10
@ @ @ @ @ @ @ @ @ @ 
@ @ . . . @ . . @ @ 
@ . . @ @ . @ . . @ 
@ . @ @ . . . @ . @ 
@ . . . @ @ . . . @ 
@ . @ . @ . @ @ . @ 
@ @ . . . . @ . . @ 
@ . @ @ . @ . @ . @ 
@ . . . . . . . . @ 
@ @ @ @ @ @ @ @ @ @ 
3
2 8 5 5
8 1 3 8
4 7 1 2
