10 10
@ @ @ @ @ @ @ @ @ @ 
@ @ @ @ . @ @ @ @ @ 
@ @ @ @ . . @ @ @ @ 
@ @ @ . . @ . @ @ @ 
@ @ @ @ . . . . @ @ 
@ @ . @ . @ . @ . @ 
@ . . . . . @ @ . @ 
@ . @ @ . @ . . . @ 
@ @ . . . . . @ . @ 
@ @ @ @ @ @ @ @ @ @ 
3
8 4 8 3
7 6 5 6
8 2 4 7
