50 50
@ @ @ @ @ @ @ @ @ @ @ @ @ @ @ @ @ @ @ @ @ @ @ @ @ @ @ @ @ @ @ @ @ @ @ @ @ @ @ @ @ @ @ @ @ @ @ @ @ @ 
@ . . . @ @ @ @ @ @ @ @ @ . @ . . . @ @ . @ . . . . . . . . @ . @ . @ . @ . @ @ @ @ @ @ @ @ @ @ @ @ 
@ @ @ . @ @ @ @ @ @ @ @ @ . . @ @ . @ . . @ @ . @ . @ @ @ . . . . . . . . . . @ @ @ @ @ @ @ @ @ @ @ 
@ . . . . . @ @ @ @ @ @ . @ . @ . . @ @ . . . . . @ . . @ . @ @ @ . @ . @ . @ @ @ @ @ @ @ @ @ @ @ @ 
@ . @ . @ @ @ @ . @ . . . . . . @ . @ . @ @ . @ @ . @ . . @ . @ . @ . @ . @ @ @ @ @ @ @ @ @ @ @ @ @ 
@ @ . . @ . @ . . . . @ @ . @ . . . . . @ . . @ . . . . @ . . @ . . . . . . @ @ @ @ @ @ @ @ @ @ @ @ 
@ . @ . @ . @ . @ . @ . . . @ . @ . @ . . @ . . @ . @ @ . @ . . . @ @ . @ . @ @ @ @ @ @ @ @ @ @ @ @ 
@ . . . . . . . @ @ . . @ . @ @ . @ . @ . . @ . @ . . @ . @ @ @ . @ @ . . @ @ @ @ @ @ @ @ @ @ @ @ @ 
@ @ @ . @ . @ . @ . @ . . @ . . . . . . @ . @ . @ . @ . . . . . . . . @ . @ @ @ @ @ @ @ @ @ @ @ @ @ 
@ @ @ @ . @ @ @ . . . . @ @ @ @ . @ @ . . . . . . . . . @ @ . @ . @ @ . . @ @ . @ . @ @ . . @ @ @ @ 
@ @ @ . . . . . . @ . @ @ @ @ . @ @ . . @ @ . @ @ . @ . . @ @ . @ . @ @ . @ . . . . . . . @ @ @ @ @ 
@ . . @ . @ @ . @ . . @ . @ . . @ @ @ @ . . . @ . . . @ . . . . @ . . @ . @ @ . @ . @ . @ @ @ @ @ @ 
@ . @ . . . . @ . . @ . . . @ . . @ . . . @ . @ @ . @ . @ . @ . . . @ . @ @ . . @ @ @ @ @ @ @ @ @ @ 
@ . @ @ @ @ @ @ @ . @ @ . @ . @ . . @ . @ . . @ . . . . . @ . . @ . @ . @ . . @ . @ @ @ @ @ @ @ @ @ 
@ . . . . . @ . . . @ . . . . . @ . . @ @ . @ @ @ @ . @ . . @ . . @ . . . . @ . . . @ @ @ @ . @ @ @ 
@ @ @ @ . @ . @ . @ @ . @ . @ . . . @ . . @ @ @ . @ . . @ . . @ . . @ . @ @ . . @ @ . @ . . . @ @ @ 
@ . . . . . . . @ . @ . @ @ . @ . @ @ . @ @ . . . . . @ . . @ . @ . . . . . . @ . @ . @ . @ . @ @ @ 
@ @ . @ . @ . @ @ . . @ . . . . . . . . . @ @ . @ . @ . @ . . . . @ . @ . @ . @ . . . . @ . . . @ @ 
@ . @ @ . @ . . . @ . . . @ . @ . @ . @ . . @ @ . @ @ . @ . @ @ . @ . @ @ . @ . . @ . @ . @ . @ . @ 
@ . @ . @ @ . @ @ @ . @ . . @ @ @ . . @ @ . . . . . . . . . @ . . . @ @ . . . @ @ . . . . @ . . . @ 
@ . . . @ . . . @ @ @ . . @ . @ . @ . . . @ . @ . @ @ . @ . . @ . @ . . . @ @ . . @ . @ @ @ . @ . @ 
@ . @ @ . @ . @ . @ . @ . @ . . . . . @ . . @ . . . . @ . . @ @ . @ @ . @ . @ . @ . . . . . . . @ @ 
@ . . . . . . . . . . . . @ . @ . @ . . @ . . @ @ . @ . @ . . . @ . . . . . . . @ . @ @ . @ . @ @ @ 
@ . @ . @ . @ . @ . @ . @ . . . @ . . @ @ . @ @ @ @ . . @ . @ . . . @ . @ . @ . . . . . @ . . @ @ @ 
@ @ @ @ . . . @ @ @ @ @ . . @ . . @ . . . @ @ @ @ @ @ . . . . @ . @ @ @ . . . @ . @ . @ . @ . . @ @ 
@ . @ . @ . @ @ @ @ @ @ @ . @ . @ @ @ @ . . @ @ @ @ @ @ @ . @ @ . . . . @ . @ . @ . . . . . @ @ . @ 
@ . . . . . . @ @ @ @ @ @ @ . . . @ @ . @ @ . @ @ . @ @ . . . . @ . @ @ @ . @ . @ @ @ . @ . . . . @ 
@ @ @ . @ @ . @ @ @ @ @ @ @ @ . @ . . . . . . . . . @ . @ @ @ . . @ @ . @ @ . . . . . @ @ . @ @ @ @ 
@ @ @ @ @ . @ @ . @ @ @ . . . . @ . @ . @ . @ . @ . . . . . @ . @ @ @ . . . . @ . @ @ . . . . . . @ 
@ . @ @ . . @ . . @ . . @ . @ . . @ . . . @ @ . @ . @ . @ . . . . @ . . @ . @ . . . @ . @ @ . @ . @ 
@ . @ @ @ . . @ . . . @ @ @ . . @ @ @ . @ . . @ . @ . @ . . @ . @ . @ . . @ . @ . @ . . @ . . . @ @ 
@ . . @ . . @ . @ @ . . @ @ @ . . @ @ @ @ @ . . . . . . . @ . . . . . . @ . . . . @ @ . . @ . @ @ @ 
@ . @ @ @ . @ . @ . @ . @ . @ @ . @ @ . @ . . @ . @ . @ . . @ . @ . @ . @ @ @ @ @ @ @ @ @ . . . . @ 
@ . . . . . . . . . . . . . @ . @ . . . @ @ . @ . . @ . . @ @ @ . . . @ . @ @ @ . @ @ . @ @ . @ . @ 
@ @ . @ . @ . @ @ . @ . @ . . . @ . @ . . @ @ . . @ @ . @ @ @ @ . @ @ @ . . @ @ . @ . . . . . . @ @ 
@ @ @ . . . @ . . . @ . @ . @ . @ @ . . @ . . . @ . . . @ @ . @ @ . @ @ . @ @ . . . @ . @ . @ . . @ 
@ @ @ @ . @ . @ . @ . . @ @ @ . . @ . @ . @ @ . . @ . @ @ . . . . . . . . . . . @ . . @ . . @ . @ @ 
@ @ @ . @ . . . . . @ . @ . @ . @ . . . . . @ . @ . . . @ @ . @ . @ . @ . @ @ . @ @ . @ @ . @ . @ @ 
@ . . . @ . @ . @ @ . . @ . . . . . @ . @ . . . @ @ . @ @ @ @ . . . @ . . . @ . @ . . . . . . @ . @ 
@ . @ . @ . @ . @ . @ . @ @ . @ . @ . . . @ . @ . . . . @ @ @ @ @ . . @ . @ . . @ . @ . @ . @ . . @ 
@ . @ @ . . @ @ . . . @ . . @ . . . @ @ @ @ . @ @ @ @ @ @ @ @ @ @ @ . . @ . . @ . @ . . . @ . @ . @ 
@ . . @ . @ . . . @ . . . @ . @ . @ . . . . . . @ . @ . @ @ @ . @ . . @ @ @ @ . . . . @ @ @ . . . @ 
@ . @ . @ . . @ . . @ . @ . . . . . @ @ . @ . @ @ . @ . . @ . . . @ . . . @ @ @ . @ @ . . @ . @ @ @ 
@ . . . . @ . @ @ @ . . @ @ . @ . @ . . @ . . @ . . @ . @ . @ . @ . @ . @ . @ . . . . . @ . . . . @ 
@ @ . @ . @ . @ @ . @ . @ . @ . . @ . @ . @ . . @ . . . . . . . . . . @ . . . @ . @ @ . . . @ @ . @ 
@ @ @ . . . @ . . . . . . . . . @ @ . . . . . @ . @ @ . @ @ . @ . @ . . @ @ . . . . . @ . @ . . . @ 
@ . @ @ . @ . . @ . @ . @ . @ . . @ @ @ . @ . . . . . . . @ . . @ @ . @ . @ . @ . @ . . @ . @ @ @ @ 
@ . . . . . . @ . . . @ . . @ @ @ . @ . . @ . @ . @ . @ . . @ . . . @ @ . @ @ @ . . @ . . . . . . @ 
@ @ . @ . @ . @ . @ . . @ . @ @ . . . . @ . . . @ . . . @ . @ . @ . . . . @ @ . . @ @ . @ . @ . @ @ 
@ @ @ @ @ @ @ @ @ @ @ @ @ @ @ @ @ @ @ @ @ @ @ @ @ @ @ @ @ @ @ @ @ @ @ @ @ @ @ @ @ @ @ @ @ @ @ @ @ @ 
3
35 48 25 44
1 33 30 43
17 30 21 26
