100 100
@ @ @ @ @ @ @ @ @ @ @ @ @ @ @ @ @ @ @ @ @ @ @ @ @ @ @ @ @ @ @ @ @ @ @ @ @ @ @ @ @ @ @ @ @ @ @ @ @ @ @ @ @ @ @ @ @ @ @ @ @ @ @ @ @ @ @ @ @ @ @ @ @ @ @ @ @ @ @ @ @ @ @ @ @ @ @ @ @ @ @ @ @ @ @ @ @ @ @ @ 
@ @ . . . @ . . . . @ . . . . @ . . . . . @ . . . . @ . @ . . . @ . @ . @ . @ @ . . . @ @ @ . . . @ . . @ @ . . . @ @ @ @ . . @ @ . . . . @ @ . @ @ @ @ @ @ @ @ @ @ . . @ @ @ @ @ . . @ @ @ @ . . @ . @ 
@ . @ @ . . @ . @ . . @ . @ @ @ . @ . @ . @ . @ @ . @ . @ . @ @ . . @ . . . . . @ . @ . @ . @ . @ @ . @ . @ . @ . . @ @ . @ . @ @ @ . @ . @ . . @ @ @ @ @ @ @ @ @ . . @ . @ @ @ . . @ . . @ . @ . . . @ 
@ . @ . @ . @ @ @ @ . . . . @ . . . @ @ . @ . . . @ @ . . . . . . @ . . @ @ @ . . . . . @ . . . . . . . . . . @ . @ . . . . . . @ @ @ . . . @ . @ @ @ @ @ @ @ @ @ . @ . . . @ . @ . . . @ . . . . @ . @ 
@ . . . . . . . . @ @ @ . @ . @ @ @ . . . @ . @ . . . . @ . @ @ . . . @ @ @ . . @ . @ . @ . @ . @ . @ @ . @ . @ @ @ @ @ . @ @ @ . @ @ @ @ . . . . . . @ @ . @ . . . . @ . @ . . . . @ @ @ @ . @ . . @ @ 
@ . @ . @ @ . @ . . @ . . . . @ @ . @ @ . @ . @ @ @ @ . . @ @ @ @ . @ @ @ @ @ . . @ . @ @ @ . . @ @ . . . @ . . @ . @ . . . . . . . . . . @ . @ . @ . @ . . . . @ . @ . . . @ @ @ . . . @ @ @ . . @ @ @ 
@ . . @ . . . @ . @ . @ @ . @ . . . @ . . . @ @ @ . . . @ . . @ . @ @ @ @ . @ @ . . . @ @ @ @ . @ @ @ @ . @ . @ . . . @ . @ . @ . @ . @ . . @ . . . @ . @ @ . @ . . . . @ @ @ @ . . @ @ @ @ @ . @ . . @ 
@ . @ @ @ . @ . . . . @ . . . . @ . . @ . @ . @ . @ . @ . @ . . . . . @ . . . . @ . @ @ @ @ @ . @ @ @ @ @ . . @ . @ @ . . . @ @ @ @ @ . @ . . @ . @ . . . . @ . @ . @ . @ . @ . @ . . @ @ @ . . . . @ @ 
@ . . @ . . . @ . @ . . @ @ @ @ @ @ . . . . . . . . . . . . . @ @ . @ @ @ . @ @ @ @ . @ . @ @ . @ @ @ @ . @ . . . @ . @ . @ . @ . . . . @ @ @ . . . @ . @ @ . . @ . . @ . . . . . . @ @ @ @ @ @ @ . . @ 
@ . @ @ @ . @ @ @ . @ . @ . @ . . . . @ @ @ @ @ . @ @ . @ @ . . @ @ @ @ . . . @ @ @ . . . . . @ . @ @ @ . @ . @ @ . . . . . . . . @ @ . @ . . @ @ . . . @ @ @ . . . @ . @ . @ . @ . @ @ @ @ @ . @ @ . @ 
@ . . @ @ @ @ @ . . . . . . . @ @ . @ . . . . @ . @ @ @ . @ . @ . . @ . @ . @ . . @ . @ . @ . . . . . . . . . . @ . @ @ @ @ . @ . . @ @ . @ . @ . @ @ . @ . . @ @ . . . . . . @ . . @ @ @ . . . @ . . @ 
@ . @ @ @ . @ . @ @ . @ . @ . @ . . . @ . @ . . @ . @ . . . . . . @ . . . . . @ . . @ . . @ . @ . @ . @ . @ . @ . . . @ . . @ . . @ . . . . . . . @ @ . @ @ . @ . . @ @ @ . @ @ @ . @ @ . @ . @ . @ . @ 
@ . . @ . . . . @ @ @ . @ . . . @ @ @ @ @ . . @ . . . @ @ @ . @ . . @ . @ . @ . @ . . . @ . . . @ @ . . @ . . . . @ @ . @ . @ . @ @ . @ . @ . @ . . . . . . . . @ . @ . @ @ . . @ @ . @ . . . . . . . @ 
@ @ @ . @ . @ . . @ . . . @ . @ @ @ . @ . @ . @ @ . @ . . . . . @ . . @ . . . . . @ @ . . @ . @ . @ . @ @ @ . @ . @ . . @ . . @ . @ @ @ @ . . @ @ @ . @ . @ @ . . . . . . . . @ . . . . @ @ . @ . @ . @ 
@ @ @ . @ @ . . @ . @ @ . . . . @ . . . . . . . @ . @ @ . @ @ . . @ . . @ @ . @ . @ . @ @ . . . . . @ @ @ . @ @ @ . @ . . . @ @ . . . @ . @ @ . @ @ . @ . @ . . @ . @ . @ . @ . . @ . @ . . @ @ . @ . @ 
@ @ . . @ . @ . @ . @ . @ @ . @ . . @ . @ @ @ . . . . @ . @ . . @ @ @ . @ . . . @ . . @ @ @ . @ . @ @ @ . . . @ @ . @ . @ @ @ . @ . @ @ . . @ . . . . . @ @ @ . @ @ @ @ . . @ @ . @ . . . @ . . . . @ @ 
@ @ @ . . . . . . . . . @ . . @ @ @ . . . @ . @ @ . @ . . @ . @ @ @ . . . @ . @ . @ . @ . . . @ @ @ . . @ . @ . . . @ . . . . . . . . . . @ . @ . @ . @ @ @ @ . @ . @ . @ . . @ @ . . @ @ . . @ @ @ . @ 
@ @ . . @ . @ . @ . @ . . @ . . . @ @ @ @ @ . @ . . . @ @ @ @ . @ . . @ . . . . . . . . . @ . . . . @ . . . . @ @ . @ @ . @ . @ @ . @ @ . . . @ @ @ . @ @ @ @ @ . . @ . . . @ . . @ . @ . @ . . @ . . @ 
@ . . @ . . . @ . . @ @ . @ . @ . @ . . @ . . @ @ . @ . @ @ @ . . @ . . @ . @ . @ @ . @ . @ . @ . @ @ @ @ . @ . @ . . @ . . @ . . . . @ . @ @ . . @ . @ . @ @ @ @ . @ . @ . @ . @ . . . . @ . @ . @ . @ 
@ @ . . @ . @ . @ . @ . . . . @ @ . . @ @ @ . . . . . . . @ . . @ . @ . . @ @ . . @ @ . . . @ . . . @ . . . . . . @ . @ @ @ @ @ @ . @ . . @ . @ . . @ . . . . @ . . . @ . . . . . @ @ . @ @ . @ . @ . @ 
@ . . @ @ . @ . . . . @ . @ . @ . @ . . . . @ . @ . @ . @ @ @ . . . . . @ . @ @ . @ @ @ @ @ . @ . @ @ @ . @ @ . @ . . @ @ . . @ @ @ . @ . . . . . @ . @ . @ @ . @ . @ . @ @ . @ . @ . . . . . . . . . @ 
@ @ . @ @ @ . . @ . @ @ @ . . . . @ . @ . @ @ @ . . . @ @ @ . @ . @ . @ . . @ . . @ @ . . . . . . . @ @ @ @ @ . . . @ @ . . @ @ @ @ . . @ @ . @ . . . . . . . . . . . . . . @ . . . @ @ . @ . @ @ . @ @ 
@ . . . @ @ @ . @ . @ @ @ @ . @ . @ . . @ . @ . @ . @ . @ @ . @ @ @ @ . @ . . . @ . . @ . @ @ @ . @ . . . @ . . @ @ . @ @ . . @ @ @ . @ . @ @ . . @ . @ @ . @ . @ . @ . @ @ . @ @ . . . . @ @ @ . @ @ @ 
@ . @ . @ @ @ . @ @ . . . . @ . . . . @ . . . . @ . @ . @ . . . . @ . . . @ . @ @ @ . . . . . @ . @ . @ . @ . @ . @ . @ . . @ . @ . . . . . . @ @ @ . @ . . . @ @ . @ . @ . . . @ . @ @ . . @ @ . . . @ 
@ . . @ @ @ @ @ . . @ . @ . . @ @ @ . . . @ @ . @ . . . . @ . @ . @ @ . @ . @ . @ . . @ . @ @ . . . . . @ . . @ . @ . @ @ . @ . @ . @ @ @ . @ @ @ @ @ @ . @ @ . . @ @ @ @ @ . @ . @ @ . . @ . . @ . @ @ 
@ . @ @ @ . @ . . @ . @ @ @ . . . @ @ @ . . @ . @ . @ @ . @ . @ @ . . . . . @ . . . @ . . @ @ @ . @ @ @ . @ . . . . . . . . . . . . . @ . @ @ @ . . @ . . . @ . @ . @ @ @ . . . . . @ @ . . @ . . . . @ 
@ @ . @ @ . . @ . @ . @ @ . . @ @ . . . . @ . . @ . . . @ . . . . @ . @ @ @ . @ . @ @ @ . . @ . . . @ . . . . @ @ @ @ . @ . @ . @ . @ @ . . @ . @ . . @ . @ . . . . @ @ . @ . @ . @ . . . @ . . @ @ @ @ 
@ . . . @ @ . . . @ . . . @ . . @ . @ . @ . @ . . . @ . @ @ . @ . . . . . . . . . @ @ . . @ @ . @ . . @ @ @ . . @ @ @ @ @ @ . @ @ @ @ @ . @ . . . @ . . . . @ @ . @ @ . . . . @ @ @ @ @ . @ . @ . @ @ @ 
@ . @ @ . @ @ @ . . . @ @ . @ . . @ . . @ . @ @ . @ . @ . . @ @ @ . @ . @ . @ . @ . . . @ @ @ @ . . @ . . @ . @ @ @ @ . @ . . . @ . . . . @ . @ @ . @ . @ . . . . . . @ . @ @ @ @ . @ . . @ . . . . . @ 
@ . @ @ . . @ . @ . @ . @ . @ . @ @ @ @ . . . . . . . @ . @ . @ @ @ . . @ @ . . . @ @ . . @ . . @ . @ . @ . . . @ @ . . . @ . @ . @ . @ @ . . @ . . . @ . @ . @ . @ . @ . @ . @ . . . @ . . . @ . @ . @ 
@ . . @ . @ . . . . . . . . . . . @ . @ . @ @ @ . @ . . . . . . @ @ @ . @ . @ . @ @ @ @ @ . . @ . . @ . . . @ . @ @ . @ . . . . . . . . . . @ . @ . @ . . . @ . . . @ @ . @ . . @ . @ . . @ . . @ . . @ 
@ . @ . . . . @ . @ . @ . @ @ . @ . . @ @ . . . . . @ . @ . @ @ . . . . @ . . . @ @ @ @ . @ . . @ . @ @ . @ . . . . @ . . @ . @ . @ . @ @ . . . @ . . @ . @ . @ @ . . . . @ . @ . . @ . @ @ @ @ @ @ @ @ 
@ . @ @ . @ . . @ . . . @ @ . . . @ . . @ . @ @ @ . . @ @ @ @ @ @ . @ . . @ @ . @ . @ . . . @ . @ . @ . @ . @ . @ . . @ . @ @ . . @ . @ @ . @ @ @ @ . . . . . @ . . @ @ @ . . @ @ . . . . @ @ @ @ @ @ @ 
@ . @ @ @ . . @ @ @ . @ @ . @ . @ . @ . @ @ . @ . @ . @ @ @ @ @ @ @ . . @ @ . . . . @ . @ . . . . . . . . . . . . @ . . . . @ @ . . @ @ @ @ @ @ @ @ @ . @ @ . @ @ . . @ @ . @ @ . . @ . @ @ @ @ @ . @ @ 
@ . . . . @ . . @ . @ @ . . . . . . . . . . . . . . . @ @ @ @ @ . @ @ . @ . @ . @ . . @ @ @ @ @ . @ @ @ @ . @ . @ @ . @ @ . @ . . @ @ @ . @ @ @ @ @ @ @ . . . . . . @ @ @ . . . @ . @ . @ @ @ @ . . @ @ 
@ @ . @ @ . @ @ @ . . . @ @ . @ . @ . @ . @ @ . @ @ . . @ @ @ . . . @ @ . . . . @ . @ @ @ @ @ @ @ . . . @ @ . . @ @ @ . . . @ . @ @ @ @ . @ @ @ @ @ @ @ @ @ @ . @ . . @ . . @ @ . . @ @ . @ @ . @ . @ @ 
@ . . . . . . . . @ . @ @ . @ @ @ @ @ . . . . @ . . . @ @ @ . @ . @ . @ . @ . @ . . . @ @ @ @ @ . @ . @ @ . @ . . @ @ @ . @ @ . @ @ @ . . . @ . @ . @ @ @ @ @ @ . . @ @ @ . . @ @ . . @ . . . . . . @ @ 
@ @ @ @ @ @ @ @ . . . . . . . @ . @ . @ . @ . @ @ @ . . @ . . @ . . . . @ . @ . @ . @ . @ @ @ . . @ . . @ . @ . @ . @ @ @ @ @ @ . @ @ @ . @ @ . . . @ @ @ @ @ . . @ . @ . @ . @ . . @ . @ @ . @ @ . . @ 
@ . . . . @ . . @ . @ @ . @ . . . . . . . . @ @ @ . . @ . @ . @ . @ @ . @ . . . . @ @ . @ @ @ . @ . . @ . . . . . . . @ . @ @ . . @ . . . . @ . @ @ . . @ @ . @ . @ . . . . . . @ . @ . . @ @ @ @ . @ @ 
@ @ @ @ . @ . @ . @ . . . @ @ @ @ . @ @ . @ . @ @ @ . . . . . . . . . @ . . @ . @ . . . . @ . . . . @ . @ . @ . @ . @ . . . . @ . . @ @ . @ @ . . . . @ . . . . . @ . @ . @ @ @ . . . . @ . @ . @ . . @ 
@ . . . . . . @ . @ . @ . . @ . . . . @ @ @ . . @ @ @ @ . @ . @ . @ . @ @ @ . . . @ @ @ . . @ . @ . . . . @ @ @ . . @ @ @ . @ . . @ @ @ . . . @ @ @ . . . @ . @ @ . . . @ @ . @ . @ @ @ . . @ . @ . @ @ 
@ @ @ . @ . @ . . @ . @ @ . @ . @ . @ @ @ . . @ . @ @ . @ . . . @ . . . . @ . @ . @ @ . @ . @ @ . @ @ . @ . @ . @ . @ . @ . . . @ @ @ . . @ . . @ . . @ @ . @ @ @ @ . @ . . . . . . @ @ @ . . . @ . . @ 
@ @ . . @ . . . @ . @ . . @ . @ . . . @ . @ . @ . . . . . @ . @ . @ . @ @ . @ . . . . . . . . . . . . . . . . . . . . . . . @ . @ @ . @ . . @ @ . @ . @ . . . . @ . . . . @ . @ . @ @ @ @ @ @ . @ . @ @ 
@ @ . @ . @ @ . . . . . @ @ . @ @ . @ @ . @ . . . @ @ @ @ @ @ . . . . . . . . . @ . @ . @ . @ . @ . @ . @ . @ . @ . @ . @ . . @ . . . @ . @ . . . . . @ @ . @ @ . @ . @ @ @ @ . @ @ @ @ @ @ . . @ . @ @ 
@ @ @ . . . @ . @ . @ @ . . . . . . . . . . . @ . . . . @ @ @ @ @ . @ . @ . @ @ . . . @ . @ . . @ @ . . @ . . @ . . . @ . . @ . @ @ . @ . . @ @ . @ . . . . @ . . . . . @ @ @ . . @ . @ @ . @ . @ . . @ 
@ @ . . @ @ . . @ @ . @ @ . @ . @ . @ . @ . @ . . @ @ @ @ @ @ @ . . @ . . @ . . @ . @ @ . . @ @ . . . @ . . @ . @ . @ @ @ . @ . . @ . . . @ . @ @ @ @ . @ . @ @ . @ . @ . @ @ . @ @ . . . . . . . . @ @ 
@ @ @ . . . @ . @ . . . . . . @ @ @ @ @ @ @ @ @ . @ @ @ @ . . . . @ . . @ . @ . . . @ @ . @ @ @ @ @ . . @ . . . @ @ @ @ . . @ . @ @ @ . @ . . . . @ . . . @ . . . . @ . . @ . . . . @ . @ . @ @ . @ @ @ 
@ . . @ @ . . . @ @ . @ . @ @ @ @ @ @ @ @ @ @ @ @ . . @ @ . @ @ . . @ @ @ . @ . @ . . . . . @ @ . @ . @ . @ . @ @ @ @ . @ . @ . . @ . . . . @ . @ . @ . @ . @ @ . @ . . @ @ . @ . @ @ @ @ @ @ . . . @ @ 
@ @ . . @ . @ @ @ @ @ . @ @ . @ @ @ @ @ @ @ @ @ . @ . . @ @ . @ . @ . . . . . @ . . @ . @ @ . . . @ @ . . . . . @ @ . . . . . @ . . . @ . @ @ @ @ . . . . . . . . . . @ . . . . @ @ @ @ @ @ @ @ . @ . @ 
@ . . @ . . . @ @ @ . . @ . . @ @ @ @ @ @ @ @ @ . . @ . . . . . @ . . @ @ . @ . @ . . @ . @ . @ . . @ @ . @ . @ @ @ . @ @ . @ . . @ @ . . @ @ @ @ . @ . @ @ . @ . @ . . . @ @ @ @ @ @ @ @ @ @ @ . . . @ 
@ @ . . @ @ . . @ @ @ . . @ . . @ @ @ @ @ @ @ @ @ . @ . @ @ . @ . @ @ . . . . . . . @ . . . @ . . @ . . @ . . @ @ @ @ . . . . . @ @ . @ @ @ @ @ @ @ . . @ . . @ . . @ . @ @ @ . @ @ @ @ @ @ @ @ . @ @ @ 
@ @ @ . @ . @ . . @ . @ . . . @ @ @ @ @ @ @ @ @ . . . . . @ . . . . @ @ @ . @ . @ . . . @ @ . @ . . . @ @ @ @ @ @ @ . @ @ @ @ . . @ . @ . @ . @ @ . @ . . @ . . @ . . @ @ @ . . @ @ @ @ @ . . . . @ @ @ 
@ @ . . . . . . @ . . @ @ @ . . @ @ @ @ @ @ @ . @ . @ . @ @ @ @ . @ . . @ . @ @ . . @ . . . . @ . @ . @ @ @ @ @ @ . . . . . . @ . . . . . . . . . . . . @ . . @ . @ @ . @ . @ . . @ . @ . . @ @ . . @ @ 
@ @ . @ . @ @ . @ @ . . @ . . @ . @ @ @ @ @ . . . @ . . @ @ . @ @ . . @ . @ @ . . @ . . @ @ . . . @ . . @ @ . @ . @ @ . @ . @ . . @ . @ . @ @ . @ @ . @ @ @ . . . . @ . . . . . @ . . @ @ . @ . @ . . @ 
@ @ @ @ @ @ @ . . @ . @ . @ . . . . @ @ @ . @ . @ . @ . . . . @ . @ . . . . . @ @ . @ . @ . . @ . @ . @ @ . . . . . @ @ . . . @ . @ @ . . @ @ @ . @ . @ . @ . @ . @ . . @ . @ @ . @ . @ . . . . . @ @ @ 
@ @ . @ . @ . . @ . . @ . . . @ . @ @ . . . . . . . . . @ @ @ . . @ . @ . @ . . . . . @ @ @ . . @ @ . @ . @ @ . @ . @ . @ . @ . @ @ . @ . . @ . . . @ . . . @ . . . @ . . @ @ . . . . . @ @ @ . @ . . @ 
@ . . . . . @ . . @ . . @ @ . . @ @ . . @ . @ . @ . @ . . . . @ . @ . . @ @ . @ . @ . @ @ @ . @ @ . . @ . @ @ @ . . . . . . . . . . . . . @ . @ . @ . @ . @ . @ . @ . . @ @ @ @ @ @ . @ . . . . . . @ @ 
@ . @ . @ . . @ . @ . @ . . . @ . @ . @ @ . @ @ . . . @ . @ . . . @ . @ . @ @ @ @ @ @ . @ @ @ . . @ @ . . . @ @ @ @ @ . @ @ @ @ @ @ . @ . . . . . . . . . . . . @ @ @ . . @ @ @ @ . . . . @ . @ . @ . @ 
@ . @ . . @ . . . . . . @ . @ . . . @ . . @ . . @ . @ @ @ @ . @ . . . . . . @ @ @ @ . . . @ . . @ . @ @ . @ . @ @ @ @ @ . @ @ @ @ @ @ . @ @ . @ . @ . @ . @ . @ @ @ . . @ @ @ @ . . @ . @ . @ @ @ @ . @ 
@ @ . . @ . @ . @ . @ . . . . @ . @ . @ . @ @ . . . @ . . . @ @ @ . @ @ . @ @ @ @ @ @ . @ . @ . @ . @ . . . . . @ . @ . . . . . . . . . . . . @ @ @ @ @ @ @ . @ . . @ . . @ @ . . @ . @ . . @ @ @ @ . @ 
@ @ @ @ . . . . . @ . @ @ @ . . . . . . . . . @ @ . . @ @ . @ . . . @ . @ @ @ @ @ . @ . . . . . . . . . @ . @ . . . @ @ @ @ @ @ . @ . @ . @ . . @ @ @ @ . @ @ . @ . @ . @ . . @ . . . . @ . . . @ . . @ 
@ @ @ @ @ . @ @ @ . . . . . . @ . @ @ @ . @ . . @ . @ . . . . . @ . @ . . @ @ . @ . @ @ @ . @ @ . @ @ . . @ . @ @ . @ . . . . . @ . . . @ . @ . @ @ @ . . . @ . @ . @ . @ . @ . . @ . @ . . @ @ . @ . @ 
@ @ @ @ @ . @ . @ @ . @ @ . @ . . . @ . . @ . @ @ @ . @ @ @ . @ . . . . @ . . . . . . . . @ @ @ @ . . @ @ . . @ @ . @ . @ . @ @ . . @ @ @ . . . @ . . @ . @ @ . . . . . . . @ . @ @ @ @ . @ . @ . @ . @ 
@ @ @ @ . @ . . . . . . . @ . . @ . . @ . @ . . . . . @ . @ @ . @ @ . @ . . @ . @ . @ . @ @ @ . . . @ . . @ . . . . . @ @ . . @ . @ . @ . @ @ . . @ . @ . @ . @ @ @ . @ . @ . . . @ . . . . . . . . . @ 
@ . @ . . . . @ . @ . @ @ @ . @ @ . @ @ @ . @ @ . @ . @ . . @ . @ @ . . @ @ . @ . . . @ . @ @ . @ @ . @ . . @ . @ . @ @ . . @ . @ . . @ . . . . @ . . . . . . . @ @ @ . . . . @ @ . @ @ . @ @ . @ . @ @ 
@ . @ @ . @ . . @ . . @ . . @ @ @ . . @ . . @ @ @ . . . . @ @ . @ . . @ . . . . . @ @ . . . . . . . . . @ . @ @ . . . . @ . . . . @ . . @ . @ . @ @ . @ . @ . @ . . @ @ . @ @ @ @ . . @ . . . @ @ . . @ 
@ . . @ @ . @ @ . @ @ @ . @ . @ . @ @ @ . @ . @ @ @ . @ . @ . . . @ . @ . @ . @ . . . @ . @ @ . @ . @ . . . @ . @ @ . @ @ . @ . @ @ . @ @ @ . . . @ . @ . @ . . @ . @ . . . . . . . @ . @ . @ . @ . @ @ 
@ . @ . @ . . . . . . @ . @ . @ . @ . @ . . . . . @ @ . . @ @ @ . . . @ @ @ @ . @ . @ . @ . @ @ @ @ . . @ . . . . . . . . . . @ @ . . . . . @ @ . . @ . . . @ . . . . . @ . @ . @ . . . . . . . . @ @ @ 
@ . . . @ @ @ @ . @ . @ . . . @ . . . . . @ . @ . @ . @ . . @ . @ @ . . . . . . . . . . . . . . @ . @ @ . . @ . @ @ . @ @ . @ @ . @ @ . @ . @ @ . @ . @ . @ . @ @ . @ . @ @ . @ . @ @ @ . @ . @ @ @ @ @ 
@ . @ @ . @ @ . @ @ . . . @ . @ @ @ . @ . . @ @ @ . . . . @ @ . @ . @ . @ . @ . @ . @ @ . @ @ . . . @ . @ @ . @ . @ @ . . . . . . . . @ . . . . . . . . . @ . @ . @ . . . . . . . . . @ @ . @ . @ @ @ @ 
@ . . . . . . . . . . @ @ . . . . . @ . . @ @ @ @ @ . @ . . . . . . . . . @ . . . @ . . . . @ . @ . . . . . . . . . . . @ . @ . @ @ . @ @ . @ @ . @ . @ . . . . . . @ @ @ @ . @ @ @ . . . . . . @ @ @ @ 
@ @ . @ . @ . @ . @ @ @ . @ . @ . @ . . @ @ @ . @ . . @ . @ . @ @ . @ . @ @ @ . @ . . @ . @ . @ . @ @ . @ @ . @ @ . @ . @ . @ . @ . . . . @ . @ @ . @ @ @ @ . @ . @ . @ @ . . . . . @ @ . @ @ @ @ @ @ @ 
@ @ @ . . @ @ . . @ @ . . . . . @ . @ . . @ . . . @ . . @ . . @ @ @ . . @ @ . @ . . @ . . @ . @ . . . . @ @ @ . . . . @ @ @ . @ . @ . @ . . . . . . @ @ @ . @ . . . . . . @ @ @ @ . @ . @ @ . . @ @ @ @ 
@ . . @ . . . @ . . @ @ @ . @ . @ . @ . @ . @ . @ . . @ @ @ . @ @ . . @ . . . . . @ . . @ . . . @ . @ @ . . . . @ . @ @ @ . . . . . . @ . @ @ . @ . . @ . . . @ . @ @ . @ . @ . . @ . . . . . @ . @ . @ 
@ @ . . . @ . @ @ . . . . @ . . . . . . . . . . . . @ @ @ @ @ @ . @ @ . . @ . @ . @ @ . @ . @ . . . @ . @ @ . @ . @ . @ . @ . @ . @ . @ @ . @ . @ @ . @ @ @ . . . . . @ @ . . . @ . @ . @ @ . . . @ . @ 
@ @ @ . @ . @ . . @ . @ . @ . @ @ . @ . @ . @ . @ . @ @ @ @ . . . . @ @ . . @ . . . . @ @ . . @ . @ @ . . . . @ . @ . @ . @ . . @ . . . @ . @ @ @ . . . . . . @ . @ @ @ . @ @ . . . . . @ . @ @ . @ . @ 
@ @ . @ . . @ . @ . @ . @ . @ . . . . @ . . @ . . @ . @ @ . @ . @ . . @ . @ @ @ . @ . . . @ . @ @ @ . . @ . @ . . . . . . . . @ . @ . @ . . . @ @ . @ . @ . @ . . . @ . . @ . . @ @ @ . . . . @ @ . . @ 
@ . . . . @ . . . . @ . . . . . @ . @ . . @ . . @ . . . @ . . @ . . @ @ @ @ . . @ @ @ @ @ @ @ @ @ @ . @ . . @ . @ @ . @ . @ @ . . . @ . @ . @ . . @ @ @ . @ . @ . @ . . @ . @ . @ @ . @ @ . @ . . @ . @ 
@ . @ @ . . @ . @ @ . @ @ . @ . . @ . . @ @ @ . @ . @ @ . . @ . @ . @ @ . @ . @ . @ . @ . @ . @ @ . @ . @ . . @ . @ @ . . . . . @ @ . . . . . @ . . @ @ . . . . . . @ . . . . . @ . . . @ . @ @ . @ . @ 
@ . . . @ . . . . . . . . . @ @ @ . @ . @ @ @ . . . . . @ . . . . . . . . . . . . . . . . . . . . . . . . . @ . . . @ @ . @ @ . @ . . @ @ . @ @ . @ . . . @ @ . @ . . . @ @ . @ . . @ . @ @ . . . . . @ 
@ . @ . . @ . @ . @ . @ . @ . . . . . . @ @ . . @ @ . @ @ @ . @ @ . @ . @ . @ . @ . @ . @ . @ . @ . @ . @ . . @ . @ @ . @ . @ @ . @ . @ . . . . . . . @ . @ . . . @ @ . . . @ . . @ . @ @ @ . @ @ . @ @ 
@ @ @ @ . . @ . . @ @ . . @ @ . @ . @ @ . . . @ . @ . . @ @ @ @ @ @ @ @ . . . @ . . @ @ . . @ . @ . @ @ . . @ . . . . . . . . @ . . @ @ @ @ . @ . @ . @ . . @ . @ @ @ @ . @ @ @ . . . @ @ . @ @ . . . @ 
@ @ @ @ . @ @ @ . @ @ @ . . . @ @ @ . @ @ . @ . . . . @ @ @ @ @ @ @ @ @ @ . @ . . @ . . . @ . . @ @ . . . @ @ @ . @ . @ . @ . @ @ . @ @ @ . @ . . . @ . . @ . @ . @ @ . . @ . . . @ @ . . . @ . . @ @ @ 
@ @ . @ . . @ . @ . . . . @ @ @ @ . . @ . @ . @ . @ . @ @ @ @ @ @ @ @ @ @ @ . @ . @ @ . @ . . @ . . . @ . @ @ . . @ . @ @ . @ . . . . . . . . @ . @ . @ . . . . . . . @ . . @ . @ . @ . @ @ . @ . @ @ @ 
@ @ . @ . @ . . . @ . @ . . . . @ . @ @ . @ . @ . . @ @ @ @ @ @ @ @ @ @ @ . . @ @ . . . @ @ @ . . @ @ @ @ . @ @ . @ @ . . . @ @ @ . @ @ . @ . . @ . . . . @ . @ . @ . . @ . . . . . . . . . . @ . @ @ @ 
@ . . . @ @ . @ @ @ @ . . @ . @ @ . . @ . . . . . @ @ @ @ @ @ @ @ @ @ @ . @ . . . . @ . @ @ . . @ . @ . . . . . . @ . @ @ . . @ . . . @ @ . . @ @ @ . @ . . @ @ . . @ . @ @ @ . @ @ @ . @ . @ @ . . @ @ 
@ @ . @ . . . . @ @ @ @ . . @ . . @ . . @ @ @ . @ @ @ . @ @ @ @ @ @ @ . . . . @ . @ @ @ . . . @ . . . . @ @ . @ . . . . . . @ @ @ . @ @ @ @ @ @ @ @ @ . . @ . @ . @ . . . . . @ @ . . . . @ . @ . @ @ @ 
@ . . . . @ . @ . @ @ @ . @ . . @ @ @ . . . . . @ @ . . . . @ @ . . . @ . @ . @ . @ @ . @ @ @ . @ . @ . @ @ . @ @ . @ . @ . . @ . . @ . . . @ . . . . @ . . . . @ @ @ . @ . @ . . @ @ . @ @ . @ . . . @ 
@ . @ @ . . @ . . . @ . . @ . @ @ @ @ @ . @ @ . @ . @ . @ . @ . @ . @ @ . . @ . . . @ . . . . . @ . . @ . . . . . @ . . . @ . @ @ . . . @ . . . @ @ @ . @ . @ . . . @ @ . . . . @ . . . . . . . . @ @ @ 
@ @ . @ . @ . @ . @ . @ . . . . . @ @ @ @ . @ @ . . @ @ . . . . . . . . . @ @ . @ . . @ . @ . @ . . @ @ . @ @ @ . @ @ . @ @ . @ . @ @ . @ . @ . . . . . . . . @ . @ . . . @ . @ @ @ @ . @ @ . @ . . . @ 
@ . . . . . . . . . . . . @ . @ @ @ @ @ @ . @ . . @ @ . @ @ . @ . @ . @ @ . . . @ . @ . . . @ . @ . @ . . . @ . . . @ @ . . . . . . . . @ @ . @ . @ . @ @ . @ . @ . . @ . @ . . @ . . . @ . . . @ . @ @ 
@ @ . @ . @ @ . @ @ @ @ @ @ . . . @ @ @ @ . . @ . . @ . . . . . @ . . @ . . @ . @ @ @ @ . @ . . . . . @ . @ @ . @ . . . @ . @ . @ @ @ . . @ . . @ . . @ @ @ . . . . @ . . @ . @ @ . @ . @ @ . @ . . . @ 
@ . @ @ @ . . . . @ . . . . . @ . . @ @ . @ . @ . @ . @ . @ . @ @ @ @ @ @ . @ . . . @ . . . . @ . @ . . @ . . @ @ @ @ . . @ . . @ . . . @ @ . @ @ @ . . . . @ @ . @ . . @ . @ @ . @ . . . . @ @ @ @ @ @ 
@ . @ @ . . @ . @ . . @ . @ . . @ . @ . . . . . . . . . . @ . . @ @ @ @ @ @ . . @ . @ . @ . @ . . . @ @ . @ . @ . . @ . @ . @ . . @ . @ . . . . @ . . @ . @ @ @ @ . . @ . . . . . . @ . @ @ @ @ @ @ @ @ 
@ . . @ . @ . . . @ . @ . @ . @ . @ @ @ . @ . @ . @ . @ . @ . @ @ @ @ @ @ @ @ @ @ @ . @ . . @ @ . @ @ . . . . . . @ . @ . . . . @ @ @ . . @ . @ . @ . @ @ @ @ @ @ @ . . @ . @ . @ . @ . . @ @ @ @ @ @ @ 
@ . @ . @ . . @ . @ . @ @ . . @ . @ @ @ . @ @ . @ . . @ @ . . . . @ @ @ @ @ @ @ @ @ . . @ . . . @ . @ @ . @ . @ . @ . @ @ @ . @ @ @ . . @ . . . . . . . @ @ @ . . . . @ @ @ . . . @ . . @ @ @ @ @ @ @ @ 
@ . . . . @ . @ . @ . @ @ @ . @ . . @ . . . . . @ @ @ @ @ @ @ . @ @ @ @ @ @ @ @ @ @ @ . . . @ . . . . . @ @ . . @ . . . @ . . . @ . @ @ @ @ . @ . @ . @ . @ . @ @ @ . . @ . @ . @ @ @ . . @ @ @ @ @ @ @ 
@ @ @ @ . . . @ . . @ @ @ . . . . @ . @ . @ . @ @ @ @ @ @ @ @ @ @ @ @ @ @ @ @ @ @ @ . @ . @ . . @ . @ . @ . . @ . @ . @ . @ . @ . . @ . @ @ . @ @ . . . . . . @ . . . @ . . . . . . . . @ @ @ @ @ @ @ @ 
@ . . . . @ . @ . @ @ @ @ @ . @ . . . @ . . @ @ @ @ @ @ @ @ @ @ @ @ @ @ @ @ @ . . . . . . . @ . @ . . @ @ @ . . . . . . . . . . @ . . . . . . . . @ . @ . @ @ @ . @ . @ . @ . @ . @ . @ @ @ @ @ @ @ @ @ 
@ @ @ @ @ @ @ @ @ @ @ @ @ @ @ @ @ @ @ @ @ @ @ @ @ @ @ @ @ @ @ @ @ @ @ @ @ @ @ @ @ @ @ @ @ @ @ @ @ @ @ @ @ @ @ @ @ @ @ @ @ @ @ @ @ @ @ @ @ @ @ @ @ @ @ @ @ @ @ @ @ @ @ @ @ @ @ @ @ @ @ @ @ @ @ @ @ @ @ @ 
3
81 44 61 51
16 53 80 85
45 2 42 56
