25 25
@ @ @ @ @ @ @ @ @ @ @ @ @ @ @ @ @ @ @ @ @ @ @ @ @ 
@ @ @ @ . @ @ @ @ . . . @ . . @ . @ . . . . @ . @ 
@ . . . . @ @ @ @ @ . @ @ . @ . . . . @ @ . . . @ 
@ @ @ @ . . . @ @ . . . . . . . @ . @ . . . @ . @ 
@ @ . . . @ @ . . @ . @ . @ . @ @ @ @ @ @ . . @ @ 
@ @ . @ . . . @ . . @ . . . @ @ @ . @ . @ @ @ @ @ 
@ . . @ . @ . @ . @ . @ . @ . . . . . . . @ @ @ @ 
@ . @ . @ . . . . . . . . . . @ . @ @ . @ . @ @ @ 
@ @ . . . . @ . @ @ . @ . @ . . @ . @ . . . . . @ 
@ . @ @ . @ . . . @ . . @ . . @ @ . . . @ . @ . @ 
@ . . . . . @ . @ @ . @ @ . @ . . . @ . @ . . @ @ 
@ @ . @ . @ . . @ @ @ . . . @ @ . @ @ @ . . @ @ @ 
@ @ . . @ . . @ . . . . @ . . @ . . @ . . @ . @ @ 
@ . . @ @ . @ . . @ . @ . . @ . @ . . @ @ . . . @ 
@ @ . @ @ @ . . @ @ . . @ . . . . @ . . @ @ . @ @ 
@ . . . @ . . @ . . . @ @ . @ . @ @ . @ . @ . @ @ 
@ @ @ . @ . @ . . @ . . @ @ . . . . @ . . . . . @ 
@ @ @ @ @ @ @ @ . @ . @ @ . @ . @ @ . @ @ @ . @ @ 
@ @ @ @ @ @ @ @ @ @ @ . . . . . . . . . . . . . @ 
@ @ @ @ @ @ @ @ @ @ @ . @ . @ . @ . @ . @ . @ . @ 
@ @ @ @ @ @ @ @ @ @ . . . @ . . . @ @ . @ . @ . @ 
@ @ @ @ @ @ @ @ @ . @ . @ @ @ . @ . @ . . @ @ . @ 
@ @ @ @ @ @ @ @ . . . . @ @ @ . . . @ . @ . . . @ 
@ @ @ @ @ @ @ @ @ . @ . . @ . . @ @ . . @ . @ @ @ 
@ @ @ @ @ @ @ @ @ @ @ @ @ @ @ @ @ @ @ @ @ @ @ @ @ 
3
18 20 20 14
8 5 13 17
10 19 14 15
