25 25
@ @ @ @ @ @ @ @ @ @ @ @ @ @ @ @ @ @ @ @ @ @ @ @ @ 
@ @ @ @ @ @ . @ . . @ . @ @ @ . @ . @ . . . @ @ @ 
@ @ @ . @ . . @ . @ . . . @ . . . . . @ . @ . @ @ 
@ @ @ . @ @ . . . . @ . @ . @ . @ . @ . . . . . @ 
@ @ . . . . . @ . @ @ . . . . . . @ . . @ @ . @ @ 
@ . @ . @ @ . @ @ @ . . @ @ @ @ . . @ . @ @ @ @ @ 
@ . . @ . . . @ . @ @ . @ . @ . . @ . . . @ @ @ @ 
@ @ . @ @ . @ . . . @ @ . . . @ . . . @ @ . @ @ @ 
@ . . @ . . . . @ . @ . @ . @ @ @ . @ . @ . . . @ 
@ @ . . @ . @ @ @ @ . . @ . . @ @ . . . . . @ . @ 
@ @ @ . . . @ . . . @ . @ . @ @ @ . @ @ . @ . @ @ 
@ @ . @ @ . @ @ @ . @ . . . . @ . . . . @ . . . @ 
@ . . . . . @ . @ . . . @ . @ . @ . @ @ . @ . @ @ 
@ @ @ . @ . . . @ . @ . . @ . . . . . . . . . . @ 
@ @ @ @ @ @ @ . . @ . @ . @ @ . @ . @ @ @ . @ . @ 
@ @ @ @ @ @ @ . @ . . . . @ . . . @ . . . . . @ @ 
@ @ @ @ @ @ . . @ . @ @ . @ . @ . @ . @ @ . @ @ @ 
@ @ @ @ @ . @ . . @ @ . . @ . . @ . @ . @ . @ @ @ 
@ @ @ @ . . . . @ @ . . @ . . @ . . . . . @ @ @ @ 
@ @ @ @ @ . @ . @ . @ . @ @ . . . @ @ . @ @ . @ @ 
@ @ @ @ @ @ . . . . . . . . . @ . . . @ . @ . . @ 
@ @ @ @ @ @ @ . @ . @ . @ . @ @ @ @ @ . . . . @ @ 
@ @ @ @ @ @ @ @ @ @ . . @ . . . . . . . @ . @ @ @ 
@ @ @ @ @ @ @ @ @ @ @ . @ . @ . @ @ @ @ @ @ @ @ @ 
@ @ @ @ @ @ @ @ @ @ @ @ @ @ @ @ @ @ @ @ @ @ @ @ @ 
3
17 11 3 11
7 5 16 18
12 17 6 4
