100 100
@ @ @ @ @ @ @ @ @ @ @ @ @ @ @ @ @ @ @ @ @ @ @ @ @ @ @ @ @ @ @ @ @ @ @ @ @ @ @ @ @ @ @ @ @ @ @ @ @ @ @ @ @ @ @ @ @ @ @ @ @ @ @ @ @ @ @ @ @ @ @ @ @ @ @ @ @ @ @ @ @ @ @ @ @ @ @ @ @ @ @ @ @ @ @ @ @ @ @ @ 
@ @ . @ . . @ @ @ @ . . @ @ @ . @ . . @ @ @ @ @ @ . . . . . . . @ . @ . @ . . . . @ . @ . . . . @ . . . @ @ @ @ @ @ . . @ @ @ @ @ . @ @ @ . @ . . @ . . . . . @ @ @ @ @ @ @ . . . @ . . @ @ . . . @ @ @ 
@ . . . @ . . @ @ @ . @ @ @ . . . . @ @ @ @ @ @ @ @ @ . @ . @ . . . . . . @ @ . @ . . . @ @ . @ . @ . @ . @ @ @ @ . @ . . @ . @ @ . @ . @ . . . @ . @ . @ @ . @ . @ @ . @ . . @ . . . @ . @ . @ . @ @ @ 
@ . @ . @ . @ @ @ . . . . . @ . @ @ . @ @ @ @ @ @ @ @ @ @ @ @ @ . @ . @ . @ . . . . @ . . . . . . . . . . @ @ @ . . @ . @ . . . . . @ . . . @ @ . . . @ @ . . . . @ . . . . @ . . @ @ . . . @ . . . @ @ 
@ @ . . @ . @ @ @ @ . @ @ . . . . . . . @ @ @ @ @ @ @ . . . @ @ @ . . . @ . @ . @ . @ . @ . @ . @ . @ . @ . @ . @ . . . . . @ @ @ @ @ @ . @ . @ . @ @ @ . @ . @ @ . . @ . @ @ @ . @ @ . @ @ . @ . @ . @ 
@ . @ . @ . @ @ @ @ @ . . . @ @ . @ @ . @ @ . @ @ . @ . @ @ . @ . @ . @ . . @ . . @ @ @ . . . @ . . @ @ . . . . . . @ . @ . . . . . . . . . . . . . . @ . . . . . @ . . @ @ @ @ @ . . . @ @ . . . . . @ 
@ . . . . . . . . @ @ @ . @ @ @ @ . . . . . . . . . . . . . . . . @ . . @ . @ . @ . @ @ @ . @ @ @ . . . . @ . @ . @ . @ @ @ @ @ @ @ @ @ . @ @ . @ . @ . . @ . @ @ . . @ . @ . . . . @ . . . . @ . @ . @ 
@ . @ @ @ @ . @ . @ . . @ @ @ @ @ @ . @ @ . @ @ . @ @ . @ . @ @ . . . @ @ . . . @ . . @ @ . . @ . . @ . @ @ @ . . . . . . . . . . . . @ . . . @ @ @ . . @ @ . . . @ . @ . @ @ . @ @ . . @ . @ . . . @ @ 
@ . . @ . . @ @ . . @ . @ @ @ @ @ @ @ . . . @ @ . @ . . @ @ @ . @ @ . . . @ @ . . . @ . . @ . @ @ . . @ . . @ @ @ . @ . @ @ . @ . @ . @ @ . @ . @ . @ . @ . @ . @ . . . . . . @ . . . @ . @ @ @ @ . . @ 
@ @ @ . @ . @ . . @ . . . @ @ @ @ @ @ @ . @ . . . @ @ . . . @ . . . . @ @ @ . @ . @ . . @ . @ . @ . @ @ @ . . . . @ . . . . @ @ . . @ . . @ . . @ . @ . @ . . . . @ . @ . @ @ . . @ @ . . . @ . @ . @ @ 
@ @ . . @ . @ . @ . @ . @ @ @ @ @ @ @ @ @ @ @ . @ . . @ @ @ @ @ . @ . . @ . . . . . . @ . . . . @ . . . . . @ . @ @ @ . @ . . . @ . . . @ . @ . . . . @ . @ . @ . . . . @ . . @ . . @ . @ @ @ . . @ @ @ 
@ . @ . . . @ . . . . . . @ . . @ . @ @ . @ . @ . @ . . . @ . . . @ . @ . @ . @ . @ @ . . @ . @ . @ . @ . @ . @ @ @ @ . . @ . @ @ . @ . . . . . @ . @ . . . @ @ . @ . @ . . @ . . @ . . @ . @ . @ . @ @ 
@ . . @ @ . . . @ . @ @ @ . @ . @ . . . . . . . . . @ @ . . @ @ @ . . . . . . . @ @ @ . @ . @ . . . . @ . . . @ . @ . . @ @ . . . @ . @ . @ . @ @ . . . @ . . . . . @ @ . @ @ . @ . . @ . . . . . . . @ 
@ @ . @ . @ . @ . @ . . . . . . . . @ . @ . @ . @ . @ @ @ . @ @ @ @ . @ @ . @ . . . . . @ . . @ . @ . . @ @ . . . . @ . . . @ . @ @ . @ . . @ . @ . @ . @ @ . @ @ . . . . . . . . . @ . @ . @ . @ . @ @ 
@ @ . . . . . . . . . @ @ . @ . @ @ . @ @ @ . @ . . . @ . . . @ @ @ @ . . . . @ . @ . @ @ @ . @ @ . . @ @ . @ . @ @ @ @ @ . . @ . . . . . @ @ . . @ @ @ @ @ @ . . . @ . @ . @ . @ . . . . . . @ @ . @ @ 
@ @ @ . @ . @ . @ . @ . . . @ @ . . . @ @ . . . @ . @ . @ . @ @ . . . . @ . @ @ @ . . . @ @ . @ @ @ . @ . . . . . . @ . @ @ @ @ @ @ . @ . . . . @ . @ . @ @ @ . @ . . @ . . . @ . . @ . @ . @ . @ @ . @ 
@ @ @ @ . . . @ @ @ . . @ @ @ @ @ @ . @ . @ . @ . . . . . . . . . @ @ @ . . @ . . @ . @ @ . . . . . . @ @ @ @ . @ . . . . . . . @ . @ . @ . @ . . . . . . . . @ @ @ @ @ @ . @ . @ . . @ . . . . . . . @ 
@ @ . . . @ @ . @ @ . @ . . . @ . . . . . . . @ . @ . @ . @ . @ . . @ . @ . . . @ . . . @ @ . @ . @ . . . . . @ . . @ . @ . @ . . . . . . @ @ @ . @ . @ . @ @ . . . . @ @ @ @ . . @ . @ @ . @ . @ . @ @ 
@ @ . @ . . . . . . @ . @ @ . . @ @ @ . @ @ . . . . @ . @ . . @ @ . . . @ . @ @ @ @ . @ . . . . @ . . @ . @ @ @ @ . . @ . @ @ . @ . @ . @ . @ . @ @ @ . @ . . @ @ . @ . @ @ @ . @ . @ . @ . . @ @ @ @ @ 
@ . . . @ . @ @ @ @ @ . @ . @ . @ @ . @ . . . @ . @ @ . . @ . @ . . @ . . @ @ @ @ . . . @ @ . @ @ @ . . @ @ . @ . @ . @ . . . . . @ @ . . . . . . . . . @ @ . . . . . . . . . . . . . . . @ @ . @ . @ @ 
@ @ . @ . . @ . . @ @ . . . . . . . . . . @ . @ . . . . @ . . @ . @ . . @ @ @ @ @ @ . @ . @ . . @ @ @ . @ . . . . . . . @ @ . @ . . . @ . @ . @ @ . @ . . . . @ . @ @ . @ @ . @ @ . @ . @ @ @ . . . . @ 
@ @ . . @ @ . . @ @ @ . @ . @ . @ . @ @ . . @ . @ . @ . . @ . . @ @ @ . @ @ @ @ @ @ . . . . @ @ . . . . . @ @ . @ @ . @ . @ @ @ . @ . . @ @ . @ @ @ @ . @ . @ . . . . @ @ . . @ . . . @ . . @ . @ @ @ @ 
@ @ . @ @ @ @ . . @ @ . . @ . . @ @ . . . @ . . . . @ . @ @ @ . . @ . . . . @ @ @ @ . @ . @ @ . . @ @ @ @ @ @ @ . . . . . . . @ . . @ . . . @ . . . . . . @ @ . @ . @ . @ @ . . @ . @ @ . @ . . . . . @ 
@ . @ @ @ . . . @ . . . @ @ @ @ . . . @ . @ @ . @ @ @ @ . @ . . @ @ @ @ @ @ @ . @ @ . . @ @ @ . @ @ . @ @ @ @ @ . @ . @ . @ . . @ @ . . @ . . @ @ . @ . @ . . @ @ . . . . . @ @ @ @ @ @ . . @ . @ @ . @ 
@ . . @ . @ . @ . @ . @ . @ @ @ @ @ . . @ . . . . @ @ @ . @ @ . . @ @ @ . . . . . . . @ . @ @ @ . . . . @ @ @ @ @ . . . @ . . @ . @ @ . @ . @ @ @ @ . . . @ . @ @ . @ . @ . @ @ @ @ @ . @ . . . . @ . @ 
@ . @ . . . . . . . . . . . @ @ . @ . @ @ . @ . @ @ . . . . . . @ @ @ @ @ . @ . @ @ @ . . . @ @ @ @ . @ . @ @ @ . @ . @ . @ @ . . . @ . . @ @ @ @ @ @ @ . . . . . @ @ . @ . . @ @ @ . . . @ @ . @ . @ @ 
@ . . . @ @ . @ . @ . @ . @ @ . . @ . @ . @ . . @ . @ . @ @ @ . @ @ @ @ @ @ . . . . . . @ . . @ . . . . . . @ . . . . . . . . . @ . @ . @ . @ @ @ @ @ @ @ @ . @ @ @ . @ . @ @ . @ . @ @ . . . . . . . @ 
@ . @ @ . @ . . @ . . @ @ @ . @ . @ . . . @ . @ . . . . @ . @ . . @ . @ @ . @ . @ @ @ @ . @ @ @ @ . @ . @ . @ @ . @ . @ @ . @ . @ . . @ @ . . @ @ @ @ @ . @ . . . . . . . . . . . . . . . @ @ @ @ @ @ @ 
@ . @ . . . . @ @ @ . @ . . . . . @ . @ . . @ @ @ @ . @ . . . . @ . . . . . . . . . . . . . . @ . . . @ . @ @ . @ . . . . @ . . . @ . . @ . @ . @ . . . . . . @ . @ . @ @ @ . @ . @ . @ . . . . . . . @ 
@ @ . . @ . @ @ @ @ . . @ . @ @ . . . . @ @ . @ @ . . @ @ @ @ . @ @ @ . @ . @ . @ . @ . @ @ @ @ @ . @ . . . . . @ @ @ . @ . @ . @ . @ . . . . . . @ . @ . @ . . @ . @ . @ . . . @ . . @ . @ . @ @ . @ @ 
@ . . @ . . . . @ @ . @ . @ . . . @ . @ . . . . . . @ . . . . . . . @ @ . . . @ . . @ @ @ @ . @ . . @ . @ @ . @ @ @ . . . . . @ . . . @ . @ . @ @ . @ @ @ . . @ @ . . . . @ . @ @ @ . . @ @ . . . @ @ @ 
@ @ . . @ . @ . @ . @ . . . . @ . . @ . . @ @ . @ . @ . @ . @ . @ . . . @ @ @ . @ . . @ @ . . . @ . . . . @ @ . . . @ . @ @ @ . . @ @ @ . @ . @ @ . . @ . @ . . . . @ . @ . . . . . @ . . . @ @ @ @ @ @ 
@ . @ . @ @ . @ . . . . @ . @ @ . @ . . @ . . . . @ . . . @ @ @ . . @ @ . . . . . . @ @ @ . @ . @ . @ . @ . . @ . @ @ @ @ @ @ @ . . . . @ . @ . . . @ . . @ . @ . @ . @ @ @ @ @ . @ . . @ . . @ @ @ @ @ 
@ . @ . . @ . . @ . @ . . @ @ . . @ @ . @ . @ . @ @ @ . @ . @ @ . @ @ . . @ @ . @ . . @ . @ . . . . . @ @ @ . . . . @ @ @ @ @ . . @ @ . @ . . @ @ . . . @ @ @ @ @ . . . @ . . . @ @ @ . . @ @ @ @ @ @ @ 
@ . @ . @ @ @ . @ . @ @ . . . @ . . @ @ . . . @ . . . . . . . . @ @ @ @ @ . . . . @ @ . . . . @ @ . @ @ @ @ @ @ . @ . @ . @ . . @ . . @ @ . @ . @ . @ @ . @ . @ . @ . @ . @ . @ . @ @ . @ @ @ . . @ @ @ 
@ . . @ . @ @ . @ . @ . . @ . . @ @ . . . @ . . @ . @ . @ . @ . . @ @ @ . . @ . @ @ . @ . @ . @ . . @ . . @ . . . . . . . . . @ . . @ . . . . . . . . . . . . . . . . . . . . . . . . @ . @ @ . @ @ @ @ 
@ @ . @ . . . . . . . @ . @ . @ @ @ @ @ . @ . @ . @ . . . @ . . @ @ @ @ @ @ . . . @ . @ . @ @ . @ . . @ . . . @ . @ . @ . @ @ . . @ . . @ . @ @ . @ . @ . @ @ @ . @ . @ @ . @ @ . @ . . . . . . . . @ @ 
@ . . . . @ @ . @ . @ . @ . @ @ @ @ @ . . @ . . . . @ . @ @ @ . @ @ . @ @ . @ . @ @ . . @ @ @ . . . @ . . @ @ . @ @ . @ @ . @ . @ @ . @ . @ . . . . @ . . @ . @ . . @ @ @ . . @ @ . . @ . @ . @ . @ @ @ 
@ . @ . @ . @ @ . . . . . . @ @ . @ @ @ @ . . @ . @ . @ @ @ . @ . . . . . . . . . @ . @ . @ @ @ @ . @ . @ . @ . @ . @ . . . . . . . . . . . @ @ . @ . @ . . . . @ @ @ @ @ . @ @ . @ . @ . . @ . . . @ @ 
@ . @ . . . . . @ . @ . @ . . . . . @ . @ . @ . . . . . @ . . . @ @ . @ . @ . @ . . . . . . . . . . . . . . . . . . . . @ . @ . @ @ . @ . @ . . @ . . . @ @ . @ . . @ @ . @ . @ . . @ . . @ . @ . @ @ @ 
@ . @ . @ @ @ @ @ . . @ @ . @ . @ @ . . @ @ . . @ . @ @ . . @ . . . . . @ . . @ . @ @ @ . @ . @ . @ . @ . @ . @ @ . @ . . @ . @ . @ @ . . @ . @ . @ . @ @ . @ . @ . . . . . . . . @ @ @ . . . . @ @ @ @ 
@ @ . . @ . @ . . . @ @ . . . @ @ . @ . @ . @ . @ . . @ @ @ @ . @ @ . @ @ @ . @ . . . @ @ . . @ @ @ @ . . . @ @ @ . . @ . . . . . . . @ @ . . . . . . . . . . . . . @ . @ . @ . @ . . . . @ . @ @ @ @ @ 
@ . . @ . . . . @ . . @ . @ . @ . . . . . . . . . @ . . @ . @ . . @ @ . @ . . @ . @ . . . @ . @ . @ . . @ . . @ . @ . . @ . @ . @ . @ . @ @ . @ @ @ @ @ @ . @ . @ . @ . . @ . @ . @ . @ @ . . . @ @ @ @ 
@ . @ . . @ . @ . . @ @ . . @ . . @ . @ @ @ @ . @ @ . @ . . . . @ . @ . @ @ . @ . . @ . @ . . . . . @ @ @ . @ . . @ . @ . @ @ @ . . . . . . . . . . . @ . . @ . . @ . . @ @ . . . @ @ . . @ . @ @ @ @ @ 
@ . @ @ @ . . @ @ . @ . @ @ . . @ . . . . @ @ @ @ @ . . @ . @ @ @ . . . . . . @ . @ . . @ . @ . @ @ . . . . . @ . . . . . . . @ @ . @ . @ @ . @ . @ @ . . @ . . @ @ . @ @ . . @ . @ @ . @ . . . @ @ . @ 
@ . @ @ . . @ . . . . . @ . @ . @ @ . @ @ @ @ @ @ . @ @ @ . @ . . @ . @ . @ . . @ . @ . . @ @ . . @ @ . @ . @ @ @ @ . @ . @ . . . @ @ . @ @ . . @ @ @ @ . @ . @ @ . . . . . @ @ @ @ . . @ @ . @ . . . @ 
@ @ . . . @ . . @ @ @ . . . @ @ . @ . . @ . . . . . . . . . . . @ . @ . . . @ @ . . @ . @ . . @ . @ . @ . @ . @ . @ @ . . . @ . @ . . . . . @ @ @ @ @ @ . . @ . @ @ @ @ . @ @ @ . @ @ . . . @ . . @ @ @ 
@ @ @ @ . . @ . . . . @ . @ . . . . . @ . . @ . @ . @ . @ . @ @ . . @ . @ . . . @ . . . . @ . @ . . . . . . . . . . @ @ . @ @ . @ @ @ . @ . . @ @ @ @ . @ @ . . @ . @ @ @ . @ . . . . . @ . @ @ . . . @ 
@ @ . . @ @ @ . @ . @ @ . . @ . @ . @ . @ . . @ . . . @ @ . @ @ . @ @ . @ . @ . @ . @ @ . @ . @ . @ . @ . @ . @ . @ @ . . . . @ . @ @ . . @ . . . . . . . @ . @ . . . @ . . . @ @ . @ . . @ . @ . @ @ @ 
@ @ . @ . @ . @ . . @ . . @ . . . @ @ . . . @ @ @ @ . . @ @ . . . . . . @ . . @ @ @ . . . @ . . . @ . . @ @ . @ . @ @ @ . @ . . . . . @ . . @ . @ . @ . @ . . . . @ @ . @ @ . . . . . @ . @ . . . . @ @ 
@ . . . . . . . . @ @ @ . . @ . @ . . . @ . . @ . . . @ @ @ . @ . @ @ . @ . @ . @ @ @ . @ . . @ . @ @ @ @ @ @ @ . @ @ . @ @ . @ . @ @ . . @ @ . @ . . @ @ @ . @ @ . @ . . @ @ . @ @ @ . . @ . @ . @ . @ 
@ @ . @ @ . @ . @ . @ . . @ . . @ . @ . . @ . . @ @ @ @ @ . @ . . @ . . @ . . . . @ . . @ . @ . . . @ . . @ @ . . . . . . . @ . @ @ . @ . . . @ @ @ @ @ @ . . . @ . @ . @ . . . . . @ @ . . @ . . . . @ 
@ . . . . @ . . . . @ @ . . @ . . @ @ @ @ . @ @ . . @ . . . . . @ . . @ . . @ @ . . @ . . @ . . @ . . @ . @ @ . @ . @ . @ . . . . . . . @ . @ @ @ . @ @ @ . @ @ . . . . . . @ . @ @ . . . @ . . @ . @ @ 
@ @ . @ . . @ . @ @ . @ . @ . . @ . . @ . . . @ . @ @ @ @ @ . @ . @ . . @ . . . @ @ . . @ . @ . . @ @ . . . @ . @ . @ @ @ . @ . @ . @ @ . . . @ . . . @ . . . . . @ @ . @ @ . @ @ @ @ . @ . . @ @ @ @ @ 
@ . . . @ @ . @ . . . . . . @ . . . @ . . @ @ . . . @ @ @ . . . . . @ @ . . @ . @ @ @ . @ . @ @ . . . . @ . @ @ . . @ @ @ . . @ @ @ @ . @ . @ @ @ . @ . @ . @ . @ . . . . . . . . @ . . @ . @ @ @ @ @ @ 
@ . @ . . @ . . . @ . @ . @ . . @ @ @ @ . @ . @ . @ . @ @ . @ . @ @ . . @ . . @ @ @ @ . . . . . @ @ . @ . @ @ @ @ . . . . @ . . @ . @ . @ . . . . . . . . . . @ . . @ . @ . @ . @ @ @ . @ . . @ @ @ @ @ 
@ . @ . @ . @ @ . . @ . . @ . @ @ . . . . . . . . . . . . . @ . . @ . @ . . @ @ @ . . @ . @ . @ @ @ . . . . @ @ @ @ . @ . . @ . . . . . . @ . @ . @ . @ @ . @ . @ @ . . . @ . . . @ @ @ @ . @ . @ . @ @ 
@ . @ . @ . @ . . @ @ @ . @ . @ . . @ @ . @ @ . @ @ . @ @ . @ . @ @ . . . @ . @ . . @ @ . . @ @ @ @ @ . @ @ . . @ . . . @ . . @ . @ . @ @ @ . . @ . . . . @ . . . @ @ . @ @ @ . @ . . . . . . . . . . @ 
@ @ . @ . . . . @ . . . . @ . . @ . . @ @ . . @ @ @ @ . . . . @ @ . @ @ . . . . @ . . @ @ . . @ . @ . . @ . @ . . @ . @ @ . @ . . . @ @ . @ . @ @ @ . @ @ . @ . @ . @ . @ @ @ @ . . @ . @ @ @ . @ . @ @ 
@ @ . . @ @ . @ @ @ . @ . @ . @ @ @ . @ . @ . . @ . . . @ . @ . . . . . . @ @ @ . . @ @ . @ @ . . . . @ . . . . @ . . . . @ @ @ . @ @ @ . @ @ @ @ . . . . . . . . . . @ . @ . @ . @ . . . . . @ . . . @ 
@ . . @ @ . . . . . @ . . @ . . @ . @ @ . @ . @ . @ @ . . @ @ @ . @ . @ . @ @ @ . @ . @ . @ . @ . @ . . . @ @ @ @ @ . @ @ @ @ . . . . . . . . . @ @ . @ . @ . @ . @ . . . . . . . . @ . @ . @ . @ . @ @ 
@ @ . @ . @ . @ @ . . @ . @ . @ . . . . . . . . . . . . @ @ @ @ @ @ @ @ . . . . . . . . . . . . @ . . @ . . . . @ . . @ @ @ . @ . @ . @ @ . @ . @ @ . @ . . @ . @ . . @ @ . @ . @ @ . . . @ . . . . . @ 
@ . . . . . . . . @ @ . . @ . . @ . @ . @ . @ . @ . @ . . @ @ @ @ @ @ @ @ . @ . @ . @ @ . @ . @ . @ . . @ . @ . . @ . . . . . @ . @ . @ @ @ . . . . @ . @ . . . @ @ . . . @ @ @ . . @ . @ . @ . @ . @ @ 
@ . @ @ . @ . @ @ @ @ @ . @ . @ @ @ . . @ . @ . . @ . . @ @ @ @ . @ @ @ @ @ . . . @ @ . . . @ . . . . @ @ . . @ . . @ @ . @ . . @ @ . @ . @ @ . @ . . . @ @ . @ . . . @ . @ @ . @ . @ . . . @ @ . . . @ 
@ . . . @ . . . . @ @ . . @ . @ . . @ . . @ . . @ . . @ @ @ @ . . @ @ . @ . @ . @ @ . @ . @ @ @ . @ . . . @ . @ @ @ . . . . @ . . . @ @ . . . @ . . @ . . . @ . @ @ @ @ @ @ @ . . . . @ . @ . . @ . @ @ 
@ . @ @ . @ . @ . . . @ . @ @ @ @ . . . @ @ @ . @ @ . . . @ @ . @ . @ . @ . . @ . . . . . . @ @ @ . @ . @ @ . . . @ . @ @ @ . . @ . . . @ . @ . @ . @ . @ . . . . @ . @ @ @ . @ @ @ . . @ . . @ @ @ @ @ 
@ @ . . . . . . @ . @ @ @ @ . @ . . @ . . . @ @ @ @ . @ . . . . . . . . @ . @ . . @ . @ . @ @ . @ . . . . . @ . @ @ . . . . @ . . @ @ . . . . . @ . @ @ . @ . @ . . . . @ . . @ . . . @ @ . @ . @ . @ @ 
@ @ . @ . @ . @ @ . @ . . . . . . @ . . @ @ . . @ . . . @ . @ @ @ . @ @ . . . . @ @ @ . . . . . . @ @ . @ . . @ @ . . @ . @ @ @ . . . @ @ . @ . @ . . @ . . . . @ @ . @ . @ . . @ . @ . @ . . . . . . @ 
@ @ @ @ @ . . . . @ . @ @ . @ . @ . . @ . . @ . @ @ . @ @ @ @ @ . @ @ @ @ . @ . . @ @ @ . @ . @ . @ . . @ . @ @ @ @ . @ . . @ . @ . @ @ @ . . @ . . @ . . @ . @ . @ @ @ . . @ . . . . . . . @ @ . @ . @ 
@ @ @ @ . @ . @ . . . @ @ @ @ @ . @ . @ @ . @ . . . . . . . @ . . @ . . . . @ . @ . @ . . . @ @ . . @ . . @ @ @ @ @ . @ . @ @ . @ . . @ @ . @ @ . @ . @ . . @ . . @ @ @ . @ . @ . @ . @ . @ . @ . . @ @ 
@ . @ . . @ @ @ @ @ . @ . @ @ . . @ @ . . . . . @ @ . @ . @ @ . @ . @ . @ . @ . . . . @ . @ @ @ . @ . . @ . @ @ @ @ . . @ @ @ . @ . @ . @ @ @ . . @ . . @ @ @ @ . . @ . . @ . . @ . . . @ . . . @ @ @ @ 
@ . . @ . . . @ . @ @ . . . . @ . . @ @ . @ @ . . . @ . . . . . . . . @ . @ . . @ . @ @ . . . . @ . @ . . . . . . . @ @ @ @ . . . . . . . @ . @ @ @ @ . @ . @ . . @ . @ . @ . @ . @ . @ . @ . @ @ @ @ @ 
@ @ . . . @ @ . . @ @ @ . @ . . @ . @ . . @ @ . @ @ . . @ . @ . @ @ . . . @ @ . . @ @ . . @ . @ . . . . @ . @ . @ @ . @ @ @ @ . @ . @ @ . . . . . . . . . . . . @ @ . . . . . . . . . . . . . . @ . @ @ 
@ . @ @ . @ . . @ @ @ @ . . @ . . . . . @ . . . . . @ . . @ . . @ . @ @ . @ . . @ . . @ . . @ @ @ . @ . . @ . . @ @ . . . @ . @ . . . . @ . @ . @ . @ @ . @ . @ . . . @ . @ . @ @ @ . @ @ . @ . . . . @ 
@ . . @ . . . @ @ @ @ . . @ @ @ . @ . @ @ @ @ . @ @ . . @ . . @ . . . . . . @ . . . @ . @ . . . . @ . . @ . @ . @ . . @ . @ . . @ . @ @ @ . . @ . @ @ @ . . @ . @ . @ . @ . . . . . @ . @ . . @ . @ . @ 
@ . @ . @ @ . . . @ . @ . . @ @ @ . . . @ @ @ . . . @ . @ . @ . @ @ . @ . @ . . @ . . . . @ . @ . . @ . . . . @ . @ . @ @ . @ . @ . @ @ @ . @ @ . @ . . . @ . . . . . . @ @ @ . @ . . . @ . @ . @ @ . @ 
@ . . . . . . @ @ . . . . @ . @ @ @ . @ @ @ @ . @ @ . . . @ . . . @ . @ . @ @ . . @ . @ @ . . . @ @ . . @ @ @ . . . . @ @ . . . . . . . . @ . . . . . @ . . . @ . @ . @ @ . . @ @ @ . @ . . . . . . @ @ 
@ @ . @ . @ . . . . @ . @ . . . @ . . . @ @ @ @ . . @ . @ . @ . @ @ @ . . @ @ @ @ . . @ @ @ . @ . @ @ . @ . @ @ . @ . . . @ @ . @ . @ . @ @ @ . @ . @ . . @ . . @ . . . @ . @ . @ . @ @ @ . @ . @ @ @ @ 
@ . . @ @ @ . @ . @ . . . @ . @ . @ . @ . . @ @ . @ . . . . . . . . . @ . . . @ @ . @ @ @ . . . . @ . . @ . @ @ @ . . @ @ . . @ . . . @ . @ . @ . . @ @ . . @ @ @ @ @ . . . . . . . . @ @ @ @ . @ . @ @ 
@ . @ . @ . @ . . . @ . @ . . . . . . . . @ @ . . . @ . @ . @ . @ @ . @ . @ @ @ @ . @ @ . @ @ . @ @ @ . . . . . . . @ . @ . @ @ @ . @ . . . . . . @ . . . @ . @ @ . @ . @ . @ @ @ . @ . @ @ @ . . . . @ 
@ . @ . . . . . @ . . @ . @ . @ . @ . @ . . . . @ @ . @ . . . @ . . . @ @ . . @ @ . @ . . @ . . . @ . . @ . @ @ . @ @ . . . @ . . @ . . @ @ . @ . @ @ . @ . . . . . . @ . . @ @ . @ @ . . @ . @ . @ @ @ 
@ @ @ @ @ . @ . @ . @ . . . . @ @ . . . @ @ @ @ . . . . @ . @ @ @ @ . . @ . @ . @ @ . . @ @ @ . @ @ @ . . @ . @ . @ @ @ @ . . @ . . . @ . . . @ @ . . . . . @ . @ @ @ . @ . @ . . @ . @ . . . . @ @ @ @ 
@ @ @ @ @ @ . . @ @ . . @ . @ . . . @ . . . @ @ @ . @ . . . @ @ @ @ @ . . . . . . @ . @ . @ . . @ . . . @ . . . . . @ @ @ . @ @ @ . @ . . @ @ . . . @ . @ @ . @ . @ . . . @ @ @ . . . . . @ @ @ . @ @ @ 
@ @ @ @ @ . . @ @ . . @ . . . @ @ . @ . @ . . @ . . @ . @ . . @ @ @ @ . @ . @ @ . @ . @ . . @ . . @ . @ @ @ . @ . @ @ @ . . . @ @ @ . @ @ . . @ . @ . . . @ . @ . . . @ . @ @ . @ . @ . @ . @ . . . @ @ 
@ @ @ @ @ . @ . . @ . . @ @ @ . . @ . . . @ . . @ . . @ . @ . . @ @ @ . . @ . . . . . . . @ . . @ . . @ . @ . . @ @ @ @ @ . @ @ . . . . . @ . . . . @ . @ . . . @ @ . . @ @ . . . . . @ @ . . @ . @ . @ 
@ @ @ @ @ . . . @ @ @ . . . . . @ @ @ . @ @ @ . . @ @ . . . . @ . @ . @ . @ . @ . @ . @ . . @ . . @ . @ . @ . @ @ @ @ @ . . . . @ . @ @ . @ @ @ . @ @ . . . @ . . . @ . . . @ . @ . @ . @ . @ . . . . @ 
@ @ @ @ . . @ @ . . . @ . @ . @ @ . . . @ @ @ @ . @ . @ . @ . . . . . . @ . . . @ . . . @ @ . . @ @ . . . . @ . @ . @ . @ . @ @ @ @ @ . . . @ . . . @ @ . @ . @ @ @ . @ . @ . @ . . . . . . . . @ @ @ @ 
@ @ @ @ @ @ . @ . @ @ @ . . @ . @ . @ . . @ @ @ @ @ . @ . @ . @ . @ . @ . @ . @ . . @ . . . @ @ @ . @ . @ . . . . . . . . . . . . . @ @ . @ . @ @ . @ @ . . . . . . . . . . . . . @ . @ @ . @ . . . . @ 
@ @ @ @ . . . . . . . . . @ @ . . @ @ . @ . @ @ @ . . . . @ . . @ . . @ . . @ @ @ . @ . @ . @ . . . . . . @ . @ . @ . @ . @ . @ @ . . . . . . @ @ @ . . . @ @ . @ . @ . @ . @ . @ . . . @ . . @ . @ . @ 
@ @ . @ . @ @ . @ @ @ . @ @ . @ . @ @ . . . . . . @ @ @ @ . . @ . @ . @ . @ . . . @ . . @ @ @ @ @ @ @ . @ . . . @ @ . . @ . . . . @ @ . @ @ . . . @ . @ . . . @ . @ . . . @ . . @ @ . @ . @ . . @ . . @ 
@ . . . . @ @ . . @ . @ . . . . . @ . @ . @ . @ . . @ . . . @ . . . . . . . . @ . . @ . . @ @ @ . . . . . @ @ . . . @ . . @ . @ . . @ . . . @ . @ . @ . . @ @ . . . . @ . @ . @ @ . @ @ . @ . @ . @ . @ 
@ . @ . @ . . . @ . . . . @ . @ . . . @ . @ . @ @ @ @ . @ . @ . @ @ @ . @ . @ . . @ @ @ . . @ @ . @ @ . @ . . @ . @ @ . @ . . . @ . . @ . @ @ @ . . . @ . . @ @ . @ . @ . . @ @ . . . . . @ . . . @ . @ 
@ @ @ . . @ @ @ @ @ . @ @ . . @ @ @ . . . . @ . . . . . @ . . @ . . . . . @ @ @ . . . @ . @ @ @ @ . . . . . @ . @ @ . @ @ @ . @ @ . @ . @ @ @ . . @ @ . . @ . . @ . . @ . @ @ . @ . @ . @ @ @ . @ . . @ 
@ @ @ . @ . @ . @ @ @ . . . @ . @ @ @ @ . @ . @ . @ . @ @ @ . . @ . @ . @ . @ . @ . @ @ . . @ . . . @ . @ . @ . . @ . @ @ @ . . . @ . . @ @ . @ . . . . @ . @ . . @ . @ . @ . . . . . @ @ . . @ @ @ . @ 
@ @ . . . . . . @ @ @ @ @ . . . . . @ . . . . @ @ . . . @ @ . @ . @ @ . . . . . @ . . @ @ @ . @ . @ . . . @ . @ . . . . @ . . @ . . . @ . . . . @ @ @ . @ . @ . @ @ @ . @ . @ @ @ . @ @ . . @ . @ . . @ 
@ @ @ . @ . @ . @ @ @ @ . . @ . @ . . @ . @ . . . @ . @ . . . . . @ @ . @ . @ @ @ @ . @ . @ . . . @ @ . @ . . . . @ . @ . @ . . @ . @ @ @ @ . @ . . . . . . . . . . . . . . . . @ . . . @ . @ . . . @ @ 
@ @ @ @ @ . @ @ . @ @ . @ . . @ . . @ @ . . @ . @ @ @ . @ @ . @ . . . @ . . . . . . @ . . @ @ . @ . . . . . @ . @ @ @ @ . . @ @ . . . . . . . @ @ . @ . @ . @ . @ . @ . @ @ . @ . . @ . @ . . @ @ . . @ 
@ @ @ @ @ @ . . . . . . . . @ . . @ . @ . @ . @ . . @ . . . . . @ @ . . @ . @ . @ @ . @ . @ . @ @ . @ . @ . @ @ . @ . @ . @ @ . @ . @ . @ . @ @ @ @ . . . @ . . @ . @ . @ @ @ @ . @ . @ . @ . @ @ . @ @ 
@ @ @ @ @ @ . @ . @ . @ . @ @ @ . . . @ . . . @ @ . . . @ . @ . . . @ . @ . . @ . . . . . . . . . . . @ . . . . . . . . . . . . . @ . . . @ @ @ @ @ @ . @ @ @ . . @ @ @ @ @ @ . . . . . . . . . . . . @ 
@ @ @ @ @ @ @ @ @ @ @ @ @ @ @ @ @ @ @ @ @ @ @ @ @ @ @ @ @ @ @ @ @ @ @ @ @ @ @ @ @ @ @ @ @ @ @ @ @ @ @ @ @ @ @ @ @ @ @ @ @ @ @ @ @ @ @ @ @ @ @ @ @ @ @ @ @ @ @ @ @ @ @ @ @ @ @ @ @ @ @ @ @ @ @ @ @ @ @ @ 
3
59 75 65 62
62 14 30 61
16 72 73 31
