50 50
@ @ @ @ @ @ @ @ @ @ @ @ @ @ @ @ @ @ @ @ @ @ @ @ @ @ @ @ @ @ @ @ @ @ @ @ @ @ @ @ @ @ @ @ @ @ @ @ @ @ 
@ @ @ @ @ @ @ @ @ @ @ @ @ @ @ @ @ @ . . . @ . @ . @ @ . @ @ @ @ @ @ @ @ . . . . . . . . . . . . . @ 
@ @ @ @ @ @ @ @ @ @ @ @ @ @ @ @ @ . @ @ . . . . . . . . . @ @ @ @ . @ . @ . @ @ . @ . @ . @ . @ . @ 
@ @ @ @ . @ @ @ . . . @ @ @ @ @ @ . . . . @ @ . @ . @ . @ @ @ . . . . . . . . @ @ . @ . . . @ . . @ 
@ @ @ . . . . . @ @ . @ @ @ @ @ @ @ @ . @ . . @ . . . @ @ . . . @ . @ . @ @ @ @ @ . @ . @ @ @ @ . @ 
@ @ . @ @ . @ . @ @ . . @ @ @ @ . . @ @ . . @ . . @ @ . . @ @ . . @ @ @ . . @ @ . . . @ . . @ . . @ 
@ . . @ @ @ . . . . . @ . @ @ . @ . . @ @ . @ . @ . @ . @ . @ . @ . @ . . @ . . @ @ . . . @ @ @ . @ 
@ @ . @ @ @ @ . @ @ . . . . . . . . @ . . . . . . . . . . . . . . . . @ . @ . @ . @ . @ . @ @ @ @ @ 
@ . . . @ . @ . @ . . @ . @ . @ . @ . . @ @ . @ . @ . @ . @ . @ . @ . . . . . . . . @ . . . @ @ @ @ 
@ @ . @ . . . @ . @ . @ @ @ @ @ @ . . @ . . @ @ @ @ @ . @ . @ @ . @ . @ . @ . @ . @ . @ . @ . . @ @ 
@ . . . @ . @ . . . . . . @ @ @ . . @ @ . @ . @ . . . . . . . . @ . @ @ . . @ @ . . . . . . . @ @ @ 
@ . @ . . . . @ . @ . @ . . . @ . @ . . . . . . @ . @ @ . @ . @ . . . . @ @ @ . @ @ @ @ @ . @ @ @ @ 
@ @ @ @ @ @ . . @ . . @ @ @ @ . . . . @ . @ . @ . . . @ . . @ . @ . @ @ @ . @ . @ . . . . @ @ @ @ @ 
@ . @ . @ . . @ . @ . . @ @ @ @ . @ . @ . . @ . @ @ . . @ . . . . . . . . . . . . . @ . @ @ @ @ @ @ 
@ . . . . . @ @ . @ . @ . @ . @ . . @ . @ @ . . . @ . @ . . @ @ . @ . @ . @ . @ . @ . . . @ @ @ @ @ 
@ . @ . @ @ . . . . . @ . . . . . @ . . . @ . @ . @ . @ @ . @ @ . . @ . @ @ . . @ @ @ . @ @ @ @ @ @ 
@ @ . . @ @ @ @ @ @ . @ . @ . @ . @ . @ @ . @ . . @ . . @ . . @ . @ @ . . . . @ . @ @ @ @ @ @ @ @ @ 
@ @ @ . @ @ @ . . . . . . . @ . @ . . . . . . @ . @ . @ . @ . . @ @ . @ . @ . . . . @ @ @ @ @ @ @ @ 
@ @ . . . @ . . @ @ . @ . @ . . . . @ . @ . @ . . @ . @ . . @ . @ . . @ @ . @ . @ @ @ @ @ @ @ @ @ @ 
@ @ @ . @ @ @ . . . @ . . @ . @ . @ . @ @ @ . . @ . . . . @ . @ . @ . . . . . @ . @ @ @ @ @ @ . @ @ 
@ . . . . . . . @ @ . @ @ . . . @ . . @ . . @ . @ . @ @ . . . . . . . @ . @ . . . . . @ . @ @ . . @ 
@ @ . @ @ . @ . @ @ . . @ @ . @ @ . @ @ @ . . . @ . . @ @ . @ @ . @ . @ @ . @ @ . @ . . . . . . @ @ 
@ @ . . . @ @ . . . . @ . . . . . . . @ . @ @ . . . @ @ @ . @ . @ . . . . . . . @ @ . @ . @ . @ . @ 
@ . . @ . @ . . @ . @ @ @ @ . @ @ @ @ . . . @ @ . @ . @ @ @ @ . . . @ @ . @ . @ . . . . @ . . @ . @ 
@ @ . . @ . @ . . @ @ @ @ @ . . @ @ @ @ . @ . . . . . . @ @ . @ . @ . @ . . @ . . @ . @ . @ . . . @ 
@ . . @ . . . . @ . @ @ @ . @ . . . @ @ . @ . @ . @ @ . @ . . . . . . @ . @ @ @ @ . . . . . @ . @ @ 
@ . @ . @ @ @ . . . . @ . . . . @ @ . @ . . . . @ @ . @ . @ . @ . @ @ . . @ @ . . @ . @ . @ @ . . @ 
@ @ . . @ @ . . @ @ @ . @ @ @ . . . . . . @ . @ . @ . @ . . . @ . @ @ @ . @ . . @ . . . @ @ @ . @ @ 
@ . @ . @ . @ . @ . . . . . . . @ . @ . @ @ . . . . . . @ @ . @ @ @ @ @ . . @ . @ @ . @ @ @ @ @ . @ 
@ . . . . . . . @ . @ @ . @ @ @ . . . @ @ @ @ . @ . @ . . . @ @ @ @ @ @ @ @ . . . . @ @ @ @ @ . . @ 
@ @ @ . @ . @ . . . . @ @ @ @ @ . @ . . @ @ @ @ . . @ . @ . @ @ @ @ @ @ @ @ . @ . @ @ @ @ @ @ . @ @ 
@ @ @ @ . . @ . @ @ @ . @ @ @ . . @ . @ @ @ @ @ @ . @ . . @ @ @ @ @ @ @ @ . . . @ . . @ . @ . . . @ 
@ @ @ @ @ @ . . . @ @ . . @ . @ @ @ @ @ @ @ @ @ . @ . . @ @ @ @ @ . . @ . @ . @ @ @ . . . . @ . @ @ 
@ @ @ @ @ @ @ . @ . . . @ @ . . . . . @ @ @ @ . . . . @ . @ @ @ @ @ . @ . . . @ @ . . @ . @ . . . @ 
@ . @ @ @ . . . . . @ . . . . @ @ . @ . @ . . @ . @ . @ . . . @ @ @ . @ @ @ . . @ @ . @ . . @ . @ @ 
@ . @ @ . . @ @ . @ . . @ . @ @ @ . . . . @ . . @ @ @ . . @ @ . @ . . . . @ @ . . @ @ . @ . @ . . @ 
@ . . . @ . . @ . @ @ . @ . . @ @ @ @ . @ @ . @ . @ . . @ . @ . . . @ . @ . @ . @ . @ . . . . . @ @ 
@ . @ @ . . @ @ . . @ . @ . @ @ @ @ @ . . . . . . . @ . . . . . @ @ @ @ @ . . . . . @ @ @ @ @ . . @ 
@ . . @ . @ . @ . @ . @ . @ @ @ @ @ . @ @ . @ @ . @ . . @ . @ @ . . @ . . . @ . @ @ . . . . . . @ @ 
@ . @ . . . . . @ . . . . . @ @ @ . . . . @ . . . @ . @ . @ . @ . @ . @ @ . @ . . . . @ @ @ . @ @ @ 
@ . . . @ @ @ @ . @ . @ . @ . @ @ @ . @ . . . @ . . . . . . . . . . . . . . . @ @ . @ . . @ . . . @ 
@ . @ . . . . . . . . @ @ . . @ . @ @ . @ . @ . . @ . @ @ @ . @ @ . @ @ . @ @ . . . . @ . . @ @ . @ 
@ . . @ . @ . @ @ . @ . @ . @ . . . @ . . . . @ @ . . @ @ @ . . . @ @ . . . @ @ . @ . . . @ . @ . @ 
@ . @ . @ @ @ . . . @ . . . . . @ . @ . @ . @ . . @ . . . . @ @ . @ . @ . @ @ . . @ . @ . . . . @ @ 
@ . . . . @ . @ @ . @ @ . @ . @ . . . @ . . . . @ @ @ . @ @ . . . . . . @ . @ @ @ . @ @ . @ . @ @ @ 
@ . @ @ @ . . . @ . @ @ @ @ @ . @ @ . @ @ . @ . . @ . @ @ . . @ . @ . @ . . . . @ . . @ . . @ @ @ @ 
@ . . . @ @ . @ . @ . @ @ @ @ . . . . . . . @ @ . . . . . @ @ . . . @ . @ @ . @ . @ . . . @ @ @ @ @ 
@ . @ . . . . . . . . . @ @ @ . @ @ . @ @ . . @ @ . @ . @ @ @ @ . @ @ . . . . . . @ . @ . . @ @ @ @ 
@ . . @ @ . @ . @ . @ . . . @ . . . @ . . . @ @ . . . @ @ @ @ @ . . . . @ . @ @ . @ @ . . @ @ @ @ @ 
@ @ @ @ @ @ @ @ @ @ @ @ @ @ @ @ @ @ @ @ @ @ @ @ @ @ @ @ @ @ @ @ @ @ @ @ @ @ @ @ @ @ @ @ @ @ @ @ @ @ 
3
44 31 37 8
19 47 45 23
36 1 15 18
