100 100
@ @ @ @ @ @ @ @ @ @ @ @ @ @ @ @ @ @ @ @ @ @ @ @ @ @ @ @ @ @ @ @ @ @ @ @ @ @ @ @ @ @ @ @ @ @ @ @ @ @ @ @ @ @ @ @ @ @ @ @ @ @ @ @ @ @ @ @ @ @ @ @ @ @ @ @ @ @ @ @ @ @ @ @ @ @ @ @ @ @ @ @ @ @ @ @ @ @ @ @ 
@ @ @ @ @ @ @ @ @ @ @ @ @ @ @ @ @ @ . @ @ @ . @ . @ . @ @ @ @ @ @ @ @ @ . . . @ @ @ @ @ @ @ . . . @ . @ . @ . . . @ @ @ . . @ @ @ @ @ . . . @ . @ . @ @ . @ . @ . @ . . . . . . @ . @ . @ @ . @ . @ @ @ 
@ @ @ @ @ @ @ @ @ @ @ @ @ @ @ @ @ @ . . @ . . @ . @ . @ @ @ @ @ @ @ @ . @ @ . . . @ @ @ @ . @ @ . @ . . . @ @ . @ . @ . @ . . @ @ @ . @ @ . . . . . . . . . . . . . . @ @ . @ @ . . . . @ . . . . . @ @ 
@ @ @ @ @ @ @ @ @ @ @ @ @ @ @ . @ . . @ . @ . . . . . . @ @ @ @ @ @ . . . . . @ @ @ @ @ . . @ . . . . @ . . . . . . . . . . @ . @ . . . . . @ . @ . @ @ . @ @ @ @ . @ . @ . @ . . @ . @ . @ . @ @ . . @ 
@ @ @ @ @ @ @ @ @ @ @ @ @ @ . . . @ . . . @ @ . @ @ . @ . . @ . @ @ . @ . @ . . @ @ @ . @ . . @ @ . @ . @ . @ @ . @ . @ . @ . . . @ . @ . @ . . @ . . . @ . . . . @ . . . @ . @ . . @ . . @ . @ @ @ @ @ 
@ @ @ @ @ @ @ @ @ @ @ @ @ . @ @ . . . @ . @ . . @ @ @ . @ . . . . . . . @ . @ . @ . . . . @ . . @ @ . . . @ . . @ @ @ . . . @ . @ . @ @ @ . @ . . @ @ @ . . @ . @ . @ . @ . . . . @ . @ . . . @ @ @ @ @ 
@ @ @ @ @ @ @ @ @ @ @ @ @ . @ . @ @ . . @ . @ . @ . . . @ @ @ @ . @ . @ . . @ . . @ @ @ . . . @ . . . @ . . @ . @ @ @ @ @ . . . . . . @ . . @ @ . . @ @ @ . . @ . . . . . @ . @ . . . . . @ . @ @ @ @ @ 
@ @ @ @ @ @ @ @ @ @ @ @ . . @ . @ . . @ . . . . . . @ @ . @ . . . @ @ @ @ . . @ . . . . . @ . . @ . @ @ @ . @ . . @ . . . @ . @ . @ @ . . @ . @ . @ . @ @ . @ . . @ @ . @ @ @ . . @ . @ @ . @ . @ @ @ @ 
@ @ @ @ @ @ @ @ . @ @ @ @ . . . . @ . . @ @ @ . @ . . @ . . @ @ . . @ @ . . @ . . @ @ @ . . @ . @ @ . @ @ . . . @ @ . @ @ . . @ @ . @ @ . . . . . . . . @ . . @ . . . @ @ @ . @ . . @ @ . . . . . @ @ @ 
@ @ @ @ @ . . . . . @ @ . @ . @ . . @ . . @ . . @ . @ . . @ . . . @ @ . @ . . @ @ . . . @ @ . . . @ . @ . @ . @ . @ . @ . @ . . @ . . . @ @ . @ . @ @ . @ . @ @ . @ @ . @ . . . @ . . . . @ @ . @ . @ @ 
@ @ @ @ @ @ . @ @ . @ . . . . . @ . . . @ @ @ @ . . . . @ . . @ . @ . . . . @ @ . . @ . . . @ . @ . . . . . . . . . . . . . . @ . @ @ . @ . . . @ . @ . . . . . . . . . @ . @ . . @ . @ . @ . @ . . @ @ 
@ @ @ @ . . . . @ . @ . @ . @ @ . . @ . . @ . @ @ . @ @ . @ . @ @ . @ @ @ . . . @ . @ . @ @ . . . . @ . @ @ @ . @ . @ @ . @ . . . . @ . . @ . @ . . . @ @ . @ . @ @ . @ . @ @ @ . . @ @ . . . . @ . @ @ 
@ @ @ @ . @ . @ . @ . @ . @ . @ @ . @ @ . . . @ @ . . @ . . @ . . . . . . . @ @ . @ . . . . @ . @ . @ @ @ @ @ @ . @ . @ . @ . @ . @ @ @ . . . . . @ @ @ @ . @ . @ @ @ @ . . @ . . @ @ . . @ @ . . . . @ 
@ @ @ @ @ . . . . . . . . . . . . . @ . . @ . . @ . @ . @ . @ @ . @ . @ . @ . @ . . @ . @ . . . . @ @ @ @ @ . . . @ . . @ . . @ . . @ . . @ . @ . @ @ @ @ @ @ @ . . . . . @ . @ . @ . @ . . . @ . @ . @ 
@ @ @ . . . @ . @ . @ . @ @ @ . @ . . @ . @ . @ @ . @ . . . . @ @ . @ . . . . @ @ . . . . @ @ . @ @ @ @ @ . @ @ . . . @ . @ . @ . @ . . @ @ @ . . @ @ @ @ @ @ @ @ . @ @ . . . . . . . . . @ @ . @ @ @ @ 
@ @ @ . @ . . @ . @ . . . . . @ . . @ @ @ . . @ @ . . @ @ @ . @ . . . @ . @ @ . @ @ @ . @ @ @ @ @ @ @ @ @ . @ @ @ . @ . . . . . @ @ @ . @ @ . @ . . @ @ @ @ @ @ @ . . . @ @ . @ . @ . @ . . . . . . . @ 
@ @ . . @ @ . . . . @ . @ . @ @ @ . @ @ @ @ . @ . @ . . @ . . . @ . @ . . @ @ . . . @ @ @ @ @ @ @ @ @ @ @ . . . . . @ . @ . @ . @ @ @ @ . . . . . @ . @ @ @ @ @ @ . @ . . @ . . @ . @ @ . @ @ . @ . @ @ 
@ . @ @ . . . @ . @ . . @ @ . @ . . . . @ . . . . . . @ . . @ . . . . @ . @ . . @ . @ . @ @ @ @ @ @ @ @ . @ @ . @ . . . . @ . @ @ @ @ . @ @ . @ . . . . @ @ @ @ . @ . . @ . @ @ @ . . . . . . @ . @ @ @ 
@ . . @ @ @ . . @ @ @ . @ @ . @ @ . @ . . @ @ . @ @ . @ . @ . @ @ . @ . . @ . @ . . . . . @ @ @ @ @ @ @ . . . @ @ @ @ . @ . . . @ @ . . . @ @ . . @ @ @ . @ . @ . . @ . @ . . . @ . @ @ . @ @ @ . @ @ @ 
@ @ . . . . . @ @ @ @ @ . . . . . . @ . @ . @ . @ . . . @ . . @ . . . @ . . . . @ . @ @ @ @ @ @ @ @ @ @ @ . @ . @ . @ . @ . @ . @ @ @ . @ . . @ . @ @ @ . @ . . @ . . @ . . @ @ . . @ . @ . @ . . . @ @ 
@ . . @ @ @ . . @ @ @ . @ . @ @ . @ . @ @ . @ @ . @ @ . . @ . @ @ . @ @ . @ . @ . . . . @ @ @ @ @ @ . @ . . . . . . . . . @ @ . . @ . . @ . @ . . . @ . . @ @ . @ . @ . @ . . @ . @ . . . . . @ . @ . @ 
@ @ . . . . @ . . @ . . . . . . @ . . . @ . . @ . @ . @ . @ . . @ . . @ . . @ @ @ . @ . @ . @ @ @ . . . @ @ @ . @ . @ . @ @ . . @ . @ . . . . @ . @ . @ . @ @ . . . . . . . @ . . . . @ . @ . . . . . @ 
@ @ @ . @ @ . @ . . @ . @ . @ . . @ @ . . . @ @ . @ . . . . . @ . . @ . . @ . . @ @ . @ . . @ . . @ . @ . . @ . . @ . . @ . @ . . . . @ . @ . @ . . . . . . @ @ @ . @ . @ @ . . @ @ . @ @ . . @ @ . @ @ 
@ @ @ @ . @ . . @ . @ @ @ @ @ @ @ . . @ @ . . @ . . . @ @ @ . . @ . . @ . . @ . @ . . . . @ . @ . . . . @ . @ . @ . @ . @ . @ . @ . @ . . . @ . . @ . @ @ . @ . . . . @ @ @ . @ . @ @ . . @ . . . @ @ @ 
@ @ @ . . . . @ . @ . @ . @ @ . . @ . . @ . @ . @ @ @ @ @ . @ . @ . @ @ . @ . . @ @ . @ . . . . @ . @ . @ . . @ . . . . . . @ . @ @ . @ . @ . . @ . @ @ . . @ @ . @ @ . @ . . . . . @ . @ . @ . @ @ @ @ 
@ @ . @ . @ . . . . . . . . . @ . . . @ . . . . @ . . @ . . . . . . . @ . . . @ . . . . @ . @ . . @ . . . . @ . @ . @ . @ . @ . . @ . @ . . @ . . . @ . @ . @ . . . @ . . . @ @ @ . . . . . . @ @ @ @ @ 
@ . . . @ . . @ . @ . @ . @ @ . @ @ . . @ @ @ . . @ . @ @ . @ @ . @ . . . @ @ @ @ . @ . @ . @ . @ . . @ @ . . . . @ @ @ . . @ . @ . . . . @ . . @ . @ . . @ . @ . @ . . @ . . . . @ . @ @ . @ @ @ @ @ @ 
@ @ . @ . @ . @ @ . @ . @ @ @ . @ . @ . @ . @ . @ . . . @ @ . . @ @ . @ @ . @ . @ . . @ . @ . . . @ @ . . . @ . @ @ @ . @ . . . . @ . @ @ . @ @ . . . . @ . . . . . . @ @ @ . @ . @ @ @ . @ @ @ @ @ @ @ 
@ . . . . . . . . . . . . @ . . . . . . . . . . . . @ @ @ . @ . @ . . . . . . . @ @ @ . . . @ . @ . . @ . @ . . @ @ . . . @ @ @ . . . . . . @ . @ . @ . . . @ @ @ . @ @ @ @ . @ . . . . . @ @ @ @ @ @ @ 
@ @ . @ . @ . @ . @ . @ . . @ . @ . @ @ . @ @ . @ . . . . . . . . . @ . @ . @ . . . . @ @ . . . . . @ @ @ . @ . . @ @ @ . . @ . . @ @ @ @ . @ . . @ . . @ . @ @ @ @ @ @ @ . . . @ . @ . @ @ @ @ @ @ @ @ 
@ @ @ . . @ @ . . . @ @ . @ . @ . . @ . @ . . . . @ . @ @ . @ @ . @ . . @ . @ . @ @ @ . . @ @ @ @ . . @ . . . . @ @ @ @ . @ . @ . . @ . @ @ . . @ . @ . . @ @ @ @ @ @ . . . @ . @ . . @ @ @ @ @ @ @ @ @ 
@ . . @ @ @ @ @ @ . @ . . . . . . @ . . . . @ . @ @ @ @ @ @ . . @ . @ @ . @ . . @ . . @ . . @ @ . . @ @ @ . @ . . @ @ . . . . @ . @ @ . . . @ . . . . . @ . @ . @ @ . . @ . @ . . @ @ @ @ @ @ @ @ @ @ @ 
@ @ . . @ @ @ @ . @ . . @ . @ . @ . . @ . @ . . @ @ . @ @ . . @ . . . . . . @ . . . @ . @ . @ . @ . . @ . @ . . @ @ @ @ . @ . . . . . . @ @ . @ . @ @ . . . @ . . . @ @ . . @ . @ . @ @ @ @ @ @ @ @ @ @ 
@ . @ . . @ . . . @ . @ . . . @ . . @ . . @ @ . . . . . @ . @ @ . @ . @ . @ . . @ @ . . . . . . . @ . . . . @ . . @ @ @ @ . . @ . @ @ . . @ . . @ @ . . @ @ . . @ @ . @ @ . @ . . . . @ @ @ @ @ @ @ @ @ 
@ . . . @ @ . @ . . . . @ . @ @ . @ . . @ . . . @ @ @ . . . . . @ @ @ . . @ @ . @ @ @ @ . @ . @ . . . @ . @ @ . @ . @ @ . @ . @ . @ . . @ @ . @ . . @ . . @ @ . . . . . @ . @ @ @ . @ @ @ @ @ @ @ . . @ 
@ . @ . . . @ @ . @ . @ @ @ @ @ . @ @ @ . . @ . . @ . . @ @ . @ @ @ . @ . @ @ . @ @ . @ @ @ . @ @ @ . @ . @ . . . . . @ . @ @ . . @ @ . . @ . @ . @ @ . @ . . @ . @ . @ . @ . @ . @ @ . . @ @ @ . . @ @ 
@ @ . @ . @ . . . . @ @ @ @ @ @ @ . . . . @ . . @ @ . @ @ . . @ @ . . . . . @ . . . . . . . @ @ @ . . @ . . @ @ @ . @ . . . @ @ . @ . . @ . . @ . . @ . @ . @ . . . @ . . . . . . @ . . @ . @ . @ . @ @ 
@ . . . . . . @ @ @ . @ @ @ @ @ @ @ . @ . . @ . @ . @ . @ @ @ . @ @ . @ @ @ . . @ @ . @ . @ @ @ . @ . @ . @ @ @ . . @ @ . @ . @ @ @ @ . . . @ . @ . . . @ . @ @ . @ . @ . @ @ @ . @ . @ . . . . . . . @ 
@ . @ @ @ . @ @ @ @ . . @ @ @ @ @ . . @ . @ @ . . . . . . . . . . @ . . . . @ . @ @ @ . . @ @ @ . @ . . @ @ @ . @ . . @ . . . . . @ . . @ . . . @ . @ @ @ . @ @ . . . . @ . . . . . . . . @ . @ . @ @ @ 
@ . . @ @ @ @ @ @ . . @ . @ @ @ @ @ . . @ @ @ . @ . @ . @ @ . @ @ . @ . @ . . @ @ @ @ @ . @ @ . . . . @ . @ . . . @ . . . @ @ . @ . @ . @ @ . @ . . @ . . . @ . . @ @ @ . . @ . @ @ . @ @ @ . @ . . . @ 
@ . @ . . . @ @ . @ . @ . . @ @ @ @ @ . . @ @ @ @ . @ . . . @ @ . . @ . @ . @ @ @ @ . . . . @ @ . @ . . . @ . @ . . @ @ . . . @ . . . . @ @ @ . . @ . . @ . . @ . . . @ @ . @ . . . @ @ @ @ @ . . @ . @ 
@ @ . @ . @ . @ . @ . . . @ @ @ @ @ @ . @ . @ . . . @ . @ @ . . @ . . . . @ @ @ @ . @ . @ . . @ . . @ @ . @ . @ @ . @ . . @ . . @ . @ . @ @ . @ . . @ @ . . @ . @ @ . . @ . . @ . @ @ @ @ @ @ @ . . @ @ 
@ . . @ . . . @ . . . @ @ . @ @ @ @ @ @ . . . . @ . . @ @ @ @ . . @ @ . @ . @ . @ . . @ . . @ . @ @ . . . . @ . . . . @ . . @ . @ . @ . . @ . . . @ . . . @ . . . . @ . @ . @ @ . @ @ @ @ @ @ @ @ . @ @ 
@ @ . @ . @ @ . @ @ . . @ . . . @ @ @ @ @ . @ . . @ . @ @ @ @ @ . @ . . @ . . . . . @ . @ . . . @ . . @ . @ . @ . @ . . . @ @ @ @ . . @ . @ . @ @ . @ . @ . . @ . @ . . . . . . @ @ @ @ @ @ @ @ @ @ @ @ 
@ . . . . . @ . . . . @ . . @ @ @ @ @ @ . . @ . @ . @ . @ @ @ . . . @ . . @ @ @ @ . . . @ . @ @ . . @ . . @ . @ @ . @ @ . . @ . . @ @ . . @ . @ @ . . . . . @ . @ @ . @ . @ @ @ . @ @ @ @ @ @ @ @ @ @ @ 
@ @ . @ . @ . . @ . @ . . @ @ @ @ @ @ @ @ . . @ . . @ . . @ . @ @ . . . @ . . . @ . @ . . . . . @ . @ @ . . . . . . . . . @ . . @ @ . @ . @ . @ . . @ . @ @ . . @ . @ . . . . @ . . . @ @ @ @ @ @ @ @ @ 
@ @ @ . . . @ . @ @ . . @ . @ @ @ @ @ @ @ @ @ @ @ . . . @ @ . @ . @ @ . . @ @ . . @ @ @ @ @ . @ . @ . . @ @ @ @ @ . @ @ . . . @ @ . . . . @ . . @ . @ @ @ . @ . . . @ @ @ . @ . @ . @ @ @ @ @ @ @ @ @ @ 
@ @ . @ @ . . . . @ @ . . . @ @ @ @ @ @ @ @ . @ . @ . @ . @ . . . @ . @ . @ . @ . @ . @ . . . . . . . @ . @ . @ . @ . . @ @ . . . @ . @ . @ @ . . . . @ . . . . @ . @ . . . . . . . . @ @ @ @ @ @ @ @ @ 
@ @ . . . @ @ . @ . @ . @ @ . . @ @ @ @ @ . . . . . . . . . @ @ . . . . . . . . . . . . @ . @ @ . @ . . . . . . . . @ . @ . @ . @ . @ . . . @ . @ . @ . @ . @ . @ . @ . @ . @ @ @ . @ @ @ @ @ @ @ @ @ @ 
@ . . @ . . . . . . . . . . . @ . @ @ @ @ @ . @ . @ . @ @ . . . . @ . @ @ . @ . @ . @ . @ @ . @ @ . @ @ @ @ . @ . @ . . . . . . . . . . @ . @ . . @ . . . @ . . @ . . . . @ . . . @ @ @ @ @ @ @ . @ @ @ 
@ . @ @ . @ @ . @ @ . @ @ @ @ . . . @ @ @ @ @ . . . @ . . @ . @ @ @ @ @ @ @ @ @ . @ . . . . . . . . . . . . @ . . . . @ . @ . @ . @ . @ . . . . @ . @ . @ . @ . @ . @ @ . . . @ @ @ @ . . @ @ @ . . @ @ 
@ . @ @ @ . . . @ . @ . @ @ . @ . @ . @ @ . . @ . @ . @ . . . @ . @ . @ @ . @ @ . . @ @ . @ @ . @ . @ . @ . . . @ . @ . . . @ . . . @ . @ @ . @ . . . . . . @ . . @ @ @ @ . @ @ @ @ . . @ . @ . . @ @ @ 
@ @ . @ . @ @ . . . . . . @ . . . . . . . @ . . . . . . @ . @ . . . . . . . @ . @ . @ . @ @ . @ . @ . @ . @ @ . @ . . @ . @ . @ . @ . . @ @ . . @ . @ @ @ . . . @ @ @ @ @ @ @ @ @ @ @ . . . . @ . . @ @ 
@ . . . . @ . @ @ @ @ . @ . @ . @ @ . @ . . @ . @ @ @ @ . @ . . @ . @ @ @ . . . . . . . . . . . . . . . . . . . @ . @ @ @ . . . . . @ . @ . @ . . @ @ @ . . @ . . @ . @ . . @ @ @ @ . . @ @ . @ . @ . @ 
@ @ @ @ . . . . . . . . . . . @ . . . . @ . @ @ . @ . . . @ . @ @ @ . . . . @ . @ @ @ . @ @ . @ . @ @ . @ @ . @ . . @ . . . @ . @ @ . . . . . . @ @ @ . . @ . . @ @ . . . @ . @ @ . . @ . . . . . . . @ 
@ . . . . @ . @ . @ . @ @ . @ . @ @ . @ . @ @ @ . @ . @ . @ @ @ @ @ @ . @ . @ @ @ @ . . @ . . @ . . . @ . . . @ . @ . @ @ . @ . . . @ . @ . @ . . @ @ @ @ . @ . . @ . @ . . . . . @ . @ @ . @ . @ . @ @ 
@ . @ . @ @ @ @ @ . @ @ . . . . . . . . . . @ @ . @ . . @ @ @ @ @ @ . . . @ . . . . . @ . . @ . . @ . @ @ . @ . . . . . . @ . . @ @ @ @ @ @ . . @ . @ @ . . @ . @ . @ @ . @ . @ . . . @ . . @ . . @ @ @ 
@ @ . . @ @ . @ . . @ . . @ . @ . @ @ . @ . @ . . @ . @ . @ @ @ @ @ @ . @ @ @ @ . @ . . @ . @ @ . @ @ . @ . . @ @ . @ @ . . @ . @ @ @ . @ . @ . @ . @ . @ . @ . @ . . . @ @ @ @ @ @ . @ @ @ . . @ . @ @ 
@ . @ @ @ . . . . @ . . @ . . @ . @ @ @ . . . @ . @ . . . . @ @ @ @ @ @ . @ @ . @ @ . @ . . . @ @ @ @ . @ . @ @ @ @ . . . @ @ @ . . . . . . . . . . . . . . . . . @ . @ . @ . . . . . . @ @ @ . @ . @ @ 
@ . . . . . @ @ . . . @ . . @ @ @ @ @ . @ . @ . . . . @ @ @ @ @ @ @ @ @ . . @ . . . @ . @ . @ . . @ . . . . . @ @ @ @ . @ @ @ . @ @ @ @ @ @ . @ . @ . @ @ @ @ @ . . . . . . @ . @ @ . @ . . . . . . . @ 
@ @ @ @ @ @ . . . @ @ . . @ . @ . @ @ . . . . @ @ . @ @ @ . @ @ @ @ @ . . @ . . @ . @ . @ @ @ . @ . @ . @ . @ @ @ @ . . . @ . . . . . . . . @ . @ . @ . . @ . . . @ . @ . @ @ . @ @ . @ @ . @ . @ . @ @ 
@ . @ . @ . @ @ @ . @ @ @ @ . . . . @ @ . @ . . . . . @ . . . @ @ @ @ @ . @ . @ . . . . . . @ . @ . . . . @ @ @ . . @ . @ . @ . @ . @ . @ . . . . . . @ . . @ . @ @ . . @ . @ . . @ . @ . . @ . . @ @ @ 
@ . . . . . . . . . . . . . . @ . @ @ . . @ @ . @ . @ . @ @ . . @ @ @ . . . @ . @ @ @ . @ . . . . @ @ . @ @ @ . @ . @ . @ . . @ . . @ @ . @ @ @ @ @ . . . @ . @ . @ . @ @ . @ . @ . . @ @ . @ . @ @ @ @ 
@ . @ . @ @ . @ . @ . @ @ @ . . @ @ . . @ @ @ @ . . . . . @ . @ . @ . @ . @ . . . . . @ . . @ @ . @ @ @ @ @ . . . . . @ . @ . . @ . @ . . . . . . . . @ . . . . . . . . . . . @ . @ . @ . @ . @ @ @ @ @ 
@ . . @ @ @ @ . . . @ . . @ . @ . @ . @ . @ @ @ . @ . @ . . . . . . . . . . @ @ @ . @ . @ . @ @ @ @ @ @ @ @ . @ @ @ . @ . @ @ . @ @ @ @ . @ . @ . @ . @ @ @ . @ . @ . @ . @ @ @ . . . . . . . . @ @ @ @ 
@ . @ @ . @ @ @ . @ @ . @ . . . . . . . . . @ @ @ @ @ @ @ . @ . @ @ . @ @ . . . . . . . . . . @ @ @ @ @ @ @ @ @ . @ . . . . . . @ . @ . . . @ @ @ . . . . . @ . . . @ . @ . @ . . @ . @ @ . @ @ @ . @ @ 
@ . . . . . @ . . @ . . . . @ . @ . @ . @ @ . @ . @ . @ . @ @ . . @ @ . . @ . @ @ @ . @ . @ . . @ . @ . . . . . . . . @ . @ @ . . . . @ . @ . @ @ @ . @ @ @ . @ . @ @ . . . . @ . @ @ . . @ . . @ . @ @ 
@ . @ . @ @ @ @ . . @ . @ . @ @ . . @ . @ . . @ . . . . . . . @ @ @ @ . @ . @ . . @ . @ @ @ . @ . . . @ . @ . @ @ @ . . @ . . @ . @ . @ @ . . . . . . . . . . @ @ . @ @ . @ . . . . . . @ . @ . @ . @ @ 
@ . . @ @ @ @ . . @ @ @ . . . . @ . . @ @ . @ . . @ . @ . @ . @ @ @ . . . . @ @ . . @ @ @ . . . @ @ . . @ @ @ . . @ . @ @ . @ @ @ . . . . . @ @ . @ . @ . @ . . @ . . . . @ . @ @ . @ . . . . . . . . @ 
@ @ . @ . @ . . @ . @ @ @ . @ . @ . @ @ . . . @ . @ @ @ @ . . . @ . @ . @ @ @ @ . @ @ @ . @ . @ @ . @ . @ @ @ @ . . @ @ @ . . . . . @ @ . @ . . @ . @ . . . @ . . . @ @ . @ . @ . . @ @ . @ . @ . @ . @ 
@ . @ . . @ @ @ . . . @ . . @ . . @ . . @ . @ . . . . . . @ . @ . . . . . . . . . . @ . . . . . . . . . . @ @ . @ . @ @ . @ . @ @ . @ @ . . . @ @ . @ @ . @ @ . @ . . . @ @ @ . @ . . . @ @ . . @ @ . @ 
@ . . . @ . @ . @ . @ . @ . . @ . . @ . . . . @ @ . @ . @ . . . . @ @ . @ @ . @ @ . . . @ @ . @ . @ @ @ . . . . . . . . . . . @ . @ . . . @ @ . . . . . . . . @ . . @ . . @ @ . . . @ . . . @ @ @ . . @ 
@ . @ . . . . . . . . . . . @ @ . @ . @ @ @ . . . . . @ @ @ . @ . @ @ . @ . @ . . . @ . . @ @ @ . . @ @ . @ @ . @ . @ @ @ . @ . . . . @ . @ @ @ . @ . @ . @ . @ @ . @ . @ @ . . @ . . @ . @ @ @ . @ . @ 
@ . @ @ @ . @ @ @ . @ . @ . @ . . . . . . . @ . @ . @ @ @ . . @ @ . . . @ . @ . @ . @ . @ . @ . @ @ . @ @ @ @ @ . . @ @ . . @ @ . @ @ . . . @ . . . @ . . . @ . . . . @ @ . @ . @ @ . . @ @ @ . . . . @ 
@ @ @ @ @ @ . . . . . @ . . . @ . @ @ @ . @ @ @ . . . @ . . @ . . . @ . . . . @ . . @ @ . . . . . . . . . @ @ @ . @ . . . @ . . . @ . @ . @ . . @ @ . @ . @ . . @ . @ @ . . . . . @ . @ . . . @ @ . @ @ 
@ @ . . . @ @ . @ . @ @ @ . @ @ . . . . @ @ @ . @ . @ @ @ . . @ . @ . . @ @ @ . . @ @ . @ @ @ @ @ @ @ @ . . . . . . @ @ . . @ @ . @ . . . . @ . @ . . @ @ . . @ . . @ @ @ . @ @ . @ . . @ @ . @ @ . . @ 
@ . . @ . @ @ @ . . @ . . . . . @ . @ . @ . . . . @ @ @ @ @ @ . @ @ @ @ @ . . . @ . . . . . . . . . . . . @ . @ . @ @ . @ . @ . . @ @ @ . @ . @ . . @ @ . @ . @ @ @ @ @ . . . . @ . . @ . @ . @ . @ @ @ 
@ . @ . . . @ @ @ . @ @ . @ @ . . @ @ . @ @ . @ . . @ . . . . . . . . . . . @ . . @ @ . @ . @ . @ . @ @ @ . . @ . . . . . @ . @ . . . . @ . . @ . @ @ . . @ @ @ @ . @ . @ . @ . . @ . . . . . . . . . @ 
@ . @ @ . @ . @ . @ . . . @ @ @ . . . @ @ @ @ . @ . @ . @ @ . @ . @ @ @ @ @ . @ @ . @ . . @ . . . @ @ @ . . @ . @ @ @ . @ . . . @ . @ @ @ . @ . . . . @ . @ . @ @ . . . . . . @ . . @ @ . @ . @ . @ . @ 
@ @ . . . . . . . . . @ . @ @ . . @ . . @ @ . . . . . @ . . . @ @ . . . . . . . . . . . @ . @ . @ . @ @ @ . . . . @ . . @ @ . @ . . . @ . . . . @ @ . . . . . . @ @ @ . @ @ @ . . @ . @ @ . . @ . . @ @ 
@ . . @ . @ . @ . @ @ . . @ . @ . @ . @ @ . @ . @ . @ . @ . @ . . @ . @ . @ @ . @ . @ . . . . @ . . . @ . . @ . @ @ . @ @ . . . @ . @ . @ . @ @ @ @ @ @ @ @ . @ @ @ @ @ @ @ @ @ . . . . . @ . . @ @ . @ 
@ . @ . @ . . . @ . . . @ @ . . @ . . @ . . . @ . . . . @ . @ @ . . . . @ @ @ @ . @ @ . @ . @ . @ . @ . @ . . @ @ @ @ . . . @ . . . . . . . . . . @ . . @ . . . @ @ @ @ @ @ . @ . @ . @ . @ . @ . . . @ 
@ . . . . @ . @ . @ @ . @ @ @ . @ @ . @ @ . @ . @ . @ @ . @ . @ . @ . @ @ @ @ . . . . . @ . @ . . . . . . . @ . @ @ . @ @ . . @ @ . @ . @ . @ . @ . @ . . @ . @ @ @ @ @ @ . . . . . @ @ @ @ . @ . @ . @ 
@ @ @ . @ . . . . @ @ @ @ . . . . . . @ . . . . . . . . . . . . . . @ @ @ @ . @ @ . @ @ . . . @ . @ . @ @ . . . . . . @ . @ @ . @ . . @ . . . @ . . . . @ . @ @ @ @ @ @ @ @ . @ . @ @ @ . . . . . @ . @ 
@ . @ . . @ . @ @ @ @ . @ @ . @ . @ . @ . @ . @ . @ @ @ . @ . @ . @ . @ @ . . . . . . . @ @ @ . . . @ @ @ . @ . @ . @ . . @ . . . . @ @ @ . @ @ @ . @ . . . @ @ @ @ . @ @ @ @ . . . @ . @ . @ . @ . . @ 
@ . @ @ @ . . . @ @ @ . . . @ @ @ @ @ @ @ . . . @ . . . . . @ . @ @ . . . . @ . @ . @ @ . @ . @ . @ @ @ . . . @ @ . . @ . . . @ @ . @ . @ . . @ @ . @ @ @ . @ @ @ . . @ @ @ @ @ . @ @ . . . . @ . @ . @ 
@ . . . @ @ . @ @ @ . . @ @ @ @ . @ @ . . @ . @ . @ . @ . @ . . @ @ @ . @ . @ . @ @ . . . . . . . @ . @ . @ . . . @ @ @ @ . @ . . . . . @ @ . . . @ . @ . . . @ @ . @ . @ . @ . @ . @ @ @ . @ . . @ . @ 
@ @ . @ . @ . . . . @ . . . . . . @ . . @ @ @ . . . . . @ . @ . @ @ . . @ . . @ @ @ . @ . @ . @ . @ . . . . @ . @ . @ @ . . @ . @ . @ . . . @ . @ @ . @ @ . @ . . . . . @ . . . . . . @ . . . @ . @ . @ 
@ . . . . . . @ . @ @ @ . @ . @ . . . @ . @ @ @ . @ . @ . . @ . . @ . @ . . @ . @ . @ . . . @ . . @ @ @ . @ . . . . . . @ . @ @ . . @ @ @ @ . . . @ . @ . . @ . @ @ @ . . . @ . @ . @ . @ @ . . . @ @ @ 
@ @ . @ . @ . . @ @ @ @ @ @ @ . . @ @ . . @ @ @ @ . . @ @ . . . @ . . . @ . . . @ . . @ . @ . @ . . @ @ . . @ . @ . @ @ . . @ @ @ . @ @ . . @ . @ @ . . @ . . @ . @ . @ @ @ . @ . . . . . . . @ . . @ @ 
@ . . . @ . . @ @ . @ . . @ @ @ . @ @ . @ . @ @ @ @ . @ . @ . @ . @ . @ @ . @ @ . @ . @ @ . . . . @ . . . @ @ @ @ @ @ . @ @ . . . . . @ . @ @ @ @ @ @ . @ . @ . . . . . . . . . . @ @ @ . @ . . @ . @ @ 
@ @ . @ . @ . . @ . @ . @ . . . . . . . . . . @ @ @ @ . . . . . . . . @ @ . . . . @ . . . . @ . @ . . @ . @ @ . @ . . . . . . @ @ . @ @ . . @ @ @ @ @ . . . . . @ @ . @ . @ @ . @ . . . . . @ . @ @ @ @ 
@ @ @ . . . . @ . . . . . . @ . @ . @ @ . @ . . . @ @ . @ . @ . @ @ @ . . . @ @ . . @ . @ . @ @ . @ . . @ @ . . @ . @ . @ . @ @ @ @ @ . . @ . @ . @ @ @ . @ @ . @ . @ . . @ . . . @ . @ . @ . . . . . @ 
@ @ @ . @ . @ . . @ . @ . @ . . . @ . . . . @ . @ @ @ @ . . . @ . . @ @ . @ @ . . @ @ . @ @ . . . . . @ @ . @ . @ . @ @ . . . @ @ @ . @ . @ . . . . @ . . @ @ . @ . . . @ . @ . @ @ . @ . . @ . @ . @ @ 
@ @ @ @ @ . @ . @ . @ @ @ . @ . @ @ @ . @ @ . . . @ @ @ @ . @ @ . @ . . . . . @ . @ . . @ @ @ @ . @ . . @ . . . . . . @ @ . @ @ @ . . . . . . @ . @ . . @ . . . @ . @ . . . @ . @ @ @ . . @ . . . @ . @ 
@ @ @ @ @ . . . . . . @ @ . @ . . @ @ . . @ . @ @ @ @ @ @ @ . . . . @ @ . @ @ . . . @ . . @ . . . @ . @ @ @ . @ @ . @ @ @ @ @ @ @ @ . @ . @ . @ . . . @ @ @ . @ . . . @ @ . @ . @ @ . @ . @ . @ . . . @ 
@ @ @ @ . . @ @ . @ @ . . . . . @ . @ @ @ @ . . @ @ @ @ @ @ @ @ @ . . . . . . @ . @ @ @ @ @ @ . @ @ @ @ @ @ @ . . . . . @ @ @ @ @ . @ @ . @ . @ . @ . . @ @ . . @ . @ @ . @ . @ . . . . . @ . @ . @ . @ 
@ @ @ @ @ . . . @ . . . @ . @ . . . . @ @ @ @ . . @ @ @ @ @ . . . . @ . @ . @ . @ @ @ @ @ @ @ @ @ @ @ @ @ @ @ . @ . @ @ @ @ @ . . . . . . @ @ . @ . . @ @ . . @ @ . @ . . . . . . @ . @ . @ . @ . . @ @ 
@ @ @ @ @ @ . @ . . @ . @ @ . . @ . @ @ @ @ @ . @ @ @ @ @ @ @ @ @ @ . . @ . . . @ @ @ @ @ @ @ @ @ @ @ @ @ @ @ @ . . @ @ @ @ @ @ . @ @ @ . . . . . @ . . . @ @ . . . . @ . @ . @ . @ @ . . @ . @ . @ @ @ 
@ @ @ @ @ @ @ @ @ @ @ @ @ @ @ @ @ @ @ @ @ @ @ @ @ @ @ @ @ @ @ @ @ @ @ @ @ @ @ @ @ @ @ @ @ @ @ @ @ @ @ @ @ @ @ @ @ @ @ @ @ @ @ @ @ @ @ @ @ @ @ @ @ @ @ @ @ @ @ @ @ @ @ @ @ @ @ @ @ @ @ @ @ @ @ @ @ @ @ @ 
3
94 55 37 97
55 87 40 5
37 62 59 21
