12 12
@ @ @ @ @ @ @ @ @ @ @ @ 
@ @ @ . . . . . @ . @ @ 
@ @ @ @ @ . @ . @ . . @ 
@ @ @ . . . . @ . . @ @ 
@ @ . @ @ . @ . @ . @ @ 
@ . . . . . . . . . . @ 
@ . @ @ @ . @ . @ . @ @ 
@ . @ . @ . . @ @ . @ @ 
@ @ . . . . @ . @ . @ @ 
@ . @ . @ . . . . @ . @ 
@ . . . . @ . @ . . . @ 
@ @ @ @ @ @ @ @ @ @ @ @ 
3
3 5 9 3
7 1 1 9
3 8 9 1
