12 12
@ @ @ @ @ @ @ @ @ @ @ @ 
@ @ @ @ @ @ @ @ . . . @ 
@ . @ @ @ @ @ . . @ @ @ 
@ . . . . @ @ @ . . . @ 
@ @ @ @ . @ @ . @ . @ @ 
@ . . . . . . . . . . @ 
@ . @ . @ . @ . @ . @ @ 
@ . @ @ @ . @ . . @ @ @ 
@ @ . . . . @ . @ @ @ @ 
@ @ @ . @ . @ . . @ @ @ 
@ @ @ @ @ @ . . @ @ @ @ 
@ @ @ @ @ @ @ @ @ @ @ @ 
3
9 8 5 5
2 8 4 9
3 3 10 6
