20 20
@ @ @ @ @ @ @ @ @ @ @ @ @ @ @ @ @ @ @ @ 
@ . @ . @ . @ . @ . . . @ @ @ . . @ @ @ 
@ . . . . . . . . . @ . @ @ . . @ @ @ @ 
@ @ . @ . @ @ . @ . . @ . . @ . . @ @ @ 
@ . . @ @ @ @ @ . . @ . @ . @ . @ @ @ @ 
@ @ @ . . @ @ . @ . . . . . . . . @ @ @ 
@ @ . . @ @ . . @ . @ @ . @ @ . @ . @ @ 
@ . @ . @ . @ . @ . @ . @ . . . . . . @ 
@ . . . . . . . . . @ . . . @ . @ @ . @ 
@ @ . @ . @ . @ @ . @ @ . @ . . . . @ @ 
@ . . @ . @ . @ . @ . . . . @ @ @ . . @ 
@ @ @ . . . @ . . . . @ . @ @ @ @ . @ @ 
@ @ @ @ . @ . @ . @ @ . . . . . @ @ @ @ 
@ @ @ @ @ @ . . @ . . . @ . @ @ . @ @ @ 
@ @ @ @ @ @ @ . . @ @ . @ . . . . . @ @ 
@ @ @ @ @ @ @ @ . . . . @ . @ @ . @ . @ 
@ @ @ @ @ @ @ . @ . @ @ . . . @ . @ . @ 
@ @ @ @ @ @ . . . . . . @ . @ . . . . @ 
@ @ @ @ @ @ @ . @ . @ @ . . . @ . @ . @ 
@ @ @ @ @ @ @ @ @ @ @ @ @ @ @ @ @ @ @ @ 
3
14 17 15 8
14 8 6 15
9 2 12 6
