12 12
@ @ @ @ @ @ @ @ @ @ @ @ 
@ . . . . . . . . . . @ 
@ @ @ . @ . @ . @ @ . @ 
@ . . @ @ @ . . @ @ . @ 
@ . @ @ @ @ @ . . . @ @ 
@ . . @ @ . . @ @ . @ @ 
@ . @ . @ . @ @ @ . @ @ 
@ . . . . . @ . . . @ @ 
@ @ @ . @ . . @ @ . . @ 
@ @ @ @ @ . @ @ . @ . @ 
@ @ @ @ . . . . . . . @ 
@ @ @ @ @ @ @ @ @ @ @ @ 
3
4 7 8 5
5 6 8 10
5 2 10 7
