10 10
@ @ @ @ @ @ @ @ @ @ 
@ . . . . . @ . . @ 
@ . @ . @ . @ . @ @ 
@ . @ @ @ @ . . . @ 
@ . @ @ @ @ @ @ . @ 
@ . . @ @ @ . . . @ 
@ @ . . @ @ . @ . @ 
@ . @ . @ . @ @ . @ 
@ . . . . . . . . @ 
@ @ @ @ @ @ @ @ @ @ 
3
6 3 5 7
5 8 7 5
5 2 8 6
