50 50
@ @ @ @ @ @ @ @ @ @ @ @ @ @ @ @ @ @ @ @ @ @ @ @ @ @ @ @ @ @ @ @ @ @ @ @ @ @ @ @ @ @ @ @ @ @ @ @ @ @ 
@ @ @ @ @ @ @ . . . . . @ . . . @ . . . . . @ . . @ @ @ . . @ @ . @ . @ @ @ @ . . . @ @ @ . . . . @ 
@ @ @ @ @ . . . @ @ . @ @ @ . @ . . @ . @ . . @ . . @ @ . @ . @ . . . . @ @ @ @ . @ . . . @ . @ . @ 
@ @ @ @ @ . @ @ @ . . . @ . . . . @ . @ @ . @ . . @ . @ . . . @ . @ . @ . . @ . . . @ @ . . . . @ @ 
@ @ @ @ @ . . @ . . @ . . @ . @ . . . . . @ . . @ @ . . . @ . . @ @ . . . @ . @ . @ . @ @ @ @ . @ @ 
@ @ @ @ . @ @ . @ . . @ @ . . . @ . @ . @ . @ . @ . @ @ @ @ . @ @ . . @ . . . . . . . . . . . . . @ 
@ @ @ @ . . . . . . @ . . @ . @ . . @ . @ . . . . . . . @ . . @ . @ . . @ . @ . @ @ . @ @ . @ @ . @ 
@ @ @ @ @ . @ . @ . @ . @ @ . . @ . . @ . @ @ . @ @ . @ . @ . . . @ @ . @ . . @ . . @ . . . . . @ @ 
@ @ @ . @ @ @ @ . . . . @ . . @ @ @ @ . . . @ . @ @ @ . . @ . @ . . . . . @ @ . . @ . @ @ . @ . . @ 
@ @ . . . . @ . @ . @ @ . @ . . @ @ . @ . @ . . . . @ . @ . @ @ @ @ @ . @ . @ @ . . . . @ @ . . @ @ 
@ . @ . @ . @ . . . . . . . . @ . . . . . . . @ @ . . . . . . . . . . . . . . . @ . @ @ . @ @ . . @ 
@ . . . @ . @ . @ @ . @ @ . @ . @ . @ . @ . @ . . . @ . @ . @ @ . @ . @ . @ . @ @ . . . . . @ . @ @ 
@ . @ @ . @ . @ . @ @ . . . . . . . . @ . @ @ . @ . . @ . @ @ . . . @ @ @ . . . . . @ . @ . @ . @ @ 
@ . . . . . . . . . . . @ . @ . @ . @ @ . @ . @ . . @ @ . @ @ @ . @ . @ @ @ . @ . @ . . . @ . . . @ 
@ @ @ . @ . @ @ @ @ @ . @ . . @ . . . . . . . . @ . @ . . . @ . . . . . . . @ . . . @ @ . . @ @ @ @ 
@ . . . @ @ @ @ @ @ . @ . . @ . @ @ . @ @ @ . @ @ . . @ . @ @ @ . @ @ @ . @ @ @ . @ . @ . @ . . . @ 
@ . @ . . @ @ @ @ . . . @ . . . . . @ @ . . . . . @ . . . @ @ . @ . . . @ @ @ . . @ . @ @ . @ . @ @ 
@ @ . . @ @ @ @ . @ @ . @ . @ . @ @ @ . @ @ . @ . @ @ @ . . . . @ @ . @ . @ . @ . . . . . . . . . @ 
@ @ @ . @ @ . . . . . . . . . @ . . . . . . . . @ @ @ . . @ @ . . . . . . . . . @ . @ . @ . @ @ . @ 
@ @ @ @ . . @ @ @ . @ . @ @ . @ . @ . @ . @ . @ . @ . @ . . @ @ . @ . @ @ @ @ . . @ . . . @ @ . @ @ 
@ @ @ @ @ . . . . . @ . . @ . . @ @ @ . . @ . . . . . . @ . @ . . . @ @ . @ . . @ @ @ . @ . @ . . @ 
@ @ @ @ @ . @ . @ @ . . @ . . @ @ . . . @ . . @ @ . @ @ . @ @ @ . @ . @ . @ . @ . . . . . . . @ . @ 
@ @ @ @ @ @ @ @ . . . @ . . @ @ @ @ @ . . @ . . . @ . . . . @ . . . . . . . @ . @ @ . @ . @ . . . @ 
@ @ @ @ @ . . . . @ . @ @ . . . . @ @ @ . @ @ . @ . @ . @ @ @ @ @ . @ . @ . @ . @ @ . @ . @ . @ @ @ 
@ @ @ @ @ @ . @ . . @ . @ . @ @ . @ @ . @ @ . . . . . . . @ @ . . @ . . @ . @ . . . @ . @ . . . . @ 
@ @ @ @ . . . @ . @ @ . @ . . @ @ @ . . . @ @ . @ @ @ . @ @ @ . @ . @ . @ . . . @ . . . @ . @ @ . @ 
@ @ @ . @ . @ . . . @ . . . @ @ @ . @ . @ . @ @ @ . . . . @ . . . . . @ . . @ @ @ @ @ . . @ . . . @ 
@ . . . . . . @ . @ . . @ . . . . . . . . . . @ . . @ @ . . @ @ @ @ . @ . @ @ @ @ @ . . @ . @ @ . @ 
@ . @ . @ @ . . @ . . @ . . @ @ . @ . @ . @ . . @ . @ . . @ @ . . . . . @ . @ . @ @ @ @ . . . . . @ 
@ . @ @ @ @ @ . @ @ . @ @ . . . @ @ . . @ @ . @ @ @ . @ . . . . @ @ @ . . . . . . @ . @ @ @ . @ . @ 
@ @ @ . @ @ . @ . @ @ . . . @ . . @ @ . . . @ @ . . . @ @ @ . @ . @ @ . @ . @ . @ . . . @ . @ . . @ 
@ . . . . . . . . . . . @ . . @ . @ @ . @ @ . @ @ @ . . . . . . . . . @ @ @ . @ . @ @ . . . . @ @ @ 
@ @ . @ . @ . @ . @ . @ . . @ . . . @ . . . . . @ . @ @ @ @ . @ . @ . . . . . . . . . . @ . @ @ @ @ 
@ . @ . . . @ . . @ @ @ @ . . @ @ . . @ . @ . @ . . @ . . . . @ . . @ . @ . @ . @ . @ @ @ @ @ @ @ @ 
@ . . @ . @ @ @ . @ . @ @ . @ @ @ . @ @ . . @ . @ . . @ . @ . . @ . . @ . . . @ . . @ @ @ @ @ @ @ @ 
@ @ . @ . . @ . @ . . . . . @ . . . . . @ . @ . @ . @ . @ . . @ @ . @ @ . @ . . @ @ @ @ @ @ @ @ @ @ 
@ @ . @ . @ @ . . . @ @ @ . . @ . @ . @ @ . . . . . . . . @ . . @ @ . . . @ . @ @ @ @ @ @ @ @ @ @ @ 
@ . . . . @ . @ . @ . . . . @ . @ @ . . . @ . @ . @ . @ @ @ @ @ . . . @ . @ @ @ @ @ @ @ @ @ @ @ @ @ 
@ . @ . @ . . . . @ @ . @ . . . . . @ . @ . @ . . . @ @ @ @ . . @ . @ . . . . . @ @ @ @ @ @ @ @ @ @ 
@ @ @ @ . . @ @ . @ . @ . . @ . @ @ @ . . . . @ @ . . . . . . @ . . . @ @ . @ @ @ @ @ @ @ @ @ @ @ @ 
@ . @ @ @ @ . . . . . @ @ @ . @ @ @ . . @ . @ . @ . @ . @ . @ @ . @ @ . . . . . @ @ @ @ @ @ @ @ @ @ 
@ . . @ . @ @ @ . @ . . . @ . @ @ @ . @ . . . . . @ @ . @ . . @ @ @ . @ . @ . @ @ @ . @ @ @ @ @ @ @ 
@ . @ . . . . . . @ . @ . . . . @ . . @ @ . @ . @ . . . . @ @ . . . . . . @ . . . . . . @ @ @ @ @ @ 
@ . @ @ . @ . @ . . @ . . @ . @ . @ . . @ . . @ @ @ @ . @ . @ . @ @ . @ . @ . @ @ . @ @ @ @ @ @ @ @ 
@ . @ . @ . . @ . @ . @ . . @ . . . . @ . . @ . @ . @ . . . . @ @ . @ . . @ . @ @ . @ @ @ @ @ @ @ @ 
@ . . . . . @ . . @ . @ . @ @ @ . @ . . @ . . . . . . @ . @ @ @ @ . . . @ . . . . @ @ @ @ @ @ @ @ @ 
@ @ @ . @ . @ @ . . . @ . . @ . . . @ . @ . @ @ . @ . . @ @ @ @ @ . @ . . @ . @ . @ @ @ @ @ @ @ @ @ 
@ . . . @ @ . . . @ . . @ . @ @ . @ . . @ . . @ . @ @ . @ @ @ @ @ @ . . @ . . . @ @ @ @ @ @ @ @ @ @ 
@ @ . @ . . . @ @ . . @ @ @ @ @ @ @ @ . @ . @ . . . @ . . @ @ @ @ @ @ . . @ . @ @ @ @ @ @ @ @ @ @ @ 
@ @ @ @ @ @ @ @ @ @ @ @ @ @ @ @ @ @ @ @ @ @ @ @ @ @ @ @ @ @ @ @ @ @ @ @ @ @ @ @ @ @ @ @ @ @ @ @ @ @ 
3
39 5 44 29
5 47 41 30
9 20 24 25
