10 10
@ @ @ @ @ @ @ @ @ @ 
@ @ @ . . . . . . @ 
@ @ . @ . @ . @ . @ 
@ . . . . . @ . @ @ 
@ . @ @ . @ . . @ @ 
@ . @ . . . @ . @ @ 
@ @ . @ . @ @ . @ @ 
@ . . . . . . . . @ 
@ . @ . @ . @ . @ @ 
@ @ @ @ @ @ @ @ @ @ 
3
4 7 1 6
6 4 1 3
5 1 7 5
