25 25
@ @ @ @ @ @ @ @ @ @ @ @ @ @ @ @ @ @ @ @ @ @ @ @ @ 
@ . . . . . @ . . . @ @ @ @ . . . @ @ @ . . . . @ 
@ . @ @ . @ . @ @ . . . @ . . @ . @ @ @ . @ . @ @ 
@ @ @ @ . . . @ @ . @ . . @ . . @ @ @ @ @ @ . @ @ 
@ @ @ . @ @ . @ . . . @ @ . . @ . @ @ @ . . . . @ 
@ @ . . . @ . . @ @ . . . @ . @ . @ @ . @ @ . @ @ 
@ . @ . @ . @ . @ . @ . @ . . . . . @ . . . . . @ 
@ . . . . . . . @ . @ . . . @ @ . @ @ @ @ . @ . @ 
@ @ . @ . @ @ . . . . . @ @ . @ . . @ @ @ @ . . @ 
@ @ @ . . . . @ . @ @ . . . . . @ @ @ @ @ @ @ . @ 
@ @ @ @ . @ @ . @ . . . @ . @ . @ @ @ @ @ @ . . @ 
@ @ @ @ . @ . . . @ . @ @ @ @ @ @ @ @ @ @ . . @ @ 
@ @ @ @ @ . @ @ . . . . @ @ @ @ @ @ @ @ . @ . @ @ 
@ @ @ . @ . . . . @ @ . @ . @ . @ . @ @ . . . . @ 
@ @ . . @ @ @ @ . @ . . . . . . . . . @ . @ . @ @ 
@ . @ . @ . . @ . @ @ . @ . @ . @ @ . . @ . . . @ 
@ . . . . . @ . @ @ @ . . @ . . . . @ . . @ . @ @ 
@ . @ . @ . . . . . . . @ . . @ @ . . @ . . . @ @ 
@ @ . . . @ . @ @ . @ . . @ . . @ . @ . . @ . @ @ 
@ . . @ @ . . . . @ . . @ . @ @ @ . @ @ . . @ @ @ 
@ . @ . . @ . @ @ @ @ . . . . . . @ . . . @ @ @ @ 
@ . @ @ . . . @ @ . @ . @ . @ . @ . . @ . @ @ @ @ 
@ . . @ @ . @ . . . . . @ . . @ @ @ @ . . . @ @ @ 
@ . @ @ @ @ @ @ . @ . @ @ . @ @ @ @ @ @ . @ @ @ @ 
@ @ @ @ @ @ @ @ @ @ @ @ @ @ @ @ @ @ @ @ @ @ @ @ @ 
3
20 20 13 22
8 11 1 9
9 5 17 9
