100 100
@ @ @ @ @ @ @ @ @ @ @ @ @ @ @ @ @ @ @ @ @ @ @ @ @ @ @ @ @ @ @ @ @ @ @ @ @ @ @ @ @ @ @ @ @ @ @ @ @ @ @ @ @ @ @ @ @ @ @ @ @ @ @ @ @ @ @ @ @ @ @ @ @ @ @ @ @ @ @ @ @ @ @ @ @ @ @ @ @ @ @ @ @ @ @ @ @ @ @ @ 
@ @ @ @ @ @ @ @ @ @ @ @ @ @ @ @ @ @ @ @ . . @ . @ . @ . . . . . @ . @ @ . @ @ @ @ . @ @ @ . @ @ . . . . @ . . . @ @ . @ . @ . @ @ @ @ @ @ @ . @ . @ . . . @ @ @ . @ @ @ @ @ @ @ @ @ @ @ @ @ @ @ @ @ @ @ 
@ @ @ @ @ @ @ @ @ @ @ @ @ @ @ @ @ @ @ @ @ . . . @ . @ @ . @ . @ . . . . . . @ @ . . @ @ . . . . @ @ @ . . . @ @ @ . . . . . . @ @ @ @ . . @ . . . . . @ @ . @ @ . . @ @ @ @ @ @ @ @ @ @ @ @ @ @ @ @ @ @ 
@ @ @ @ @ @ @ @ @ @ @ @ @ @ @ @ @ @ @ @ @ @ @ . @ . . . @ . . . @ . @ . @ . . . @ . . . @ . @ @ . @ @ @ . @ . . . @ . @ . @ . . . @ . . @ @ . @ . @ @ . . . . @ @ . . . @ @ @ @ @ @ @ @ @ @ @ @ @ @ @ @ 
@ @ @ @ @ @ @ @ @ @ @ @ @ @ @ @ @ @ @ @ @ @ @ . . . @ @ . @ . @ @ . @ @ . @ . @ . . @ @ . . . @ . . @ . . . . @ . . @ @ @ @ . @ @ . @ . @ @ @ . . . @ . @ @ @ . . @ . @ . @ @ @ @ @ @ @ @ @ @ @ @ @ @ @ 
@ @ @ @ @ @ @ @ @ @ @ @ @ @ @ @ @ @ @ @ @ @ . @ . @ . . . . . . . @ . . . . . . . @ . . @ . @ . . @ . @ . @ . @ @ @ . . . . . . . . . . . @ . @ . @ . . @ @ @ . @ . . . . @ @ @ @ @ @ @ @ @ @ @ @ @ @ @ 
@ @ @ @ @ @ @ @ @ @ @ @ @ @ @ @ @ @ @ @ @ @ . . . . @ @ . @ . @ @ . . @ . @ . @ . . @ . . . . @ . @ . @ @ @ . @ . @ . @ . @ . @ . @ @ . @ . . @ . @ . @ . . . . @ . @ . @ @ @ @ @ @ @ @ @ @ @ @ @ @ @ @ 
@ @ @ @ @ @ @ @ @ @ @ @ @ @ @ @ @ @ @ @ @ @ @ . @ . @ @ @ . . . @ . @ . . . @ . . @ @ @ @ . @ . . @ . . . . . . . . @ . @ @ . . @ @ @ @ . . @ . . . . . . @ . @ @ . . @ @ @ @ @ @ @ @ @ @ @ @ @ @ @ @ @ 
@ @ @ @ @ @ @ @ @ @ @ @ @ @ @ @ @ @ @ @ @ @ @ @ . . . @ @ @ . @ . @ @ @ @ . @ @ . . @ . @ . . . @ @ @ . @ . @ @ . @ . . . . . @ . @ . @ @ . @ . @ @ @ . @ . @ . . . @ . @ @ @ @ @ @ @ @ @ @ @ @ @ @ @ @ 
@ @ @ @ @ @ @ @ @ @ @ @ @ @ @ @ @ @ @ @ @ . @ . @ . @ @ @ . . . . . . . . @ . . @ . @ . @ . @ @ . @ @ @ . . . @ . . @ @ . @ @ @ . . . . . . . . . . . @ . . . @ @ . @ . . @ @ @ @ @ @ @ @ @ @ @ @ @ @ @ 
@ @ @ @ @ @ @ @ @ @ @ @ @ @ @ @ @ @ @ @ . . . . . . . @ . @ @ @ . @ @ @ @ . @ . . . @ . @ . . . . @ @ . @ . @ @ @ . . . . . @ . . @ . @ @ @ @ . @ @ @ . @ . @ . . . . . @ . @ @ @ @ @ @ @ @ @ @ @ @ @ @ 
@ @ @ @ @ @ @ @ @ @ @ @ @ @ @ @ @ @ @ @ @ . @ @ . @ . . . @ . . . @ . . . . . @ @ . . . . . @ @ . . . . @ @ @ @ @ @ . @ . @ @ @ . . @ . . . . @ . . . . . . @ . @ . @ @ . . @ @ @ @ @ @ @ @ @ @ @ @ @ @ 
@ @ @ @ @ @ @ @ @ @ @ @ @ @ @ @ @ @ @ @ @ @ . @ @ . @ @ . . @ @ . @ @ @ @ @ . @ . @ . @ @ . . @ @ . @ . . @ @ @ @ @ . @ . . @ . . @ @ @ @ . @ . @ . @ @ . @ @ @ . . . @ . @ @ @ . @ @ @ @ @ @ @ @ @ @ @ 
@ @ @ @ @ @ @ @ @ @ @ @ @ @ @ @ @ @ @ @ @ . . . @ . @ . @ . @ . . . @ . . @ . . . . . . @ @ . @ . @ @ . @ . @ @ @ . @ . @ . . @ . . @ . @ . . . . . @ . @ @ @ . @ . @ @ . . @ . . @ . @ @ @ @ @ @ @ @ @ 
@ @ @ @ @ @ @ @ @ @ @ @ @ @ @ @ @ @ @ @ . @ . @ . . . . . . . @ . @ . . @ . @ @ @ @ . @ . @ @ . . . @ @ . . @ @ . . . . . . @ . @ . @ . @ . @ @ @ @ . . @ @ . . . . @ @ . @ . @ . . . . @ @ @ @ @ @ @ @ 
@ @ @ @ @ @ @ @ @ @ @ @ @ @ @ @ @ @ @ . . . . . . @ @ . @ @ . . . . @ . . . @ @ . . . . . . @ @ @ . . . . @ . . . @ @ . @ . . . . . . . @ . . . @ @ @ . . @ @ . @ @ . . . . . . . @ @ @ . @ @ @ @ @ @ @ 
@ @ @ @ @ @ @ @ @ @ @ @ @ @ @ @ @ @ @ . @ . @ @ . @ @ @ @ @ . @ @ . . @ @ . @ . . @ . @ . @ @ . . @ . @ . @ . @ . . @ @ . . @ . @ . @ . @ . @ @ . @ . . @ . . . @ . . @ . @ . @ . @ . . . . . @ @ @ @ @ 
@ @ @ @ @ @ @ @ @ @ @ @ @ @ @ @ @ @ . @ . . @ . . @ @ @ @ . @ @ @ @ . . @ . @ @ @ @ . . @ . . @ . . @ . . . @ . . @ @ . . @ . @ . . @ . . . . . . @ . @ @ . @ . . @ . . @ @ @ . . @ @ . @ . @ @ @ @ @ @ 
@ @ @ @ @ @ @ @ @ @ @ @ @ @ @ . . . . . . @ @ @ . . @ @ . . . @ . . . @ . . . . . . . @ . @ . . . @ @ . @ . . @ @ @ . @ . . . . @ . . @ . @ . @ . @ . . . . . @ . @ . @ . @ @ @ . @ . . @ @ . @ @ @ @ @ 
@ @ @ @ @ @ @ @ @ @ @ @ @ @ @ @ . @ . @ @ . . . . @ . . @ @ . . @ @ . . @ . @ . @ @ . @ . @ . @ . @ . @ @ . @ . . . . @ . @ . @ . . @ . @ @ @ @ @ . @ . @ . @ . @ . . @ . @ @ @ . @ @ . . @ . . @ @ @ @ 
@ @ @ @ @ @ @ @ @ @ @ @ @ @ . @ @ . . @ . @ . @ @ . @ . @ . @ . @ @ @ . @ @ . @ . . . @ . . @ @ . . . @ @ . @ . @ @ . . . . @ @ @ . . . . . @ @ . . . . @ . @ . . . @ . . . @ . @ . @ . @ . . @ @ @ @ @ 
@ @ @ @ @ @ @ @ @ @ @ @ . . . . . @ . @ . . @ . . . . . . . . . . . . . . . . @ @ @ . @ . @ @ . . @ . . @ . @ @ . @ . @ @ . @ . @ . @ . @ . . . @ @ @ . . @ @ @ @ . . . @ @ . . . . . . @ @ . @ @ @ @ @ 
@ @ @ @ @ @ @ @ @ @ @ @ . @ . @ . @ . . . @ . . @ @ . @ . @ . @ . @ @ . @ @ . @ . . . . . . @ . @ . . @ @ . . . . . . . . @ @ . . @ @ @ @ @ @ @ . . . . @ . @ . @ . @ @ . @ . @ @ . @ . @ . . . @ @ @ @ 
@ @ @ @ @ @ . @ @ @ @ @ @ @ . @ @ . @ @ . @ @ . @ . . . @ . @ . @ @ @ @ @ . . . @ . @ . @ @ @ @ . @ . @ @ @ . @ . @ . @ @ @ . . @ @ @ @ @ @ @ @ @ . @ . . . . . . . . . . . . @ . @ . @ . @ . @ . @ @ @ 
@ @ @ @ @ @ . . @ @ @ @ @ . . . . . @ . @ . . @ @ . @ . @ . . . . . @ . . @ @ . @ @ . . @ . @ . . @ . . @ . . . @ @ . . . . . @ . @ @ @ @ @ @ @ @ @ . . @ . @ . @ . @ . @ @ . . . . . . . . . . . . . @ 
@ @ @ @ @ . . @ . @ @ @ @ @ . @ . @ @ . . @ . @ . @ . @ . @ . @ @ . . @ . @ @ . . . @ . . . . @ . @ . @ @ @ . @ @ . . @ . @ @ . . . @ @ @ @ @ @ @ . . @ . @ @ @ @ . @ . . . @ . @ @ . @ . @ . @ @ @ . @ 
@ @ @ @ @ @ . @ . . @ @ @ . . @ @ @ @ @ . . . . . . . . . . . . . @ @ . . . . @ @ . . @ . @ . . . . . . . . @ . @ @ . @ @ @ @ . @ . . . @ @ @ @ . @ . . . . @ @ . @ . @ . @ @ . @ . . . @ @ @ . . @ . @ 
@ @ @ . @ . . @ . @ . . . @ . . . . @ @ @ . @ . @ . @ @ . @ . @ . . . @ @ @ . @ @ @ . @ . @ . @ . @ @ @ @ . . . @ . . . @ @ . . . @ . @ @ @ @ . . . . @ . @ @ @ . @ . . @ @ . . . @ @ @ . . . @ . . @ @ 
@ @ . . . @ . @ . . . @ . . . @ . @ @ @ @ @ . @ . . @ . @ @ @ . . @ @ . @ . . . @ . . . @ . . @ . . . @ @ . @ @ @ @ . @ @ @ . @ @ . @ @ @ @ @ @ . @ . . @ @ @ . . @ . @ . @ . @ @ @ @ @ . @ . . . @ @ @ 
@ . @ @ . . . @ . @ @ . @ @ . . @ @ @ @ @ . . . . @ . . . . @ . @ @ . . . @ . @ . @ . @ . @ . . @ . @ . . @ . . . . . . @ . . @ @ . . @ @ @ @ . @ @ . @ . @ @ @ . @ . . . @ @ . . @ @ @ . . @ . @ @ @ @ 
@ . . @ @ @ . @ @ . . . @ . . @ . @ @ @ @ . @ @ @ . @ @ . @ @ . . . . @ . . . . . . . . . . . @ . @ . @ . @ @ . @ . @ . . @ . . @ . @ . @ . . . . . . . . . @ . . @ . @ @ @ . @ . . @ . . @ @ . @ @ @ @ 
@ @ . . . . . . . @ @ . . @ . @ . . @ @ @ . @ @ . . @ . . . @ @ . @ . . @ . @ . @ . @ @ . @ . . . . . . . @ . . . @ @ @ @ . . @ . . . . . . @ @ @ @ . @ . @ . . @ @ . . . @ . . @ . . @ . . @ . @ . . @ 
@ @ @ @ . @ . @ . @ . @ . @ . @ . @ . @ . @ @ @ . @ . @ . @ . . @ . . @ @ . . @ . . . @ @ @ @ @ . @ . @ . @ @ . @ . @ . @ @ . . . @ . @ @ . . . . . @ . . @ . @ . @ . @ @ . @ . @ . @ @ . @ . @ . . @ @ 
@ . @ . @ . @ . . . . . . . . . . . . . . . . . . . . . . . @ . @ @ . . @ . @ . @ . @ @ . @ . @ . @ @ . . . . . . . . . . . . @ @ @ . . @ . @ @ . @ . @ . . . . . . . . . . . . . . . . . . . . @ . . @ 
@ . . . @ . . @ . @ . @ . @ . @ . @ . @ . @ . @ . @ . @ @ . . . . . . @ @ @ . . . . . . . . . . @ . @ @ . @ . @ . @ . @ . @ . . . @ @ @ . . @ @ @ . . . . @ @ @ . @ . @ . @ . @ . @ @ . @ . @ @ @ . @ @ 
@ @ @ . @ @ . . . . @ . . @ @ . . . @ @ . . @ . @ . . . . @ . @ . @ . . @ @ @ @ . @ . @ . @ @ . . . @ . . . @ . @ . . @ . . @ @ . . . @ . @ @ @ @ @ @ @ . @ @ . . . @ . . @ . . @ . . . . @ @ . . . . @ 
@ . . . . . . @ . @ . . @ . . . @ . . . @ @ . . . @ . @ @ @ . @ . . @ @ @ @ @ @ @ . . . @ . . . @ @ @ @ . @ . . @ . @ . . @ . @ . @ . @ . @ @ @ @ @ . @ @ . @ @ @ @ . @ . @ . @ @ . @ . @ @ . . @ @ . @ 
@ . @ . @ . @ . @ . . @ . . @ . @ . @ . @ @ . @ @ . @ @ . @ @ @ . @ . @ @ @ @ . . . @ @ . . @ . @ . . . . . . @ @ @ @ @ . . . @ . . @ . @ . @ . @ @ . . . . @ . @ . . @ . . @ @ @ @ . . . . @ . . @ @ @ 
@ . @ @ . . @ . @ . @ . . @ . . @ . @ . . . . . . . @ . . . . @ @ . . . @ @ @ . @ . . . @ @ . . . @ . @ . @ . . @ . @ . . @ . . @ . @ . . . . . @ . @ @ . @ . . @ . @ @ . @ @ @ @ @ @ . @ . . . @ . . @ 
@ @ . @ @ . @ . . . @ @ @ . . @ . . . @ . @ . @ . @ @ . @ @ @ @ . @ . @ @ @ . @ . . @ . . @ @ @ @ . . @ . @ @ @ . . . @ . . @ . @ . . @ @ . @ . . . . @ . @ . @ . . . @ . @ @ @ @ @ . . . @ . @ . . @ @ 
@ @ . @ @ . . @ . @ @ @ @ @ . . @ . @ @ @ . . @ . . . . @ @ . . . . . . @ . . . . @ @ @ @ . . @ @ @ @ . . @ @ @ . @ . @ @ @ . @ . . @ . @ . @ . @ @ . . . . . . . @ @ @ @ . @ . @ @ @ . @ . . . . @ @ @ 
@ . . . . . @ . . @ @ . @ . . @ . . @ @ . @ . . @ @ . @ @ . @ @ . @ @ . . . @ . @ . @ @ . @ . @ . . . @ . . @ . . . @ . . . . . @ . . . @ @ . . . . @ . @ @ . @ . @ . . . . . . . @ . @ @ @ . @ @ . @ @ 
@ . @ @ . @ . . @ . . . . . @ @ @ . @ . . . . @ . @ @ . . . . . @ . . @ . @ . @ . . . . . . . . @ . @ . . @ . @ . @ . . @ . @ @ . . @ @ @ @ @ . @ @ . @ @ . . . @ @ @ . @ @ . @ @ . . . . . . . . . . @ 
@ . . . @ . . @ . @ . @ @ . @ . . . . @ . @ @ . . . . @ @ . @ . @ @ . @ . . . . @ . @ @ @ . @ . . . . @ . . . . . . . @ @ @ . . . @ . @ . @ . . . . . @ @ @ . @ @ @ . . . @ . @ @ @ . @ . @ @ . @ . @ @ 
@ . @ @ . @ . . . . @ . . . @ @ . @ . @ @ . . . @ . @ @ @ @ @ . . . . . . @ @ @ @ @ . . @ @ @ . @ @ . . . @ @ . @ . @ . @ . . @ . . . . . @ . @ . @ . . . @ . . @ . @ . @ @ @ @ @ @ @ . . @ . . @ . . @ 
@ . . @ . . . @ . @ @ @ @ . . . @ . . @ @ @ . @ . . . @ . . . @ @ . @ . @ . . @ @ @ . @ . . . @ . . . @ . . @ . . @ @ . @ @ . . @ . @ @ . @ . . @ . @ @ @ @ @ @ . . @ . . @ . . . @ . @ . . @ . . @ . @ 
@ . @ @ . @ . . @ @ @ @ @ @ . @ . @ . @ . . . . @ . @ . @ @ . . . . . @ . . @ @ @ . . @ @ @ . @ . @ @ . . @ . . @ . . . @ @ . @ . . @ . . . . @ @ . . . . @ @ @ . @ . . @ . . @ . . . @ . @ @ @ . . @ @ 
@ . . . @ . . @ @ @ @ @ @ @ @ . . . . . @ . @ . . @ @ . @ . @ @ @ @ @ . @ . . @ . @ . @ . @ . . . @ . . @ . @ . . . @ . @ @ @ . @ . . @ . @ . @ . @ @ . @ . @ @ . . @ . @ @ . @ . @ . @ . . @ . . @ @ @ 
@ . @ @ . @ @ @ @ @ @ @ @ @ @ @ . @ . @ . . @ . @ . . . . . . . . . . . . . @ @ . . . . . . . @ . . @ . @ . . @ . @ . . @ @ . . . . @ . @ . . . . . . . . . . . @ . @ . . . @ . . @ . . @ . . @ @ @ @ @ 
@ . . @ . @ . @ . @ @ @ @ @ . . @ . . @ . @ . . @ . @ . @ @ . @ . @ . @ @ . @ . @ . @ . @ . @ . . @ . @ . @ . @ . . @ @ . . @ . @ . . . . @ . @ . @ . @ . @ . @ . . . . @ . . . @ @ . @ . . @ @ . @ @ @ 
@ @ . . . . . @ . . @ @ @ @ @ . @ @ . @ . @ . @ @ . . @ . @ . @ . . @ @ . . . . . . . @ . . @ @ . . . . . @ . . @ @ @ @ @ . @ . . @ . @ @ . @ . . . @ @ @ @ . . . @ @ . @ @ . @ . . . . @ . . . . . . @ 
@ @ @ . @ . @ . . @ . @ @ @ . . . @ @ @ @ . . . . . @ @ . . @ . . @ @ . @ . @ . @ . @ . @ . @ . . @ . @ . @ . @ @ @ @ @ . . . . @ @ . . . . @ @ . @ . . @ . . @ . . . @ . . . @ . @ . @ . @ . @ . @ . @ 
@ @ . . . @ . @ . @ . . @ . @ . @ . @ @ @ . @ . @ . @ @ . @ . @ . . @ . . @ . . @ . @ . . . @ @ . @ @ @ @ @ . . @ @ @ . @ . @ . @ . . @ @ . . @ . . @ . @ @ . . @ . @ @ . @ . . @ . . . . @ . . @ . . @ 
@ @ @ . @ @ . @ . @ . @ . . . . . . . . @ @ . . @ @ . . . . . . . @ @ . @ . @ @ . . @ @ . @ @ . . . . @ . . . @ . @ @ . . . @ @ . . @ @ . @ . . @ . . . . . @ @ . . . @ @ @ . @ . @ . @ @ . . @ . @ . @ 
@ @ . @ . . . . . . . . @ . @ . @ @ @ . . . @ @ . . . @ . @ . @ . . @ . . . @ . @ . . @ @ . . . @ . @ . @ @ . . . . . @ @ . @ . . @ . @ . . @ . . @ . @ . @ . . @ . @ @ . . @ . . . . . . @ . . . . @ @ 
@ . . . . @ . @ . @ @ . . . . @ @ @ . . @ @ . . @ . @ . . . @ @ . @ . . @ @ . . . . @ @ . . @ @ . . . . . . . @ . @ . @ . . . @ . @ . . . @ . . @ . . . @ @ @ . @ . @ . @ . @ @ . @ . @ @ . . @ . @ @ @ 
@ @ . @ . . @ @ @ . @ @ @ @ @ @ @ @ @ . . . . @ . @ . @ . @ . @ @ @ @ . . . @ @ . @ . @ @ . . @ @ . @ . @ . @ @ @ . . . @ . @ @ @ . @ . @ . . @ @ @ . @ @ @ . . . . . . . . . @ @ @ . @ @ @ . . @ @ @ @ 
@ @ . @ . @ @ @ . . . . . . . @ @ @ . @ @ @ . . . . . . . . . . @ . . @ @ . @ @ @ @ . @ @ @ @ . . . . @ . . @ @ . @ @ @ @ @ @ @ . . . . . . @ @ @ . . . @ . @ @ @ @ . @ @ . @ @ @ . @ . @ . . @ @ @ @ @ 
@ . @ . . @ . . . @ . @ @ @ . . @ . . . . . . @ . @ @ . @ . @ @ . @ . @ . . . @ . . . . @ . . @ . @ @ . @ . . . . . . @ @ . . . @ @ @ . @ . @ @ . . @ . . . . . . @ @ . . @ @ @ . . @ . . @ . . @ @ @ @ 
@ . . . @ . . @ . . @ @ . @ . @ . . @ . @ . @ . @ . . . @ . @ . . . . . @ . @ . @ @ . @ . . @ . . . . . @ . @ @ . @ . . @ @ . @ . @ . @ . @ . @ @ . @ . @ . @ . @ . . . @ . @ . @ . @ @ . . . @ @ @ @ @ 
@ @ @ . @ . @ . . @ @ . . . . . . @ . @ @ @ @ . . . @ . @ . @ . @ . @ . . . . . @ . . . . @ . @ . @ . @ @ . . @ . . @ . . . . . . . . . . @ . . . . . @ . . @ . . . @ @ . . . . . . . . @ . @ @ @ @ @ @ 
@ . @ @ . . @ @ . @ @ @ . @ . @ . . . @ @ @ @ @ . @ . . @ . @ @ . . @ . @ . @ . . @ . @ @ . . . . . @ . . . @ @ . @ @ . @ . @ . @ @ @ . @ . . @ . @ . . @ @ . @ @ . . @ . @ @ . @ . @ @ . @ @ @ @ @ @ @ 
@ . . . . @ . . . . @ . @ . @ . @ @ @ @ @ @ @ @ . @ . @ @ . @ . . @ . . . @ . @ . . . . . . @ @ . @ . @ . @ @ @ . . . @ @ . . @ . @ . . @ . @ . . @ . @ . @ . . . . @ @ @ . . . @ . @ @ . @ @ @ @ @ @ @ 
@ . @ . @ . . @ @ . @ . @ . . . . . . @ @ @ @ @ @ . . @ . . @ . @ @ @ . @ @ . @ . @ . @ . @ . . . . . @ . @ @ . . @ . . . @ . . . . @ . @ @ @ @ . @ . . . . @ . @ . @ @ @ @ @ @ . . @ . . . @ . @ @ . @ 
@ . @ @ . . @ . . . . . . @ . @ . @ @ . @ @ @ @ . . @ . . @ . . . @ . @ . . . . @ . . @ @ . @ . @ . @ @ . @ @ @ . . @ . @ @ @ . @ . . @ @ . . @ . @ . @ . @ . @ . . . @ @ @ @ @ @ . . . @ @ . . @ . . @ 
@ @ . @ @ . @ . @ . @ . @ @ . . @ . . . @ @ @ @ @ . @ @ . . @ . @ . . . @ @ . @ . . @ . . . . . @ . . . @ @ @ . . @ @ . . . . @ @ . @ . . . @ . . @ . . @ . . . @ . @ . @ . . . @ @ @ . . @ @ . @ @ . @ 
@ @ . . . . @ @ . . @ @ @ . . @ . @ @ . @ @ @ @ @ . . . @ . @ . . @ . @ . . . . . @ . . @ . @ . @ . @ . . . . @ . . . @ . @ . . . @ . @ @ . @ @ . @ . @ . @ . @ . @ @ . . @ . @ . @ @ . @ . @ . . . . @ 
@ @ @ . @ . . . @ . . . @ @ . . . . . . . @ @ . . . @ @ . @ . @ @ @ . . @ . @ . @ . . @ @ @ . . @ . . @ @ . @ . . @ . . @ . . @ . . . . . . . . @ @ . . . . . . . . . @ . . . . . . . . . . . . @ . @ @ 
@ @ . . . @ . @ . @ . @ . . . @ . @ @ . @ . @ @ . @ . . . . . @ . @ . @ . @ . . . @ . @ @ . @ . @ . @ @ . . . @ . . @ @ . @ . . @ . @ . @ @ @ @ . . . @ . @ @ . @ . @ @ . @ . @ . @ . @ . @ . @ @ . . @ 
@ @ @ . @ . . @ . . . . @ @ . . @ @ . . @ . . . @ . . @ @ @ . . . . . . . . . @ . @ @ . . . . . @ . @ @ @ . @ . . @ @ @ . . . @ . @ . . . @ . . . @ . . @ @ @ @ . . . . . @ . @ @ @ . . @ @ @ . @ . @ @ 
@ @ . @ @ @ . . @ . @ @ @ @ . @ . . @ . . @ @ . @ @ . @ . . . @ . @ . @ . @ . @ . . . @ . @ . @ . . @ @ @ . @ @ . . . @ . @ @ @ . . @ . @ . . @ . @ @ . . @ @ @ @ . @ . @ @ @ . @ . . @ . . . . . @ @ @ 
@ @ . . @ @ @ @ . . . . @ . . . @ . @ @ @ . . . . . . @ @ . @ . . @ . . @ . . @ . @ . . @ . . @ @ . . . . @ @ @ @ . @ . @ . @ @ @ . . . . @ . @ @ @ @ @ @ . @ @ . . . @ @ @ @ . @ @ . . . @ @ @ @ . @ @ 
@ . @ . . @ @ . @ . @ @ @ . @ @ @ . . @ @ @ @ . @ . @ @ . . . @ . . @ @ @ @ . @ . . @ . . @ . . @ . @ . @ . . @ @ . . . . . . @ . . @ . @ @ . . @ @ @ . @ . @ @ @ . @ . @ @ . . . . @ @ . . . . . . . @ 
@ . . . @ @ . . . . . . . . @ @ @ . @ . @ @ @ @ . . . @ @ . @ . @ . . . . @ @ @ . @ @ @ . . @ . . @ . . . @ . @ . . @ @ @ @ @ @ @ @ . . @ . . @ @ . . . @ . . @ . . . . . . @ . @ . @ . @ @ @ @ @ . @ @ 
@ . @ . . . @ . @ . @ @ @ . . @ . . . . . . . @ @ . @ . @ @ @ . . . @ . @ . . . . . @ @ @ @ @ . @ . @ . @ @ . . . @ @ @ @ @ @ @ . . @ . @ @ @ . . . @ @ . . @ . @ . @ . @ . . . . @ . . . . . . . @ . @ 
@ @ . @ . @ @ @ . . . . . @ @ . @ . @ @ . @ . @ . @ . . . . . . @ . @ . @ @ . @ @ . @ @ . . @ . . . . @ . . . @ . . @ @ @ . . . . @ @ . . . @ . @ @ . @ @ . . . . . . @ . @ . @ . . . @ @ @ . @ . . . @ 
@ . . . . @ @ . @ . @ @ . . @ . . . . @ @ @ @ . . @ . @ . @ . @ . . . @ @ @ @ . @ @ @ . . @ . . @ . @ . @ @ @ . @ . . @ . @ . @ . . @ . @ . . . . . . . . @ @ . @ . @ @ . @ @ . @ @ . . . . @ @ @ @ @ @ 
@ @ @ @ . . . . . . . . @ @ . . @ . @ @ @ @ . @ . . @ @ @ . . @ @ . @ . . . @ . . @ . @ . @ @ . . @ . . . . . . . . @ . . @ @ . @ . @ . . @ . @ . @ . @ @ . . . @ . . . . . . . @ . . @ @ . . . . . . @ 
@ . . . . @ @ @ @ . @ . . @ @ . . @ @ @ . . . . @ . @ . @ @ @ . . . . @ . @ . . @ . . . . . . . @ @ @ . @ . @ . @ . . @ . . . . . . . . @ . . . @ . . . @ . @ . @ . @ . @ . @ @ @ @ . . . @ @ . @ . @ @ 
@ @ . @ . . @ . . @ @ . @ @ @ . @ . @ @ @ . @ . . . . . . . . @ . @ @ . . . @ . @ @ @ . @ . @ @ @ @ @ @ . . . @ . . @ . @ . @ @ . @ . @ . . @ . @ @ @ @ @ . @ @ . . . @ . . . . @ . . @ . . . @ . . @ @ 
@ . . . @ @ . @ . . @ @ @ @ . . . . . @ @ @ @ @ . @ @ . @ . @ . @ . . . @ . . . . . . . @ . . @ @ @ @ @ @ . @ @ @ . . . . @ @ @ @ . . . @ . @ . . . . . . @ @ @ @ . @ . @ @ . @ @ @ . . @ . @ @ . @ . @ 
@ @ @ @ . @ . . . @ @ @ @ . @ . @ @ @ @ . . . . . . @ @ . . . . . . @ @ . @ . @ @ . @ . . @ . . . @ @ @ . . @ @ . @ . @ @ . @ @ @ @ . @ . @ . . @ @ . @ @ @ . . . . . . . @ . @ @ @ . @ . . @ . @ @ . @ 
@ . . . . . . @ . . . . . . . . . . . . . @ . @ . @ @ . @ . @ . @ . . . . @ @ @ @ @ . . @ @ . @ @ @ @ @ @ . @ @ . . . . . . . . @ . @ . . @ @ . . . @ @ @ @ @ . @ . @ . @ . . . @ . . @ @ . . . . . . @ 
@ @ . @ . @ @ . @ . @ . @ . @ . @ . @ . @ . @ @ . @ . . @ . @ @ . . @ @ @ . . @ @ @ @ . . . @ @ . @ @ @ . . . @ @ @ . @ . @ @ . . . . . @ @ . @ . @ . @ @ @ @ @ . . . @ @ @ . @ @ @ . @ . . @ . @ . @ @ 
@ . @ . . . @ . . . @ @ . . @ . @ @ . . @ . . . @ . @ . @ . @ . @ . @ . @ . @ @ @ @ @ . @ @ . . . @ . @ @ . @ @ @ . . . @ . . . @ @ @ . @ . . . . . . . . @ @ @ @ @ . . @ @ @ @ @ . . . @ . . @ @ @ @ @ 
@ . . . @ @ . @ @ @ . . . @ . . . . @ @ . @ @ . . . . . . . . . @ . @ . . . . @ @ @ . . @ . @ @ . @ . . @ @ @ @ @ @ @ @ @ . @ . @ . . @ @ . @ . @ . @ . @ @ . . . . . @ . @ . @ @ @ . @ @ @ @ . @ . @ @ 
@ @ @ . . . . . @ @ . @ . . @ . @ . . . . . . @ . @ . @ @ . @ @ . . @ . @ . @ @ @ . @ . . . . @ . . . @ @ @ @ @ @ . . . . @ . . @ . @ . . . @ @ . @ . . . . @ @ . @ . . . . . . @ @ . . . . . . . . . @ 
@ @ @ @ @ @ . @ @ @ . . @ . @ @ . . @ @ . @ . . @ . . . . @ . . . @ . . @ . . . . . . . @ . @ . . @ @ @ @ @ . @ . . @ . @ @ @ . . . . @ @ . . . . . @ . @ . @ . . @ @ . @ . @ . . . @ . @ . @ . @ . @ @ 
@ @ @ @ @ @ . @ @ @ @ @ . . . . @ . . . @ @ . @ . @ . @ . . @ @ . . @ . @ @ @ . @ . @ . . @ @ . @ . @ @ . . . . @ . @ @ . @ . . @ . @ . . . @ . @ @ . . . @ @ @ . . @ . . @ @ @ . @ . . . @ @ . . @ @ @ 
@ @ @ @ @ @ @ . @ @ . . @ . @ . @ . @ . . @ . . . @ @ . @ . @ . @ @ . . @ . . . @ @ . . @ . . . . . . @ . @ . @ . . . . . . @ . . @ @ @ . @ . . . . @ . @ . @ @ @ @ @ . @ @ @ @ @ . @ . @ . @ . @ @ . @ 
@ @ . @ . . @ . . @ @ . @ . . @ @ @ . . @ . . @ . . . . @ . . . @ @ . @ . @ @ . . @ @ . . . @ @ . @ . . . . @ . @ . @ . @ . . . @ . @ . @ . @ . @ . . @ . . @ . . . . . . @ @ . @ . @ . . . @ . . @ . @ 
@ . . . . @ @ . @ . . . . . @ @ @ @ @ @ @ @ . @ . @ @ @ . . @ . @ . @ . . . . . @ . @ . @ . . . @ @ @ @ @ @ . . @ . . @ . . @ . . . . . . . . @ . . @ . . @ . . @ @ . @ . . . . . . @ . @ . . @ . . . @ 
@ @ @ @ . . . . . . @ . @ . @ @ @ @ @ . . @ . . @ @ @ @ @ @ @ @ . . . . @ . @ @ . . . . @ . @ . . . . . . . . @ . . @ @ @ . @ @ @ @ @ . @ . @ . @ @ . @ . @ @ . @ . . . @ . @ . @ . . @ . . @ @ . @ . @ 
@ . . . . @ @ . @ . @ @ . . @ @ @ @ @ . @ . @ . . . @ . . . @ . . @ . @ . . @ @ @ . @ . . @ . . @ . @ @ . @ . . @ . . @ @ . . @ @ . @ @ . . . . . . . . . . @ . @ @ . @ @ . . @ @ . @ @ @ . . . @ . . @ 
@ . @ . @ . . . @ @ . @ @ . . @ @ @ . . . . . . @ . @ . @ . @ @ . @ @ @ . @ @ @ @ @ . . @ . @ @ . . . . @ @ @ . . @ @ . @ @ . . . . . . @ . @ @ . @ . @ . @ @ @ . . . @ @ @ . . . @ . @ @ . @ . . @ . @ 
@ @ . . . @ @ . . @ . . . . @ . @ @ @ . @ . @ . . @ @ @ . . . @ @ . . . . @ @ @ @ . @ . . . . @ @ @ . @ @ @ @ @ . . @ . . . . @ . @ . @ . . . @ . . @ @ . . . @ . @ . . . @ . @ @ . . . @ . . @ . . @ @ 
@ @ @ . @ @ . . @ . @ @ @ . . . . @ @ . . @ . . @ . @ . @ @ . . . . @ . @ . . . . . . . @ . @ @ @ @ @ @ @ @ @ @ @ . @ . @ . @ @ @ @ . . @ . @ @ @ . . . @ @ @ . . @ . @ . @ . . . @ @ . . . @ . . @ @ @ 
@ @ . . . @ . @ . . . . . . @ @ @ . @ @ @ @ @ . . . . . . . @ . @ . . @ . . @ . @ @ @ . . @ @ @ @ @ @ . @ @ . @ @ . @ . @ @ @ @ @ . . @ . . . . . @ . @ @ @ . . @ . . @ . @ . @ @ . @ @ . @ @ @ . . . @ 
@ @ @ . @ @ @ . . @ @ . @ . . . . . . . @ @ @ @ . @ . @ . @ @ @ . . @ @ @ . @ . . . @ . @ @ @ @ @ @ @ . . . . . . . @ . @ @ @ @ @ @ . . @ . @ . @ @ @ @ @ @ @ @ @ @ . . @ . . . @ . . . . . . @ . @ . @ 
@ @ @ @ @ @ @ @ @ @ @ @ @ @ @ @ @ @ @ @ @ @ @ @ @ @ @ @ @ @ @ @ @ @ @ @ @ @ @ @ @ @ @ @ @ @ @ @ @ @ @ @ @ @ @ @ @ @ @ @ @ @ @ @ @ @ @ @ @ @ @ @ @ @ @ @ @ @ @ @ @ @ @ @ @ @ @ @ @ @ @ @ @ @ @ @ @ @ @ @ 
3
27 15 97 28
87 80 16 93
53 14 85 63
