100 100
@ @ @ @ @ @ @ @ @ @ @ @ @ @ @ @ @ @ @ @ @ @ @ @ @ @ @ @ @ @ @ @ @ @ @ @ @ @ @ @ @ @ @ @ @ @ @ @ @ @ @ @ @ @ @ @ @ @ @ @ @ @ @ @ @ @ @ @ @ @ @ @ @ @ @ @ @ @ @ @ @ @ @ @ @ @ @ @ @ @ @ @ @ @ @ @ @ @ @ @ 
@ . @ @ @ @ @ @ @ @ @ @ @ . . . @ . @ . @ @ @ @ @ . @ @ . @ . . . . @ @ @ @ @ @ @ @ @ . @ . @ . @ @ @ @ @ . . . @ . @ @ . . . . @ @ @ . @ . . . @ @ . @ . @ . . . @ @ . @ . . . @ . @ . @ . @ . @ @ . @ 
@ . . . . @ @ @ @ @ @ @ . @ . @ @ . . . @ @ @ @ . . . . . . . @ @ . @ @ @ @ . @ . @ . . . . . . . @ @ @ . . @ @ . . . . @ . @ . . @ . . @ . @ . . @ . @ . . @ . @ . . . . @ @ . . . . . . . . . . . . @ 
@ . @ . @ @ @ . @ @ . . . . . . @ . @ . @ @ @ . @ . @ . @ . @ @ . @ . @ . . . . . @ . @ @ . @ . @ . @ . @ . . @ . @ @ @ . @ . . @ . @ . . @ @ @ . . . @ . @ . . . @ @ . @ . @ . @ @ . @ . @ . @ . @ @ @ 
@ . @ . . @ . . @ . . @ @ . @ . @ @ . . . . . . . . @ . . @ . . . . . @ @ @ . @ @ . @ . @ @ . . . . . . . . @ . . . @ . . . @ . . . . . @ @ @ @ . @ . @ . . @ @ . . @ . . . . . @ @ . @ @ @ . @ @ . . @ 
@ . @ . @ . @ . @ . @ @ @ @ @ @ . @ . @ @ @ . @ . @ . . @ . . @ . @ . . @ . . . . . . . . . . @ @ @ . @ . @ . @ . @ . @ . @ @ . @ . @ . @ . @ . . . @ . . @ . . . @ . . @ . @ . @ . . @ . . @ . . . @ @ 
@ @ . . . . . . . . @ . @ . @ . . @ @ . @ . . . @ . @ @ @ @ . @ . @ . @ . @ . @ . @ . @ @ . @ @ @ @ . @ . . . . . . . . . . . . . @ . @ . . . @ . @ . . @ . . @ . . @ . @ @ @ @ . @ @ @ . @ . . @ @ . @ 
@ . @ @ . @ . @ @ . @ . . . . @ . . @ . . . @ . . . @ . @ @ @ @ @ . . . . . . . @ . . @ @ . . . @ . @ @ @ . @ . @ . @ . @ . @ . @ . . @ . @ . @ . . @ . @ @ @ . @ . . . . . @ . . . . . . . . @ . @ . @ 
@ . . @ @ . @ @ @ . @ @ . @ . @ . @ @ @ . @ . @ @ @ . . . @ @ @ . @ . @ . @ . @ . @ . . . @ @ . . . . @ . . . @ @ . . @ . . . @ @ @ . @ . . @ @ @ . . . @ @ . . . . @ @ . @ @ @ @ @ . @ . @ @ . . . . @ 
@ . @ . @ . . @ . . . . @ @ . . . @ . @ . . . @ @ @ @ . @ . @ . . . . . @ . @ . . @ . @ . @ @ @ . @ . @ @ . @ . . . @ . @ . @ @ @ . . . . @ @ @ . . @ . @ . @ @ @ . . . @ @ @ . . . @ . . @ . . @ @ @ @ 
@ . . . @ . @ . @ . @ @ @ . . @ . @ . @ @ . @ . . @ . . . . . @ @ @ . @ . . @ @ . . . . @ @ @ . . @ @ . @ @ . . @ . . . . @ @ @ . @ . @ @ . . . @ @ @ . . . . @ . . @ @ @ @ @ @ @ . @ . @ . @ . . . . @ 
@ @ @ . . . . . . . @ @ @ . @ . . @ . @ @ . @ @ . . . @ @ @ . . . . . @ . @ . . @ @ @ . . @ @ . @ . . . @ . @ . @ . @ @ @ @ . . . . . . @ @ . @ . @ . @ . @ . . @ . . @ @ @ . . @ . . . . . . . @ @ @ @ 
@ . . @ @ @ @ @ @ . . @ . @ @ @ . @ . @ . . . @ . @ @ . @ . @ @ . @ @ @ . @ . @ . . @ . @ @ @ @ . @ @ . @ . . . @ @ . . . . @ . @ . @ @ . . . . . . . . @ . . @ . . @ . @ . . @ . @ . @ . @ @ . . . @ @ 
@ @ . @ . . @ . . . @ . . . @ . . @ . @ @ @ . @ . . . . . . @ . @ @ . @ . . . . . @ . . . @ @ . . @ . . . @ @ . . . @ . @ . @ . . @ @ @ @ . @ . @ . @ @ . @ . . . @ @ . . @ . . . @ . @ . . @ . @ @ @ @ 
@ @ . . . @ . @ @ . . . @ . @ @ . @ . . . @ . . . @ . @ @ @ . . . . . . . @ . @ @ . @ . @ . . . @ . @ . @ . @ @ . @ . @ . . @ . @ . @ @ @ @ . . @ . @ . . @ . @ @ . . . @ @ . @ @ @ . . @ . . @ . . @ @ 
@ . @ @ . @ . @ . . @ @ . @ @ @ . @ . @ @ . . @ @ . @ @ @ @ @ . @ . @ . @ . @ . @ . . @ . . @ . . . . . . . . @ @ . . . @ . . . . . . @ @ . . @ . @ . . @ . . . . . @ . @ . . . . . . @ @ @ @ @ @ . . @ 
@ . . . . . . . @ . @ . . @ . . . . . . . @ . @ @ . . @ . @ . @ . . @ @ . . . . . . @ @ @ @ . . @ . @ @ . @ . @ . @ . @ . @ @ @ @ . @ @ . @ . . . . @ . . . @ @ @ @ @ @ . @ . @ @ . @ @ @ @ @ . . . @ @ 
@ @ . @ . @ @ . . . . @ . . @ . @ . @ @ @ . . @ . . @ . . . . . . @ @ @ . @ @ . @ . . @ . @ . @ . . . @ @ @ @ . . . . . . . . . . . . . . . . @ @ . . . @ @ . . . . . . . . @ @ @ . @ @ @ @ @ @ @ . . @ 
@ . @ @ . @ . @ . @ . . @ . . @ . . @ . @ @ . . @ . . . @ . @ @ @ . . . . . . @ @ @ . . . . @ . @ . @ . . @ @ @ . @ . @ . @ @ . @ @ . @ @ @ . . . @ @ . . . . @ . @ . @ @ . @ @ . . . @ @ @ @ . . @ . @ 
@ . . . @ @ . @ . . @ . @ @ . @ @ . . . @ . . @ . @ @ . @ @ . . . . @ . @ . @ @ @ @ @ . @ . @ . . . @ @ . @ . . . @ . @ . @ . @ @ @ @ . . . . @ . . . @ @ @ @ . . @ @ @ . @ . @ . @ @ @ @ @ @ . @ . . @ 
@ . @ @ . . . . @ @ . . . @ . . . . @ . . @ . . . . @ . . @ . @ . @ @ @ . . . @ @ @ . . @ . . @ @ . @ . . . @ . @ . . . @ . . . @ @ @ @ . @ . . @ . @ @ . @ . @ @ . . @ . . . . . @ @ @ @ @ . . . . @ @ 
@ . . . @ . @ . @ . @ @ . . @ @ . @ . . @ @ @ @ . @ . . @ . . . @ @ @ . @ . @ . @ @ @ @ @ . @ . . . . . @ @ . @ . @ . @ @ @ . @ @ @ @ @ @ @ @ . . @ @ . . . . . @ @ . . . @ . @ . . @ @ @ @ . @ @ . . @ 
@ . @ . @ . @ . @ . @ . @ . @ . . @ @ . . @ . . . . . @ . . @ @ . @ . . @ . . . . . . @ . @ @ @ . @ @ . . @ . . . . . . . . . . @ @ @ @ @ @ @ @ . . . . @ . @ @ . . @ . @ @ @ @ @ @ @ @ @ @ @ . @ . @ @ 
@ @ . . . @ @ . @ . @ . @ . . @ . . @ @ @ . . @ . @ @ . . @ . @ . @ . @ @ . @ @ @ . @ . . . . @ @ . @ . @ . . @ . @ . @ . @ . @ @ @ @ @ @ @ @ @ @ . @ . @ @ @ @ @ . . . . @ @ @ @ @ @ @ @ @ @ . . . . @ 
@ @ @ . @ . . . . . . . . . @ . . @ @ . . @ . . @ @ @ . @ . . . . . . . @ . . . @ . . @ . @ @ @ @ . @ . @ . @ @ @ @ @ . . . @ . @ @ @ @ @ @ @ @ . @ @ . . . @ @ @ @ . @ @ . @ @ @ @ . . @ @ . . @ . @ @ 
@ . . . . @ . @ . @ . @ @ . . @ . @ . . @ . . @ . @ . . . . @ @ . @ @ @ @ . @ . @ . @ . . @ . @ @ . . . . . . @ . . . . @ . @ . . . @ @ @ @ @ . . . . @ . @ @ @ @ @ . . . . @ @ @ . @ . @ . . @ . @ @ @ 
@ @ . @ . @ @ . @ . . @ . @ . . . . @ . . @ . . . . . @ @ @ . @ . @ . . @ . . @ . . . @ . . . @ . . @ . @ . @ @ @ . @ . @ @ @ @ . @ @ @ . @ . @ . @ @ @ @ @ @ @ @ . . @ . @ @ @ . . . . . @ . . . . . @ 
@ @ @ . . @ @ . @ @ @ . . . @ . @ . @ . @ @ . @ @ . @ . . . . @ . . @ . . @ . . @ . @ @ @ @ . . @ . . @ . . . @ @ @ @ @ . . . . . . @ @ . . . . . @ . @ @ @ @ @ @ @ . . @ @ @ @ . @ . @ . . . @ . @ @ @ 
@ @ . . @ . . . . . @ @ @ . @ @ @ . @ . . @ . @ @ @ . . @ . @ . @ @ . . @ . @ . @ @ @ @ @ . . @ . @ . . @ @ . . @ . @ . @ . @ @ . @ . @ @ @ . @ . . . @ @ @ @ @ @ @ . @ . @ @ . . . @ @ @ . @ . @ . @ @ 
@ @ @ . @ . @ @ . @ . . @ . @ . . . . . @ . . . . @ . @ . . @ . @ . . @ . . . @ . @ @ @ . @ . . . . @ . . @ . @ @ . . . . . . @ . . . . @ @ . @ . @ @ . @ @ . @ . . . . . . . @ . @ . @ @ @ . . . . . @ 
@ @ . . @ . . @ . . . @ . . . @ @ . @ . . @ . @ @ . @ @ @ . . . @ . @ . . @ @ . . . @ . . . . @ . @ . . @ . . @ . @ . @ . @ . @ . @ @ @ . . @ @ . @ . . . . . . . @ . @ . @ . . . . . . @ . @ . @ @ . @ 
@ @ @ . . @ . . @ @ . . @ @ . . @ @ . . @ @ . . @ . . @ . . @ . @ . @ . @ . @ . @ @ @ . @ . @ @ @ . . @ @ @ . . . . @ @ . @ @ . . @ . . . @ @ . . . @ . @ . @ . @ . @ @ @ . @ . @ . @ . . . . . . . @ @ 
@ @ . . @ . . @ @ @ @ . @ . @ . . . @ . @ . . @ . . @ @ @ . . @ . . . . . . . . . @ . . . @ @ @ . . @ . @ @ . @ @ . . . @ . @ . @ . @ @ . . . @ @ . . . @ . . @ @ . @ @ . . @ @ . . . @ . @ @ . @ @ @ @ 
@ . @ . . . @ . @ @ @ @ @ . . . @ @ . . @ . @ . @ . . @ . . @ . . @ . @ . @ . @ . @ . @ @ . @ . @ . . . @ @ @ @ @ . @ @ . . . . . . . . . @ @ @ . @ @ . . @ @ . . . . . . @ @ . @ @ @ @ @ . . @ @ . @ @ 
@ . . @ @ . . . . @ @ . . @ @ . @ . @ . . . . . . . @ . @ . . . @ . . @ . @ . . @ . . . . . @ . @ . @ @ @ @ @ @ . . . . @ . @ . @ . @ . @ . . . . @ . . @ @ @ . @ @ @ . @ . . . . . @ @ . @ . @ . . . @ 
@ @ . @ . @ @ @ . @ . @ . . . . . . . @ . @ . @ . @ @ . . . @ @ @ @ . . @ . @ . @ . @ . @ @ @ . @ . . . . @ @ @ @ . @ @ @ @ . . . @ . . @ . @ @ . . @ . @ @ . . . @ . . . @ . @ . @ @ @ . @ . . @ . @ @ 
@ . . . . . . . . . . @ @ . @ @ . @ . . . . @ . . @ . . @ @ . @ @ @ . @ . . . @ . . @ @ . @ . . @ . @ . @ @ @ . @ @ . @ . . @ . @ . @ @ . @ . . @ . . . . . @ @ . . @ @ @ . . . @ @ @ . . . . @ . . . @ 
@ @ . @ . @ . @ . @ . @ . @ . . @ . . @ . @ . @ @ . @ . . . . . @ @ @ @ . @ @ @ . @ . . . . @ . . . . @ @ . . . @ . . . @ . . . . . . @ . . @ . . . @ . @ . . . . @ . . @ @ . @ . @ @ @ . @ . @ . @ . @ 
@ . . . @ . . @ @ @ . . . @ @ . @ @ . @ . @ . . @ . . . @ . @ . @ @ . . . . @ . . . . @ . @ . @ . @ . @ @ @ @ . @ @ . @ @ @ @ . @ . @ . . @ . @ . @ . . @ @ @ @ . @ @ . @ . . . . . @ @ . . @ . . . @ @ 
@ @ . @ . @ @ . . @ . @ . @ . . . . @ . . . . @ . @ . @ . @ . . . . @ @ . @ . @ . @ @ . @ . . . . . @ . @ . . . . . . . @ . @ . . @ @ @ . . . . @ . @ . . @ @ @ @ . . . . . @ . @ @ . . . @ . @ . @ . @ 
@ @ . . . @ . . @ . . . @ . . @ . @ @ @ . @ @ . . . . . . @ @ . @ . . @ . . . @ . . . . . . @ @ @ . . . . . @ . @ . @ . . . @ . @ . @ . . @ @ . . . . . @ @ @ @ . @ . @ . @ . . . . @ @ . @ . . . . . @ 
@ @ . @ @ @ @ . . @ @ . @ . @ @ @ . . @ . @ . . @ . @ . @ . @ . . @ @ . . @ @ . . @ . @ . @ . @ . . @ . @ @ . @ . . . @ @ . . . . . . @ . @ . . @ . @ . @ . . @ . . @ . . . @ . @ @ . @ . @ . @ . @ . @ 
@ . . . . @ @ @ . . . . . . . @ . . @ . . . @ . . @ @ @ . . . @ @ @ . . @ . @ . @ @ @ . . . . . @ @ . . . . . . @ . @ . @ @ . @ . @ . . . @ @ . . @ . . @ @ . @ . @ . @ . @ . @ @ . . . . . . . @ . @ @ 
@ @ . @ . @ @ . @ @ . @ @ . @ . @ . . . @ @ . . @ . . . @ . @ @ . . . @ . . . . . @ . @ . @ @ . . . @ @ . @ . @ . . . . . @ . . @ . @ @ . . @ . @ @ @ . . . . . . . . . . . . . . . @ . @ @ . @ @ . . @ 
@ . @ . . @ . . . . @ . . . @ . . @ . @ . @ . @ . @ . @ . . @ . @ @ . . . @ . @ @ . . @ . . . @ @ . @ @ . . @ @ @ . @ . @ . . @ @ . . @ . @ @ @ @ @ @ . @ @ @ @ @ . @ . @ . @ . @ . @ @ . . . . . . @ @ 
@ . . @ . . . @ . @ . @ . @ @ . @ @ . . . . . . . . . . . @ @ . . @ . @ . @ @ . . . @ . @ @ @ . . @ . @ . @ . @ . . . @ @ @ . @ . . @ . @ @ @ @ @ @ . @ . . @ . . @ @ @ @ @ . . . @ @ . . @ . @ . @ @ @ 
@ @ . @ . @ @ @ @ @ . . . . . . . . . @ @ @ . @ . @ . @ . @ . @ . @ . . @ @ . @ . @ . . . . . @ . . . @ @ . . @ . @ . @ @ @ @ @ . @ . . @ @ @ @ @ @ . @ . @ . @ . . . . @ @ @ . @ . @ . @ . . . @ @ @ @ 
@ . . . @ @ . . . . @ @ @ . @ @ . @ . @ . . @ . . . @ . . @ . . . . . @ @ @ . . . . @ . @ @ . @ . @ @ . . @ . . @ @ @ . @ . @ . . . @ . @ @ @ @ @ . . . . . . . @ @ @ . . @ . @ . . @ . @ @ . @ . @ @ @ 
@ . @ . @ . . @ @ @ @ . @ @ . @ @ . . . @ . @ @ . @ . @ . . . @ @ . @ . @ . @ . @ . . . . . @ @ . @ . @ . . . @ @ @ . . . . . @ @ . . . . @ @ @ . @ . @ . @ . @ . . . . @ . . . @ . . @ . . . . . . @ @ 
@ . . @ . . @ @ . @ . . . . . . . . @ . . . . . @ . . . . @ @ . @ . . . . . . @ @ . @ . @ @ . . . . . . . @ . @ @ @ @ @ . @ @ . @ . @ @ @ . @ . . . . @ . @ @ . . @ . @ . . @ @ . . @ . . @ . @ . @ @ @ 
@ . @ . @ . . . . . . @ @ . @ . @ . . @ . @ . @ . @ . @ . . . . . @ . @ . @ . @ . @ . . . @ . @ . @ . @ @ . @ @ @ @ @ . . . @ . . . @ . . . . @ . @ . . @ . . @ @ . . . . @ . . . @ @ @ . . @ . @ . @ @ 
@ . . . . @ @ . @ . @ . . . . @ . . @ . . @ @ . . . . @ @ . @ . @ . . . @ . . . . . @ . @ . . . @ @ @ . . . . . @ @ . @ . @ . . @ . . . @ . @ @ @ . . @ . @ . @ . @ . @ @ . @ . @ . @ @ @ . . . . . . @ 
@ @ @ @ . @ @ @ . . @ @ . @ . @ @ . @ . @ . @ @ . @ . @ . . . @ . @ . @ @ . @ . @ . . . . . @ @ . @ @ . @ . @ . . . . . . . . @ @ @ @ . . @ . @ . @ . @ . . . . . . . . . . . . . . . @ . @ . @ . @ . @ 
@ @ @ . . . @ @ . @ . . . . @ @ @ @ @ @ @ . @ . @ . . . @ . @ @ . @ @ . . @ @ . . @ @ . @ . . . . . . . . @ . . @ . @ . @ . @ . @ @ . @ . . . . . . . . . @ @ @ @ . @ @ @ . @ . @ . @ . . @ . . @ @ @ @ 
@ @ . @ @ . . . @ . . @ @ . @ @ @ @ @ . . . . . . . @ @ . . . . . @ . @ . @ . @ . @ . . . @ @ @ . @ . @ @ @ @ . . @ . @ @ @ . . . @ . @ @ @ . @ . @ . @ . . . . . @ @ @ . . @ . @ @ . @ . @ @ @ . @ @ @ 
@ @ . @ . @ . @ . @ . . . @ @ @ @ @ . @ @ . @ . @ . . . @ @ . @ . . . . . . . @ @ @ @ . @ . . @ . . @ @ . @ @ @ . @ . . . . @ @ . . . . . @ . . @ @ @ @ @ . @ @ @ . @ . . @ . . @ . . . . . . . . . @ @ 
@ . . . . . . . . . . @ . @ @ @ @ @ . . @ . . @ . . @ . . . @ @ . @ . @ . @ . . . @ @ . . . @ . . @ @ . . @ @ . . . @ @ . @ . . . @ . @ . @ . @ . @ . @ @ . . . . . . @ . . @ @ @ . @ @ . @ @ . @ @ . @ 
@ . @ . @ . @ . @ . @ . . @ @ @ @ @ @ . . . @ . @ . @ . @ . . @ . . @ @ @ @ @ . @ @ . @ . @ . @ . . . @ . . . @ . @ . . . . @ @ . . @ @ @ @ . . . . . . . @ . @ . @ @ . . @ @ @ . . . . @ @ @ . . . . @ 
@ @ @ . . @ . . . @ . @ . . @ . @ . @ . @ . . . . @ @ @ . . @ . . @ . @ . @ . . . . . @ . @ . @ @ . @ @ @ . @ . @ @ @ @ . @ . . . @ . @ . . . @ @ . @ . @ . . . @ . . . @ @ @ @ @ . @ @ . . @ . @ . @ @ 
@ @ . . @ . @ . @ . . . . @ @ . . . . @ . . @ @ . . @ . @ . . @ . . . . . . @ . @ . @ . . . . . @ @ . @ . . . . . @ @ . . . . @ . @ . . @ @ . @ @ . . @ @ @ . @ @ @ . @ @ @ @ @ . . @ @ . @ . . . @ @ @ 
@ . . @ . . . . . @ @ @ . @ @ . @ . @ . @ . . . @ @ . . . . @ @ @ @ . @ . @ . . @ . . @ @ . @ . . . . . . @ . @ . . . @ . @ @ @ @ . . @ . @ . . . @ @ . @ . @ @ @ @ . . . @ . . @ . @ . . @ @ . @ @ @ @ 
@ @ @ . . @ . @ . @ . . . . @ @ . . . . . . @ . . . @ . @ @ . @ @ . . . @ @ @ . . @ . . . @ @ . @ . @ . @ @ @ @ . @ . . . . . @ @ . @ . . . @ @ . @ . . . . @ @ @ @ . @ @ @ . @ @ . . . @ @ @ @ @ @ @ @ 
@ @ . . @ . . @ . @ . @ . @ . . @ @ @ @ . @ . @ @ @ . . . . . . @ @ . @ @ . . . @ . . @ @ @ @ . . @ . . . . . @ @ . . @ . @ . . . . . . @ @ . @ . @ . @ @ . @ . . . @ @ @ . . . @ . @ @ . . @ @ @ @ @ @ 
@ @ @ @ . . @ . . @ . . @ @ . @ @ @ . . . . . @ @ . @ . @ @ . @ . @ . @ . @ @ . . @ . @ . @ . @ . . @ . @ . @ . . @ . . @ . . @ @ . @ . . . . . @ @ . @ . @ . @ @ . @ @ . @ . @ . . . . . @ @ @ @ @ @ @ 
@ . @ . @ . @ . @ . . @ @ . . . . @ @ . @ . @ . . . . . . . @ . . @ . . . . @ . @ . . . . . . @ . @ . . . @ @ . @ @ @ @ @ @ . . . @ . . @ . @ . . . . . . . . . @ . @ . . . . . . @ . @ @ @ @ @ @ @ @ @ 
@ . . . . . @ @ . . @ . @ @ . @ . @ . . . @ @ . @ @ . @ . @ @ . @ . @ . @ @ . . . @ @ . @ . @ @ @ @ @ . @ @ . . . @ . . @ @ . @ @ @ @ @ . . . @ . @ . @ . @ . @ @ . . . @ . @ . @ @ . . @ . . @ @ @ @ @ 
@ @ @ . @ . . . @ . . . . . . @ . . @ . @ @ @ . . . @ . @ . . . . . . . @ . @ . @ @ @ . . @ @ . . . . . . . @ . @ . @ . . . @ . @ @ @ . @ . @ @ @ . @ @ . @ . . @ @ . @ . @ @ . @ @ . @ @ @ . . . @ @ @ 
@ @ . @ . . @ @ . . @ @ @ @ @ . . @ @ @ . @ . @ . @ @ . . . @ . @ . @ . @ . . . . . . @ @ @ . . @ . @ . @ . . . . . . . @ @ @ . . @ @ . . . . . . . . . @ . . @ @ . . . . . . @ . @ @ . @ . . @ @ . @ @ 
@ . . @ @ . . @ @ . . . . @ . . @ . @ . . @ . . . . . @ . @ . @ @ . . @ @ . @ . @ @ @ @ @ . @ @ . . @ . . @ . @ @ . @ . @ . @ . @ . . @ @ . @ . @ @ . @ . @ . . . . @ . @ @ @ @ . . . . . @ . . @ . @ @ 
@ @ . @ . @ @ . . . @ . @ @ @ . . . . . @ . @ . @ . @ @ . . . . . @ @ . . @ . @ @ @ . @ . . . @ . @ . . @ . . . . @ @ . . . . . . . @ . . . . @ . . . . . . @ . @ . . @ @ @ @ @ . @ . @ . @ . @ . . . @ 
@ . . . . @ . @ @ . . @ . @ . . @ @ . @ @ . @ . @ . @ . . @ . @ . @ . @ . . . @ @ @ . @ @ . @ @ . @ . @ @ . @ . @ @ @ @ @ . @ . @ . @ @ . @ . @ . @ . @ . @ . . @ . @ . @ . @ . . . @ @ @ . . . @ . @ @ 
@ @ @ @ . . . . . . @ . . . @ . @ @ @ . . . . . @ . . @ . . @ @ . . . . . @ . @ @ @ . @ . . . . @ . . . @ . . @ @ @ @ . . . . @ . . . @ @ @ @ @ @ . . . @ . @ @ @ . . . . . . @ . @ . @ @ @ . @ . . . @ 
@ . . . . @ . @ . @ . @ . @ . @ . @ . @ @ . @ . @ . @ @ @ . . . @ @ . @ . . @ @ @ @ . . @ . @ @ . @ . @ @ . @ @ @ . @ . @ . @ . @ . @ . . @ . . . . @ . . . . . @ @ @ . @ @ . . . . . . . . . . . @ @ @ 
@ . @ . @ @ . @ . . . . . . . . . . . . @ @ . . . @ @ @ . @ . @ . . . . @ @ . . @ @ . @ . . . . . . . @ . . @ . @ . @ @ . . @ . @ . . . @ . @ . @ . @ . @ . @ . . . . @ . . . @ . @ . @ . @ @ . @ . . @ 
@ @ . . @ . @ @ . @ . @ . @ . @ @ @ . @ . @ @ . @ . . . . . . . @ . @ . . . @ . . . . . @ @ . @ . @ . @ @ . . . . . . . @ . @ . . . @ . . . . @ @ @ @ . @ . @ . @ . @ . . @ . . @ . . @ . . . @ . @ . @ 
@ @ @ . . . @ @ @ . . . @ @ . . . @ . @ . . . @ @ @ @ . @ @ . @ @ . @ . @ . . . @ @ @ . . . @ @ @ . @ . . . @ . @ . @ @ @ @ . . @ . @ . @ @ . @ @ @ . @ . @ @ @ . @ @ @ . @ . @ . @ . . @ . @ @ . @ . @ 
@ @ @ @ . @ @ @ . @ . @ . . . @ . @ @ @ . @ . . @ @ . . @ . . . . @ @ . @ . @ . . . . @ . @ . . @ . . @ . @ . @ @ . @ @ . . @ . . @ . . . @ . . . . . . . . . . . @ @ @ @ . . @ . @ . @ @ @ . . . . . @ 
@ @ @ @ @ . . . . . . . @ . @ @ . . . . . . @ . . . @ . . @ . @ . . . @ . . . @ . @ . . @ @ . @ @ @ . @ . . . @ . @ . @ . @ . @ . . @ . @ . . @ . @ . @ . @ @ . @ @ @ @ @ @ . . . @ @ . @ @ . @ @ . @ @ 
@ @ @ @ @ @ @ @ . @ . @ @ @ . . . @ @ . @ @ @ @ . @ . . @ @ . . @ . @ . @ . @ @ @ . @ . . . . @ @ @ . . . @ . . . . . . . . . . @ @ @ @ . . @ . . . @ @ @ . . . @ @ @ @ @ . @ . @ . . . . @ . @ . . . @ 
@ @ @ @ @ @ @ @ @ . . . . . @ . @ @ @ . . . @ . . . @ @ . . . @ @ . . . . @ . @ . . @ . @ @ . . @ . . @ . . @ . @ @ . @ . @ . @ @ @ @ @ @ @ . . @ . . @ @ @ @ . @ @ . @ . . @ . . . @ . @ . @ . . @ @ @ 
@ @ @ @ . @ @ @ . @ . @ . @ . @ . @ @ . @ . @ @ . @ . @ @ @ . . . @ . @ . . . . . @ . . . . @ . @ @ . @ @ @ . . . . @ @ . . @ . @ @ @ . . @ @ . @ . @ @ . @ @ . . . . . @ . . @ . @ . . . . . @ . . . @ 
@ @ @ @ . . . . . . . @ . . . . . . . @ @ @ . @ . @ . . . . . @ . @ @ . . @ . @ . @ @ . @ . @ . @ . . . @ @ @ . @ . . . @ . . . . . . . @ @ . . @ . . . . . . @ @ . @ . . . @ @ . . @ . @ . @ . . @ @ @ 
@ @ @ . . @ . @ . @ . . @ . @ @ . @ . @ . . . . . . @ @ . @ . . @ . . @ . . @ . @ . @ . . @ . @ . @ . @ @ . @ @ . . @ @ @ . @ . @ @ @ . . . @ @ @ @ . @ . @ . . . @ . . @ . @ . @ . @ @ . @ @ . @ . @ @ 
@ @ @ . @ . . @ @ . . @ . @ @ @ . . @ @ @ @ . @ . @ @ @ @ . . @ . . @ . . @ . . . . . . @ . . . . . . . . . . . @ . . . . @ @ . . @ @ . @ . . . @ . . @ . . @ @ @ . . @ . . . . @ . . . . . . . . . . @ 
@ @ . @ . . @ @ . . @ . . @ @ . . @ @ . . @ . . @ . @ @ @ @ . . @ . @ . @ . . @ . @ @ @ . @ . @ @ @ . @ . @ . @ @ . @ . @ @ @ @ . . . @ @ . @ @ @ @ . . @ . . . @ @ . . @ @ . @ @ @ @ . @ . @ . @ . @ @ 
@ . . . . @ . . . @ . @ . . @ @ . @ . . @ . . @ . . @ . @ . @ . @ . . @ @ @ @ . . . . . . . @ @ . . . . @ . . @ . . . @ @ @ . @ . @ . . . @ . . . . . @ @ . @ @ . . . @ @ . . . @ . . . . @ . . @ . @ @ 
@ . @ . @ @ @ @ . . . . . @ @ @ . . @ . . . @ . @ . . . @ . . . . . @ @ @ @ . @ . @ . @ . @ . . . @ . @ . @ . @ . @ . . . . . . @ @ . @ . . @ @ . @ . . . @ . @ . @ @ . . @ . @ @ @ @ @ . @ @ . @ . . @ 
@ @ . . . . . . @ . @ . @ . . . . @ . @ @ . . . . @ @ . @ . @ . @ @ . . . . . . . . @ . . @ . @ @ . @ @ . . . @ . @ @ . @ . @ . . . @ . . @ . @ @ . . @ . @ . @ . . . . @ . . . @ . @ @ . . . @ @ @ @ @ 
@ . . @ . @ . @ . . @ . . @ . @ . . . . @ . @ . @ . . . . . . @ . . @ @ @ @ . @ . @ @ @ @ @ . . . . . @ @ @ . @ . @ . . . @ @ . @ @ . @ . . . . . @ . . @ . . @ . @ . @ . @ . @ . . . . @ @ . @ @ @ @ @ 
@ @ @ . . @ @ @ @ . . @ . . @ . . @ @ . . @ . @ @ . @ . @ . @ . @ . @ @ @ @ @ @ . . . @ @ . . @ @ . @ @ @ . @ @ . . @ . @ . . . . . . . @ . @ . @ @ @ . @ . @ @ . @ @ . . . . . . @ . @ @ @ . . . @ @ @ 
@ @ @ @ . @ . @ @ @ @ . . @ . . @ @ @ . @ . . . . @ . . . @ @ . . . . @ @ @ . . . @ . . . @ . . @ @ @ @ @ . @ @ @ . @ . @ . @ . @ . @ . . @ @ @ . . . . . . . @ @ . . . @ . @ @ @ . . . @ . . @ . @ @ @ 
@ @ @ @ . . . @ @ . @ @ . . @ . . @ @ . . @ . @ . . @ . @ @ . @ @ . @ . @ . @ @ . . @ . @ . . @ . @ . @ . . . . . . . @ @ . @ . . @ . . @ @ @ @ @ . @ . @ . @ . @ @ . @ . . @ @ @ @ @ @ @ @ . . @ @ @ @ 
@ . . @ . @ . @ . . . . . @ . . @ . . . @ . . . @ . . @ . . . . . . . . . . . . @ . . @ . @ . . . . . . @ @ @ . @ . @ . . @ . . @ . @ . @ @ @ @ . @ . . . @ . . . . . . @ . . @ @ . . @ @ @ . @ . . @ @ 
@ @ . . @ @ . . @ @ . @ . . @ . @ . @ . @ . @ @ . @ @ . @ @ . @ . @ . @ . @ . @ . . @ @ . @ @ . @ @ . @ . . @ . . @ @ . @ . @ . . . . @ @ @ @ @ . @ @ . @ . . @ . @ . @ @ . @ @ . @ . . @ @ . @ . @ . @ 
@ @ @ . . . . @ . @ @ . . @ @ @ . . @ . . . . . . . . . . . . . @ . @ @ . @ . . @ @ . . . . . . . @ . . . @ . . @ @ . . . . . . @ @ @ @ @ @ @ . . . . . @ . @ . . @ @ . . . . . . . . @ . . . . . . . @ 
@ @ @ @ . @ . . . . . @ . @ @ . @ @ . . @ . @ @ . @ . @ @ . @ @ . . @ @ @ . @ @ @ @ @ . @ . @ . @ @ . @ . @ @ . . @ . @ . @ . @ @ @ @ @ @ @ . . @ . @ . . @ @ . @ . . . @ . @ . @ . @ . @ @ . @ . @ . @ 
@ @ . @ @ . . @ . @ @ . . . . . . . @ . . @ . . . . @ @ @ . . . . @ . @ @ . . . @ @ @ . @ . @ . . . @ . @ . . . @ . . . @ . . . . @ @ @ @ @ @ . . @ . . @ . . . @ @ . @ . . . @ . . . . . . @ . . . @ @ 
@ . . . . . @ . . @ . @ . @ . @ @ @ . . @ . @ @ @ . . . . @ . @ . . . @ @ . @ . @ . @ . @ @ . . @ . . . @ . @ . @ @ . @ @ @ . @ . . . @ @ @ @ @ @ @ @ . @ @ . @ . . . . @ . @ . @ . @ . @ @ . . @ @ . @ 
@ @ . @ . @ @ @ @ . . . . . @ @ @ @ @ . . . . . . @ @ @ . . @ . . @ . . . @ . . . . . . @ @ @ . @ . @ . . @ . . . @ @ @ . . . . @ . @ @ @ @ @ @ @ @ @ @ @ @ @ . . @ . @ @ . . . @ . . @ @ @ @ . . . . @ 
@ @ @ @ @ @ @ @ @ @ @ @ @ @ @ @ @ @ @ @ @ @ @ @ @ @ @ @ @ @ @ @ @ @ @ @ @ @ @ @ @ @ @ @ @ @ @ @ @ @ @ @ @ @ @ @ @ @ @ @ @ @ @ @ @ @ @ @ @ @ @ @ @ @ @ @ @ @ @ @ @ @ @ @ @ @ @ @ @ @ @ @ @ @ @ @ @ @ @ @ 
3
30 19 82 92
79 58 45 8
73 90 42 71
