10 10
@ @ @ @ @ @ @ @ @ @ 
@ @ @ @ @ . @ @ @ @ 
@ @ @ @ . . . @ @ @ 
@ @ . . @ . @ @ @ @ 
@ . @ . @ . . @ @ @ 
@ . . . . . @ . @ @ 
@ . @ . @ . . . . @ 
@ . @ @ . . @ . @ @ 
@ . . @ @ . . @ @ @ 
@ @ @ @ @ @ @ @ @ @ 
3
5 2 5 7
6 7 2 4
6 8 3 3
