10 10
@ @ @ @ @ @ @ @ @ @ 
@ @ @ @ @ . . . @ @ 
@ @ @ @ . @ . @ . @ 
@ @ @ . . . . . . @ 
@ . . . @ . @ . @ @ 
@ . @ . . @ . . . @ 
@ . @ @ . @ @ . @ @ 
@ . @ . . . . @ @ @ 
@ . . @ . @ . . . @ 
@ @ @ @ @ @ @ @ @ @ 
3
2 8 8 2
4 7 6 7
7 1 3 4
