25 25
@ @ @ @ @ @ @ @ @ @ @ @ @ @ @ @ @ @ @ @ @ @ @ @ @ 
@ @ @ @ @ @ . . . . . . . . . . . . . . . . . . @ 
@ @ @ @ @ @ @ @ . @ . @ . @ @ . @ . @ . @ . @ . @ 
@ @ @ @ @ @ @ @ @ @ . . @ @ @ @ . . @ . . @ @ @ @ 
@ @ @ @ @ @ @ @ . . . @ @ . @ . @ @ . . @ @ @ @ @ 
@ @ @ @ @ @ @ @ @ . @ @ . . . . . . @ . @ @ @ @ @ 
@ @ @ @ @ @ @ @ . @ . . @ . @ . @ . @ . @ . @ . @ 
@ @ @ @ @ @ . . . @ @ . . . . @ . . . . . . . . @ 
@ @ @ @ @ @ @ . @ @ . . @ . @ @ @ . @ @ . @ . @ @ 
@ @ @ @ @ @ @ . . . @ . . @ @ @ @ . . . @ @ . . @ 
@ @ @ @ @ @ @ . @ @ @ . @ . . @ . . @ . . . @ . @ 
@ @ @ @ @ @ @ . . . . . . . @ @ @ . . @ @ @ . @ @ 
@ @ @ @ @ @ @ @ . @ . @ @ @ @ @ . @ . @ . @ . @ @ 
@ @ @ @ @ @ @ @ @ . . . . @ @ . . . @ @ . . . @ @ 
@ @ @ @ @ @ @ @ . . @ @ . . . @ @ . . @ . @ @ . @ 
@ @ @ @ @ @ @ @ @ . . @ . @ . . . @ . . . @ @ . @ 
@ @ @ @ @ @ @ @ @ @ . @ . . @ . @ . @ @ . . . . @ 
@ @ @ @ @ @ @ @ @ @ . @ . @ . . . . . . . @ . @ @ 
@ @ @ @ @ @ @ @ @ @ . @ . @ @ . @ . @ . @ . @ . @ 
@ @ @ @ @ @ @ @ @ @ . . @ @ @ . @ . @ . . . @ . @ 
@ @ @ @ @ @ @ @ @ . @ @ @ @ @ . . @ . . @ @ . . @ 
@ @ @ @ @ @ @ @ @ . @ . @ @ @ . @ @ @ . . . @ . @ 
@ @ @ @ @ @ @ @ . . . . . . . . . . . @ @ . @ . @ 
@ @ @ @ @ @ @ @ @ @ . @ @ . @ @ . @ @ . . . . . @ 
@ @ @ @ @ @ @ @ @ @ @ @ @ @ @ @ @ @ @ @ @ @ @ @ @ 
3
18 23 11 8
8 7 5 15
15 12 15 15
