100 100
@ @ @ @ @ @ @ @ @ @ @ @ @ @ @ @ @ @ @ @ @ @ @ @ @ @ @ @ @ @ @ @ @ @ @ @ @ @ @ @ @ @ @ @ @ @ @ @ @ @ @ @ @ @ @ @ @ @ @ @ @ @ @ @ @ @ @ @ @ @ @ @ @ @ @ @ @ @ @ @ @ @ @ @ @ @ @ @ @ @ @ @ @ @ @ @ @ @ @ @ 
@ . @ . @ . @ @ . . @ . . @ @ @ @ . . . @ . . . @ @ @ @ @ . @ @ @ @ @ . . @ . @ @ . @ @ . . @ . . . @ @ @ @ @ @ @ @ . . @ . . @ . . @ @ @ @ @ . . @ . . @ . . . . . @ @ . . @ . . . @ . . @ @ @ . @ @ @ 
@ . . . . . . . @ . @ . @ @ @ @ . @ . @ . @ . @ . @ @ @ @ . . @ @ @ @ @ . @ . . @ . . . @ . . . @ . . @ @ @ @ @ @ . . @ @ . @ . . @ @ @ . @ . . @ . @ . . @ . @ @ @ @ @ @ . @ @ . @ . @ . . . @ . . @ @ 
@ . @ @ @ . @ . . . . . . @ . . . . . . . . . . . . . @ . . @ @ @ @ . . . @ . @ @ @ . @ . . @ @ . @ . @ @ @ @ . . @ . . @ . @ @ . . @ @ . . @ . . . @ @ . . . . . @ @ @ . . . . . . . . @ @ . . . @ @ @ 
@ . @ @ . . @ . @ . @ . @ @ @ @ @ @ @ @ @ @ @ . @ . @ . @ . @ . @ . @ @ . @ . . @ . . . @ . . @ . @ @ @ @ @ . . @ @ . @ @ . . @ @ . @ . @ . @ . @ @ . @ . @ . @ . @ @ . @ . @ . @ . @ @ . . . @ . @ . @ 
@ @ . . @ @ @ @ @ @ . . . @ . . . . @ . @ @ . . . @ . . . . . . . . . . . . . @ @ @ . @ . . @ . . . . @ @ . @ . @ . . . . . @ . . . . . . . . . . @ . . @ . . @ . @ . . . . . @ @ . @ . . @ . . @ @ . @ 
@ . @ . . . @ . . . @ . @ . @ @ @ . . . @ @ @ . @ . @ . @ . @ . @ @ @ @ @ @ . . @ . . . @ . . . @ . @ . . . . . @ @ . @ . @ . . @ @ . @ . @ . @ . @ . @ . @ . . @ . . @ @ . @ . @ @ . . @ . @ @ @ @ . @ 
@ . @ . @ @ . @ . @ . . . . @ . . . @ . @ @ . . . . . . . @ . @ . . @ . . @ . @ . @ . @ . . @ . @ @ @ . @ . @ . . . . . @ @ . @ @ . @ . . . @ . . . . . . . . @ @ @ @ . . . . . . . @ . @ . @ . @ @ . @ 
@ . . . . . . . . . @ . @ . . @ @ @ . . @ . @ . @ . @ . @ . . . . @ . @ . @ . . . . . . . @ @ @ . @ . @ . . . @ . @ . @ . @ . @ . . . . @ @ . @ @ . @ . @ . @ . @ @ . . @ . @ . @ . . . . . . . . . . @ 
@ @ @ . @ @ @ . @ . . . @ . @ @ @ . @ . @ . . @ . @ @ @ @ @ . @ . . . . . . . @ . @ @ @ . . @ . . . . @ @ . @ @ @ @ . @ . @ . . @ . @ . @ . . @ . . . @ @ . @ . . . @ . @ . . @ . . @ . @ @ . @ @ @ . @ 
@ . . @ . . @ . . @ . @ . . . @ . . . . . . @ . . @ @ @ @ @ . @ @ . @ . @ . @ @ @ . . . . @ . . @ . @ @ @ . . @ . . . . . . @ @ @ . . @ @ @ . @ . @ @ @ . @ . . @ @ . . @ . @ . @ . . @ @ @ . . . . @ @ 
@ . @ . @ . . @ @ . @ . @ . @ . @ @ . @ . @ . @ . . @ . @ . @ @ . . . @ . . @ . . @ @ . @ . . @ . @ @ @ . @ @ . @ @ . @ . @ @ . . . @ . @ . . . . . . . . . . @ @ . @ . @ . . . . @ . @ @ @ . @ . @ @ @ 
@ . . . . . @ @ . . . . . . . . @ @ @ . . @ . @ . @ . . . . @ @ @ . @ . @ @ . @ . @ @ . . @ . . . . . . . . . . . @ @ . . @ . @ . @ . . . @ @ . @ . @ . @ . @ @ . . . . @ . @ . @ . @ . @ . . . @ @ @ @ 
@ @ @ . @ . . @ @ . @ . @ . @ . . @ . @ . . . . . . @ . @ . . @ . @ @ . @ . . . . @ . . @ @ @ . @ @ . @ @ @ . @ @ @ @ @ . @ . . @ @ @ @ . . @ . @ . . @ @ . . @ @ . @ . @ . . @ . . . . @ . @ . . . @ @ 
@ @ @ @ . . @ . . @ . . @ . @ . @ . . . @ . @ @ @ . @ @ . . @ @ . . . . . @ . @ . . @ . . @ @ . . @ @ . @ @ . . @ @ @ . . @ . @ @ . . . @ . . . . @ . . . @ @ . @ @ . . . @ . . . @ @ . . @ @ @ @ @ . @ 
@ @ @ . @ . @ . @ . @ . . @ . . . @ . @ @ @ . . @ . @ . @ . @ . @ . @ . @ . @ @ @ . . . @ . . @ @ @ . . . . . @ . @ . @ . @ . . . . @ . @ @ @ . @ . @ @ . . . . . @ @ . @ . . @ . @ @ @ @ . . . @ . . @ 
@ @ . . . . . . @ . @ @ . @ @ @ . @ . . @ . . @ @ . @ . . . . . . . @ @ . . @ @ . @ @ . . . @ @ @ . . @ . @ . @ . . . . . . . @ @ . . @ . . . . . . . @ . @ . @ . . . @ . @ . . @ . @ . @ . @ @ . @ . @ 
@ @ . @ @ . @ . @ . . . @ . . @ . . . @ . @ . . @ . . @ @ . @ . @ . @ . . @ . . . . . . @ @ @ @ @ @ . . @ . . . @ . @ . @ @ @ @ . @ . @ @ . @ . @ . @ . . @ @ @ @ . @ . . . @ . . . . . . . . . . . . @ 
@ . @ @ @ @ . . @ . @ @ . @ . . @ @ . . . @ . @ . @ . @ @ @ . . . @ . @ . @ @ . @ . @ . @ . @ @ . @ . @ . . @ . @ @ @ @ . . @ . . . . @ . . @ @ @ @ . @ . . . . . @ . . @ @ @ . @ . @ . @ . @ . @ @ . @ 
@ . @ . @ @ @ . . . @ . . . . @ . . . @ . . . . . . . . @ . @ . @ . . . . . @ @ . @ . . . . . . . @ @ . @ . @ @ @ . @ . . @ . @ @ @ . . . @ @ . . . . . . @ . @ @ . @ . @ . . . . @ @ . @ . @ . . . @ @ 
@ . . . @ @ . @ . @ . @ . @ @ . @ . @ . . @ . @ . @ . @ . . @ . . @ . @ @ . . . . . . @ . @ . @ . . . . . . . . . . . @ . @ . @ . . . @ . . @ . @ . @ . @ @ . @ . . . . . . @ . @ . @ . . @ . . @ @ @ @ 
@ . @ . @ . . . . . . . . . . . . . @ @ . @ @ . . @ . . @ . . . @ . @ . @ . @ . @ . @ . . @ . . @ . @ . @ . @ . @ @ . . . @ . . @ @ @ . @ . . @ . @ @ @ @ . . . @ . @ . @ . @ @ @ . @ . @ . @ . . @ @ @ 
@ @ . . . . @ @ @ . @ . @ . @ . @ . . . @ . . . @ . @ . @ @ @ . @ . . . . . . @ . . @ . @ . @ @ . @ . . . @ @ @ . . @ @ . . . @ . @ . . . . @ @ . . @ @ @ . @ @ . @ . . @ @ . . @ . . . . . @ . @ . @ @ 
@ . . @ @ @ @ . @ @ . @ . . @ @ . @ @ . . @ . @ . . . . . . . . . . @ @ @ . @ . @ . @ . @ . . . . . . @ . . @ @ @ . @ . @ . @ . . . @ @ @ . . @ . @ @ @ @ @ . . . . @ . . . . @ @ @ . @ . @ @ @ @ . . @ 
@ . @ . @ . @ . . @ . . @ . @ . . . . @ @ . @ @ @ @ . @ . @ . @ . @ @ . . @ @ . @ @ . . . @ . @ . @ . @ . @ . . . . . . . . . @ . @ @ . . . @ . . . @ . @ . @ @ @ . . . @ @ @ @ @ . . @ . @ @ . @ . @ @ 
@ @ . . . . . . @ . . @ @ @ . @ . @ @ @ . . . @ . @ . @ @ . @ . . . . . @ . @ . . @ @ . @ @ @ . . @ @ . @ . @ . @ . @ . @ @ . . . . . @ . @ . @ . @ . . . . . . . . @ . . . . @ . @ . @ . @ . . . . . @ 
@ @ @ . @ . @ . . @ . . @ @ . @ . @ @ . @ . @ . . . . @ @ . . @ . @ @ @ @ . . @ . @ @ @ . @ . @ . @ . . . . . . @ . @ @ @ @ . @ @ @ . . . . . . . . . @ . @ @ . @ . @ @ . @ . @ . . . @ . . @ @ . @ @ @ 
@ @ @ . @ . @ @ . . . @ . . . . . . . . . . . . @ . @ . . . @ . . . @ @ @ @ . @ . @ . . . . . . . . @ . @ . @ @ . @ . . . . . @ . . . @ . @ @ . @ @ @ @ . . . @ . . @ . @ @ . @ . @ . @ . @ @ @ . . @ @ 
@ . . . . @ @ . @ @ . . . @ @ @ . @ . @ . @ . @ . . @ @ @ . @ @ . @ . @ . . . . . . . @ . @ . @ . @ @ @ . . @ @ . . . @ . @ . @ @ . @ . . @ . . . . @ . . @ . @ @ . @ . . . @ @ @ . . . @ @ @ . . @ @ @ 
@ . @ . @ @ . . @ . . @ @ . . . . . @ . . . @ . . @ . . . . . . . @ . @ @ . @ @ . @ . . @ @ @ . . @ @ . @ . . . @ . @ . . @ . . . @ . @ @ . . @ @ @ @ @ . . @ . . @ . @ . @ . @ . . @ @ . @ . @ . @ @ @ 
@ . . @ . . @ . @ @ . . . @ . @ . @ @ @ . @ . @ @ . . @ . @ . @ . . . . @ . . . @ . . @ . . . @ . @ . . . . @ . . @ . . @ . . @ @ . . @ @ @ @ . . . . . . @ @ @ . @ . . . @ . @ @ . . . . . . . . . . @ 
@ . @ @ @ . . . @ . . @ . . @ . . @ . @ . . . . @ @ @ . @ . . @ . @ . @ . . @ @ @ @ . @ @ @ . @ . . @ . @ . . @ . . @ . . @ . @ @ @ . @ . @ . . @ . @ . @ @ . . . . . @ . . . . . . @ @ . @ . @ . @ . @ 
@ @ . @ . @ . @ @ . @ @ . @ . . @ . . . . @ . @ . . . . @ . @ . . . @ @ @ @ . @ @ . @ . @ . . . @ @ @ @ . . @ @ . @ @ @ . . @ @ @ @ . . . . @ . . @ . . @ @ @ . @ . @ @ @ . @ . @ . . . @ @ @ @ @ . @ @ 
@ . . . . . . . . . @ . @ . @ . . @ . @ . . @ . . @ @ . @ . . @ . @ . @ . . . . . . . . . . @ . @ . @ . @ . . . @ . @ . . @ @ @ @ . . @ @ . . . @ @ @ . . . @ @ . . @ @ @ @ @ @ . . @ . . @ . . @ . . @ 
@ @ . @ . @ . @ . @ . . . . . . @ @ @ . . @ @ @ . @ . @ @ . @ @ . . . . @ @ . @ . @ . @ @ @ @ . @ . . . . . @ . . . . @ . . . @ @ @ @ . . @ . @ . . . . @ . . . @ . . @ @ @ @ @ @ . @ . @ @ @ . . . @ @ 
@ . @ . . @ . @ @ . . @ . @ @ . . . @ @ . @ @ . . . . . . . @ @ . @ . @ @ @ @ . @ . @ . @ . @ . . . @ . @ . . @ . @ @ . @ . @ @ @ . @ . @ . @ . . @ . @ . . @ . @ . @ @ @ @ @ @ @ . . @ . @ . @ @ . . @ 
@ . . @ @ . . . @ @ . @ @ . . . @ @ . . @ . . . @ . @ . @ @ . . . . @ @ @ @ . . @ . @ . @ . @ . @ . @ @ . . @ @ @ @ . . . @ . . . . . . . . . . @ @ @ @ @ . . @ . . @ @ . @ @ @ @ . @ . . . . . . . @ @ 
@ @ . @ . @ . @ @ . @ . . . @ . @ @ . @ . @ @ . . @ @ @ . . . @ . @ @ . @ . @ . . . . . . . . . . @ @ . @ . @ . @ . @ . @ @ @ . @ . @ . @ . @ . . @ @ @ @ @ . . @ . . . . . . @ . . @ . @ @ . @ @ . . @ 
@ . . . . @ . @ . . . . @ . @ @ . . . . . . . . @ @ @ @ . @ . @ @ @ . . . . . @ . @ @ . @ . @ . @ . @ . . . . . . . . . . @ . @ . @ . . . @ . . @ @ @ @ . @ . @ @ . @ . @ . @ @ @ . . . . @ . . @ . @ @ 
@ @ @ @ . . . @ . @ @ . . @ . . . @ @ @ . @ @ . . . @ @ . @ . . @ . . @ . @ . @ @ . . . @ @ @ @ . . . . @ . @ @ @ @ @ . @ . . . . . . @ @ . @ . . @ . . . . . . . @ . . . @ @ @ @ @ . @ @ @ @ @ . @ @ @ 
@ . . . . @ . . @ . . . @ . @ . @ . . . . . . @ . @ . . @ . . @ @ @ @ . @ . . . . . @ . . . . @ . @ . @ . . . . . . . @ . . @ . @ @ . @ . . . . @ @ @ @ . @ . @ . @ @ . @ @ @ @ @ . . @ . @ . . . . @ @ 
@ @ . @ . . @ @ @ @ . @ @ . @ . @ @ . @ @ @ . @ @ . @ . . @ . @ @ @ . . . . @ . @ . . @ . @ @ @ @ @ . . @ . @ . @ . @ @ @ @ . . @ . . @ . @ @ . . @ @ @ @ . . . @ @ @ @ @ @ @ @ @ @ . . . . . @ . @ . @ 
@ . @ . . @ @ . @ . @ . . . @ . . . @ . @ . @ @ . . . . @ @ @ . @ @ @ . @ @ . . @ . @ @ . . @ @ @ @ @ @ . . @ . @ @ @ @ @ @ @ . @ . @ . . . @ . @ . @ @ . . @ . @ @ @ @ @ @ @ @ @ . @ . @ . @ @ . . . @ 
@ . . . @ @ . . . . . . @ . @ @ . @ . . . . . . @ @ @ . . @ . . . @ . @ . . . @ . . @ @ @ @ @ @ @ @ @ @ @ . @ @ . . @ @ @ @ . @ . . @ @ . @ . . @ . @ . @ . @ . . . @ @ @ @ @ @ @ . . . . @ @ . . @ . @ 
@ . @ . . . @ . @ . @ . @ . . . @ . @ . @ . @ . @ . @ . @ . @ . @ . . @ . @ . @ . @ @ @ . . @ . . . . . . . @ . @ . . @ @ @ . . . @ . . . . @ . . . @ . . . @ . @ . . . @ @ @ @ . . @ . @ @ . @ . . @ @ 
@ @ . . @ @ . @ . . . @ . . @ . . . . . @ @ . . . . . . . . . . . . @ @ @ . . . @ . @ . @ . @ . @ . @ . @ . @ . . . @ . @ . @ . @ . . @ . @ . @ . @ @ @ @ . @ . @ @ . @ @ @ @ @ @ . @ @ . . . . . @ @ @ 
@ @ @ . . . . . @ . @ . @ . @ . @ . @ . . @ . @ . @ . @ . @ . @ . @ . @ . @ @ @ . . . . . . . @ . @ . @ . @ . @ @ . @ . . . . . @ @ . @ @ . . . . . @ . . . @ . . @ . . @ @ @ @ @ @ . . @ . @ @ . . @ @ 
@ . . . @ . @ @ @ @ @ . @ @ . @ . . . @ @ @ . . @ . . . @ @ @ . . . . . . . . . . @ . @ . @ . . . . . . . . . . . . . . @ @ . @ . . . @ . . @ . @ @ @ . @ @ . . @ @ . @ @ @ @ . @ @ @ . . @ . . . @ @ @ 
@ . @ . . @ . . @ @ . . . @ . . @ . @ . . . @ @ . @ . @ @ @ @ . @ @ . @ . @ . @ . @ @ . . @ @ . @ @ . @ . @ @ . @ @ . @ . . . @ . @ . @ . @ . . . @ @ @ @ @ @ . . . @ . . @ . . . @ . @ . @ @ . @ @ @ @ 
@ . . @ @ @ @ . . @ @ . @ . @ . @ @ @ @ . @ . . . @ @ . @ . @ . . @ @ . . @ . @ @ . . @ @ @ . . @ @ . . @ . . . . . @ . . @ . @ @ . . . @ @ @ . @ @ @ @ @ @ @ . @ @ @ . @ . @ . @ . . . . . . @ @ @ @ @ 
@ @ . @ . @ . . @ @ @ . @ . . . @ . @ @ . . @ . @ . @ . @ . . . @ @ . @ . @ @ . @ @ . . . . . @ . . . @ @ @ @ . @ . @ . @ . . . @ @ . @ . . . . . @ @ @ @ @ . . . . . . . . . . . . @ . @ . @ @ @ @ @ @ 
@ . @ @ . . @ . . @ . . . @ @ . . . . . @ . . . . . . . . . @ @ . . . . . . @ . . . . @ . @ . . @ . @ . @ . @ . @ @ . @ . . @ . . . @ @ @ @ @ . @ . @ @ @ @ @ . @ @ . @ . @ . @ . @ @ . . @ @ @ @ @ @ @ 
@ . . . . @ . . @ . @ . @ . . . @ . @ . @ @ . @ . @ . @ @ . . . @ . @ . @ . . @ . @ . @ @ @ @ @ . . . . . . . @ . . . . . @ . . @ @ . @ . . . . . . . @ @ @ . @ @ . . . @ . . @ . @ . @ @ @ @ @ @ @ @ @ 
@ @ . @ . . . @ . . . . . . @ . . @ . . . . . . @ . . @ . @ . @ . @ @ @ . . @ . . . @ . @ . @ @ @ . @ . @ . @ @ @ . @ @ @ . . @ . @ . . @ . @ . @ . @ @ @ . . . . @ . @ @ @ @ @ . . . . . @ @ @ @ @ @ @ 
@ @ @ @ . @ . . @ . @ . @ . @ @ @ . . @ . @ . @ . @ . @ . . . @ . . @ . @ . . @ @ . @ . . . . @ . . . @ . . @ @ @ @ @ @ . @ . . . . . @ . @ . . . @ . . @ @ . @ . . . . . . . . @ . @ . @ @ @ @ @ @ @ @ 
@ . @ . @ . . @ . @ . . @ . . . . @ . . @ @ . . . . @ . . @ . . . @ @ . . . @ . @ @ . @ @ . @ . @ . @ . @ . @ @ @ @ @ . . . . @ . @ . @ . . @ . @ @ . @ . @ @ . . @ . @ . @ . @ @ . . @ @ @ @ @ @ @ @ @ 
@ . . . . @ . . . . . @ . . @ . @ @ @ . @ . . @ @ @ @ . @ . . @ @ . . @ @ . . . . @ . . . . . . . . . . . @ . @ . @ . @ . @ . . @ . . @ . @ @ . . . . . . . @ @ @ . . . @ @ @ . . . @ . @ @ @ @ @ @ @ @ 
@ @ . @ . . . @ . @ . . @ . . @ @ @ . @ @ . @ @ @ . @ . . @ . @ . @ . @ . . @ . @ . @ . @ . @ . @ . @ @ . . . . . . . @ @ . . @ @ @ @ . . . @ @ . @ @ . @ @ @ . . @ . @ @ @ @ @ @ . . . . @ @ @ @ @ @ @ 
@ . . @ . @ . @ @ @ @ . @ @ . . . . . . . @ @ @ . . . . @ @ . @ . . . . . @ @ . . . . @ @ @ . @ . @ . @ . @ . @ @ . @ @ @ @ @ @ . . @ . @ . . . . . . @ @ @ . @ . . . . @ @ @ . . @ @ @ @ @ @ @ @ @ @ @ 
@ @ . . @ . . . . @ @ @ . . . @ . @ @ . @ @ @ @ . @ . @ . . . . @ . @ . @ . @ @ . @ . @ @ @ . @ . . . . . . @ @ @ @ . @ @ @ . . @ . . @ @ @ . @ . @ . @ @ . . . . @ . @ . @ . @ . @ . @ @ @ @ @ @ @ @ @ 
@ . @ @ . @ . @ @ . @ . @ @ . . @ @ @ . . @ @ @ @ . . . @ . @ @ @ @ . . . . @ . . . @ @ @ . . . . @ . @ . @ @ @ @ @ . @ @ . @ . @ . @ @ @ . @ . . . @ . . . @ @ @ . . @ . @ . . . . . . @ @ @ @ @ @ @ @ 
@ . . . . . . . @ . . . . . . @ . @ . . @ . . @ . @ . @ @ . @ . @ . @ . @ . . @ . @ . @ . . @ @ . . @ . . . @ @ @ . . @ . . . . . . . @ . . . . @ . @ @ @ . . . . @ . . . . . @ . @ . @ . @ @ @ @ @ @ @ 
@ . @ @ . @ . @ . @ . @ . @ . . . . @ . . . @ . . . . @ @ . @ . . . . . . @ @ . @ . . . @ @ @ @ @ @ . . @ @ @ . . @ . . . @ . @ . @ . . @ . @ . @ . @ . @ . @ . @ @ @ . @ . @ . . @ . . . . @ @ @ @ @ @ 
@ @ . . . . @ @ . @ @ @ @ . . @ . @ . @ . @ @ . @ . @ . @ . . @ . @ . @ . @ . . @ . @ @ . @ . @ . . . @ . @ . @ . . @ . @ . . . @ @ @ @ @ @ @ @ . . . . . @ . @ @ . . @ @ @ . @ . . @ . @ @ @ @ @ @ @ @ 
@ . . @ . @ . . . . @ @ @ @ @ . @ @ . . . . @ @ . . . . @ @ . @ @ . . @ . . @ . . . . . . . . . . @ . . . @ . . . @ @ @ . @ . @ @ @ . . @ @ @ @ @ . @ . @ . . @ . . @ . . . . . . @ @ . @ @ @ @ @ . @ @ 
@ . @ . @ . @ . @ . @ . . . . . @ @ @ . @ . @ @ @ @ . @ @ @ . @ . @ . @ . @ @ @ . @ . @ @ . @ . @ . . @ . . @ @ . . . . . . . . . . . @ @ @ @ . . . @ @ @ . @ . @ . @ @ . @ . @ @ . . . . @ @ @ . . . @ 
@ . . . . . . @ @ . . . @ @ . @ @ @ @ . . @ @ . . . . @ @ . @ . . @ . @ @ . . @ @ . . @ . . . @ . . @ . @ @ . @ . @ . @ . @ . @ . @ . @ . @ . @ @ . . . . . . . . . . . @ . . . . @ @ . @ . @ . @ . @ @ 
@ . @ @ . @ . @ . @ @ . . @ @ @ @ @ @ . @ . @ @ . @ . @ . . @ @ . . . @ @ @ . @ . . @ @ @ . @ @ @ . . . @ @ . . . . @ . . @ @ . @ . . . . . . . . . @ . @ . @ . @ @ @ . @ @ @ . @ . . . . . . . . . . @ 
@ @ . @ @ @ @ @ . @ . @ . . @ @ @ @ @ @ @ . . @ . . @ . @ . . @ . @ . @ @ . . @ @ . . @ @ . @ . . . @ @ . . @ @ . @ @ . @ . . . . . @ . @ . @ . @ . . @ . . @ . . . . @ . . @ . . @ . @ . @ . @ . @ . @ 
@ . . @ . . . . . . . . . @ @ @ @ @ @ . . @ . . . @ . . . . @ @ @ . . @ @ @ . . . . @ . . @ . . @ . @ @ @ . @ . @ @ . @ . . @ . @ . . @ . . . @ . . @ @ @ . . @ . @ . . . @ . . @ . . @ . . @ . . @ . @ 
@ @ . . @ @ . @ . @ . @ . . @ . . @ . . @ @ . @ . . @ . @ . @ . @ . @ @ @ @ . @ . @ @ . @ . @ . @ @ @ . . . . . . . . . . @ . @ . @ @ . @ . @ . @ . . . . @ @ @ . . @ . @ . @ . . @ . @ . @ @ @ . . @ @ 
@ . @ . . @ @ . . . @ . . @ . . @ . @ . @ . @ . . @ . @ . . . . . . . . @ . . . @ . . . . . . @ . . . . @ @ @ . @ . @ @ . . . . . . . . . @ @ . . @ . @ . . . . @ . . @ . . . . @ . . @ . @ . . . @ . @ 
@ . @ . @ . @ @ . @ . @ . . @ . @ . @ . @ . @ @ . . . @ @ . @ . @ . @ @ @ . @ @ @ @ @ @ @ @ . . . @ . @ . . . . @ @ . . . @ @ . @ . @ . @ @ @ @ . . . . @ . @ @ @ . @ @ . @ @ . . @ @ @ @ . . @ . . . @ 
@ . . . . . . . . . . . @ . . . . . . . . . . . . @ . @ . . . @ . . @ . . . @ @ . . . . . . . @ . . @ . . @ . @ . . . @ . @ @ . @ . . @ @ @ @ @ @ . @ . @ . . . . @ @ . . @ @ @ . . . @ @ @ @ . . @ . @ 
@ . @ @ . @ . @ . @ . @ @ @ . @ . @ . @ . @ . @ . @ . . @ . @ @ @ . . @ . @ @ . . @ . @ @ . @ . . @ . . @ @ . @ @ . @ . . . . @ . . @ @ @ @ @ . @ . @ @ . . @ @ . @ @ @ . @ . . @ @ . . . . . @ . . @ @ 
@ . @ . . @ @ . . . @ @ @ @ @ . . . @ . . @ @ . . . @ . @ @ . . . . @ . @ . . . @ @ @ . . . . @ . @ @ . @ @ @ . . . . @ @ . @ @ @ @ @ @ @ . . . . . . @ @ @ . @ . @ @ @ . . @ . . . . @ . @ @ . . @ @ @ 
@ . @ . @ . . . @ . . @ @ @ @ @ . @ . @ . . . @ . @ @ @ . . @ @ @ . . . @ @ . @ . . . . @ . @ @ @ . . . . @ . . @ . @ . . . @ @ @ @ . @ . @ @ . @ . @ @ . @ . . . @ . @ @ @ @ @ . @ . . @ . . @ @ @ @ @ 
@ @ @ @ @ . @ . @ . @ @ @ @ @ @ @ . . . . @ @ . . . @ @ . @ . . . . @ @ @ @ . . @ . @ . . @ . . . . @ . @ @ . @ . . @ . @ . . @ @ . . . . . . @ . . . @ . @ @ @ . . . . . @ @ @ @ . . @ . @ . . . @ @ @ 
@ . . @ . @ . . @ . @ @ @ @ . @ . @ . @ . @ . @ . @ . . . . @ . @ . @ . @ @ @ . @ @ @ @ . . @ . @ . @ . . @ . . @ . . @ . . @ @ . @ . @ @ . @ @ @ . @ . . . @ . @ . @ . @ . @ . . @ . @ . . . @ @ @ @ @ 
@ @ . . . . . @ . @ . . @ . . . . . . @ . @ . . @ . @ @ . @ . . @ . . . @ @ @ @ . . . . . @ @ . @ @ . . @ @ . @ @ . @ . @ . . . . . . . @ . . @ . . . . @ @ @ . @ . @ . . . . . @ . @ . . @ @ . . @ @ @ 
@ @ @ . @ @ @ @ . . @ . . . @ . @ . @ . . @ . @ @ . . . . . . @ @ . @ . . @ @ @ @ . @ @ . @ @ . . @ @ . . @ . . @ . . . @ @ . @ . @ . @ . @ @ . @ . @ . . . . . . @ @ @ . @ @ . @ . @ . @ @ @ . @ . @ @ 
@ @ @ @ . . . @ @ . . @ . @ . . @ . @ @ . . . . . @ . @ . @ . . @ . @ @ @ @ @ @ @ @ . @ @ @ @ . @ . @ . @ @ . @ @ @ . @ . . . . @ . . @ . @ . . . . . @ . @ . @ @ . . . @ . @ . . . . . . . . . . . @ @ 
@ . . . . @ . . . . @ @ . @ @ . @ @ . . . @ . @ @ . @ . @ . . @ . @ . @ @ @ @ @ @ @ . . @ @ . @ . . . . @ @ . @ @ . . @ . @ . @ . @ . . . . @ @ . @ . @ . . @ . @ . @ @ . . . . @ . @ . @ @ . @ . @ . @ 
@ @ . @ . . @ @ @ . @ . . . @ @ . . . @ . . @ @ . . . . . @ . . . . . @ @ @ @ @ @ @ @ . . @ . . . @ . @ . . . @ . . @ . . . @ . . . . @ . @ @ @ . . @ @ @ . . . . . . @ @ . @ @ . . . @ . . . @ . @ . @ 
@ @ . . @ @ . . . . . . @ @ . . @ . @ @ @ @ @ . . @ . @ . . . @ @ . @ . @ @ . @ . @ . . @ . @ @ @ @ @ . . @ . . @ . @ . @ . . @ @ @ . @ . @ @ . @ @ . . . . @ @ @ . @ . . @ @ . @ . @ @ . @ . . @ . . @ 
@ @ . @ @ . . @ . @ . @ . . @ . @ @ . . . . . . @ . . . @ . @ @ . . @ . . . . . . . @ . @ . @ . . @ @ . @ @ @ . @ . @ . @ . @ . @ . . . @ @ @ . @ @ @ . @ . . @ . . . . @ . . . . @ @ @ @ . . @ . @ . @ 
@ @ @ @ @ @ . . @ . . @ @ . . . . . . @ @ . @ . @ @ . @ @ . . . @ . . . @ @ @ . @ . . . . . @ . @ @ @ @ @ @ @ . . @ . @ @ . . . . @ @ @ @ @ @ . . @ @ . @ . @ . @ @ @ . . @ . @ . @ @ @ @ @ . . . . . @ 
@ @ @ @ . @ . @ @ . @ . . . @ . @ . @ . . . @ @ . . . @ @ @ . @ @ @ @ . . . . @ @ . @ @ . @ . . . @ @ @ @ . @ . @ . . . . . @ . @ @ . @ @ @ . @ . . . @ . . . . . @ @ . @ . @ . . . @ @ @ . . @ . @ . @ 
@ @ @ . . @ @ . @ @ . . @ . . @ . @ @ . @ . @ @ . @ . . @ . . . . . @ . @ @ @ @ . @ . @ @ . @ . @ @ @ @ . . @ @ @ . @ @ @ . . @ . . . . . . . @ @ . @ . @ . @ @ . @ . . . . . @ . @ . @ @ @ . . @ . . @ 
@ @ @ @ . . @ . @ @ . @ . . @ . . @ . . . @ . @ @ . . @ . @ . @ @ . @ . . . . . . . . . . . . . . . @ @ . @ . . . . @ . @ . @ . @ . @ @ . @ . . . . . . . . . @ @ @ @ @ . @ . . . . . . . @ . @ . @ . @ 
@ @ @ . . @ . . . @ . @ @ . . . @ . @ @ . @ . . @ . @ . . . . . . @ @ @ . @ . @ . @ @ . @ . @ @ . @ @ . . . . @ . @ . . . . . . . @ @ . . @ @ . @ . @ . @ . @ . @ @ @ . . . @ @ @ . @ @ . @ . . . . @ @ 
@ @ . @ . . @ . @ @ @ . . . @ @ @ . . . @ . . @ @ . . @ . @ . @ . . . @ . . @ . . . . @ . . . . @ @ . . @ . @ . . @ @ . @ . @ @ @ @ @ @ @ . . . . @ . @ . . . . . . @ @ . @ @ . . . . . @ @ @ . @ . . @ 
@ . . . . @ . . . . . . @ . . . @ . @ . @ @ . . . . @ @ @ . . . @ @ . @ . @ . @ . @ . . @ @ . @ . @ @ @ . . . @ @ . . . @ . . @ . @ @ . . . @ . @ . . . . @ . @ @ . . @ . . . @ @ . @ @ @ @ @ . . @ . @ 
@ @ . @ . . . @ . @ @ . . @ @ @ @ @ . . . . . @ @ . @ @ . @ . @ . . . @ . . . . @ @ . @ @ @ . . . . @ @ @ . @ . . @ . @ @ @ . @ . . . . @ . . @ @ @ . @ . @ @ . . @ . @ @ . @ @ . . . . . . @ . @ @ . @ 
@ . @ . @ . @ . @ . . . @ . @ @ @ @ @ . @ @ . @ . @ . . . . . . @ . @ . . @ . @ @ . @ @ . . . @ . @ . @ . @ @ . @ @ . @ @ . . @ . @ . @ @ @ . @ @ . . . @ @ . . @ . @ . . . @ . @ . @ . @ . @ @ @ @ @ @ 
@ . . . . . . . . @ @ . . . . @ @ @ @ @ . . . @ . . . @ . @ . @ . . . @ . . @ . . . . @ . @ . . @ @ . . . @ @ . . @ . . . @ . . @ . . . @ @ @ @ @ @ . @ . . . @ . . . . @ . . . . @ . @ @ . . . @ @ @ @ 
@ @ @ . @ . @ . @ @ @ . @ . @ @ @ @ @ @ @ . @ . . @ @ . . . @ @ . @ @ . . @ . . @ @ . @ @ . . @ . . . @ @ . . @ . @ . @ @ . . @ @ @ . @ . @ . @ . . . @ . @ @ . @ @ . @ . . @ . @ . . @ . @ . @ . @ @ @ 
@ . . . . @ @ @ @ @ . . . @ @ @ @ @ . @ . . @ @ . @ @ @ . @ @ @ . @ . . @ @ @ . @ . . . . . @ . @ . @ . @ . @ . . . . . . @ . . @ . @ . . . . . . @ . . . . . . . . @ . @ . . @ @ @ . . . . . . . . @ @ 
@ . @ . @ @ @ @ @ @ @ . @ @ @ @ . . . . . @ . . . @ @ . . . . . @ @ @ . . @ . . . @ @ . @ . . . . . . . . . . @ @ . @ . @ @ . @ . . . . @ . @ . @ . . @ . @ @ . @ . . . . @ @ @ @ @ @ . @ @ . @ . @ @ @ 
@ @ @ @ @ @ @ @ @ @ @ @ @ @ @ @ @ @ @ @ @ @ @ @ @ @ @ @ @ @ @ @ @ @ @ @ @ @ @ @ @ @ @ @ @ @ @ @ @ @ @ @ @ @ @ @ @ @ @ @ @ @ @ @ @ @ @ @ @ @ @ @ @ @ @ @ @ @ @ @ @ @ @ @ @ @ @ @ @ @ @ @ @ @ @ @ @ @ @ @ 
3
40 92 86 17
67 11 20 60
41 92 69 40
