12 12
@ @ @ @ @ @ @ @ @ @ @ @ 
@ . @ . . . . . @ @ @ @ 
@ . . . @ . @ . . @ @ @ 
@ @ . @ . . @ . @ . @ @ 
@ . . @ @ . @ @ . . . @ 
@ @ @ . . . @ . @ . @ @ 
@ @ @ @ @ . . . . . . @ 
@ @ @ . @ . @ @ . @ . @ 
@ . . . . . @ @ . . @ @ 
@ @ . @ @ . . . @ . @ @ 
@ . . . . @ . @ . . @ @ 
@ @ @ @ @ @ @ @ @ @ @ @ 
3
2 8 10 4
4 1 6 6
1 7 4 2
