25 25
@ @ @ @ @ @ @ @ @ @ @ @ @ @ @ @ @ @ @ @ @ @ @ @ @ 
@ . . @ . . @ @ . . . @ @ @ @ @ @ @ @ @ @ @ @ @ @ 
@ . @ . @ . @ . @ . @ @ . @ . @ . @ @ @ @ @ @ @ @ 
@ . . . . . . . . . . . . . . . . . @ @ @ @ @ @ @ 
@ @ . @ . @ . @ . @ . @ . @ @ . @ . @ @ @ @ @ @ @ 
@ @ @ . . . @ . . . @ . . @ @ @ . . @ @ @ @ @ . @ 
@ . @ @ . @ @ @ . @ . @ . @ @ . @ . . @ @ @ . . @ 
@ . @ . . @ @ . . . . . @ . . . . . @ . @ @ . @ @ 
@ . . . @ . . . @ . @ . . @ @ @ @ . . . . . . . @ 
@ . @ . @ @ @ . @ . . @ . @ . @ . @ . @ . @ . @ @ 
@ . @ @ @ . . . @ @ . . @ . . . . . . . @ . . . @ 
@ . @ @ . @ . @ @ . @ @ . @ . @ . @ . @ . @ . @ @ 
@ @ . . . . . @ . . . . . . . @ @ . . . . . @ @ @ 
@ . . @ . @ . . @ . @ @ @ . @ @ . @ @ . @ @ . @ @ 
@ @ . @ @ . . @ . . . . . @ @ . . . . . . . . . @ 
@ @ . @ . @ . @ . @ . @ . @ @ . @ . @ . @ . @ @ @ 
@ @ @ . . . . @ @ . . . @ . . @ . . . @ . . @ @ @ 
@ . . . @ . @ @ . @ . @ . . @ . . @ . . @ . @ @ @ 
@ @ @ . . @ . . . . . @ . @ . @ . @ . @ . . . @ @ 
@ @ . @ @ @ @ . @ . @ . . . . . . @ . @ @ . @ . @ 
@ . . . . . . . . @ @ @ . @ . @ . . @ . . . @ . @ 
@ @ . @ @ . @ @ . . @ @ @ . . @ . @ @ . @ . . . @ 
@ @ @ . . . . @ . @ . @ . . @ . . @ @ @ . . @ . @ 
@ . . . @ . @ . . . . . @ . @ @ . . @ @ @ . . @ @ 
@ @ @ @ @ @ @ @ @ @ @ @ @ @ @ @ @ @ @ @ @ @ @ @ @ 
3
21 19 7 8
15 19 22 20
18 16 4 6
