10 10
@ @ @ @ @ @ @ @ @ @ 
@ . @ . @ . @ @ @ @ 
@ . . . . . @ @ @ @ 
@ @ @ . @ . . @ @ @ 
@ @ @ . @ @ . . @ @ 
@ @ @ @ . . @ . @ @ 
@ @ @ . @ . @ . . @ 
@ @ . . . . . . @ @ 
@ @ @ . @ @ . @ @ @ 
@ @ @ @ @ @ @ @ @ @ 
3
6 7 3 5
2 3 7 7
5 4 6 5
