20 20
@ @ @ @ @ @ @ @ @ @ @ @ @ @ @ @ @ @ @ @ 
@ @ . @ . @ . @ . @ . @ . @ . @ . . @ @ 
@ . . . . . . . . . . . . . . @ . @ . @ 
@ @ . @ . @ @ . @ . @ @ . @ . @ . . . @ 
@ @ @ . . @ @ @ . . . . @ . . @ . @ . @ 
@ @ @ @ @ . @ . @ . @ . . @ . . @ . . @ 
@ . @ . . . . . . @ @ @ @ . . @ . @ . @ 
@ . . @ . @ . @ . @ @ . . @ . . . . . @ 
@ @ . . @ @ @ . . @ . . @ . . @ @ @ . @ 
@ . . @ . @ . @ . @ . @ . @ . . @ @ @ @ 
@ @ . . . . . . . . . . . . . @ @ @ @ @ 
@ @ @ . @ . @ . @ @ @ . @ @ . @ @ @ @ @ 
@ @ @ @ @ @ . . @ . . . . @ . . @ @ @ @ 
@ @ @ @ @ . @ @ . . @ . @ . . @ . @ . @ 
@ @ @ @ @ . . . . @ . . . @ . . . . . @ 
@ @ @ . . @ @ . @ @ . @ . @ @ . @ . @ @ 
@ @ . @ . @ . . . @ . . @ . . . . @ @ @ 
@ . . . . . . @ @ @ @ . @ . @ . @ @ @ @ 
@ . @ . @ . @ @ @ @ @ . . @ . . . @ @ @ 
@ @ @ @ @ @ @ @ @ @ @ @ @ @ @ @ @ @ @ @ 
3
13 16 2 1
13 11 9 2
6 13 13 14
