100 100
@ @ @ @ @ @ @ @ @ @ @ @ @ @ @ @ @ @ @ @ @ @ @ @ @ @ @ @ @ @ @ @ @ @ @ @ @ @ @ @ @ @ @ @ @ @ @ @ @ @ @ @ @ @ @ @ @ @ @ @ @ @ @ @ @ @ @ @ @ @ @ @ @ @ @ @ @ @ @ @ @ @ @ @ @ @ @ @ @ @ @ @ @ @ @ @ @ @ @ @ 
@ @ @ @ @ . @ . @ . . @ @ @ . @ @ . . . . . . . . . . . . . . @ @ @ @ . . . @ @ @ @ . @ @ @ @ @ @ @ @ @ @ @ @ @ @ @ @ . . . @ @ . @ . @ @ @ @ @ @ @ @ @ @ @ @ @ @ @ @ @ @ @ @ . . @ @ @ . . @ @ @ . @ @ 
@ @ @ @ . . . . . . @ . . . . . . @ . @ . @ . @ . @ . @ . @ . . @ @ . . @ . . . . . . . @ @ @ @ @ @ @ @ @ @ @ @ @ @ @ @ . @ @ @ . @ . . @ @ @ @ @ @ @ @ @ @ @ @ @ @ @ @ @ @ . . @ @ @ . . @ . @ . . . @ 
@ @ @ @ @ . @ . @ . . @ . @ @ . @ . @ @ @ . . . @ . . @ . . @ . . . @ @ @ . @ . @ . @ . @ @ @ @ @ @ @ @ @ @ @ @ @ @ . . . . @ . . . . @ . @ @ @ @ @ @ @ @ @ @ @ @ @ @ @ @ @ @ . @ @ . @ . . . . . @ . @ 
@ @ @ . @ @ . @ @ @ . . @ @ . . . . . @ . @ . @ @ @ . @ @ @ @ @ . @ . @ . . . @ @ @ . . . @ @ @ @ @ @ @ @ @ @ @ @ @ @ . @ . . @ . @ @ . . @ @ @ @ @ @ @ @ @ @ @ @ @ @ @ @ . . . @ . . . . @ . @ @ @ . @ 
@ @ . . . @ . @ . . . @ @ . . @ . @ . @ . . . @ @ @ @ . . @ . . . . . @ @ . @ . @ @ @ . @ . @ @ @ . @ @ @ @ @ @ @ @ @ @ . @ . @ . . @ @ . . @ @ @ @ @ @ @ @ @ @ @ @ @ @ @ @ . @ . @ . @ @ . @ . @ . @ @ 
@ @ @ . @ . . . @ @ . . . @ . . @ . @ @ . @ @ . @ @ @ . @ . @ @ . @ . @ . . . . . @ . . . . . . @ . @ . @ @ @ @ @ @ @ . . . . . . @ @ @ . @ . @ @ @ @ @ @ @ @ @ @ @ @ @ @ @ . . . . . . . . . . . . @ @ 
@ @ . . @ . @ . @ . . @ @ . . @ @ . @ . @ @ @ . @ @ . . . . . @ @ . . . @ . @ . @ . . @ . @ . @ . . . . @ @ @ @ . @ @ . @ @ . @ . . @ . . . . . @ @ @ @ @ @ @ @ @ @ @ @ @ @ @ . @ . @ . @ . @ @ . @ . @ 
@ . @ . . @ . . . @ . . . @ . @ . . @ . . @ . . . . . @ . @ . @ . @ . @ . . . @ . . @ . . @ . . . @ . @ @ @ @ . . . @ @ . . @ . . @ @ @ @ . @ . @ @ @ @ @ @ @ @ @ @ @ @ @ @ @ @ . . . @ . . @ @ . . . @ 
@ . . . @ . @ @ . . . @ . . . . @ . . . @ @ @ @ @ . @ . . @ . . . . . . . @ @ . @ @ . . @ . . @ . @ @ @ @ @ @ @ . @ . . @ . @ . @ . . @ @ @ @ . . . . . @ @ @ @ @ @ @ @ @ @ @ @ @ @ @ @ @ @ . . . @ . @ 
@ . @ . . . . . @ . @ . @ @ . @ . @ . @ @ @ @ . . @ @ . @ @ @ . @ . @ @ . . @ . @ @ @ . . @ @ @ . . @ @ @ @ @ @ . . @ . @ . @ . . @ . . @ @ . @ @ . @ . @ @ @ . @ @ . @ @ @ @ . @ . @ @ @ @ @ . @ . @ @ 
@ . . @ . @ @ . @ @ . . . @ . . . . . . @ @ . @ . @ . @ . @ @ @ . . @ . . @ . . . @ @ @ . @ . @ . @ @ @ @ @ @ . @ . . . . . @ . @ @ @ . . . . @ @ . . @ . @ . . . . . . @ . @ . . . . @ @ @ . . . . . @ 
@ @ @ . . . . @ . . @ @ . . . @ @ . @ @ . . . . . @ . . . . . . . @ . @ . @ . @ @ @ . @ @ . . . @ @ @ @ @ @ . . . @ @ . @ . @ . @ @ @ . @ @ @ . . . @ . . . . @ @ @ . @ @ . @ . @ . @ . @ . . @ . @ @ @ 
@ . . @ . @ . . @ . @ . @ @ . @ . @ . @ . @ . @ @ @ @ . @ . @ . @ . . . . . . @ @ . . . . @ @ . @ @ @ @ @ . . @ . @ @ @ . . @ . @ @ @ . . . @ . @ . . . @ . @ @ @ . @ @ . . . @ . . . . @ @ @ . . . @ @ 
@ @ . . . @ @ . . . . . . . . . . . . . . . @ @ @ @ . . . @ @ @ . @ @ @ . @ @ @ . @ @ @ . . @ . . @ @ @ . @ @ @ . @ @ . @ . @ . . @ . . @ . . @ . . @ @ . . . @ . . @ . @ . @ @ @ @ @ . . . @ @ . @ . @ 
@ @ . @ . . . @ @ @ . @ . @ . @ . @ . @ . @ @ @ @ @ @ @ @ . @ . . @ @ . . @ @ . . @ . . . @ . . @ @ @ @ . @ . . . . . . . . @ . @ . . @ @ @ @ . @ . @ @ @ . @ . @ . . . . . . @ . . @ @ @ . . . . @ . @ 
@ . @ . . @ @ @ @ . . . @ . . . @ . . . @ @ @ @ @ @ . . @ . . @ . @ . @ . . . @ . @ @ @ . . @ . @ @ @ @ . . @ . @ . @ . @ . @ . . . @ . . . @ . . . . @ . . @ . . . @ @ @ . @ . @ . . . @ @ @ @ . . . @ 
@ . @ . @ . . @ @ @ . @ @ @ . @ . @ . @ @ @ @ @ @ . . @ @ @ . . . . . . @ @ . . . . @ . @ . . . . @ @ . . @ @ @ . . @ @ . . @ @ @ . . @ . @ . @ . @ . @ @ . . @ @ . . . @ @ . . . . @ @ . . . . @ . @ @ 
@ . @ . @ . @ @ @ @ @ @ @ . . . . . @ @ @ @ @ @ . . @ . @ . @ . @ . @ . . . @ . @ @ . . @ . @ . @ . @ @ . . . . @ . . . @ . . . @ . @ . . . . . @ . . . @ . @ @ . . @ . . . @ . @ . . . @ . @ . . . . @ 
@ . . . @ . @ @ @ @ @ @ . @ @ . @ . @ . . . @ . @ . @ . . . @ . . @ . . @ @ @ . . . @ . . @ . . . . . @ . @ . @ @ @ . @ . . @ @ . . . @ @ . @ @ @ @ . @ . @ @ @ @ . . @ . @ . . . @ . @ . @ . @ . @ . @ 
@ @ . @ . . . . @ @ @ . . . . @ . . . . @ @ . . @ . @ . @ . . @ @ . @ . @ . . @ @ . . . @ . @ . @ . @ . . @ @ @ @ . @ . @ . . . @ . @ . . . . @ @ @ . . . . . @ . . @ . @ @ @ . @ . @ . . . . . . . @ @ 
@ . . @ . @ . @ @ @ . @ . @ @ . @ . @ . . . . @ . . . @ . . @ . . . . . . @ . . @ . @ . @ . @ . . @ . @ . @ . @ @ . . . . @ @ . . . . @ . @ @ . . @ . @ . @ . @ . @ . . . @ . . . . . @ @ @ . @ . @ . @ 
@ . @ @ @ . . @ . . . . . . . . . . @ . @ . @ @ . @ @ @ @ . . @ . @ . @ . . . @ . @ . . . . @ . @ . . . . . . . @ @ . @ . @ . @ . @ @ . . . @ . @ . . @ @ . . . . . @ . @ . @ . @ @ @ . @ . @ @ . @ . @ 
@ @ . @ . @ . @ . @ . @ @ . @ . @ . . @ @ @ @ . . . . @ . . @ . @ . @ @ . @ . @ . . . @ @ . . . . @ @ . @ . @ . . . @ . . . . . . . . @ . @ @ . @ . @ . @ @ @ . @ @ . . . . . . . . . . . . @ . . . . @ 
@ @ . . . . . . @ @ @ . . @ @ @ . . @ @ @ . . . @ . @ . @ . . . . . . . @ . . @ @ . @ @ @ @ . @ @ @ @ @ . . . @ @ @ . @ @ . @ @ . @ @ . . @ . . @ . . . . . . @ @ @ @ . @ . @ @ . @ . @ . @ @ @ . @ . @ 
@ . . @ . @ . @ @ @ @ @ . @ . . @ . . @ . @ @ . @ . . . . . @ . @ . @ . @ @ . . @ @ @ @ @ . . . @ . . @ @ . @ @ . @ . @ @ . @ . . . @ @ . @ @ . . . @ . @ . @ . @ . @ . . @ . . . . @ . . . @ . . . @ @ 
@ @ . @ . . @ @ @ . . . . . . @ . . @ @ . @ @ @ @ . @ . @ @ . @ . . . @ . @ . @ . . @ @ . @ . @ . . @ . . . @ . . . . . . @ @ @ . @ . . . . . @ . @ . . . @ @ . . . . @ . . @ @ . @ . @ @ @ . @ . @ . @ 
@ . . . @ . @ @ . @ . @ @ @ . . @ . . @ . . @ @ @ . @ . . @ . . @ . @ @ . @ . @ . @ @ . . . . @ @ . @ @ . @ . @ . @ . @ @ @ @ . . . . @ @ @ @ . . . @ . @ . @ @ @ . @ @ . @ . @ @ . . . @ . . @ . . . @ 
@ @ . @ . @ . @ . . @ @ @ . . @ . . @ . . @ @ @ @ @ . . @ . . @ @ @ @ . . . . . . . . @ . @ . . @ . . @ . . . . @ . . . . @ . @ @ @ . . @ . . @ . @ . @ . . . . . . . . . . . . @ . @ @ . . @ . @ @ . @ 
@ . . . . . . . . @ . @ . @ . @ @ . . . @ @ @ @ @ @ @ . . . @ @ @ . @ @ @ . @ @ . @ @ . @ . @ . @ @ . . @ @ . @ . @ . @ @ . . @ @ . . @ . . @ @ . . . . @ . @ . @ @ . @ . @ @ . . . . . @ . . . @ . . @ 
@ @ @ @ . @ . @ . . . . . . . @ . @ @ . @ @ @ @ @ @ . @ @ . . @ @ . . @ . . . @ . @ . . . . . . @ . @ . @ . . . . . . . . @ . . . @ . . . @ . . . @ . @ . @ @ @ @ . . . @ . . . @ . @ . @ . @ . . @ . @ 
@ @ @ @ . . @ @ @ . @ . @ @ . @ . . . . . @ @ @ @ . . @ . @ . . @ . @ . @ . @ . . @ @ @ . @ @ . . . @ . @ . @ . @ . @ @ . @ . @ . . . @ . @ @ @ . . @ . . . @ . . @ . @ @ . @ . . @ . . . @ . @ . . . @ 
@ @ @ @ @ @ . @ . . @ @ . @ . . @ . @ . @ . @ @ @ @ . . . . . @ . . . . . . . @ . @ . . . @ . @ @ . @ . @ @ @ . @ @ . . . . @ @ @ @ . . @ . @ @ . @ . @ . @ . @ . @ . . @ @ . . @ . @ . @ @ . . @ @ . @ 
@ @ @ @ . . . . @ . @ . . . @ . @ @ . . . . @ @ @ @ . @ . @ . . . @ @ . @ . @ . . . @ @ @ . . . @ . @ . . @ . @ @ . @ @ @ . . . . . . @ @ . . @ . @ . . . . . . . @ . @ @ @ @ . . . . @ . @ . @ @ . . @ 
@ @ @ @ @ . @ . . @ . @ @ . @ . . . @ . @ . . @ @ @ @ . @ . . @ @ @ . @ @ . @ . @ . @ @ @ @ @ . @ . @ . @ . . . @ . @ @ . @ @ @ @ @ . . @ . @ . . @ . @ . @ @ @ . . . . @ @ @ . @ . @ . . . . @ . . @ @ 
@ @ @ @ @ @ . . @ . . @ . . . . @ @ . @ . . @ @ @ @ . . . @ . . . @ . . . @ @ @ @ @ @ . @ . . . @ . . . . . @ @ . . . @ . . . . @ . . @ @ . . @ . @ . . @ . . . @ . @ @ @ @ @ @ @ @ . @ . @ . . @ . . @ 
@ @ @ @ @ @ @ . . @ . . @ @ @ . . @ . . @ . . @ @ . @ @ . . . @ @ . . @ . @ . . . . @ . . @ . @ . @ . @ @ @ @ @ @ . @ . @ @ . @ . @ . @ . @ . @ . @ . @ . @ . @ . @ . . @ @ @ @ @ . . . @ . . @ . . @ @ 
@ @ @ @ @ @ . @ . @ . @ @ . @ @ . @ @ . . . @ . . . . . . @ . @ @ @ . . @ . @ @ @ . . @ . . . . . @ . . . @ . . . . . . . . . . . . . . . . . . . . . . . . . . . . @ . @ @ @ @ @ @ . @ . @ . @ . @ . @ 
@ @ @ @ @ . . . . . . . . . @ @ . . . . @ . @ @ @ @ @ . @ . . . . . . @ @ . . @ . . @ . @ @ . @ . . . @ . @ @ @ @ @ . @ . @ @ . @ . @ @ . @ . @ . @ . @ . @ . @ @ . . . . . @ . @ . . . . . . . . . . @ 
@ @ . . @ @ . @ . @ @ . @ . . . @ . @ . @ . @ . @ . @ @ . . @ . @ . @ @ . . @ . @ . . . . @ . @ . @ . @ @ . . . . . @ @ @ @ @ @ @ @ @ . . . @ @ . @ . @ . . @ @ . . @ . @ . @ . . @ . @ . @ @ . @ @ @ @ 
@ @ . @ @ . @ . @ . . . . @ @ . . . . @ . . . . . . @ @ . @ . . . @ @ . @ . @ . @ . @ . @ . . @ @ . . . @ . @ . @ @ . . . . @ . @ @ . @ . @ . @ . . @ . . @ . . @ @ . . @ @ . @ . @ . @ @ @ @ . @ . @ @ 
@ @ . . @ . @ . @ . @ . @ @ @ . @ . @ . @ . @ . @ . @ @ @ . . @ @ . @ . @ . . . . . . @ @ @ . @ . @ . @ . . @ @ @ . @ . @ . @ . @ . . . . @ . . @ . @ @ . . . @ . @ @ . @ . . . . . . . . @ @ . . . . @ 
@ . . @ . . . . @ . . @ . @ @ @ @ @ . . @ . @ . @ . @ @ . @ . @ . . . . @ . @ @ @ . @ @ @ @ @ . . . . . @ . @ . . . . @ . . @ . . @ . @ . . @ . @ . . . @ @ . . . . . @ @ @ . @ @ @ . @ . @ . . @ . @ @ 
@ @ . . . @ @ . @ . @ . . . @ @ @ @ @ . @ . . @ @ . @ . . . . . @ . @ . @ . @ @ @ @ @ @ @ @ @ @ @ . @ . . . . . @ . @ . @ . @ . @ . @ . . @ @ . @ . @ @ @ . . @ . @ . . @ @ @ . . . . . @ @ @ . . @ @ @ 
@ . . @ @ . @ . @ . . @ . @ . @ @ @ . . @ . @ @ @ @ . @ @ . @ . . . . @ . . . @ @ . @ @ @ @ @ . . . . @ @ @ @ . @ . . . . . @ . . . . @ . . @ . . @ @ @ @ @ . . @ . . @ @ @ . @ . @ . @ @ @ . . @ @ @ @ 
@ @ . . @ . . @ @ . @ @ . . . @ @ . @ . . . @ @ @ . . . . @ . @ . @ . . . @ . . @ . @ @ @ . . . @ . @ @ @ @ @ @ @ @ @ @ @ . . @ . @ . @ @ . . . @ @ @ @ @ . . @ @ . @ @ @ . . . @ . . . @ . @ . @ @ @ @ 
@ . . @ . . @ . . @ @ . . @ . @ . . . @ . @ . @ . @ . @ @ . . . @ @ . @ @ . @ @ . . . . @ @ . @ . . @ @ @ @ . @ @ @ . . @ . @ @ @ . . . @ . @ @ @ @ @ @ . @ . @ . @ . @ . @ . @ . @ . @ . . . @ . @ @ @ 
@ @ . . @ . . . @ @ @ @ . . @ . @ @ . . . . . . . . . . . @ . @ @ . . . . . @ . @ . @ . . @ . @ @ . . . @ . . . @ . @ . . . . @ . . @ . . . . @ @ @ @ . . . . . . @ . . . . . . . . . . . @ @ . . . @ @ 
@ . . @ . . @ @ . . @ . . @ @ . . . @ @ @ @ . @ . @ . @ . . . @ . @ . @ . @ . . @ @ . . @ . . . @ @ @ @ @ . @ . . . . . @ @ @ . . @ . . @ . @ @ @ @ . @ . @ . @ . @ . @ @ @ . @ @ @ . @ . @ . . @ . . @ 
@ @ . . . @ . @ . @ . @ . . @ . @ @ . . @ . . . @ . . . @ @ . . . . . . @ . @ . @ @ @ . . @ @ . @ . . @ . @ @ . @ . @ . . . @ @ @ . . @ . @ @ @ @ . . . . @ @ @ @ . @ . @ . @ . @ . @ . . . . @ . @ . @ 
@ . . @ @ . . . . . . . . @ . . . . . @ @ @ . @ . @ . @ . . @ @ . @ . @ @ . . . . @ . . @ @ . @ @ @ . . . . . . . @ . . @ @ . @ . @ . . . . @ @ @ @ . @ @ . . @ . . . . @ . . . . . . . @ @ . @ . @ . @ 
@ @ . . @ . @ @ @ . @ . @ @ @ @ . @ . @ @ @ . . . . @ . @ . @ @ @ . . @ . . @ . @ . @ . @ . . @ @ @ @ . @ . @ . @ @ @ . . @ . . . . . @ . @ @ . @ @ @ . . . @ . @ . @ @ @ @ . @ . @ . @ . . . @ . . @ @ 
@ . . @ . . @ @ @ @ @ . @ @ @ @ @ @ . @ @ @ . @ @ @ . . . . . @ @ @ . . @ . . @ @ . @ . . @ . @ @ . @ @ @ @ . . @ @ . @ . . @ @ . @ . . @ @ . . . . . @ @ . . . . . . @ @ @ @ @ @ @ @ . @ @ . @ . @ . @ 
@ @ . . . @ . @ @ @ @ . . @ @ @ @ . . . @ @ . . @ . . @ . @ . @ @ . . @ . . @ @ . . . . @ . . @ . . . @ . . . @ . @ . @ . @ . @ @ . . @ @ @ @ @ @ . @ . . @ @ . @ . @ . @ @ @ @ @ @ . . . . . @ . @ . @ 
@ @ . @ @ @ . . @ @ @ @ @ . @ @ . @ . @ . @ . @ . . @ . @ . . @ . @ . @ . @ @ @ @ . @ . . . @ @ @ . @ . @ @ @ . . . . . . . . . @ . @ . . @ . . . . @ . @ @ @ @ . . @ . . @ . @ @ @ @ @ . @ . . . . . @ 
@ . . . @ . . @ . . @ @ . . . . . @ . . . . @ . . @ @ . . @ @ . . @ . . . . . @ @ @ @ . @ . @ @ . . . . @ @ @ @ . @ . @ @ @ . @ . . . @ . . @ . @ . . . . @ @ . . @ . . @ @ . . @ @ @ @ @ . @ . @ . @ @ 
@ @ . @ . @ . . . @ @ . . @ . @ . . . @ @ @ @ @ . . . . @ @ . @ . @ @ . @ . @ @ @ . @ @ . . @ . @ . @ @ @ @ @ . . . @ @ @ . . . @ . @ . . @ @ @ . . @ . @ . . @ . . . @ . @ . @ . @ . @ . . . . . @ @ @ 
@ . . . . . . @ . @ @ @ @ . @ . . @ . . @ @ @ . . @ @ . @ . . . . . . . . @ @ . . . . . @ . . . @ . @ . @ @ . @ . @ @ @ . @ . @ . . . @ . . @ . @ . @ @ . . @ @ @ . @ . . @ . . . . . @ @ . @ . @ . @ @ 
@ @ . @ . @ @ . . . @ . @ . . . @ . . @ @ @ . . @ . . @ @ @ @ @ . @ @ . @ @ . @ @ . @ . . @ @ . @ . . . . . . . @ . @ . . @ . @ @ . @ @ . @ . . . . . . @ . . @ . . . . @ @ . @ @ @ @ . @ . @ . @ . . @ 
@ . . . @ @ @ @ . @ . . . @ @ @ . @ . . @ . @ . @ @ . @ @ . @ . @ . . . . @ . . @ @ . . @ . . . @ @ @ . @ @ . @ @ . . @ . . . . . . @ @ . @ . @ . @ . @ . @ . @ . @ @ @ . . . . @ . . . @ . @ . . . @ @ 
@ . @ . @ @ @ @ @ . @ . @ @ @ . . . . @ . . . . . . . . . . . . . . @ @ . @ . @ . . @ . . @ . @ . . @ @ . . . . . @ . @ . @ @ @ . @ . . . . @ @ @ . . . . @ . . . @ @ . @ . @ @ . @ . @ @ @ . @ @ . . @ 
@ @ . . . . @ @ . . . . . @ . @ . @ . . @ . @ @ . @ . @ . @ @ @ @ . @ . . . . . . @ . . @ @ . . . @ . . @ @ . @ . . . . @ @ @ . . . . @ @ @ . . . @ @ @ . @ @ . @ @ . . . . . . . . . . @ @ . . . . @ @ 
@ . @ . @ . @ . @ . @ @ . @ . . . . @ @ . @ . . @ @ @ @ @ . . . @ . @ . @ @ . @ @ . @ . @ . . @ @ . . @ . . @ . . @ . @ . @ . . @ . @ @ @ @ @ @ . @ @ . . . @ . @ . . @ @ @ . @ @ . @ . . @ @ . @ . . @ 
@ . . . . @ . . @ . . @ . . . @ . @ @ @ . @ @ . . @ . @ @ @ @ . @ @ @ @ . @ . . . . . . . . @ . @ . @ . @ . @ @ . . @ . . . . @ . . . @ @ @ . . . . . @ @ . @ . @ . @ . . . @ . . . . @ @ . @ @ . . @ @ 
@ @ . @ . . @ . @ @ @ . @ @ . @ @ @ . @ . . @ . @ @ . @ @ @ @ . @ @ @ . . @ @ @ @ . @ @ . @ . . . . . . . . @ . @ . @ . @ @ @ . . @ . @ @ @ . @ . @ . . . . . . . . . . @ . @ . @ . @ @ . . . @ . @ . @ 
@ @ . @ @ . . . . . . . . . . . . . . . . @ . . . @ . . . @ . . . @ @ @ . @ . . @ @ @ @ . . . @ @ @ . @ . @ . . . . . @ @ @ . @ . . @ . @ . . . @ @ @ . @ @ . @ . @ @ @ . @ @ @ . . . . @ . @ . . . . @ 
@ . @ . . @ . @ @ . @ . @ @ . @ . @ . @ . . @ . @ @ . @ @ @ @ . @ . @ . . . @ . . . @ . . @ . . . . @ . . . @ . @ . @ @ @ @ . . . @ . . . @ . @ @ @ @ @ @ @ @ . . . @ . . @ @ @ @ @ . @ . . . . @ @ @ @ 
@ . @ @ . . . . . @ . . . @ . . @ @ @ . @ . . . . @ . . . @ . . . . . @ @ . . @ . @ . @ . . @ @ @ @ . @ . @ . @ . . . . @ . @ . @ . . @ @ . @ @ @ @ @ @ @ @ @ . @ @ . @ . @ @ @ . . @ . @ . @ . . . . @ 
@ . . @ . @ . @ @ . @ . @ @ . @ . @ @ . . @ . @ . . @ @ . . @ . @ @ @ . . @ . @ . @ . . . @ . @ . @ . . . @ . . @ @ . @ . . . . @ @ . @ . . @ @ @ @ @ @ @ @ . . . . . . . . @ @ @ . . . @ . . @ . @ @ @ 
@ . @ . @ . @ . . . . . . @ . @ . @ . @ . @ @ . @ . @ . @ . @ . @ . @ . @ . . . . . . @ . . . . . @ @ . @ . . @ . @ . @ @ @ @ . . . . . @ . . @ @ @ @ @ @ . @ . @ . @ @ . @ . @ . @ @ . . . @ . @ . @ @ 
@ . . . @ . @ @ @ @ . @ . . @ . . . . . . . . . . . . . . . . . . . . . . . @ . @ @ . . @ . @ @ . @ @ @ @ @ . . . . . . . @ . @ . @ . @ . . @ @ @ . @ @ . . . . . @ @ @ @ @ . @ . @ . . @ @ . . @ . . @ 
@ . @ @ . . . . . . @ . @ @ . . @ . @ @ . @ . @ . @ @ . @ . @ . @ . @ . @ . @ @ @ . @ @ . . @ . . . @ . @ . . @ . @ . @ @ . . . @ . . . . @ @ @ . . . . @ . @ . @ . . @ @ . . . . . @ . @ @ . @ @ . @ @ 
@ . . . . @ . @ . @ . . . @ . @ . . @ . @ . . @ . . @ @ . . . @ . @ . @ . @ @ . . . . . . @ . @ . @ . . @ @ . . @ . . @ . @ . @ . @ . @ @ @ . . @ . @ @ . @ . . . . @ . . @ . @ @ . . . . . . @ . . @ @ 
@ . @ @ @ . @ . @ . @ . @ . @ . . @ . . . . @ . . @ . . . @ @ . . . . . . . . . @ . @ @ @ @ . . . . @ . . . . @ @ @ @ . . . . . . . . . . . . @ @ . . @ . @ @ . @ @ . @ . . . . . @ . @ . @ . . @ . . @ 
@ . @ . . . . . . . . . . . . . @ @ @ . @ @ . . @ . . @ . . @ @ . @ . @ . @ . @ . . . . @ @ @ @ @ . @ @ . @ . . @ @ @ @ . @ . @ @ . @ @ . @ . . @ . @ . . @ . . . @ . . . @ . @ . @ @ @ @ . . @ . @ . @ 
@ . . @ . @ @ . @ . @ . @ . @ @ @ @ @ . . . @ . . @ . @ . @ @ @ @ . . . @ . . @ @ . @ @ . @ . . @ . . @ @ . . @ @ @ @ @ . . @ . . @ @ . @ . . @ . . . . @ . . @ @ . . @ @ . @ . . . . @ @ @ . @ . . . @ 
@ @ . . . . @ @ . . . @ . . @ @ @ @ @ @ . @ @ @ . . @ . . @ @ @ . @ . @ . . @ . . . @ . . . . @ . @ . . . @ . @ . @ @ @ . @ . @ . @ . . . @ . . @ . @ @ @ @ . . @ . @ . @ . @ @ . @ @ @ @ @ @ . . @ . @ 
@ . . @ . @ . @ @ . @ @ @ . @ @ @ @ @ @ @ @ @ @ @ . @ . @ . @ @ . . . @ . @ . . @ . . @ . @ . . . . @ . @ . . . . . @ . @ . . . . . . @ . . . @ . . . . @ . . @ . . . . . . @ @ @ @ @ @ @ @ @ . @ . . @ 
@ . @ @ . . . . @ @ @ @ @ . . @ @ @ @ @ . @ @ @ @ @ . @ @ . . . . @ . @ @ . . @ . . @ @ @ @ @ . @ . . . . @ . @ . @ . . . @ @ . @ @ @ . @ @ . @ . @ . @ . @ . . . @ @ @ @ @ . . . @ @ @ @ @ . . @ . @ @ 
@ . @ . . @ . @ @ @ @ @ @ @ @ @ @ @ @ . . . @ @ @ . . . . . @ . @ . . @ . . @ @ @ . . @ @ @ . @ . . @ @ . . . . @ . @ . @ @ @ . . . @ . . . . @ . @ . @ . @ . @ @ @ @ @ @ . . @ @ . @ @ @ @ . @ . . . @ 
@ . @ @ . . @ . @ @ @ @ @ @ @ @ @ @ . @ @ . @ @ . @ @ @ @ . @ @ . @ . @ . @ @ @ @ @ . . @ . . . @ @ @ . @ @ . @ . . @ . . @ . @ @ @ @ @ . @ . . . . @ . . @ . . @ @ @ @ . @ . @ . . @ @ @ . @ . @ . @ @ 
@ @ . . . @ . . @ @ @ @ @ @ @ @ @ . . @ . . . . . . . . @ @ . . . . . . @ . @ @ @ @ @ @ @ @ @ . . @ . . @ . . . . @ . @ . . . @ @ @ @ @ @ . @ . @ @ @ @ . . @ . @ @ . . . . . . @ . . @ . . @ . @ . . @ 
@ @ @ . @ @ . @ . @ . @ . . @ . . @ . @ . @ . @ . @ . @ . @ @ @ . @ . @ . . . @ @ @ @ @ @ @ @ . @ . @ . . @ . @ . @ . . @ @ . . . @ @ @ . . . . . . . @ @ . @ . . . @ @ . @ . @ @ . @ . @ . @ . . . @ @ 
@ . . . @ . . . . . . . . @ . @ . @ . @ . @ . @ . . @ @ . @ . @ @ . . @ . @ @ @ @ @ @ @ @ @ . . @ . @ . @ @ @ . . . . @ . @ . @ @ . . @ . @ @ . @ . @ . . . @ . @ @ . @ @ @ . @ . . @ . . . . @ @ . . @ 
@ . @ . @ @ . @ . @ . @ @ . . . . . . . @ @ @ . . @ . . . . . . . @ . . . . . . @ @ @ @ @ . @ . . . . . . @ . @ . @ @ @ . @ . . . @ . @ @ @ @ @ . . . . @ @ . . . @ . . . @ . . @ . . . @ @ @ . @ . @ @ 
@ @ . . . @ . @ . . @ @ @ @ @ @ . @ . @ . @ . @ . @ . @ . @ @ . @ @ @ @ @ . @ . . @ @ @ . . @ . @ @ . @ . . . . . . . . . @ . @ @ . . . . @ @ . . @ . @ @ @ @ . @ @ . @ @ . @ . . . @ @ . . . . . . . @ 
@ @ @ . @ . . . @ @ @ @ @ @ . . @ . . . . . . . . . . @ . . . @ @ @ @ @ @ @ @ @ @ @ @ . @ . @ @ @ @ @ . @ . @ . @ @ . @ . @ . . . . @ . @ @ . @ . @ @ @ . . . . . . . . . . . . @ . . . . @ @ @ . @ . @ 
@ @ @ @ . @ . @ . . @ @ @ . . @ @ @ . @ @ . @ @ . @ @ @ @ . @ . @ @ @ @ @ @ @ @ @ @ @ . . . . . @ @ @ . . . @ @ @ @ @ @ . . . @ . @ . @ . . . . . . @ @ @ . @ . @ . @ . @ . @ . . @ . @ . . . . @ @ @ @ 
@ @ @ . . . . . @ . . @ . @ . . @ . @ . @ . @ . . @ . @ @ @ . . . @ @ . @ @ @ @ @ @ . . @ . @ . . @ . . @ . . . . @ . . . @ @ . @ . . . @ @ . @ @ . . @ . . @ . @ . @ . . @ . . @ . @ . . @ @ @ @ @ @ @ 
@ @ . @ @ . @ @ . . @ . . . . @ . . . . . @ @ @ . . . . @ @ @ . @ @ @ . . @ @ @ @ . @ @ @ @ @ . @ . @ . . @ @ @ @ . . @ . @ . . . @ . @ . @ @ . @ . @ . @ . . @ . @ @ . @ . @ . . . . @ . . @ @ @ @ . @ 
@ . . . . . . . @ . @ @ . @ . . @ . @ . @ @ @ @ @ . @ . @ . @ . . . . . @ @ @ @ . . @ . . . . . . . . . @ @ @ @ . @ . @ . . . @ . . . . . @ . . . . . . . . @ . . . @ @ . . @ . @ . @ . @ @ @ @ @ @ . @ 
@ . @ . @ . @ . . . . . . . @ . . @ . . . . @ @ @ @ . . . . . . @ . @ @ . @ @ @ @ . @ @ . @ . @ . @ @ . @ @ @ @ . . @ @ @ . @ . @ . @ @ . . @ . @ . @ . @ . @ . @ @ . . . @ . @ . . @ . @ . @ @ @ . . @ 
@ @ @ . . @ @ @ . @ @ . @ @ . . @ . @ . @ @ . @ @ . @ . @ . @ @ @ @ . . . @ @ @ @ . . . @ . @ @ . . . @ . @ @ . @ . . @ . @ . . @ @ . . @ . @ . @ . . @ . @ . . . @ . @ . . . @ @ . . . . . . . . @ . @ 
@ . @ . @ @ @ . @ . . @ . @ @ . . . . . . . . . . . @ @ . . @ @ @ . @ . @ . @ . @ . @ @ @ . @ . @ . @ . . . . . . . @ @ . . @ . @ . @ . @ . . . . @ . . . . . @ . . . @ . @ . @ . . @ . @ @ . @ . . . @ 
@ . . @ @ @ . . @ @ . . . @ . @ . @ . @ . @ @ @ @ . . . @ . . . . . . . . . . . . . . . . . . . . . @ @ . @ . @ @ . . . . @ . . . . @ . @ . @ @ @ . . @ . @ @ . @ @ @ . . @ @ . @ . . @ . . . . @ . @ @ 
@ . @ . @ . @ . @ . @ @ . @ . . . . @ @ @ @ . @ . @ @ . . . @ . @ . @ . @ @ . @ . @ . @ . @ . @ @ . @ . . . @ @ @ @ . @ . @ @ . @ . . . @ . . @ @ @ @ . . . . . . . . @ @ . @ . @ . @ . . @ . @ @ . @ @ 
@ . . . . . . . . . . . . . @ . @ . . @ . . . . . . . . @ . . @ . . @ @ . . . . @ @ @ . . @ . @ @ @ @ @ . @ @ @ @ . @ . . . . . @ . @ . . . @ . @ . . @ . @ . @ . @ . . @ . @ . @ @ @ @ @ . . . . @ . @ 
@ @ . @ @ . @ @ @ @ @ @ @ . . . @ . @ @ @ @ @ . @ . @ . . @ . . @ . @ @ . @ . @ @ @ @ . @ . . @ @ @ @ . . @ . . . . . . @ . @ . . @ @ @ @ . . . . @ . . . @ . . @ @ @ . . . . . . @ @ @ @ @ . @ . . . @ 
@ . . . @ @ . . . . . . . . @ . @ @ @ @ @ @ @ . . @ . . @ . . @ @ @ @ @ @ @ . @ @ @ . . @ @ . . . @ @ @ . @ @ . @ . @ . . @ . . @ @ @ . . . @ . @ . . @ . . @ . . . . @ @ . @ . @ @ @ . . . . . @ . @ @ 
@ @ @ @ @ @ @ @ @ @ @ @ @ @ @ @ @ @ @ @ @ @ @ @ @ @ @ @ @ @ @ @ @ @ @ @ @ @ @ @ @ @ @ @ @ @ @ @ @ @ @ @ @ @ @ @ @ @ @ @ @ @ @ @ @ @ @ @ @ @ @ @ @ @ @ @ @ @ @ @ @ @ @ @ @ @ @ @ @ @ @ @ @ @ @ @ @ @ @ @ 
3
50 15 47 90
12 93 60 80
49 93 54 7
