12 12
@ @ @ @ @ @ @ @ @ @ @ @ 
@ @ . @ @ @ . @ @ @ @ @ 
@ . . . . . . . @ @ @ @ 
@ @ . @ @ . @ @ @ @ @ @ 
@ . . @ . @ . . @ @ @ @ 
@ @ . . . . @ . . @ @ @ 
@ . . @ . @ . @ . @ @ @ 
@ @ . . @ . . . . . @ @ 
@ . . @ . @ @ @ . @ @ @ 
@ @ . . . . . . . . . @ 
@ @ @ . @ @ . @ . @ . @ 
@ @ @ @ @ @ @ @ @ @ @ @ 
3
9 2 2 5
7 6 3 2
10 6 9 10
