100 100
@ @ @ @ @ @ @ @ @ @ @ @ @ @ @ @ @ @ @ @ @ @ @ @ @ @ @ @ @ @ @ @ @ @ @ @ @ @ @ @ @ @ @ @ @ @ @ @ @ @ @ @ @ @ @ @ @ @ @ @ @ @ @ @ @ @ @ @ @ @ @ @ @ @ @ @ @ @ @ @ @ @ @ @ @ @ @ @ @ @ @ @ @ @ @ @ @ @ @ @ 
@ . . . . . . @ . . @ . @ . @ . @ @ @ @ @ @ @ @ @ @ @ @ @ @ @ @ @ @ @ @ @ @ @ @ . . . . . . . . . @ @ . @ . . . . @ . . . . . . . . . . @ @ @ . . . @ . @ @ . @ . . . @ . @ . @ @ @ @ @ @ @ @ @ @ @ @ @ 
@ . @ . @ @ . . @ . . . . . . . . . @ @ @ @ @ @ @ @ @ @ @ @ @ @ @ @ @ @ @ @ . @ . @ . @ . @ . @ @ . . . . . @ . @ . @ . @ . @ @ . @ . @ @ @ @ . @ . . . . . . . @ @ . @ . . . . @ @ @ @ @ @ @ @ @ @ @ @ 
@ @ @ @ . . @ . @ . @ . @ . @ @ @ @ @ @ @ @ @ @ @ @ @ @ @ @ @ @ @ @ @ @ @ . . . . . @ . . . @ @ @ @ @ . @ . . @ . . . . . @ . . . . @ . @ @ . . @ . @ . @ . @ @ @ . . . . @ . @ @ @ @ @ @ @ @ @ @ @ @ @ 
@ @ @ @ @ . . . . . . @ . . @ @ @ @ @ @ @ @ @ @ @ @ @ @ @ @ @ @ @ @ @ @ @ @ . @ . @ . . @ @ @ @ . @ . @ . . @ . @ . @ . @ @ . @ . @ . . . . @ . . @ . . @ . . . @ @ . @ . @ @ @ @ @ @ @ @ @ @ @ @ @ @ @ 
@ @ @ @ . @ @ . @ . @ @ @ . . . @ @ @ @ @ @ @ @ @ @ . . @ . @ @ @ @ @ @ @ @ @ . . . @ @ . . . . . . . @ @ . . . . . . @ @ . @ @ @ . @ . @ . . . @ . @ . . @ . @ @ . . . @ . . . . @ @ @ @ @ @ @ @ @ @ @ 
@ @ @ @ . @ @ . @ . . @ @ . @ . . @ @ @ @ @ @ @ @ @ @ . @ . . @ @ @ @ @ @ @ @ @ . @ . . . @ . @ . @ . . . . @ @ @ . @ . @ . @ @ . . . . . @ @ . @ . @ . @ @ . . . @ . @ . @ . @ @ @ @ @ @ @ @ @ @ @ @ @ 
@ @ @ @ . . . @ . @ . . . @ @ @ @ . @ @ @ @ @ @ @ @ . . . . @ @ @ @ @ @ @ @ @ . . . @ @ . @ @ @ @ . . @ . @ @ . . @ . . . . @ . @ @ @ @ . @ . . . . . @ @ @ @ @ @ . . . . . . @ . @ @ @ @ @ @ @ @ @ @ @ 
@ @ . . @ . @ . . . @ @ . . @ @ . . @ @ @ @ @ @ @ @ @ . @ . . @ @ @ @ @ @ @ @ . @ . . @ @ . . @ . @ . . @ @ . @ . . @ . @ . @ . . @ @ @ @ @ @ . @ . @ . @ @ @ @ @ . @ . @ @ . . . . @ @ @ @ @ @ @ @ @ @ 
@ . @ . . . . @ @ . . . . @ @ . @ . . @ @ @ @ @ @ . . . . @ . . @ @ @ @ @ @ @ @ @ . @ . . @ . . . . . @ . @ . . . @ @ @ . . . @ . . @ . . @ . . . @ @ . . @ . @ @ . . @ @ @ @ . @ @ @ @ @ @ @ @ @ @ @ @ 
@ . @ @ . @ . . . @ . @ . @ . . . . @ . @ @ @ @ @ @ . @ @ . . @ . @ @ @ @ @ @ @ . . . @ . @ @ @ @ @ . @ . @ . @ @ . @ . @ . @ . @ . @ . @ . @ . @ . @ . @ . . . . . @ @ @ @ . @ @ @ @ @ @ @ @ @ @ @ @ @ 
@ . . . @ . . @ @ @ . @ . . @ . @ . . . . @ @ @ @ @ @ . @ @ . . . . @ @ @ @ @ . . @ @ @ . @ @ . @ . . . . . . . . . . . . . . . . . . . . . . . . . . . . @ . @ . @ @ @ . . . . @ @ @ @ @ @ @ @ @ @ @ @ 
@ @ . @ . @ . . . . @ . @ . @ @ @ . @ @ . @ . . . @ . . . . @ @ @ . . @ @ @ . @ . . . . . . . . . @ . @ . @ . @ @ @ @ @ @ @ @ @ . @ . @ @ @ . @ . @ . @ @ . . . @ @ @ @ @ @ . @ . @ @ @ @ @ @ @ @ @ @ @ 
@ . . @ . . @ @ @ . . . . . . @ . . . . @ . . @ @ @ @ . @ @ . . . @ . @ @ @ . . @ . @ . @ . @ @ @ . . . @ . @ . . . . . . . . . @ @ @ . . . . . @ . @ . @ . @ @ . @ . @ @ . . @ . . @ . @ @ @ @ @ @ @ @ 
@ @ . . @ . @ . . @ . @ @ . @ @ @ . @ @ . . @ @ @ @ . . @ . . @ @ . . . . . @ . . . . @ @ @ . . @ . @ . . . . . @ . @ . @ . @ @ . @ @ . @ @ . @ . . . . . . . . . . . . . @ . . . @ @ . @ @ @ @ @ @ @ @ 
@ @ @ . . . . @ . @ @ . @ . . @ @ . . @ . @ @ @ @ . @ . . @ . . @ . @ . @ @ . @ @ . @ @ @ @ @ . . . . @ . @ . @ @ . . @ @ @ . @ . . @ . @ @ . @ . @ @ @ . @ @ . @ . @ . @ @ . @ @ . . . . @ @ @ @ @ @ @ 
@ @ @ @ . @ . . . . . . . . @ @ . @ . @ . . . @ . . . . @ . . @ . . @ @ @ @ . @ . . . @ @ @ @ @ @ . @ . . . @ @ @ @ . . . @ . . @ . . . @ . . . . . @ . @ . . . . @ . . . . . . . . @ . @ @ @ @ @ @ @ @ 
@ @ @ @ . . @ @ . @ @ . @ . . . . . . . . @ @ . . @ @ . . @ . . . @ . @ . . . @ @ . @ . @ @ . . @ . @ . @ @ . . @ . . @ . @ . @ . @ @ . @ @ . @ . @ . . . . @ . @ . @ . @ . @ @ . @ @ . @ @ @ @ @ @ @ @ 
@ @ @ . @ . @ . . @ . . @ @ @ . @ . @ @ . . @ . @ . . . @ @ . @ . . . . . @ . @ . . @ . . @ @ . . . . @ . @ . @ . @ . . @ . . . . . @ @ . . . . @ . . @ . @ . . @ . @ . . @ . . . @ . @ @ @ @ @ @ @ @ @ 
@ @ @ . . @ . @ . @ . @ . . . @ @ @ @ . . @ @ @ . @ @ . . @ . @ . @ @ . @ . @ . @ . @ . @ . @ . @ . @ @ . @ . . . . . @ . @ . @ @ @ . . . @ . @ . @ @ . . @ @ . . . . @ @ @ @ @ . . . . @ @ @ @ @ @ @ @ 
@ . . @ . @ . @ @ . @ @ @ . @ @ @ . . @ . . @ . . @ . . @ . @ . . @ @ . . . . . . . . . . . . . . @ @ . . @ @ @ . @ . . . . . . . . @ . @ @ . . . . @ @ @ . . . @ @ @ . @ @ @ . . @ @ @ @ @ @ @ @ @ @ @ 
@ @ . . . . . @ . . . @ . . . @ . @ . @ . @ @ @ . . @ . . . . @ . . @ @ . @ @ @ . @ . @ . @ . @ @ . @ . @ . . . @ . @ @ . @ . @ . @ . @ . @ @ @ . @ . . @ @ @ . @ @ @ . . @ . . @ . @ @ @ @ @ @ @ @ @ @ 
@ @ @ @ @ . @ . @ . @ . @ . @ . . . . @ . . @ . . @ . @ @ . @ . . @ . . . . . . @ @ @ . . . @ @ @ . @ . . . @ @ . . . . @ @ @ @ . . . . . . . . @ . . @ . @ . @ . @ @ . @ . @ . @ . . @ @ @ @ @ @ . @ @ 
@ @ . . . . . . . . . . @ . . @ . @ @ . . @ . @ . @ . . . . . . @ @ @ @ . @ . @ . @ @ @ . @ . @ . . . . @ @ @ @ . @ . @ @ . . . . @ . @ . @ . @ @ @ . . . . . . . . . . . . . @ @ . @ . @ . @ . . . . @ 
@ @ . @ @ @ @ . @ . @ . @ @ . . . @ . @ . @ . . . @ . @ . @ . @ @ @ @ @ . . @ @ . . . @ . @ . @ @ @ @ . . . @ . . . @ @ @ @ . @ . @ @ . @ @ @ . @ @ . @ . @ . @ . @ . @ . @ . . . . . . . . . . @ @ . @ 
@ . @ @ . @ @ @ @ @ . . . @ . @ . . . . . . . @ . . . @ . . @ @ @ @ @ . @ @ @ . @ . @ . @ . . . . . @ @ @ . @ . @ . . @ @ @ @ @ @ . . . . @ . . . @ . . @ @ @ . . . @ @ . . @ . @ . @ . @ . @ . . @ @ @ 
@ . @ . . . @ . @ @ @ . @ @ @ . . @ . @ . @ . . @ . @ @ @ . @ @ @ @ @ . . @ . . . . @ . . . @ . @ @ @ . . . . @ . . @ . @ @ @ @ @ . @ . @ . . @ . @ . @ @ @ @ @ . @ . . @ @ @ @ . @ . . . @ @ . @ @ @ @ 
@ . . @ @ . . . . @ . . . . @ . @ . . @ @ . . @ . . . . . @ . @ . @ . . @ . @ @ @ . . . @ . @ @ @ @ @ @ . @ @ . @ . . . . @ @ @ @ . @ @ . . @ . @ . . . @ @ @ @ . . @ . @ . . . . @ . @ . . . @ @ @ @ @ 
@ @ . @ . @ @ . @ . @ @ @ . . . @ @ . @ . @ . @ @ . @ @ . . . . . . @ . . . . . . . @ . . @ @ @ @ @ @ . . . . . . . @ . @ @ @ @ . . . @ @ . . . . . @ @ @ @ @ . @ . @ . @ @ . @ @ . @ . . @ . @ @ @ @ @ 
@ . . . . . . . . . . . . . @ . @ @ @ . . . . . . @ . . . @ @ . @ . . . @ @ @ @ . @ . . @ @ @ @ @ @ @ @ . @ @ . @ @ . @ @ @ @ . @ . @ . . . @ . @ . . . @ @ . . . @ . . . . . . @ . @ @ @ @ @ @ @ @ @ @ 
@ @ . @ @ . @ @ . @ @ . @ . . @ . . . . @ @ . @ @ . . @ . . . @ @ @ @ . . . . . @ @ @ . . @ @ . . . @ @ . . @ @ @ @ . @ @ @ @ . @ . @ . @ . . @ . . @ . . . @ . @ . @ . @ . @ . . . . . . @ @ @ @ @ @ @ 
@ . . . @ @ . . @ . . @ . . @ . @ @ @ . . . @ . . . @ . . @ . . . . . @ . @ . @ @ . . . @ . . . @ @ . . . @ . . . . . . @ . . . . . . . @ . @ @ @ @ . . @ . . . . . . . . @ @ . @ . @ . @ . @ . @ . @ @ 
@ @ . @ @ @ . @ . @ . . . @ . . . . . . @ . @ @ . @ . @ @ @ . @ . @ @ @ @ . @ . @ . @ . . @ @ . @ . @ @ . . . @ . @ . @ . @ @ . @ . @ @ @ @ . @ . . @ @ @ . @ . @ . @ . @ . . @ @ . @ . . . . . . . . @ 
@ @ . . @ . . . . . . @ . @ @ . @ . @ . . @ @ @ . . . @ . . . @ @ . @ . . . @ . . @ @ . @ . . . . . @ . . @ . . @ . . . . . . . . @ @ . . @ . . @ . . . @ @ @ . . @ . . . @ . @ . . @ . @ . @ . @ . @ @ 
@ . . @ . @ . @ . @ . . @ . . . @ . @ . @ . @ . @ . @ . . @ . . . . . @ . @ . @ . @ . @ . @ . @ @ . @ . @ . . @ . @ . @ @ . @ . @ . @ . @ . @ . @ . @ @ . @ . . @ @ @ . @ . . @ @ . @ @ @ . . @ @ . @ @ 
@ @ . @ . . . @ @ . . @ @ @ . @ . . @ . . . @ . . . . @ . @ @ @ . @ . . . . . . . . . . . . @ @ . . . . . @ @ . . . @ . . . . @ . . . . . . . . . . . @ . . @ . @ @ @ @ @ @ . . @ . . . . @ . . . @ @ @ 
@ . . @ . @ . @ @ . @ . @ . @ . . @ . . @ . @ . @ . @ @ . . . @ . . @ . @ @ . @ @ . @ @ . @ . @ @ . @ . @ . . . @ @ . @ @ @ @ . . @ @ @ @ @ @ . @ . @ @ . @ . @ . @ @ @ @ @ . @ . @ . @ @ @ @ . @ @ @ @ 
@ @ @ . . @ @ . . . @ . . . . @ . @ @ . . @ @ @ . . @ . . @ . @ . @ . @ . . . . . @ . . . . . . . . . @ . @ . @ . @ . @ . @ @ . @ . . . @ . . @ @ . . . . . . . . . @ @ @ . . @ . @ . . . . . @ @ @ @ @ 
@ . . . @ . . . @ . . . @ @ @ . . . . @ . @ @ @ @ . . @ . . @ . . @ . @ . @ . @ . @ . @ . @ @ @ . @ . . . . . . . . . . . . @ @ . . @ @ . @ . @ . . @ @ . @ . @ . @ . @ @ @ . @ . . @ . @ . @ @ @ @ @ @ 
@ @ @ @ @ @ @ . @ @ . @ @ . . @ . @ @ . . . @ . . . @ @ . @ @ . @ . . . @ @ . @ . . @ . . . @ @ . . @ @ . @ . @ @ . @ . @ . @ . @ . . . . . . . . @ . . @ . @ . . @ . . . . . . . @ . @ . @ @ @ @ @ @ @ 
@ @ @ @ @ @ @ . @ . @ @ @ @ . @ . . @ @ . @ @ @ . @ . . . . @ . . . @ . . . @ . . @ @ @ . @ . . . @ @ @ . . @ . . . . @ . . . . . @ . @ @ . @ @ . . @ . . . . @ . . . @ @ @ @ @ @ @ . . . . @ @ @ @ @ @ 
@ @ @ @ @ @ @ @ . . . . . . . . . @ . . . @ @ @ . @ . @ . @ . . @ . . @ . @ . . @ . @ . @ . @ @ . . @ . @ @ . . @ @ @ . @ . @ . @ . @ @ . @ . @ . @ . @ . @ @ @ @ @ @ . . . @ . . @ . @ . @ . @ @ @ . @ 
@ @ @ @ @ @ @ . . @ . @ . @ . @ . @ . @ @ . @ . . . @ . . . @ @ . . @ @ . @ @ . . . . . . . . @ . @ . . @ . @ . . @ @ . . . @ . . . . . . . . . . . . . . . @ . @ @ @ @ . @ . @ . . . . @ @ . . @ . . @ 
@ @ @ @ @ @ @ . @ . . . @ . . @ . @ . . @ . . . @ @ @ . @ @ . . @ . . @ . @ . . @ . @ . @ . @ . . @ . @ . . . . @ . . . @ . . @ . @ @ . @ . @ . @ . @ @ . @ . . . @ @ . . . . . . @ @ @ @ @ . @ . @ . @ 
@ @ @ @ . @ @ @ . @ . @ . . @ . . @ . @ . . @ @ @ @ . @ @ @ . @ . . @ @ @ @ @ . . @ . . . @ . @ . @ . . . @ . @ . @ . @ . . @ @ . @ . . @ . . @ @ . . @ . . @ . @ . . . @ . @ @ . . . . @ . . . . . . @ 
@ . . . . @ . @ . @ @ . @ . @ @ . @ . @ . @ . @ @ @ . . @ . . . . @ @ @ @ @ . . @ @ @ . @ . . . @ . @ . @ . . @ . @ . @ @ . . . @ . @ . . @ . . @ . @ . @ . . . . . @ @ . @ @ @ @ . @ . . . @ @ @ . @ @ 
@ @ . @ . . . . . . . . . . @ . . @ . @ . . . . @ . @ . . . @ . @ . . @ @ . . @ . @ . . . @ @ . . . . . @ @ . . . . @ . . . @ . . . . @ @ @ . @ . @ . . . @ . @ . @ . @ . @ @ @ @ @ . . @ . . . . @ @ @ 
@ @ @ . @ @ @ . @ . @ . @ . @ . @ . @ @ . @ . @ . . . . @ @ . . . @ . . @ @ . . . @ @ . @ . @ . @ . @ . . @ . @ . @ @ . @ . . @ . @ @ @ @ @ @ . . . . @ . . . . @ . . @ . . @ @ @ @ @ . . @ . @ . . @ @ 
@ @ @ . @ . @ @ @ . @ . @ @ . @ @ . . . . . @ . @ . @ . . . @ . @ @ . @ @ . . @ . . @ . . . @ . . @ . . @ @ @ @ @ @ . @ @ @ . @ . @ @ . @ @ . @ @ @ @ @ @ @ . @ . . @ . . @ . . @ @ @ . @ @ . . @ . @ @ 
@ @ @ . @ . . @ @ @ . . . . . . @ @ . @ . @ @ . @ . @ . @ . . @ . . . . @ . @ . . @ . . @ . @ @ . . @ . . @ . @ @ . . . . . . . @ @ . . . . . . . . . . . . . . @ . . . @ . . @ . . @ . . . @ . . @ . @ 
@ @ . . . . @ @ @ @ @ . @ . @ @ . @ . . @ . . . . . . @ @ . @ . @ . @ . @ @ . . @ @ @ . . @ . @ . @ @ . @ @ . . . @ . @ . @ . @ @ @ @ . @ @ . @ . @ . @ . @ . @ . @ . @ . @ . @ . @ @ . @ . . @ . @ . @ 
@ @ @ @ . @ @ @ @ @ @ @ . . . @ . . . @ . @ . @ @ . @ . @ @ @ . . . . @ . . @ . . @ . @ . @ . . . @ . . . . . @ . @ @ . @ . . . @ @ @ @ . . . @ @ @ . @ @ . . . . . . . . . . . . @ . @ @ . @ @ @ @ . @ 
@ @ @ . . @ @ @ @ @ @ @ @ . @ . . @ . @ . @ @ @ @ . . . . . . . @ @ @ @ . @ . . @ @ . . . @ . @ . @ @ . @ . @ @ . . . . . @ . @ @ @ @ @ @ . @ @ @ @ . . @ @ . @ . @ . @ @ . @ . @ . . . . @ . @ . . . @ 
@ @ @ @ . . @ @ @ @ @ @ @ @ . . @ @ . . . . . @ @ @ . @ . @ . @ . @ . . . @ @ . . . @ @ . . @ @ @ @ @ . . @ . . . @ . @ . . @ . . @ . . . . @ @ @ . . @ . . . . @ @ . . . @ . @ . @ . @ . @ . . @ @ . @ 
@ @ @ @ . @ @ @ @ @ @ @ @ . . @ @ . . @ . @ . . @ @ . . @ @ . . . . @ @ . . . . @ . @ . . @ . . . @ . . @ @ @ . @ . . @ @ @ @ @ . . @ @ . @ . . . . @ . . @ . @ @ . . @ . . . . . . . . @ . . @ . . . @ 
@ @ @ @ . . @ @ @ @ @ @ @ @ . . . @ . . @ . . @ . . @ . . . @ @ . @ . @ . @ @ . . @ @ @ . . @ . @ @ @ . . @ . . . @ . . @ @ @ @ . @ @ @ @ @ @ . @ . @ . @ . . . @ @ . . @ @ . @ . @ @ . . @ . . @ @ . @ 
@ @ . . . @ . @ . @ . @ @ @ . @ @ . . @ @ @ . . . @ . . @ . . . @ @ . . . . @ @ . . @ . . @ . . @ @ @ @ . @ @ . @ . @ . @ @ @ . . . @ @ @ @ @ @ . @ @ @ . . @ . @ . . @ @ @ . . @ @ . . @ @ . @ . @ . @ 
@ . . @ . . . . . @ . . @ @ . @ . @ . . @ . . @ @ @ @ . . @ . @ . . . @ . @ . . . @ @ @ . @ . @ . . @ . @ . . . . . @ . . . . @ . @ . @ . @ @ . . . @ . @ . @ . . @ . @ @ . . @ @ @ @ . . . . . . . . @ 
@ @ . . @ @ . @ @ . . @ @ @ @ @ . . @ . . @ . @ @ @ . . @ . . @ @ . @ . . @ . @ . . @ . @ @ . @ . @ . . @ . @ @ @ . @ @ . @ . . . . . . . . . . @ @ . . . . @ . @ @ . . . @ . . @ . @ . @ @ . @ . @ . @ 
@ @ @ . @ . . . . @ . . @ @ @ @ @ . @ . @ @ @ . @ . @ @ . . @ @ @ . . @ . @ . @ @ . . . . . . . . . . @ @ @ @ @ . . . @ . @ @ @ @ . @ @ . @ . @ . @ @ . @ . @ . . . @ . @ @ . @ @ . . . @ . . . @ . . @ 
@ @ . @ . @ . @ . . @ . @ @ @ @ . . . . @ . @ . . . . . @ . @ @ . . @ . . @ . @ . . @ . @ . @ . @ . @ @ @ . @ @ . @ . . @ . . . . @ . . . . @ . . . . @ @ . @ . @ . . @ . @ @ . . @ @ . . @ . @ @ @ . @ 
@ . . . . @ @ . @ . @ . . @ @ @ @ . @ . . . . . @ @ . @ . . . . @ @ . @ . @ @ @ @ . . @ . . @ . @ . . @ . . . . @ . . @ . @ . @ . @ . @ . @ . . @ . @ @ @ @ . . . @ . . . . @ . @ . @ @ . . @ . @ . @ @ 
@ . @ @ . . . . . . . . @ . @ @ @ . @ . @ . @ . @ . . . @ . @ . @ . . . . @ @ @ . . @ . @ @ @ . . @ . @ . @ @ . . @ . . . . . . @ . @ . @ . @ . . @ @ @ @ @ @ . @ @ @ . @ . . . . . . . @ . . . . . . @ 
@ . @ . . @ @ . @ . @ . . . . . . . . @ . @ . @ @ . @ @ . . @ . @ @ @ . @ @ @ @ @ . . . @ . @ @ . . @ @ . . @ . @ . @ . @ . @ . . . . . . . . @ . . . . @ @ . . . @ . . . @ . @ . @ @ . . @ . @ @ @ . @ 
@ @ . @ . . . @ . . @ @ @ @ @ . @ . @ . . . . . @ . @ . . @ . . @ . . . . @ . . . . @ . @ . . . . @ . . . @ @ . @ . @ @ @ @ . @ . @ . @ . @ @ @ @ @ @ . @ . @ . @ @ @ . @ . . . @ @ . . @ . @ . @ @ @ @ 
@ . . . . @ @ . @ . . @ . @ @ @ . . . . @ . @ . . @ . . @ @ @ . @ . @ . @ . . @ @ . . @ @ @ @ . @ . @ . @ . @ @ @ . . . @ . . . . @ . @ . . . . @ . . . . . . . . . . @ . @ . @ . . @ . @ . . . . @ @ @ 
@ . @ @ . @ . . . . @ @ . . @ . . @ . @ . @ @ @ @ @ @ @ @ @ @ . . @ @ . . @ . @ @ . @ @ @ @ @ . . . . . . . . @ . . @ @ . @ @ @ . . @ . . @ . @ @ @ . @ @ . @ . @ . @ . . . . @ @ . . . . . @ . @ @ . @ 
@ @ @ @ @ . . @ @ . . @ . @ . @ . @ . . . @ @ @ @ @ @ @ @ @ . . @ . @ @ @ . @ . . . @ @ @ @ @ . @ . @ . @ . @ @ . @ . @ . @ @ @ @ . @ @ @ . . . @ . . . . @ @ . . @ @ @ @ . @ . @ @ @ . @ @ @ . . . . @ 
@ @ @ @ . @ . . . @ @ . . . . . . . @ . @ @ @ @ @ @ @ @ @ @ @ . @ . @ @ @ . . @ . @ . @ . @ @ . . @ . . @ . . . . . . . . . @ . . . . . @ @ . @ . @ . @ @ . . . @ . . . @ . . . . . @ . . . @ @ . @ . @ 
@ @ @ @ . . @ @ @ . . @ @ @ . @ . @ . . . @ @ @ @ @ @ @ @ @ . . . . . @ . @ . @ . @ . . . . . . @ @ @ . @ @ . @ . @ . @ . @ . . @ @ . @ . @ . @ . . . . @ . @ . @ . @ . @ @ . @ @ . . @ . @ @ . . . @ @ 
@ @ . . . @ @ @ . @ . @ . . @ . . @ @ . @ @ @ @ @ @ @ @ . @ @ . @ @ @ . . . . . . . @ @ . @ . @ . @ . @ @ . . . @ @ . . @ @ @ . @ . . . . . @ . . @ . @ @ @ . . . . . @ @ . . @ @ . @ . . @ . @ @ @ . @ 
@ . @ . @ @ . . . . . @ . @ . @ . @ @ . @ . @ . @ @ @ . . @ @ @ . . . . @ @ @ @ . @ @ . @ . . . . . . @ . @ . @ . @ . @ @ @ . . . @ . @ . @ . . @ @ . . @ @ @ @ . @ . . @ @ . . . @ @ @ . . . . . . . @ 
@ . . . . . . @ . @ . . . . . . . @ . . . . . . . @ . @ . . @ . @ @ . @ . @ @ @ @ @ . . @ @ @ . @ . @ @ . . @ . . . . . @ . . @ . . @ @ @ . . @ . . . @ . . . . . . @ @ . . . @ . @ @ . . @ @ . @ . @ @ 
@ . @ . @ . @ . . @ . @ . @ . @ . . @ . @ . @ . @ . . . . @ @ . . . . @ . . . . @ . @ . . @ . . . @ @ . @ . @ @ @ @ . @ @ @ . @ . @ @ @ @ . @ @ . @ . @ . @ . @ . @ . @ . @ . . @ @ @ @ . . . @ @ . . @ 
@ . @ @ . . . @ . . @ . . . @ . . @ . . . @ . . @ @ . @ @ . @ @ . @ . . . @ @ @ . . . . @ . @ . @ @ . . @ . . . @ @ @ . @ . @ @ . . @ @ . . @ @ @ . . @ @ . @ . . @ . @ @ . . @ . @ @ . . @ . . . @ @ @ 
@ @ . . . @ . @ @ . . @ . @ @ @ . . @ . @ @ @ . . . . . . . . . @ . . @ . . . . @ . @ . . . . . . @ @ . . @ . @ . . . . . . . . @ . @ . @ . . . @ . @ . . . . . @ . . . . @ . . . . . @ . @ . @ . . @ @ 
@ . @ . @ . . @ . @ . . @ . . . . @ . . . . . @ @ . @ . @ . @ . . @ . . @ . @ @ @ @ . . @ . @ . @ . . @ . . . . . @ @ . @ @ @ . @ . @ . . @ . @ . . . @ . @ @ . . . @ . @ . . @ . @ . @ . . @ . . @ . @ 
@ . . @ . . @ @ . @ @ . . @ @ . @ @ @ . @ . @ . . . @ . @ @ @ @ @ . . @ . . . . . . @ . . @ . . @ . @ . @ @ . @ . . . @ . . @ @ . @ @ @ . @ @ . @ . @ . @ . . . @ . . @ @ @ . @ . . @ . . @ @ @ . . . @ 
@ . @ @ @ . @ . . . @ @ @ . @ . . @ . . . @ . @ . @ @ . . . @ @ @ @ . . @ . @ . @ . @ . @ @ @ . . . . . . @ . . @ . @ . @ . . @ . . @ . . . @ . . . @ . @ . @ . @ @ . . . . @ @ . @ . @ . . @ . . @ . @ 
@ . @ @ @ . . @ . @ @ . . . . . @ . @ . @ . . . @ @ @ @ . @ @ @ @ . . @ . . . @ . . @ . . @ . @ . @ . @ . @ . @ . @ . . . . @ . . @ . @ . @ . @ @ . . . . @ . . . . @ . @ . . . @ . . . . @ @ . @ @ . @ 
@ . . @ . . @ @ . @ . @ @ . @ . @ . . . . . @ @ @ @ @ @ @ @ @ @ @ . @ . @ . @ @ @ . . @ @ . . . . . @ @ . . . . . . @ . @ @ . @ . . . . . . . . @ . @ @ @ . @ . @ @ . . . @ . @ . . @ . @ . @ . . @ . @ 
@ . @ @ @ . @ . . . . . . . . @ @ . @ . @ . . . . @ @ @ @ @ @ @ @ @ @ . . . . . . @ @ . @ @ @ . @ . . . @ . @ . @ . . . . . . . . @ . @ . @ @ @ @ . @ . @ . @ . @ . . @ . . @ @ . @ . . . . . @ . @ . @ 
@ . . @ . . @ @ @ . @ . @ . @ @ @ . @ . . @ . @ @ @ . @ @ @ @ @ @ @ @ @ @ . @ . @ . . . . . . . @ . @ . . @ . . . @ . @ . @ . @ @ @ . . @ @ . . @ . @ . . . . . @ @ . @ . @ @ @ @ . . @ . @ . . @ . . @ 
@ . @ . @ . . . @ . . @ . . . . @ @ @ . @ @ . @ @ @ . . @ @ @ @ @ @ @ . . . . @ @ . @ . @ . @ . @ . @ . @ . @ @ @ . . . @ @ . @ @ . @ @ . @ . @ . @ @ . @ . @ . @ . . . @ @ @ @ @ @ . . @ . . @ @ @ . @ 
@ . . . . . @ . . @ @ . @ . @ @ . . . . . @ . . @ . @ . . . @ . @ @ @ @ . @ @ @ . @ @ @ . . . @ @ . . @ @ . @ . . . @ . @ @ . . . . . . . . . . . . . @ . . @ . @ @ . @ @ @ @ @ @ . . @ @ @ . . . @ . @ 
@ . @ . @ . . @ @ @ @ . . . . @ . @ @ . @ . @ . . . . @ @ . @ . . . . . . @ . . . . . . @ . @ . @ @ . @ . . . . @ . @ . . . @ . @ @ . @ . @ . @ . @ . . @ . @ . . @ . @ @ @ @ @ . @ . @ @ . . @ . @ . @ 
@ . . @ . . @ . @ @ . . @ . @ @ @ . . . @ . @ . @ . @ @ . . . . @ . @ @ . @ @ @ . @ . @ @ @ . . . . . . @ @ . @ . . . @ . @ @ @ . . . . @ . . . @ . . @ . @ . . @ . . . . @ @ @ . @ . @ @ @ . @ . @ . @ 
@ . @ @ @ . . . . @ @ . @ . . . @ @ @ . . . . @ . . . . @ . @ . @ @ . . . @ . . . @ . @ @ . @ . @ . @ @ . @ @ . @ . @ @ @ . @ @ @ @ . @ . @ . @ . @ . . . @ . @ @ @ . @ . . . . . @ @ @ @ . @ @ . @ . @ 
@ . @ . @ . @ @ . . . @ . @ . @ . . . . @ . @ @ @ . @ @ @ . . @ . . . @ . . @ . @ . @ . . . . . @ . . . . . @ . @ . . . . . . . . . @ . . @ . . . @ . @ @ . . @ @ @ . . @ @ @ @ . . . @ . . . . . . @ @ 
@ @ . . . . @ . . @ @ . . @ . @ . @ . @ . . . . . @ . . . . @ @ @ . @ . . @ @ . . . . @ . @ . @ . . @ . @ . . . . @ @ @ . @ . @ . @ . . @ . . @ . @ . . . @ . . @ @ . @ . . . . . @ @ . . @ . @ . @ @ @ 
@ . . @ . @ . @ . . . @ . . . . @ . . @ @ . @ . @ @ @ . @ . . . . @ . . @ . @ . @ @ @ . . . @ @ @ . . @ . . @ @ @ . . @ . @ . . @ . @ . @ @ . . @ . . @ @ . @ . . . @ . . @ . @ . @ @ @ . . @ . @ @ @ @ 
@ @ . @ @ . . . . @ @ @ . @ . @ @ @ . . @ . @ . . . @ @ . . @ . @ . @ . . . . . . . . @ . @ . @ . . @ @ @ . @ @ . . @ . . . @ . @ . . . @ . . @ . @ . @ @ . . . @ @ @ . @ @ . . @ . @ . @ @ @ . @ @ @ @ 
@ . . . . @ . @ . @ . @ @ @ . @ . . . @ . . . @ . @ @ @ @ . . @ @ . . . @ . @ . @ @ . @ . . . @ @ . . @ . . . . @ . @ . @ . @ . . . @ @ @ @ . . . . @ . . . @ . @ @ @ . @ @ @ . . . . . . . . . @ @ @ @ 
@ @ . @ @ . @ . @ @ . . . @ @ . . @ . @ . @ . . @ @ @ @ . . @ @ . . @ . . @ . . . . @ . . @ @ @ @ . @ @ @ . @ . . . . @ . . @ . @ . @ @ . @ . @ . @ @ @ . @ . . . . . @ . . . . @ . @ . @ . @ . @ @ @ @ 
@ @ . . @ . @ . @ . @ . @ . . @ . . @ . . . @ . . . . . @ . . . @ . @ . @ . . @ @ . @ . @ . . @ @ @ @ @ . . . @ . @ . . @ . . @ @ @ . @ . . . . @ . @ . . @ @ . @ . @ . @ . @ . @ @ . @ @ . . @ @ @ @ @ 
@ . @ @ . . . . . . . . . @ . @ . @ @ @ . @ . @ . @ . @ @ . @ @ @ @ . . . @ @ . . . . @ @ . @ . @ . @ . @ @ . @ . . @ @ @ @ . @ . @ . . @ @ . @ . . . . @ . . . @ . . . . @ @ . @ @ . @ . . @ . @ @ @ @ 
@ . . @ . @ . @ . @ . @ . . . . . . @ . . . . @ . . @ @ @ . @ . @ . @ . @ @ @ @ @ . @ . @ . . . @ . . . . . . . @ . @ @ @ . . . . . . @ @ . . @ @ @ . @ . . @ . . @ @ . @ . . . . . . . @ . . . . @ @ @ 
@ @ . . . . @ . . . @ . . @ . @ . @ @ @ . @ @ . . @ @ @ . @ @ . . . . . . @ @ @ . . . . . . @ . @ @ . @ . @ . @ @ . @ @ @ @ . @ . @ . . . @ . @ . @ @ @ . @ . . @ @ @ @ . . @ . @ @ . @ @ . @ . @ @ @ @ 
@ . . @ . @ @ @ . @ @ @ . @ . @ @ @ @ . . @ @ @ . . @ . . . . . @ . @ . @ @ @ @ @ . @ . @ . . @ . . . . @ . . . . @ @ @ @ . . . @ @ . @ . @ . . . . . . @ . . @ @ @ @ @ @ . . @ @ . . . . @ @ @ @ @ @ @ 
@ @ @ @ @ @ @ @ @ @ @ @ @ @ @ @ @ @ @ @ @ @ @ @ @ @ @ @ @ @ @ @ @ @ @ @ @ @ @ @ @ @ @ @ @ @ @ @ @ @ @ @ @ @ @ @ @ @ @ @ @ @ @ @ @ @ @ @ @ @ @ @ @ @ @ @ @ @ @ @ @ @ @ @ @ @ @ @ @ @ @ @ @ @ @ @ @ @ @ @ 
3
16 33 93 82
5 73 61 41
17 13 63 49
