100 100
@ @ @ @ @ @ @ @ @ @ @ @ @ @ @ @ @ @ @ @ @ @ @ @ @ @ @ @ @ @ @ @ @ @ @ @ @ @ @ @ @ @ @ @ @ @ @ @ @ @ @ @ @ @ @ @ @ @ @ @ @ @ @ @ @ @ @ @ @ @ @ @ @ @ @ @ @ @ @ @ @ @ @ @ @ @ @ @ @ @ @ @ @ @ @ @ @ @ @ @ 
@ . @ . @ . @ . @ @ . @ . @ @ . . . . . @ . . @ . @ . @ @ @ @ @ @ @ @ . @ @ @ . . @ . @ . . . . @ @ @ . @ . @ @ . @ @ @ . @ . @ . @ @ . @ . . @ . . . @ . @ . . . . . . @ @ @ @ . . . . . . . @ . . @ @ 
@ . . . . . @ . . @ . . . . . . @ . @ @ @ @ . . . @ . @ @ @ @ @ @ @ . . . @ @ @ . @ . @ . @ . @ @ @ . . @ . . @ . . @ . . . . @ . . @ . . . @ @ @ . @ . . . . @ . @ @ . @ @ . @ . @ . @ . @ . @ . @ . @ 
@ @ . @ @ . . . @ . . @ @ . @ . . @ @ @ @ @ . @ . . . . . @ @ @ @ @ @ . @ . @ . . . . . . . @ @ @ . @ . @ . @ . . @ . @ . @ @ @ . @ . @ @ . . @ . . . . @ . @ @ @ . @ @ . . . . . @ . . @ . . . . . . @ 
@ @ @ @ @ @ @ . . . @ @ @ . . @ . @ @ @ @ . . . @ . @ . @ @ @ @ @ @ . . . . . @ @ . @ @ @ @ . @ . . . . . . . @ . . . . . . @ . . . . @ . . @ @ @ . @ @ . @ @ @ @ . . @ . @ . @ @ . @ @ . @ . @ . @ . @ 
@ @ @ @ @ @ . . @ . . @ . . @ @ @ @ @ . . @ @ . @ . . @ . @ @ @ @ . @ . @ @ @ . . . . @ . . . . @ . @ @ . @ @ @ . @ . @ . @ @ @ . @ . . @ . @ @ @ . . @ . . @ @ @ . @ @ @ @ . @ . . . @ . @ . @ . . @ @ 
@ @ @ @ @ @ @ . . @ @ . . @ @ @ . @ . @ . . @ . . @ @ @ . . @ . . . . . . @ @ @ @ @ . . @ . @ . . @ . . . . . @ . @ @ @ . . @ . . @ @ @ @ . . . . . @ . . @ . . . . @ . . . . . @ . @ @ . . @ . @ . @ @ 
@ @ @ @ @ @ @ @ . @ @ @ . . @ . . . . . @ . @ . @ @ @ . . @ . @ @ . @ . @ . @ @ @ . . @ . @ @ . @ . @ @ . @ . . @ @ . . @ . . . @ . @ . . @ @ . @ @ . . @ . @ @ @ . @ . @ @ . @ . . . . . @ . . . @ @ @ 
@ @ @ @ @ @ @ . . . @ @ @ @ . @ @ . @ . . . . . . @ . @ . . . . @ @ . . . . . @ . @ . @ . . @ . . . . . @ . . @ . . . @ @ @ @ . . . . @ . . . . . @ . @ . . . @ . . @ . @ . . . . @ @ @ @ @ @ . @ @ @ @ 
@ @ @ @ . @ . @ . @ @ @ . . . . @ @ @ . @ @ @ @ . . . . @ @ . @ @ . @ . @ @ @ . . . . . . @ . . @ @ . @ @ @ . . @ @ . @ @ . . . @ . @ . @ @ @ . @ . . . . @ @ . . @ @ . . @ . @ . . . . @ . . . @ @ @ @ 
@ @ @ @ . . . . . @ @ . @ . @ . . @ . . . @ . @ @ . @ . . . . . . . . . . @ @ @ @ @ . @ . . @ . . . @ . . . . @ . . . . @ @ @ . . @ . . . . . . . . @ @ @ @ @ . @ . . . @ @ . @ @ . @ @ . . @ @ . @ @ @ 
@ @ @ . @ @ . @ . . . . @ . @ . @ . @ . @ @ . . @ @ @ @ @ @ @ . @ . @ . @ @ @ . @ @ @ . . @ . @ @ . @ . @ @ . . . @ @ @ @ @ . . @ . . @ . @ @ @ . @ . @ . @ . . . @ . @ . @ @ @ @ @ @ . @ . . @ . @ @ @ 
@ . . . @ . @ @ @ @ @ . . @ . . . . . @ @ @ . @ @ @ @ @ . . @ @ @ @ . . . @ . . . @ @ . @ @ . @ . . . @ @ . @ @ . . . @ @ . @ . @ . @ . . . @ . . @ . . . @ . @ . @ . @ . @ . @ @ @ . . . . @ . . . @ @ 
@ . @ . @ . . @ . . @ . @ @ @ . @ . @ . @ . . @ @ @ @ @ @ . . . @ . @ . @ . @ . @ @ . . . . . . @ . @ @ . . . @ . @ @ . . . . . . @ . @ . @ . @ . @ . @ . . @ . . . . @ . . . . @ . @ @ @ . . . @ @ . @ 
@ @ @ . @ . @ . @ . @ . . @ @ @ . . @ . . . @ @ @ @ @ @ . . @ @ . . . . . . . . . @ . @ . @ @ . @ . . @ . @ . . . @ . @ @ . @ . @ @ . @ . . . . @ @ @ . . @ . @ . @ . @ . @ @ . . . . . . . @ @ . @ . @ 
@ @ @ . @ . @ . . . @ . @ . @ . @ . . . @ @ . @ @ @ @ . @ . . . @ @ @ . @ . @ . @ . @ @ @ . . . . . @ @ @ @ @ @ . . . @ . @ @ . . @ . . . @ @ @ . @ @ @ . . . . . . @ . . . . @ . @ . @ @ . . . . . . @ 
@ @ . . @ . . . @ @ . . . . @ . @ @ . @ @ . . . @ @ . . . . @ @ . . . @ @ @ . . . . @ @ . @ @ . @ . . @ @ @ @ @ . @ . . . . @ . @ @ @ @ . . @ . . . @ . . @ . @ . @ . . @ @ @ . . . @ @ @ . @ . @ . @ @ 
@ . @ . @ . @ @ . @ @ . @ . . . @ . . . . @ @ . . . @ . @ . @ . @ @ . @ @ . @ . @ . . @ . . . @ . @ . . @ @ @ . @ . . @ . @ . . . . @ . . @ . @ . @ . @ . @ . . @ @ @ . . @ . @ . @ @ @ . . . @ . . @ @ 
@ . . . . . . . . . @ @ . @ @ . . @ . @ . . @ . @ . . @ . . . . . . . @ . . . . @ @ @ . @ . @ . . . . @ @ @ . . . @ . . @ . . @ @ @ . @ . @ . @ . @ . @ . @ . @ . . . . @ @ . @ @ @ @ . @ . @ @ . @ . @ 
@ . @ @ . @ @ . @ @ @ @ . @ . @ . . . @ . @ @ @ . . @ @ @ @ . @ @ @ . . @ @ @ . @ @ . . . . . @ . @ . . @ @ @ @ . . . @ . . @ . . @ . . . . . . . . . @ . . @ @ @ @ @ . @ . . . . @ . . . @ . . . . . @ 
@ . @ . . . @ . @ @ @ . . . . @ @ @ . @ @ @ @ . @ . . @ @ @ @ @ @ . @ . . @ . . . . @ @ . @ . . @ . . @ @ @ @ @ . @ . @ @ . @ @ . . . @ . @ . @ . @ . @ @ . @ . @ @ . . . @ . @ @ . @ . @ . @ @ . @ . @ 
@ @ . @ . @ . @ . @ @ @ . @ . . @ . . . @ @ . . . . @ @ @ @ @ @ . . . . @ . @ . @ @ . @ . @ . @ @ @ . . @ . @ . @ . . @ . . . @ . @ @ . @ @ @ @ . . @ . @ . . . @ . @ . @ . . . @ . . . . . . @ . . @ @ 
@ . . . . . . . . . @ @ . @ . @ . @ @ . @ . @ . @ @ @ @ @ @ @ @ @ . @ . @ . . . . @ . . @ . . . @ . . @ . . . . . @ . . @ . @ @ . . @ . @ @ @ . @ @ . . @ . @ @ . . . . . . @ @ . . @ @ @ @ . @ @ @ . @ 
@ @ . @ . @ @ . @ . . . @ . . . . . @ . . . . . . . @ . @ @ @ @ @ . . @ . @ @ . @ . . @ . @ . @ @ @ . @ @ @ . @ . @ . @ . . @ @ . @ . . . @ . . @ . @ . @ . . @ . @ . @ @ @ . @ . @ . @ . @ @ . @ . . @ 
@ . @ @ . . . @ . . @ @ . @ . @ . @ . @ @ . @ . @ . @ . . @ . @ . @ . . . @ . . . . @ . . . . . . @ . . . @ @ @ . @ . . . @ . . . . @ . @ . @ . . . . . @ . @ . . . @ . . @ . . . . . . . @ . . . @ . @ 
@ . . . @ . @ . @ . . . . @ @ . . . . @ @ . . @ . . . . @ @ . . . . @ . @ @ . @ . @ @ @ . @ . @ . . . @ . @ @ . . . @ @ . . @ @ . @ . . . . @ @ . @ @ . . . . . @ @ . @ . @ . @ . @ . @ . . . @ . . . @ 
@ @ . @ @ @ . . . @ . @ . . . @ . @ . @ @ @ @ . . @ @ . @ . @ . @ . . . . . . @ . . @ . . . @ . . @ . . @ . . @ . @ . . . @ . . . . . @ . @ @ . . @ . @ . @ . @ . @ . . . . . @ @ @ @ @ . @ @ . . @ . @ 
@ . . . . . . @ . @ @ . . @ @ . . @ . @ @ @ . @ @ . . . . . . @ . @ . @ . @ . @ @ . . @ . @ @ @ @ . . @ @ @ . . . @ @ . @ @ @ . @ . @ @ @ . @ . @ . . . . . @ @ . . . @ . @ @ . @ @ . @ . . @ . @ . @ @ 
@ . @ @ @ . @ . . @ . @ . @ @ @ . @ . @ @ . . . @ . @ . @ . @ . . . . @ @ . . . . @ @ @ @ . @ . @ @ . @ . . @ @ . . @ . . @ . . . @ @ @ @ . . @ . . @ . @ @ . . . @ @ . @ . . . . . . @ . @ . . . . . @ 
@ . @ . @ @ . @ . . . . . @ . @ . @ . . . @ @ . @ @ . . @ . @ . @ @ . @ . @ . @ . @ . . . . . . @ . . . . @ @ . . @ . . @ . @ @ . @ . @ @ . @ . @ . . @ @ . . @ . . . . . @ . @ . @ . @ . @ . @ @ @ @ @ 
@ @ . . . @ . . @ . @ @ . @ . @ @ . @ @ . @ . . . . @ @ . . . @ . @ @ . . . . . @ @ @ . @ . @ @ . @ . @ . @ @ . @ . @ . . . . @ . @ . @ . . . . . . @ . . @ . @ . @ . @ . @ @ . @ . . . . . @ . . @ @ @ 
@ @ . @ @ . @ . @ . @ . . . . . . . . . . . @ . @ @ @ . @ . @ . . @ . . @ @ . @ . @ @ @ . . . @ . . @ . . . . . . . . . @ . @ . . @ . . @ @ . @ @ . . . @ . . . @ . . @ . @ @ . @ @ @ @ . @ @ @ . . @ @ 
@ . . . . . . . . @ . @ . @ . @ . @ @ @ @ . . . . . . . . . . @ . . @ @ @ @ . . . . @ . @ . @ . @ . . @ . @ . @ . @ @ . @ @ @ . @ . . @ @ @ . @ . . @ @ . . @ . . @ . . @ . . . @ . . . @ . @ @ . @ . @ 
@ @ @ . @ @ @ . @ . . @ @ . . @ @ . @ @ . @ @ . @ @ @ @ . @ . . @ . @ @ @ . . @ . @ @ . . . . . . . @ . @ . @ @ @ @ . . . . . . . @ . . @ . @ @ . @ . @ . @ . @ . . @ . . @ @ . . @ @ . . . . . . . . @ 
@ . . @ . @ . . . @ . @ . . @ . . . @ . . @ . . @ . @ @ @ @ @ . @ . . @ . @ . . @ @ . @ . @ . @ @ . @ . . . . @ @ @ @ . @ @ . @ @ @ . @ @ . @ . . . . . . . . . @ . @ . @ @ . . @ . . . @ . @ . @ . @ @ 
@ . @ . . . . @ . @ . @ @ @ . @ @ . . @ . . @ . . . @ . . @ . . . . @ . . . @ . @ . . . . @ @ . . . . @ @ . @ @ @ @ @ . @ . . @ . . . . @ . . . @ @ @ @ . @ . @ . @ @ @ @ @ @ . . . @ @ . @ . . @ @ @ @ 
@ . . @ . @ @ . . . . . . . . . @ @ . @ . @ . @ @ . . . @ . @ . @ . . @ @ . . . . . @ @ . @ @ @ . @ . @ . . . @ @ @ . @ @ @ . @ . @ . @ . . @ . . . . . @ @ . . . . @ . @ @ . . @ @ . @ . . @ . . . @ @ 
@ @ . @ @ @ . @ @ . @ @ . @ . @ . . . . . . . . @ . @ @ . . @ @ @ @ . . . . @ @ @ . . . @ @ @ @ @ @ . . @ . @ . @ . . . @ . . @ . . @ . . @ . . @ . @ @ . . . @ . @ @ . . @ @ . @ . . . . @ . . @ . . @ 
@ @ . . @ . . . @ . . @ @ . . . @ @ @ @ . @ . @ @ @ @ @ . @ @ @ . . @ . @ . @ . @ . @ . @ @ @ @ @ @ @ . . . @ . @ @ . @ . @ . @ . @ @ . @ @ @ . @ . . . @ @ . . @ @ @ . @ . @ . . @ . @ . @ @ . . @ @ @ 
@ . . @ . @ . @ . @ @ . . @ . @ . @ @ . @ . . @ . . @ . . @ . @ . @ @ @ @ @ . . @ . . @ @ @ . @ @ @ . @ @ . @ . . . . . . @ . @ . . @ . . @ . . . @ . @ @ @ @ . . @ . . . . @ . @ . . @ @ @ @ @ . @ @ @ 
@ . @ . . . . . . @ . @ . @ . . . . @ . . @ . . . @ . @ . . . . . @ @ @ @ . @ . . @ @ @ @ . . @ @ @ . @ . . . . @ @ . @ @ . . @ . @ @ . @ @ @ . @ . @ @ @ @ @ @ . @ @ . @ @ . . . . @ @ @ @ @ @ . . @ @ 
@ . . @ @ @ @ @ . . . . . . @ . @ @ . @ . @ @ @ . . . @ @ . @ . @ @ . @ . . . . @ . @ @ . @ . @ @ . . . @ . @ . @ . @ @ @ @ . . . @ . . . @ @ @ . . . @ @ @ @ . . . . . . . . @ . @ . . @ . @ . @ . @ @ 
@ @ . . . . . . . @ @ @ @ . . . . . . . . @ . . @ @ . . . @ . . . . . . @ . @ . . . . @ . . . . . @ . @ @ @ . . @ . . @ @ . @ . @ . @ . @ . @ . . @ @ @ @ @ . @ . @ . @ . @ . . @ @ @ . @ . . . . @ . @ 
@ . @ @ @ @ @ @ @ . . . . . @ . @ @ @ @ . . @ . @ . @ . @ . @ . @ . @ . . @ @ . @ . @ @ @ . @ @ @ . . . @ . @ . @ . @ . . . . . . . . . . . @ @ . . . @ . @ . . . . @ . . @ . @ . @ . . . . @ @ @ @ . @ 
@ . . . . . . . . . @ . @ . @ @ . . . . @ . . . . . . . . . . @ @ @ . . @ . . . . @ @ @ @ . . @ . . @ . . . @ . . . . . @ @ . @ . @ . @ . @ . . . @ @ . . . . @ . @ . @ @ . . . . @ @ . @ @ . . . @ . @ 
@ @ . @ . @ @ . @ @ . @ . @ . @ @ . @ . . . @ . @ @ @ . @ . @ @ @ . @ . . @ @ . @ . @ @ . . @ . @ @ . . @ @ . @ . @ @ @ . @ @ . . . @ @ . @ . @ . @ . @ @ . @ . . . . @ @ @ . @ . @ @ . @ @ @ @ . . . @ 
@ . . . @ @ . @ . @ . @ . @ . @ . @ . @ . @ @ @ . . . @ . . . . . . . @ . @ . . . . . . . @ . . . . @ . . . . . . . . . . . @ @ . @ . @ @ . @ . . . . @ . . @ @ . @ . . @ . . . @ . . . @ @ @ . . @ @ @ 
@ @ @ @ @ @ . . . . . . . . . . . . . . . @ @ . @ . @ . @ . @ . @ @ . @ . . @ @ @ . @ . @ . . @ . @ . @ . @ . @ . @ @ . @ @ @ @ . . . . . . . . @ . @ . @ @ . . . @ @ . . @ . @ @ @ @ . . . . @ . . . @ 
@ @ . @ . @ . @ @ . @ . @ . @ @ . @ @ . @ . . . . . @ . @ . . @ . . . . @ . . @ . . . @ . @ @ . . . . . . . @ . . . . @ @ . . . @ @ @ @ @ @ . @ . . . . . @ . @ . . @ . @ . . . . @ . @ . @ @ @ . @ . @ 
@ @ . . . . . . . @ . . . @ . . @ . @ @ @ . @ @ @ . . . . @ @ . @ . @ . @ . @ . @ . @ . . . . . @ . @ @ @ . . @ . @ . . . @ @ . . . . . . . @ @ @ . @ . @ . . @ . @ @ @ @ @ . @ . . . . . . . . . . @ @ 
@ . . @ . @ . @ @ . @ @ . . @ . . . . @ @ @ . @ . @ @ . @ @ @ . @ @ . . . . . . . . . . @ . @ . @ . @ . . . @ . . . @ . @ . @ . @ . @ . @ @ @ @ @ @ @ @ . . @ . . . @ @ @ . . . @ . @ . @ @ @ . @ @ @ @ 
@ . @ @ @ . . @ . . . . @ @ . @ @ . @ @ @ . . @ . @ . . . @ . . . @ . @ . @ . @ . @ . @ . . . @ . . @ . @ . @ . @ . @ . . . . . . @ @ @ @ . @ . @ . @ . @ . . @ . @ . @ . @ . @ . . @ @ @ @ @ @ @ @ @ @ 
@ . . @ . @ @ . @ @ . @ . @ . . . . . @ . . @ @ . . @ . @ . @ @ . . @ . . . @ @ @ . . . @ . @ . @ @ @ @ @ @ @ @ . . . @ . @ . @ @ . @ . @ . . . . . . . . @ @ . . . . . . @ @ @ . @ . . @ @ @ . @ @ @ @ 
@ @ @ . . . . . . . . . . . @ . @ . @ . @ . @ . @ . @ . @ . @ @ . @ . . @ . . @ . @ . @ @ . . . @ @ @ @ @ . @ . @ . @ . . . @ . . . . . . . @ . @ @ @ . @ @ @ @ @ . @ . @ . . . . @ @ . . @ @ . . @ @ @ 
@ . . . @ @ . @ . @ @ . @ . @ @ @ . . . . . . . . . . . . . . . . . . @ . . @ . . @ @ . . . @ . @ @ @ . . . . . . @ . @ . @ @ . @ . @ . @ . . @ @ . . . . @ @ @ @ @ @ @ @ @ . @ . . . . @ @ . . @ . . @ 
@ . @ . . . @ @ @ . . . @ . . . . @ . @ @ . @ . @ . @ . @ . @ . @ . @ @ @ . @ . @ . . @ @ . . @ @ @ @ @ . @ . @ . @ . @ @ . @ @ @ @ @ @ . @ . . . @ @ . @ @ @ @ @ @ @ @ . @ @ . . @ . @ . . @ . . . @ @ 
@ . . @ . @ @ @ @ @ . @ . . @ . @ . . . @ . . @ @ @ . . @ . @ @ . . . @ . . @ . @ . @ . . . @ @ @ @ @ @ @ @ @ . . @ . . . . @ @ . @ @ . . . . @ @ . @ @ @ @ @ @ @ @ @ . . . @ @ . . @ @ @ . . . @ . @ @ 
@ . @ . @ @ @ @ . @ @ . @ . @ @ . @ . @ @ @ . . @ @ @ @ . . . . @ . @ . . @ . . . . . . @ . . @ @ @ @ @ @ @ @ @ . . . @ . @ @ @ . . @ @ . @ . . . . . . @ @ @ @ @ @ @ @ @ . . @ . @ @ . . . @ @ . @ @ @ 
@ . . . . @ @ . . . . . . . . . . . . . . . @ @ @ @ . @ @ . @ @ . . . @ . . @ . @ . @ @ . . @ @ @ @ @ @ @ @ @ . @ . @ . @ . @ . . @ . @ @ . . @ . @ . @ @ @ @ @ @ @ @ @ . . @ . @ @ @ . @ . @ @ . @ @ @ 
@ . @ . @ @ @ @ @ . @ @ . @ . @ @ . @ . @ @ . . . . . . . . @ . @ . @ @ @ . . @ . . @ . . @ . @ @ @ @ @ @ @ @ . . . . . . . . @ . . . . @ @ . @ . . @ @ @ @ @ @ @ @ @ . @ . . . @ @ @ @ . . . . . . @ @ 
@ . . @ @ @ @ @ @ @ . . . @ @ . . . . @ . . @ @ . @ . @ . @ . . . . . @ . . @ @ @ . . @ . . . @ @ @ @ @ @ @ @ . @ . @ @ @ . @ . @ . @ . @ . . @ . @ . . @ . @ @ @ @ . . @ @ @ . . @ . @ @ . @ @ @ @ . @ 
@ @ @ @ @ @ @ @ @ . @ . @ . . . @ @ @ @ . @ . @ . @ . @ @ . . @ . @ . . @ . @ @ @ . @ . . @ . @ @ @ @ @ @ @ @ . . @ @ @ . . . . @ . . @ . . @ . @ @ @ . . . . @ . . @ . . . . @ . @ . @ . . . . . . . @ 
@ @ . @ @ @ @ @ . . . @ @ @ @ @ . . . . . . . . . . @ . @ @ . . @ . . @ . @ . . . . @ @ . . @ @ @ @ @ @ . @ . . @ . @ @ @ . @ . . @ . . @ . . . @ . @ . @ @ @ @ @ . . . @ . @ . . @ . . @ . @ . @ @ . @ 
@ . . . . @ @ . @ . @ . @ . . . . @ . @ . @ . @ @ @ . . . . @ . . @ @ @ . @ . @ . @ . . . @ . @ @ @ @ . . . @ . . . . @ . . . @ . @ . @ . . @ @ . . . . . @ . @ . @ @ . @ . . . @ . . @ . . @ . . . @ @ 
@ @ . @ @ . . . . . . . . @ @ . @ . . @ @ . . @ . . @ @ . @ @ . @ . . . . . . . @ @ @ @ . @ . . @ @ . @ . @ . @ @ . @ @ @ . @ . . . . . . @ . @ . @ . @ . . . @ . . . . @ . @ @ . @ . @ . @ . @ . @ @ @ 
@ . . . . . @ . @ @ @ @ . . . . @ . @ . . @ . . . @ . . . . . . . @ . @ . @ . @ . @ . @ . @ . @ . . . . . . . . . . . @ @ . @ @ @ @ . @ @ . . . . . @ . . @ . @ . @ . @ . . . . . . . . . . . . @ @ @ @ 
@ . @ . @ @ . . @ . . . . @ . @ . . . . @ @ . @ . . @ @ @ . @ . @ . @ @ . @ @ @ . . . . . . . . @ @ @ @ . @ . @ . @ @ . @ @ . . . @ . @ @ @ . @ . @ . @ . @ @ . . @ . @ @ . @ . @ @ @ . @ . @ @ @ @ @ @ 
@ . . @ . . . @ . @ . @ . . @ . @ . @ @ . . . . @ @ @ @ . . . @ . . . . @ . . . . @ . @ . @ . @ @ @ @ . . . @ . . . @ . @ . . @ @ . @ . @ @ @ . . . . . @ . . @ . @ @ . . . . @ . . @ . . @ @ . @ @ @ @ 
@ . @ @ @ . @ @ . . . . @ @ . . @ . @ @ . @ . @ . . . @ @ . @ @ @ . @ . @ . @ @ . @ @ . . @ . . @ . @ @ . @ . @ . @ @ . . @ . . . . . . . @ @ @ . @ . @ . @ . . . @ @ @ . @ . . @ . . @ @ @ @ . . @ . @ 
@ @ @ @ . @ . . . @ . @ . @ @ . . . . @ . @ @ . @ @ . . . . @ @ . @ . . . . @ . @ @ . @ . . @ . . . . . . . . . @ . . . @ @ . @ . @ @ . @ @ @ @ . . @ . . . @ @ . . @ . . @ @ @ . . @ . . . . . @ . . @ 
@ @ @ . . . @ . @ @ . . . . . @ . @ . . @ @ @ . . . . @ @ . @ . . . @ . @ . . . @ . . @ . @ . @ . @ . @ . @ . @ . @ @ . . . . . @ @ @ . . @ @ . . @ . @ . @ . @ . @ . @ @ . . . @ . . . @ @ . @ . . @ @ 
@ . . @ . @ . @ . . . @ . @ @ @ @ @ @ . . @ . @ . @ @ . . . @ . @ . @ @ . . @ @ . . @ . . . . . @ . . . @ . . . . . . . @ . @ . . @ . . @ . @ . @ . . . . . . . . . . @ . @ @ . . . @ @ . . @ @ @ . . @ 
@ @ . . . . . . . @ . . @ . . @ . . . @ . . . . @ @ @ . @ . . @ . . . . . @ @ . @ . @ @ . @ . @ . @ . @ @ @ @ . @ . @ @ @ @ . . @ @ @ . @ . . . @ . @ . @ @ @ . @ . @ @ . . @ . @ . . . @ . @ . @ . @ @ 
@ @ @ . @ @ . @ @ . . @ . . @ . @ . @ @ . @ . @ @ @ @ @ . . @ @ @ . @ . @ . . . . . . . . . @ . . . . . @ @ @ . . @ @ . @ . . @ . . . . . @ . @ . . . @ . . . @ . @ . @ . @ @ . @ @ @ . . . . . . . . @ 
@ @ @ @ @ . @ . . . @ . @ . . . . . @ . . @ . @ @ @ @ @ @ . . . . @ @ . @ @ . @ @ . @ . @ @ . @ @ @ . @ . @ @ . @ . . . @ @ . . @ @ . @ . . . . . @ @ . @ . @ . . . . . . . . @ . . . . @ . @ . @ . @ @ 
@ @ @ @ @ . @ . @ . . . @ . @ . @ . . . @ . . . @ @ @ @ . . @ . @ @ . @ . . . @ . @ . . . . . . . @ . . . . @ . . @ @ . . @ . @ . . . . @ @ . @ . . . . . . . . @ @ . @ @ . @ @ @ @ . @ . @ @ . @ @ @ @ 
@ @ @ . . . @ @ . . @ . . @ @ . @ . @ . . @ @ . . @ . @ @ . . @ . . . . @ @ @ . . . . @ . @ . @ . . @ . @ . . @ . . @ . @ . @ . @ @ @ . @ . . . @ . @ @ . @ . @ . @ @ @ . @ . @ . @ . . . . @ @ . @ @ @ 
@ @ . @ @ . @ . . @ . . @ . . . @ @ . @ . . @ . @ . . . @ . @ . . @ @ . @ . . @ . @ . . @ . . . @ . . @ . @ . . @ . . . . . . . @ . . @ @ @ . @ . . . . @ @ . . . . . . . . . . . . . @ . @ . @ . @ @ @ 
@ . . . . . . . @ @ . @ . . @ @ . . . . . @ . @ . @ . @ @ . @ @ . @ . . . @ . . @ . . @ @ @ . @ . . @ . . . @ @ . . @ @ @ . @ @ . . @ @ @ @ . @ @ . @ . . . @ . @ @ @ . @ . @ . @ . @ @ . . . . . . . @ 
@ @ . @ . @ . @ . . . . @ @ . . . @ . @ . . . . . . . @ . . . . @ @ @ @ . . . @ . @ . @ @ @ @ @ @ . . . @ @ . @ @ . . . . @ . . . @ @ @ @ . @ . @ @ @ @ . @ @ . @ . . . . @ . . . @ . @ . @ . @ . @ . @ 
@ . . . @ . . . @ @ . @ @ @ @ @ . . @ . . @ . @ @ . @ @ @ . @ @ @ @ . . . @ . . . . . . @ @ @ @ @ @ @ . . @ . @ . . @ . @ @ @ . @ . @ @ . . . . . . . @ @ . @ @ @ @ @ . @ . @ . @ . . . @ . @ . @ @ . @ 
@ @ . @ @ @ . @ . . . . . . . . @ . . @ . . @ @ @ . . . @ . @ . @ . @ . @ . . @ . @ . @ @ @ @ @ @ . . . @ @ . @ . @ . . . . . . . . . . @ . @ . @ @ . . . . . . @ . @ @ @ . @ @ . @ . @ @ . @ . . @ . @ 
@ . . . @ . . @ . @ . @ . @ . @ @ @ @ . . @ @ @ . @ @ . . @ . . . . . . . @ . @ @ . . . @ @ @ @ . . @ . . . . . @ . @ . @ . @ . @ . @ . . . . @ @ @ @ . @ . @ . . . . . . . . . . . . . . . . . @ . . @ 
@ @ . @ . @ . @ @ . . . @ @ . . . . . @ . @ . . . . @ . @ @ @ . @ . @ . @ @ . @ . @ . @ @ . @ @ @ . @ . @ . @ . . . @ . . @ @ . @ @ . . @ @ . @ @ @ @ @ . . . @ @ . @ . @ . @ . @ . @ . @ . @ . . @ . @ 
@ @ @ . . . . . @ . @ . . . @ @ . @ @ @ @ @ @ . @ . . . . @ . @ . . . @ @ . . @ . . . @ . . . @ @ . . @ . . . @ . @ . . @ . @ . . @ @ . . @ . . @ @ @ . @ . @ . @ @ . @ @ . . @ . . . @ @ @ @ . @ @ @ @ 
@ @ . . @ @ . @ @ @ . . @ . . @ . . @ @ . . . . @ @ @ . @ . . @ @ @ @ @ . @ . . @ @ . . . @ . . . @ . @ . @ . . @ @ @ . @ . @ @ . . . @ @ . @ . @ @ . . . . . . . . . . . @ @ . @ . @ . @ . . @ . @ . @ 
@ . . @ . . . . @ @ @ . . @ . . @ . . . @ @ @ . . . @ @ . @ . . . . . . . . . @ . @ @ . @ . @ @ @ . @ @ . @ . @ . @ . . . . . . @ . @ @ . . . . @ . @ . @ . @ @ . @ @ . @ . . . . . . . . . @ . . . . @ 
@ @ . @ . @ . @ @ @ . @ . . @ . . @ @ . @ . . . @ @ . . . . @ @ @ . @ @ . @ . . . @ @ . . . . . . . . . @ . . . . . @ . @ . @ @ . @ @ @ @ . @ . . . @ @ . . . . @ @ @ . @ . @ . @ . @ . @ . . . @ @ @ @ 
@ @ @ . . @ @ . . . . . @ . @ . @ @ @ @ . . @ . . . @ @ @ . . . . . . . @ . . @ . @ . . @ . @ @ . @ . @ @ @ . @ . @ . . . @ @ . . @ @ @ @ @ . . @ . @ . @ . @ . . . . @ . . @ @ . . . @ . . @ @ . @ . @ 
@ @ @ @ @ . . @ . @ . @ . @ @ @ @ @ @ @ @ . @ . @ @ @ @ @ . @ . @ . @ @ @ @ . @ . @ @ . . @ . @ @ . @ . @ . . . @ @ @ . @ . . . @ @ @ @ @ @ @ . . @ @ . . . . @ @ . @ @ @ . @ . . @ @ @ @ . . . . . . @ 
@ . @ . . . @ . @ @ . . . @ @ @ @ @ @ . . . . @ @ @ @ @ . @ . . @ @ @ @ @ . . . @ . . @ . . . . . . . . . @ . @ . @ @ . @ . @ . . @ . @ @ @ @ @ . @ . . @ . @ . @ @ @ @ . @ @ @ . . @ @ @ . @ . @ . @ @ 
@ . . @ @ . . . @ . . @ . . @ @ @ @ . . @ . @ @ @ @ . . . . . @ @ . @ . . . @ . . @ . . . @ . @ @ . @ . @ . . . . . . @ @ @ . @ . . . . @ @ @ @ . . @ @ @ . . . @ . @ . . . @ @ @ . . @ . . . @ @ @ @ @ 
@ @ . . @ . @ . . @ . @ . @ . . @ . @ . @ @ @ @ @ @ . @ @ . @ . . . . . @ . @ . @ . . @ . . @ @ @ @ . . . @ @ . @ . @ @ @ @ . . @ @ . @ @ @ @ . . @ . . . . @ @ . . . @ @ . . @ . . @ . @ . @ @ @ @ @ @ 
@ . . @ @ @ . @ . @ . @ . . . @ . . . . . @ @ @ . . @ . @ . . @ . @ . @ . . @ @ @ . @ . . @ @ @ @ . @ . @ @ . . . @ @ @ @ . . @ . @ . @ @ @ . . @ @ @ . @ . @ @ . @ @ . @ . @ . @ . . . @ @ @ @ @ @ @ @ 
@ @ . . @ . . @ . . @ . @ . @ . @ . @ . @ . @ . @ . @ . . . @ @ @ . . . @ . . . @ @ @ @ . . @ . . . . . @ @ @ . @ . @ @ . @ . . . . . . . . @ @ . . . . @ . . . . . . . . . . . @ @ . @ @ @ @ @ @ @ @ @ 
@ . . @ . @ . @ . @ . . . . . . . . . @ . . . . . . . . @ . . @ . @ . @ . @ . @ . . . . . @ . . @ . @ . @ @ @ . . . . . . . . @ . @ . @ . @ @ . . @ . @ . . @ . @ . @ . @ . @ . . . @ @ @ @ @ @ @ @ @ @ 
@ @ . . . . . . . . . @ . @ @ . @ . @ @ @ . @ . @ . @ @ . . @ . . . . @ . . . . @ . @ @ . @ @ . @ . . @ @ @ @ . @ . @ @ . @ . . @ . . . @ @ @ @ . @ . . @ . @ . . @ . . . @ @ @ . @ @ @ @ @ @ @ @ @ @ @ 
@ @ @ . @ @ . @ . @ . @ . . . @ . . . @ . . @ . @ @ @ . @ . . @ . @ . . @ @ . @ . . @ . . @ @ . @ . @ @ @ . . . . @ @ @ @ . . @ @ @ . @ @ . @ @ . . @ @ . . @ . @ @ @ . @ . @ @ . @ @ @ @ @ @ @ @ @ @ @ 
@ @ @ @ . . . @ . . @ . . @ . @ @ . @ @ @ . @ @ . . . . . . @ @ @ . . @ @ @ . @ @ . . @ . @ . . . @ @ @ @ @ . @ @ @ @ @ @ . @ @ @ . . . . . . . @ . . . @ . . @ @ @ @ . . . . . @ @ @ @ @ @ @ @ @ @ @ @ 
@ @ @ @ @ @ @ @ @ @ @ @ @ @ @ @ @ @ @ @ @ @ @ @ @ @ @ @ @ @ @ @ @ @ @ @ @ @ @ @ @ @ @ @ @ @ @ @ @ @ @ @ @ @ @ @ @ @ @ @ @ @ @ @ @ @ @ @ @ @ @ @ @ @ @ @ @ @ @ @ @ @ @ @ @ @ @ @ @ @ @ @ @ @ @ @ @ @ @ @ 
3
70 59 40 5
49 6 93 80
33 10 77 49
