20 20
@ @ @ @ @ @ @ @ @ @ @ @ @ @ @ @ @ @ @ @ 
@ @ @ @ @ . . . . . . @ . @ . @ @ @ @ @ 
@ @ @ @ @ @ . @ . @ . . . . . . @ @ @ @ 
@ . @ @ . @ . . @ @ @ . @ @ . @ @ @ @ @ 
@ . @ . . . . @ @ @ . . . @ @ . . @ @ @ 
@ . . @ . @ . @ @ @ @ . @ . . @ . . @ @ 
@ . @ . @ @ @ . . @ . . . @ . . @ . . @ 
@ . . . . . @ . @ . @ . @ @ @ . . . @ @ 
@ @ . @ . @ @ . . . . . . @ . . @ . @ @ 
@ . . . @ . . . @ . @ @ . . @ @ . . . @ 
@ . @ . . @ @ . . @ . . @ @ @ . . @ . @ 
@ @ . @ . @ @ . @ . . @ . @ . . @ . @ @ 
@ . . . . . . . . @ . @ . . @ . . . @ @ 
@ @ . @ . @ . @ . . . . . @ . . @ @ . @ 
@ @ @ . . @ @ . . @ . @ . @ . @ . @ . @ 
@ @ @ @ @ . . @ . @ @ . . . . . . . . @ 
@ @ @ . . @ . . @ . . @ . @ . @ . @ . @ 
@ . @ . @ . @ . @ @ . @ . @ . @ . . @ @ 
@ . . . . . . . . . . . . . @ . . @ @ @ 
@ @ @ @ @ @ @ @ @ @ @ @ @ @ @ @ @ @ @ @ 
3
10 18 5 1
6 7 3 14
17 17 18 15
