12 12
@ @ @ @ @ @ @ @ @ @ @ @ 
@ . @ . . @ @ @ . . @ @ 
@ . @ . @ . @ . @ . . @ 
@ . @ . . . . . . . @ @ 
@ . . @ . @ . @ . @ @ @ 
@ @ . . . . @ . @ @ @ @ 
@ . @ . @ . . . . @ @ @ 
@ . . . @ . @ @ . . . @ 
@ . @ . . @ . . @ . @ @ 
@ @ . . @ @ . @ @ . @ @ 
@ @ @ . . . . . @ @ @ @ 
@ @ @ @ @ @ @ @ @ @ @ @ 
3
4 1 1 4
6 3 10 3
7 2 8 7
