50 50
@ @ @ @ @ @ @ @ @ @ @ @ @ @ @ @ @ @ @ @ @ @ @ @ @ @ @ @ @ @ @ @ @ @ @ @ @ @ @ @ @ @ @ @ @ @ @ @ @ @ 
@ @ @ . @ . . @ . @ . . . @ . . . . @ @ @ @ @ @ @ @ @ @ @ @ . . . @ . @ @ @ @ @ @ . . @ . @ . . @ @ 
@ . . . . @ . @ . . . @ @ . @ . @ . @ @ @ @ @ @ @ @ @ @ @ @ . @ . . . . . @ @ @ @ . @ . . . @ . . @ 
@ @ . @ @ . . . . @ @ . @ . . . . @ . @ @ @ @ @ @ @ @ @ @ . @ . @ . @ . @ . @ @ . . . . @ @ . . @ @ 
@ . . . . @ @ . @ . @ . @ . @ @ @ . . . @ @ @ @ @ @ @ @ . . . . . . @ . . . . @ @ . @ @ . @ . @ . @ 
@ @ . @ @ . . . @ . . . . . . @ . . @ @ . @ @ @ @ @ @ @ @ . @ @ @ @ . . @ @ @ . . . . . . . . . . @ 
@ . . . @ @ @ . @ . @ . @ @ . . . @ . . . . . . @ . @ @ @ @ . @ @ . @ . . . @ . @ @ @ . @ . @ @ . @ 
@ . @ . @ @ . . . @ . . . . @ @ . . . @ . @ . @ . . . @ . @ . @ . . . . @ @ . . . . . @ @ @ @ . @ @ 
@ @ . . . @ @ . @ . @ . @ . @ . . @ . @ @ . @ . . @ @ . . @ . . . @ . @ . @ . @ . @ @ . @ . . . @ @ 
@ . @ . @ . @ . . . . . @ . . @ . . @ . @ . @ @ . . . . @ . . @ @ . @ . . . . . @ @ . . . . @ @ . @ 
@ . . . . . . . @ . @ @ @ . @ . @ @ . . @ . @ @ @ . @ . @ @ . @ @ . . . @ . @ @ . @ @ . @ @ . @ . @ 
@ . @ . @ . @ . . @ . . . @ . . . @ @ . . . . . @ . @ . @ . . @ @ . @ @ . @ . @ . . . . . . . . . @ 
@ @ . . . @ @ . @ @ @ . @ . @ . @ . @ . @ @ @ @ @ @ . . . @ . @ . . . . . . . . . @ @ . @ . @ . @ @ 
@ @ @ @ @ . . . . . . . . . . . . . . . . . . . @ . . @ . . . . @ . @ @ @ @ @ @ @ . @ . . @ . . @ @ 
@ . . . . . @ . @ . @ . @ . @ @ . @ . @ . @ @ @ . . @ . @ . @ @ . . . @ . . . . . . . @ . . @ . . @ 
@ @ . @ . @ . . @ @ @ @ . . . . @ . . . @ @ @ . @ @ . . . . . . . @ . . . @ @ @ @ @ @ . @ @ . @ @ @ 
@ @ @ . . @ @ . @ @ @ @ @ . @ @ @ @ . @ . @ @ . @ . @ . @ . @ . @ . . @ . . . . . . . . . . . . . @ 
@ @ @ . @ . . . @ @ @ . . . @ . @ . . . . . . . . . . . . @ @ @ @ @ . . @ . @ . @ @ . @ . @ . @ @ @ 
@ @ . . @ @ . @ . @ @ . @ . . . . @ . @ . @ @ . @ . @ . @ @ @ @ @ @ @ . . @ @ @ . @ . . @ . . . @ @ 
@ . . @ . . . . . . @ @ . . @ . @ . . . @ . . . @ . . @ . . @ @ @ . . . @ . @ . . @ . @ . @ . @ @ @ 
@ @ @ . . @ . @ . @ @ @ @ . . @ @ @ . @ . @ @ . . @ @ . @ . @ @ . . @ . . . . . @ @ @ @ . @ . . . @ 
@ . @ @ . . @ @ @ @ @ @ @ . @ @ @ @ . @ . . @ . @ @ . . . . . @ @ @ @ @ . @ . @ @ @ . . . . . @ . @ 
@ . . . . @ . @ @ @ @ @ @ . . @ @ . . . . @ @ . . . . @ . @ . . . . @ . . . @ @ @ . @ @ . @ . . @ @ 
@ @ . @ . . . . @ @ @ @ . . @ @ @ @ . @ . . . @ . @ . . @ . . @ . @ @ @ . @ @ @ @ . . @ @ . . @ @ @ 
@ @ @ . . @ . @ @ @ @ @ @ . . @ @ . . @ . @ . @ . @ . @ @ @ . . @ . @ @ . @ @ @ . . @ @ @ @ . @ . @ 
@ @ . @ . . @ @ @ @ @ @ @ @ . @ . @ . . @ @ . . @ . . . . @ . @ . . . @ . . @ . . @ . @ . @ . . . @ 
@ . . . . @ @ @ @ . @ @ @ @ . . . . @ @ . . . @ . @ . @ @ . @ @ . @ @ . @ @ @ @ . . . . . @ @ @ @ @ 
@ . @ . @ @ @ @ . . . @ @ @ @ @ @ . @ @ @ @ . @ . @ . . . . . . . . . . . . @ . . @ @ . @ . @ . . @ 
@ @ . . . @ . . @ @ . . @ @ . @ . . . @ . @ . . . @ . @ . @ @ . @ . @ . @ . . @ . @ . @ @ . @ @ . @ 
@ . @ . @ @ . @ @ @ . @ . . . . . @ . . . . @ @ . . @ @ . @ . . . @ . . . @ . . . . . . . . . . . @ 
@ . . @ @ @ . . . . . @ . @ . @ . @ . @ . @ @ @ @ . @ @ @ . . @ . . @ . @ @ . @ @ . @ . @ . @ @ @ @ 
@ . @ . @ . @ . @ @ . @ . . @ @ @ . . . @ . . . . . @ @ @ @ . @ . @ @ . . . @ . @ @ @ @ . . . . @ @ 
@ . . . . . . . @ . . . . @ @ @ . @ . @ @ @ @ @ . @ @ @ @ @ @ @ @ . . . @ . . . . . . @ @ . @ . . @ 
@ @ @ @ . @ @ . . @ . @ . . @ . . @ . . @ . . @ . . @ @ @ . @ @ @ @ @ . . @ . @ @ @ . . . @ . . @ @ 
@ @ @ @ @ . . . @ @ . . @ . . @ . . . @ . @ . @ . @ . @ . . . . @ . . . @ @ . . . @ . @ . @ @ . . @ 
@ @ @ @ . . @ . . @ @ . @ . @ . . @ . . . . . @ . . . . @ . @ @ . @ @ . . . @ . @ . . @ . . . @ @ @ 
@ @ @ @ @ @ . . @ . . @ . . . @ . . @ . @ . @ . @ @ @ . . . . . . . @ . @ . . @ . @ . . @ @ . . @ @ 
@ @ @ @ @ @ @ . @ . @ . @ . @ . . @ . @ . . . . . . . @ @ . @ . @ . @ . @ . @ @ . @ . @ . @ . @ @ @ 
@ @ @ @ @ @ @ @ . . . . . . @ @ . . . . @ . @ @ @ @ . . @ @ @ . . @ @ @ . . . . . . @ . . @ . . @ @ 
@ @ @ @ @ @ @ . . @ . @ @ . . @ @ . @ . @ . . . @ . . @ @ @ @ . @ @ @ . @ . @ . @ @ . @ . . . @ . @ 
@ @ @ @ @ . . . @ @ @ . . . @ . . . . @ @ . @ . @ @ . . . @ . @ @ @ . . . . . @ . @ . @ . @ . . . @ 
@ @ @ @ @ . @ . . . @ @ . @ . . @ . @ . . @ . @ @ . . @ . . . . @ . @ . @ . @ @ . . . . . @ . @ . @ 
@ @ @ @ @ @ . . @ . . @ @ @ . @ . @ . . @ . . . . . @ @ . @ . @ @ . @ @ . . @ @ @ @ @ . @ . . . @ @ 
@ @ @ @ @ @ @ . @ . @ . . . @ . . . @ . @ . @ . @ . . @ . @ . @ . . . . @ . . @ . . @ . @ @ . @ @ @ 
@ @ @ @ @ @ . . . @ . . @ @ . . @ @ @ . . . . @ @ . @ . . @ . . @ . @ @ . . @ @ . @ . . @ . . . @ @ 
@ . @ @ @ . . @ . @ . @ . @ @ . . . . . @ . @ . @ . @ @ . . @ . . . @ @ @ . . . . @ @ . . @ . @ . @ 
@ . . @ . @ . @ . . . . . . . @ @ . @ @ @ @ . . . . . @ . @ . . @ @ @ . @ @ @ . @ @ . . @ @ . . . @ 
@ @ . . . . . @ . @ @ . @ @ . . @ . @ . . . . @ . @ . @ @ @ @ . @ . . . . . @ . . @ @ @ . . . @ . @ 
@ @ @ . @ @ . @ . @ . . . . @ . @ . @ . @ @ . @ . @ . . . @ . . . . @ . @ . @ . @ . . . . @ . . @ @ 
@ @ @ @ @ @ @ @ @ @ @ @ @ @ @ @ @ @ @ @ @ @ @ @ @ @ @ @ @ @ @ @ @ @ @ @ @ @ @ @ @ @ @ @ @ @ @ @ @ @ 
3
42 9 19 15
25 4 25 33
33 18 13 8
