100 100
@ @ @ @ @ @ @ @ @ @ @ @ @ @ @ @ @ @ @ @ @ @ @ @ @ @ @ @ @ @ @ @ @ @ @ @ @ @ @ @ @ @ @ @ @ @ @ @ @ @ @ @ @ @ @ @ @ @ @ @ @ @ @ @ @ @ @ @ @ @ @ @ @ @ @ @ @ @ @ @ @ @ @ @ @ @ @ @ @ @ @ @ @ @ @ @ @ @ @ @ 
@ @ . . . @ . . . . @ @ @ @ @ . @ @ @ . . . . . @ . @ . @ @ . . . @ @ @ . . . @ @ @ @ @ . @ @ @ . . . . . @ . . . @ . . @ . @ @ @ @ . . . . @ . . . @ @ @ @ @ . @ . . . @ . @ @ @ @ @ @ @ @ @ @ @ @ @ @ 
@ @ . @ . . @ @ @ . . @ @ @ . . . @ . @ @ @ . @ . . @ . @ . @ @ . . @ @ . @ @ @ @ @ @ @ . . . . @ . @ @ . . . @ . @ . @ @ . . @ . . @ . @ . . @ @ . . . . . . . . . @ . . . . @ @ @ @ @ @ @ @ @ @ @ @ @ 
@ @ @ . @ . @ . @ . @ @ @ . @ . @ @ . . @ . . @ @ . . . @ . @ @ . @ . . . @ . @ . . . . . @ @ @ . . . @ . @ @ . . . . . @ @ . . @ . . @ @ . @ @ . . @ . @ . @ . @ . @ . @ . @ @ @ @ @ @ @ @ @ @ @ @ @ @ 
@ @ @ . . . . . . . . . . . @ . @ @ . @ . @ . . @ . @ . @ . . . . . . @ . . . . . @ . @ @ . . @ @ . @ @ . @ @ @ . @ . @ . . . @ . . @ . @ . @ . @ . @ . . @ @ . @ . @ @ . @ @ @ @ @ @ @ @ @ @ @ @ @ @ @ 
@ . . @ . @ @ . @ . @ . @ . . . @ . . . . . @ . @ . @ . . @ . @ . @ @ . @ . @ . @ . . @ . . @ . @ . . @ @ . @ @ @ . . . @ @ . . . @ . . . . . . . . . @ @ . . @ . . @ . . . @ @ @ @ @ @ @ @ @ @ @ @ @ @ 
@ . @ . @ @ . @ . @ . @ @ . @ . . @ @ @ @ . . . . @ . . @ @ @ @ @ . . . . . . @ @ @ . @ . @ . . . @ . @ . . . @ . . @ @ . . . @ @ . . @ @ @ . @ . @ @ . . @ . . @ @ . @ @ . @ @ @ @ @ @ @ @ @ @ @ @ @ @ 
@ . . . . . . . . . . . . . . @ . @ @ @ @ . @ . @ . @ . @ @ @ @ . . @ . @ . @ . @ . . . . . . @ @ . @ @ @ . @ . @ . . @ @ @ . . @ . @ @ . @ @ . . @ @ @ . . . @ . . . . . . . @ @ @ @ @ @ @ @ @ @ @ @ @ 
@ . @ . @ @ . @ @ . @ . @ . @ . . . @ @ @ @ . . . . . . . @ . @ @ @ . . @ @ @ . @ @ . @ . @ . . . . . @ . . . . . . @ . @ . . @ . . @ . . . @ . @ . @ . @ @ . @ @ . @ . @ @ . . @ @ . @ @ @ @ @ @ @ @ @ 
@ . @ . . @ . @ @ @ @ @ . . . @ . @ . @ . @ @ . @ . @ . @ . . . @ @ @ . @ . . . . @ . . @ @ . @ . @ . . @ . @ . @ . . . @ @ . @ . @ . @ . @ . @ @ . . . . . . . . @ . . @ . . @ . . . @ @ @ @ @ @ @ @ @ 
@ . @ . @ @ . . @ @ @ . @ . @ . . . . . . . @ . @ @ . . . . @ @ . @ . @ . @ @ . @ . . @ . @ . . @ @ . @ . . @ @ . . @ @ . @ . . . . . . . . . . . @ . @ . @ . @ @ . @ @ . @ . . @ @ . @ @ @ @ @ @ @ @ @ 
@ @ . @ . . . @ @ @ . . @ @ @ @ . @ . @ . @ . @ @ . @ . @ @ . @ . . . . . . . . . @ . . . @ @ @ . @ @ . @ @ @ . . @ @ @ . . . @ . @ . @ @ . @ . @ @ . . @ . . . . . . . . @ . @ . . . . @ @ @ @ @ @ @ @ 
@ @ . . @ @ @ @ @ . @ . . @ @ . . . @ . . . . . . . . . . . . . . @ . @ @ . @ @ . . . @ @ . . . . . . . @ @ . @ . . @ @ . @ . . @ @ @ @ . @ @ @ @ @ . @ @ @ . @ . @ . @ . . . . @ @ . @ . @ @ @ @ @ @ @ 
@ . . @ . . . @ . . . . @ . @ @ @ @ @ . @ . @ . @ @ . @ . @ . @ . @ . . . @ . . . @ . . . @ @ . @ . @ . . . . . . @ @ . @ . . @ @ @ . . . . . . @ . @ @ @ @ . @ @ . . @ . @ . @ . @ . . . . @ @ @ @ @ @ 
@ @ . . @ . @ @ @ . @ . @ . . . @ @ @ @ . . . @ . @ @ @ @ . . . @ . . @ @ @ @ . @ . . @ . @ . @ . @ @ @ . @ . @ . . . . . @ . . @ . @ . @ @ . @ . . . @ @ @ . . . @ . . @ . . @ . @ . @ . @ . @ @ @ @ @ 
@ @ @ . . . . . . @ . . @ . @ . @ @ @ @ @ . @ . . . . @ . @ . @ @ @ . @ . . @ @ . @ . . @ @ . . . . . . . @ . @ . @ @ . @ . . @ . . . . . @ . @ . @ @ @ @ . . @ @ . . @ @ @ . . . @ . . @ @ . . @ @ @ @ 
@ . @ . @ @ . @ . . . @ . . . @ . @ @ @ @ . . . @ . @ @ . . @ . . . . @ @ . . . . . . @ . @ @ . @ . @ . @ . @ . . @ . @ @ @ . . . @ . @ . @ @ . . . . @ @ @ @ @ @ @ . @ @ @ @ @ . @ . @ . @ . @ . @ . @ 
@ . @ . @ @ . @ . @ @ . . @ . . . . . . . . @ @ . @ . . . @ . . @ @ . . @ @ . @ . @ . . . @ @ @ @ @ @ @ . . . @ . . . . @ . . @ @ @ @ @ @ . @ @ . @ . . @ . . . @ @ . . @ @ . . . @ . . . . . . . . . @ 
@ . . @ @ . @ . . . @ @ . . @ . @ . @ . @ . @ . . . @ @ . . @ . @ . . @ . @ @ . . @ . @ @ @ @ . @ . @ . @ . @ @ @ @ . @ . @ . . @ . @ . @ . . @ @ . . @ . @ . @ . @ @ @ @ . @ @ . . . @ . @ . @ @ . @ @ 
@ @ . . . . . @ . @ @ . . @ . @ . @ @ @ . . @ @ @ . @ . @ . @ . . @ @ @ . . @ @ @ . . . . . . . . . . . . . . @ . . . . . . . @ . . . . . . @ @ @ @ . . . . . . . . @ . . . @ . @ . @ . @ . . @ . . . @ 
@ . . @ . @ . . . . @ @ . . . . . . @ @ @ @ . . . . . . . . . . @ . @ . . @ . . @ @ . @ . @ . @ . @ . @ @ . @ . . @ . @ . @ . . . @ . @ . @ @ @ . . . @ @ @ @ . @ . @ @ @ . . . . . . . . @ @ @ @ . @ @ 
@ . @ @ @ . @ . @ . . @ @ @ . @ @ @ @ @ @ @ . @ @ @ . @ . @ . @ . . @ . @ @ @ . . . @ @ @ @ @ . . @ . @ . . . @ . . @ @ @ . . @ @ . @ . @ . @ . @ . @ . @ . @ . @ . . . . @ . @ @ . @ . @ @ @ @ @ @ @ @ 
@ . @ @ . . @ @ . . @ @ @ . @ @ @ @ @ @ @ @ @ . . @ . @ . @ @ . . @ . . @ . @ @ . @ . @ . @ . @ . @ @ . @ @ . . . @ @ @ @ @ . . . . . . . . . . . . . . . . . @ @ @ @ . @ . @ @ @ . . @ @ @ @ @ @ @ @ @ 
@ . @ . @ . @ . @ . . @ . . . @ @ @ @ @ @ @ @ @ . . . @ @ . . @ . . . @ @ . . . . . . @ . . . . @ @ . . @ . @ @ . . @ . . @ . @ . @ @ . @ . @ . @ . @ . @ . @ . . @ . . . . . @ . . @ @ @ @ @ @ @ @ @ @ 
@ @ . . . . . . . . @ . @ . @ . @ . @ @ @ @ @ @ @ . @ . . . @ @ @ . @ . @ @ @ . @ @ . @ . @ . @ . . @ . . . @ . . @ @ @ . . @ @ @ @ @ @ . . . @ @ @ @ @ @ @ @ @ . . @ . @ . @ @ @ . . @ . @ @ @ @ @ @ @ 
@ @ @ @ @ @ @ @ @ . . . . . . . . . @ @ @ @ @ @ @ @ . @ @ . @ . @ . . . . @ @ @ . . . . . . @ . @ . @ @ @ . . @ . . @ . . @ . @ . . @ @ @ . @ @ @ @ @ @ @ . . . . @ . @ @ @ @ @ . . @ @ . . . @ @ @ @ @ 
@ @ . . . . . . . . @ . @ . @ . @ . @ @ @ @ . @ @ @ . . . . . . . . @ . @ @ @ @ @ . @ . @ . . . . . . . @ . @ . @ . @ @ . @ . . . @ . @ . . @ . . @ . @ . @ . @ @ . . . @ @ . . @ . @ . . @ . @ . @ @ @ 
@ @ @ . @ . @ @ . @ . . . @ @ @ . . . @ @ @ . . @ . @ @ @ @ . @ . @ . @ @ @ @ @ @ @ . . . @ . @ . @ . @ @ . . . . . . . . . . @ @ . . . @ . @ . @ @ . @ . . . . @ . @ @ @ @ @ . . . . @ . @ . @ . . . @ 
@ @ @ @ . @ @ @ @ @ @ . @ . @ . @ . @ . @ . @ . . . @ @ . @ @ @ . . . . . @ . . @ . @ . @ . @ @ . @ . . . @ . @ . @ . @ . @ . @ . @ @ . . @ . . . . . . . @ . @ . . . @ @ @ @ @ . @ . . . . @ @ . @ @ @ 
@ @ @ @ . @ @ @ @ @ @ @ . . . . . . . . . . . @ @ . . @ . . . @ . @ @ . @ . @ . . . . . . . . . @ . . @ @ @ @ . . . @ . . . @ . . . . @ . . @ . @ . @ . @ @ @ @ . @ @ . . @ @ @ @ . . @ @ @ . . . . . @ 
@ @ . @ . @ @ @ . . @ . . @ @ . @ . @ @ @ @ . @ . @ . @ . @ . @ @ . . . . . . . @ . @ @ . @ . @ @ @ . @ @ @ @ @ . @ @ @ @ . . @ . @ . @ . @ @ @ . @ . . . @ @ @ . . @ . @ . @ @ @ @ . @ . @ . @ @ . @ @ 
@ @ . . . @ . . . @ . . @ . @ @ . @ . . @ . . . . . . . . . @ . . @ . @ @ . @ . @ . @ @ . . @ @ @ @ @ @ @ @ @ @ @ @ @ . . @ . @ @ . . @ . . @ . . . @ . @ . @ . . @ . . . . . . @ . . . . . . . @ . . @ 
@ . @ . @ . @ @ . @ @ . . . . @ . . @ . @ . @ . @ . @ . @ . . @ . . @ . . @ . . . @ @ . . @ @ @ @ @ @ @ @ @ @ @ @ . . . @ . . @ . @ . . . @ @ @ . @ @ . . . . . @ @ . @ . @ @ @ . @ . @ . @ . @ . @ . @ 
@ . . . . . . @ . . . @ . @ @ @ . @ . . @ @ . @ @ . . @ . @ . @ . @ @ . @ . @ @ . @ @ @ . @ @ @ @ @ @ @ @ @ @ @ . @ @ . . @ . . . . @ @ . @ . . . . . . @ @ @ @ . . . . @ @ . . . . . . @ @ . . . . @ @ 
@ @ @ . @ . @ . @ @ . @ @ . . . . . @ . . @ . . @ @ @ . . . . . . . . . . . . . . . @ @ @ @ @ @ @ @ @ @ @ @ @ . . @ . @ . . @ . @ . @ . . . @ . @ . @ @ . @ . . @ @ . @ . @ . @ . @ . @ . . @ @ . @ @ @ 
@ . . . . @ . . . . . @ . . @ . @ @ . @ . . @ . . @ @ @ @ @ . @ @ . @ @ @ @ . @ . @ . . @ @ @ . @ @ @ @ @ @ @ @ . . . . @ . . @ . . . @ @ . . . . @ . . . . @ . . . . . . @ @ . . . @ . @ . . @ . . @ @ 
@ . @ . @ . @ @ @ @ . . . @ . . @ . . . @ . . . @ . @ @ . . @ . @ . @ @ @ @ @ . . . . @ @ @ . . @ @ @ @ @ @ @ @ @ @ @ . . . @ . @ @ . @ . @ @ . @ @ @ @ . @ . @ . @ @ @ @ . @ . @ @ @ . @ . @ . . @ @ @ 
@ @ . . . . @ . . . @ @ . . @ @ . @ . @ . @ @ . @ . @ . @ . . . . @ @ . @ @ . @ @ . @ . @ . @ . @ @ @ @ @ @ . . . . . . @ . . . . . . . . . . . . . . . . . . . . . . . . . . . . . . . . . . @ . @ @ @ 
@ . @ . @ @ . @ . @ . . . @ @ @ . . . . . . . . . . . . . @ @ . @ . @ . @ . . . . . . . . . . . . . @ @ @ @ @ . @ . @ . @ . @ . @ . @ . @ . @ . @ . @ . @ . @ . @ . @ . @ . @ . @ @ @ . @ @ . . @ @ @ @ 
@ . @ . . . . . . . . @ @ @ @ @ @ . @ . @ . @ . @ @ . @ . . . . . . . . . . @ . @ . @ @ . @ . @ . @ . @ @ @ @ . @ @ . . . @ . @ . . @ . . @ . . @ . . @ . . @ . @ . . @ . . . @ @ @ . . @ . . @ @ @ @ @ 
@ . . @ . @ @ @ . @ . . . @ @ @ . . . @ . . @ @ . . . @ @ @ . @ . @ @ . @ @ . . @ @ . @ . . @ @ . . . . @ . . . @ . @ . @ . . . @ @ . . @ @ @ . . @ . @ @ . . @ . . @ . @ . @ . @ . @ . @ @ . . . @ @ @ 
@ @ . . @ @ @ . @ . @ @ . . @ . @ . @ @ @ @ @ . @ @ @ . @ . . @ @ . . . . @ @ . . . . . @ @ @ @ . @ . @ @ @ . @ @ . . . . . @ . @ . @ . . . @ @ @ @ . . . @ . @ @ @ . . @ . . . . . . @ . . . @ . . . @ 
@ . @ . @ @ . . . . . . . @ . . . . . @ . . . . . . . . . . @ . . . @ . @ . . . @ . @ . . . @ . . . @ @ . . @ . . . @ . @ @ @ @ . . . . @ . . @ . . . @ @ . . . . . . @ @ . @ @ . @ . . @ @ . . @ . @ @ 
@ . . . . . . @ . @ @ @ . . @ . @ . @ . . @ @ . @ @ . @ @ . @ . @ . . @ . . @ . . @ . . @ @ @ @ . @ . @ . @ . @ . @ @ @ . . . . @ . @ . . @ . . @ . @ @ @ . @ . @ . @ @ . @ . . @ . . @ @ @ . @ @ . . @ 
@ @ . @ . @ . @ . @ @ @ @ . . . . @ @ @ . @ . . @ . . . . @ . . @ . @ @ @ @ . . @ . @ . . . @ . . . . . . . . . . @ @ . @ . @ . . . . @ . . @ . . @ @ . @ . . @ . @ . @ . @ . @ . . @ @ @ @ @ @ @ . @ @ 
@ . . @ . . @ . @ . @ @ . . @ . @ . @ . . @ @ . @ @ . @ @ . . @ . . . @ . @ @ . . . . @ . @ . @ . @ . @ @ . @ . @ . . . . . . @ @ . @ . @ @ . . @ @ . . . . @ @ . . . . . . . . . @ . @ @ . @ @ . . . @ 
@ @ @ . . @ @ . . . . . . @ . @ . . @ @ . @ . @ . . . . @ @ . . @ . @ @ . . . @ . @ @ . . . . @ @ . . . . @ . @ . . @ . @ . @ @ . . . . . . @ . . . @ @ . @ . . . @ . @ . @ . @ . . . . . . . @ . @ . @ 
@ . @ @ . @ @ @ . @ . @ . . . @ . @ @ @ @ . . . . @ . @ @ @ . @ @ . . . @ . @ . @ @ @ @ . @ . . . @ . @ @ . . . . @ . . @ @ @ . @ . @ . @ @ . . @ . . . @ @ @ . @ . @ . . @ @ . . @ . @ . @ . . @ @ @ @ 
@ . @ . @ . @ . . . @ . . @ . . . . . @ . . @ @ . @ . . @ @ @ . . . @ . . . . . @ . @ @ . @ @ @ @ . @ @ . @ @ @ @ . @ @ . . . . . . . @ @ . @ . . @ . @ @ @ @ @ @ . . @ . @ . @ . . @ . . . @ @ . @ . @ 
@ . . . . . . . @ . @ @ . . @ . @ . @ . @ @ @ @ . @ . @ @ @ . . @ . @ . @ @ @ @ . . . @ @ . . . . . . . . . . . . . . . . @ . @ . @ @ . . . . . @ . @ @ . @ @ @ . @ . . @ . . . . @ . @ . @ @ . . . . @ 
@ . @ . @ . @ . . @ . @ . @ @ . . @ . . @ . @ . @ @ @ . @ . @ . @ @ @ @ @ @ . . @ . @ . . @ . @ . @ . @ @ @ . @ . @ @ @ . . @ . . @ . @ @ . @ . . . @ . . . . . . . . @ . @ . @ . . . . @ @ . . @ @ . @ 
@ . @ @ @ @ @ . @ . . . . . @ . @ @ @ . . . . . . @ . . . . . . @ . @ @ @ @ @ . . . . . @ @ @ . . @ @ @ @ @ . . @ . . @ . @ . @ . . . . . @ . @ . @ . @ . @ . @ @ . @ . . . @ . . @ . @ . . @ . @ . . @ 
@ . @ @ @ . @ . . @ . @ . @ @ . . . @ . @ @ @ @ . @ @ . @ . @ . . . . @ @ @ @ . @ . @ @ . @ . @ . @ @ @ @ . . @ . @ . @ @ @ . @ . @ . @ . . . . @ . . . . . @ . @ @ @ @ . @ . @ . . @ . . @ @ . . @ @ @ 
@ @ . . . . . . @ @ . @ . . . @ . @ @ . . . @ . @ . . . . @ . . @ . @ @ @ @ @ @ . . . . . . . . @ @ @ @ @ @ @ . . . . . . . . . . . @ . . @ @ . . . @ @ @ . . . . . @ . . . . . . @ . @ . @ @ @ . . . @ 
@ @ @ . @ . @ . @ @ @ . . @ . . @ . @ . @ . . . . @ . @ . @ @ . @ . @ @ @ @ @ . @ . @ . @ . @ . . @ @ @ @ . . . @ @ @ . @ . @ @ . @ . @ @ . . . @ . . . . @ @ @ @ @ . . @ . @ @ . . . . . . . . . @ . @ 
@ @ . @ @ . @ . @ @ . @ . . @ @ . . . . @ . @ @ . @ @ @ @ @ @ @ . @ . @ @ . . . . . . @ . . . @ . . . @ . @ @ @ . . . . @ @ . . . . . . @ . @ . . @ . @ . . . . . . @ @ . . @ @ . @ . @ . @ @ . @ @ . @ 
@ . . . . . . @ . . . . . @ @ @ @ . @ . @ @ @ @ . . @ @ . @ @ . . . . @ . @ . @ . @ @ . @ . @ . . @ @ . . . . @ @ @ . @ . . . @ . @ @ . . @ . @ . . @ . . @ . @ . @ @ . . @ . . . . @ . . . . @ . . . @ 
@ . @ . @ . @ @ @ . @ . @ . . . . . . @ @ @ @ @ @ . @ . . . . @ @ @ . . . . . . @ @ @ . . . . @ . @ @ . @ @ . . . . . . @ . @ . . . @ . @ @ . @ . @ @ @ . . @ @ . . . @ . . @ . @ . . @ . @ . . @ @ . @ 
@ @ . . . @ . . . . . @ . @ . @ @ . @ . @ @ @ @ @ @ . . @ @ @ . . . . @ . @ . @ . @ @ @ @ . @ . . @ . @ . . . @ . @ . @ @ @ . . @ @ . . . . . . @ @ @ @ @ . . . @ . @ @ . @ @ @ @ . @ . @ . @ @ @ @ . @ 
@ @ @ . @ . @ . @ @ . . . . @ @ . . @ . . @ @ @ . @ @ . @ @ . @ . @ @ . . @ . . . . @ . @ @ . @ . . . . . @ . @ @ . . @ @ . @ . @ . . @ . @ . @ . . @ . . @ . @ . . . . @ @ @ . @ . . . @ . . @ @ . . @ 
@ @ . . @ . . . @ . . @ . @ @ . @ . . . @ . @ @ . . . . . . . . @ . . . @ . . @ . @ . . @ . . . . @ . @ . . @ . . . @ . . . . . . @ @ @ . . @ @ @ . . . @ . @ @ @ . @ @ . . . . . . @ @ . @ . . . @ . @ 
@ . @ . @ . @ . . @ . @ @ . . . . . @ @ . . . @ @ . @ . @ . @ . . . @ . . @ . . @ . @ . @ . @ . @ . . . @ . @ . @ . @ @ @ . @ . @ . . . . @ . . @ @ @ . . . @ @ . . . @ . @ . @ . @ @ @ . . . @ @ . . @ 
@ . . . . @ . . @ . . @ . . @ . @ . . . @ . @ . . . @ . @ . @ . @ @ . . @ @ @ @ . . . . . @ . . . @ . @ . . @ @ . . . . . @ . @ @ @ . @ @ . @ . . . @ @ . @ . . @ . @ @ . . @ . . . . @ @ @ . . . @ . @ 
@ @ @ . @ . @ . . @ . . @ @ . @ . . @ @ . . . . @ @ @ @ . . . @ . . @ @ @ @ @ . @ @ . @ . @ @ @ @ @ @ @ @ @ . @ . @ @ . @ @ . . . . . . . . . . @ . . . . . @ . . . . . @ . . @ . @ . @ @ @ @ @ . @ @ @ 
@ . @ @ . . . . @ @ @ . @ . . . @ . @ @ @ . @ . @ . @ @ @ . @ @ . @ . . . . . . . @ @ . . . @ . . @ @ @ . . . . . . @ . . @ . @ . @ . @ . @ . @ . @ @ . @ . @ . @ . @ . . @ @ . . @ . . @ . @ @ . . . @ 
@ . . . @ . @ . . @ . . . . @ . . . @ @ @ @ . . . . . @ . . . . . . @ . @ . @ . @ @ . @ . @ @ @ . . @ . . @ . @ . @ . . @ . . . @ @ . @ @ . . . . . . @ . . . @ . . . @ @ @ . @ . . @ . . . . . . @ @ @ 
@ . @ . . . . @ . @ . @ . @ . @ @ @ . @ @ @ @ . @ . @ . . @ . @ @ @ @ @ @ @ @ . . . . . . @ @ . . @ @ @ . . @ @ @ . @ . . @ @ @ . . . . @ @ . @ @ . @ @ @ @ @ . @ . @ @ . . . . . @ @ . @ @ . @ . . . @ 
@ @ . . @ . @ . . @ . @ . . . . . . . . @ @ @ . . @ @ @ . . @ . @ . . @ @ @ . @ @ . @ @ . . @ @ . . @ . . @ @ @ . . . . @ @ . . . @ . @ . @ . . . @ . @ . . . . . . @ @ . @ . @ . . . @ @ @ @ . . @ @ @ 
@ @ . @ . . . @ . @ . @ . @ . @ . @ . @ @ @ . . @ @ @ . @ . . . . . @ . @ . . . @ . . @ . @ @ . @ . @ @ . . . @ @ . @ . . @ . @ @ . . . . . @ @ . . . . @ @ @ . @ @ . @ . . @ . . @ . . @ @ . @ . . @ @ 
@ . . @ @ . @ @ . @ . @ . . @ @ . . @ @ @ . . @ . . @ . . @ . @ . @ . . @ . @ . @ @ @ . . . . . . . . . . @ . . . @ . . @ . @ @ . @ . @ @ . . . @ . @ . . . . @ @ @ . . @ . . @ @ . . @ . @ . @ @ . @ @ 
@ . @ . @ . @ . . @ . @ . @ . . . @ @ @ . @ . @ @ . . . @ . @ @ . . . @ @ @ . . . . . . @ @ . @ . @ . @ . @ . @ . @ @ . . . . @ . . @ . @ . @ . . @ . . @ . @ @ . @ . @ . . @ . @ @ . @ . . . . . . . @ 
@ @ . . . . @ . @ . . . @ @ @ @ . @ @ . . . . . . @ @ . . . . . @ . @ @ @ @ @ @ . @ . @ @ @ @ . . . @ . . . @ @ . @ . @ @ . @ . @ . . . . . . @ . @ @ . @ . . . . . . @ . @ . . . @ . . @ . @ . @ . @ @ 
@ . . @ . @ . @ . @ . @ @ @ @ @ @ @ @ . @ @ . @ @ @ . @ . @ . @ . @ @ @ @ @ @ . @ . . @ @ @ . . @ @ . @ . @ . . . @ . . . . . . . @ . @ . @ @ . @ . . @ . . @ . @ . @ @ . . . @ @ . . @ @ @ . . . @ @ @ 
@ . @ . . @ . @ . @ @ @ @ . @ . . @ . @ @ . @ @ . @ . @ @ @ . . . @ @ @ @ @ @ . . . @ @ @ . @ @ . . . . . . @ @ . @ @ @ . @ . @ . . @ . . @ . . . . @ @ @ . . @ @ @ @ @ @ . @ . @ @ . . . @ @ . @ . @ @ 
@ @ @ @ . . . . . . @ @ @ . . @ . @ . . . . . . . @ . . . @ . @ @ @ @ @ @ @ . @ @ . . @ . . . . @ . @ @ . @ @ @ @ . . . . @ . . @ . @ @ @ . @ @ . @ . @ . . @ @ @ @ @ @ @ @ @ . . . . @ @ @ . . . . . @ 
@ @ @ @ @ . @ @ . @ @ @ . . @ . . @ @ @ . @ @ @ . . . @ @ . . . @ . @ @ @ @ . @ . @ . @ @ @ @ . @ . . . @ @ . . . @ . @ @ @ . @ . . . . . . . . . . . @ . @ @ @ @ @ @ @ . @ @ @ @ . @ . . @ . @ . @ @ @ 
@ @ @ . @ . . . @ @ @ . . @ @ @ . @ . @ @ . . . @ . @ . . . @ @ . . @ @ @ . . . . . . @ . . . . . . @ . . . @ @ . @ . . @ . . . @ @ . @ @ . @ @ . @ @ @ @ . . @ @ @ . . . . . . . . @ . @ . @ @ . . . @ 
@ . . . . . @ . . @ . @ . . . . . . . @ . @ . @ . . . . @ . @ . @ . @ @ . @ . @ . @ . . @ . @ . @ . . @ @ . @ . . . . @ @ @ . @ . @ @ . . . . . @ . . @ . . @ @ @ . @ . @ . @ . @ . . . . . @ . @ . @ @ 
@ @ . @ . @ . . @ . . @ @ . @ . @ . @ . . . . . . @ . @ . . . . . . . . . . . @ @ . . @ . @ . . . @ . . . @ @ @ . @ . @ . @ . . . . @ @ @ . @ . @ . @ . @ . @ @ @ . . . @ . . @ @ . @ . @ . . . . @ @ @ 
@ . . . @ @ @ @ . . @ @ @ . @ . @ . . . @ . @ @ @ . @ . . @ . @ . @ . @ . @ . @ . @ @ . . . . @ @ @ @ . @ @ @ @ . @ @ . . . . @ . @ . . . @ . . . . . . . . . @ . . @ @ . . @ @ . . . @ . . @ . @ @ @ @ 
@ @ . @ . @ @ @ . @ . @ . @ @ @ @ @ . @ @ @ @ . . . . . @ . . @ @ @ @ @ @ . @ . . . . . @ @ . . . @ . . @ @ @ . . @ . . @ . @ . . . . @ @ @ @ @ . @ . @ . @ . @ . @ . @ @ . . . @ . @ . @ . . @ @ @ @ @ 
@ . . @ . @ . . . . . @ . @ @ @ @ @ @ . @ . @ @ . @ . @ @ . @ @ . @ @ . . . . . @ . @ . @ . . @ . @ @ . . . . @ . @ . @ . . . @ @ . @ . . @ . . @ . . . @ . . @ . . . . . @ . @ @ @ @ . @ . @ . @ @ @ @ 
@ @ . . . . . @ . @ . . . . @ @ @ . @ . @ . @ . . . @ . . . . . . . . @ . @ . @ @ @ @ @ @ @ . . @ . . @ . @ . . @ . . @ @ . @ @ . . . . @ . @ . @ @ . @ . @ . @ . @ @ . @ . . . @ @ . . @ . . . . @ @ @ 
@ . . @ . @ @ . . . @ . @ @ . @ . . . . . . @ @ . @ @ . @ . @ @ . @ . . @ @ @ @ @ @ @ @ . @ @ . . . @ @ @ @ . @ @ . @ . . . . . @ . @ . . . . . . . @ @ . @ . @ . . . @ @ @ . @ . @ @ . @ . @ . @ @ @ @ 
@ @ . . @ . @ @ . @ @ @ @ . . . @ . @ . @ . . @ . @ @ @ . . . . @ . . @ @ @ @ @ @ @ @ @ . @ @ @ . @ @ @ . . . @ @ . @ . @ . @ . @ . . @ @ . @ . @ . . . . . @ @ . @ . . . @ . . . @ . . . . @ . @ @ . @ 
@ . . @ . . . @ . . @ . @ . @ @ . @ . @ @ @ . @ @ @ @ . @ . @ . . @ @ @ @ @ @ @ @ @ @ . . . @ . . @ @ . @ @ . . @ . @ . . @ . . @ . @ . @ @ . . . @ @ @ . @ . . . . @ @ @ @ @ @ . . @ . @ . . @ . . . @ 
@ @ . @ . @ @ . @ @ . . . . . . . . . . @ . . . . @ @ . . @ . . @ @ @ @ . @ . @ @ @ . @ . @ . @ . . . . . @ @ . @ @ . . @ @ @ . @ . @ . . . @ @ . . . . @ @ @ @ . @ @ @ . . . . . @ @ @ . . @ . @ @ . @ 
@ @ @ . . . . . . @ . @ . @ @ @ . @ . @ . . @ @ @ . . . @ @ @ . . @ @ @ . . . . @ . . . . . . . @ @ @ . @ @ . . . . @ . @ @ . . @ . . . @ . . @ @ . @ . @ @ . . @ @ @ . @ . @ . @ @ @ @ @ . . . . . . @ 
@ @ @ @ . @ . @ . @ . @ @ . @ @ @ . . . . @ @ @ . @ @ . @ @ . . @ @ @ . @ @ . @ . @ @ . @ . @ . @ . @ . . . @ . @ @ . . . @ @ . @ . @ . @ . @ . @ . . @ @ @ @ . . @ . . . . . @ @ @ @ @ @ @ . @ . @ @ @ 
@ @ @ @ @ . @ . . . . @ . . . @ . @ . @ @ @ . . . @ . . . @ . @ . @ . . . . . . . . . . . @ . . . . . . @ @ @ . @ @ @ @ . . . @ . . . @ @ . @ . . . @ . @ @ . @ . @ @ @ . @ @ @ @ @ . @ @ . . . @ @ @ @ 
@ @ . @ . . @ @ . @ @ . @ . @ . . . . . . . . @ . . @ . @ . . . . . @ @ . @ . @ @ . @ . @ @ @ . @ @ @ . @ @ . @ . . . . . @ . @ @ . @ . @ @ . . @ . . . @ . . . . . @ . . @ @ @ . . . . . @ . @ @ @ @ @ 
@ . . @ @ . . @ . . @ . . . . . @ . @ . @ . @ . @ . @ . @ @ . @ . @ . . . . @ @ @ @ . . . @ @ @ . . . . @ . . . . @ . @ @ @ @ . . . . . . . @ @ . . @ @ @ . @ @ @ . . . @ . @ . . @ . @ . . . @ . @ @ @ 
@ @ . . @ . @ . @ . . @ . @ . @ . . . @ . . @ . . . . . . . . . @ . . @ . @ . @ @ @ @ . @ . @ @ @ . @ . @ . @ . @ . . . @ . . . @ @ . @ . @ . . @ . @ . . @ . . @ @ @ . . . @ . @ . @ @ . @ . . . . . @ 
@ . @ . @ . @ . . @ . . @ . . @ @ . @ @ @ . . @ . @ . @ . @ . @ . @ @ . . . . @ @ @ @ . . . . @ . @ . . @ . . @ . @ . @ . . @ . . @ . . @ . @ . @ . . . @ . @ . @ @ @ @ . @ @ @ . . . . . . @ @ . @ . @ 
@ . . . . . . . @ . @ @ . @ . @ @ @ . . . . @ @ . . @ . . @ . . . . . @ . @ @ @ @ @ . . @ @ . . . . @ . @ . @ @ . . . . @ . @ @ @ . . @ . . . . . . @ . @ . @ . @ @ @ @ . . . @ @ . @ @ . @ . . . @ . @ 
@ @ . @ @ . @ . . . . . . . . @ . . . @ @ @ @ . . @ . @ . . @ @ @ @ @ . . @ @ @ . @ @ . . . @ . @ . @ . . @ @ . . @ . @ @ . . . . @ . @ . @ . @ . @ @ . . . . . . @ @ @ @ . @ @ @ @ . . . . @ @ . . @ @ 
@ @ @ . . . @ @ . @ @ . @ . @ . . @ . @ @ @ @ @ @ . . . . @ @ . @ . . @ . @ . @ . @ . @ @ @ . . . @ @ . @ . . . @ . . @ . . @ . @ @ @ . . @ @ . . . @ . @ . @ . @ @ @ @ @ @ @ @ @ @ @ . @ @ @ . . @ @ @ 
@ @ @ @ @ . . . @ @ . @ . . @ @ @ . . @ @ @ @ @ @ @ . @ . . . . . . @ . . . . . . . . . . . @ . @ @ @ @ @ @ . @ . . @ @ @ . . @ . . . . @ . . . @ . @ . . @ . . @ @ @ @ @ @ @ @ @ @ @ @ @ @ @ @ . @ @ @ 
@ @ @ @ @ @ . @ @ @ . . . @ . . . . @ @ @ @ @ @ @ @ . . @ . @ . @ . . @ . @ . @ @ @ @ . @ . . @ @ @ @ @ @ @ . . @ . . @ . . @ @ @ . @ . @ . @ . @ . @ . @ @ @ @ @ @ @ @ @ @ @ @ @ @ @ @ @ @ @ @ @ @ @ @ 
@ @ @ @ @ @ @ @ @ @ @ @ @ @ @ @ @ @ @ @ @ @ @ @ @ @ @ @ @ @ @ @ @ @ @ @ @ @ @ @ @ @ @ @ @ @ @ @ @ @ @ @ @ @ @ @ @ @ @ @ @ @ @ @ @ @ @ @ @ @ @ @ @ @ @ @ @ @ @ @ @ @ @ @ @ @ @ @ @ @ @ @ @ @ @ @ @ @ @ @ 
3
84 17 55 90
54 69 51 66
69 30 29 21
