50 50
@ @ @ @ @ @ @ @ @ @ @ @ @ @ @ @ @ @ @ @ @ @ @ @ @ @ @ @ @ @ @ @ @ @ @ @ @ @ @ @ @ @ @ @ @ @ @ @ @ @ 
@ @ . . . . . . . . . . . . . . @ . . @ @ @ @ @ @ @ @ @ @ @ @ @ @ @ @ @ . . . @ @ @ @ @ @ @ @ @ @ @ 
@ . . @ . @ . @ . @ . @ . @ @ . . . @ @ @ @ @ @ @ @ @ @ @ @ @ @ @ @ @ . @ . @ @ @ @ @ @ @ @ @ @ @ @ 
@ . @ . . . @ . . @ @ . . . @ . @ . @ @ @ @ @ @ . @ @ @ @ @ @ . @ @ @ . . . . @ @ @ @ @ @ @ @ @ @ @ 
@ @ . @ . @ @ @ . . . @ . @ @ @ . . . @ @ . @ . . . @ @ @ @ @ . . @ @ . @ . @ . @ @ @ @ @ @ @ @ @ @ 
@ @ . . . . @ . . @ . @ . @ @ @ @ . @ . . . . @ @ . @ @ @ @ . @ . . . @ . . . . . @ @ @ @ @ @ @ @ @ 
@ . . @ . @ @ @ . . @ . @ @ @ @ . . @ . @ @ @ @ @ . . . @ @ . . . @ @ @ @ . @ . @ @ @ @ @ @ @ @ @ @ 
@ @ @ . . @ @ . . @ . . . @ @ . @ . @ . . @ @ @ . . @ @ @ . . @ @ . . @ . . @ . @ @ @ @ @ @ @ @ @ @ 
@ @ . @ . @ @ @ @ . @ @ . . . . . . @ . @ . @ @ @ . . @ . @ . . @ . @ . @ . @ . . @ . @ @ @ @ @ @ @ 
@ . . . . . . @ . . @ . @ @ @ . @ . . . . . . @ @ @ . @ . @ . @ @ . @ . @ . @ . @ . . . @ . @ @ . @ 
@ @ . @ . @ . . @ . . . @ @ @ @ . . @ @ . @ @ @ . . . . . . . @ . . @ . @ . @ . . @ . @ . . . @ . @ 
@ . . . @ . . @ . @ @ . . @ @ @ @ . . @ . @ . . . @ . @ . @ . . @ . . . . @ . . @ @ . . . @ @ . . @ 
@ @ @ @ . . @ . . . . . @ . . @ @ . @ @ @ @ @ . @ . . @ @ . . @ . . @ . @ . . @ . @ @ @ . . @ . @ @ 
@ . . @ @ . . @ @ . @ . . . @ @ . . . @ @ @ @ . . @ @ . . @ . @ . @ . @ . @ . . . . . @ . @ . . . @ 
@ @ . . . . @ @ @ . @ . @ @ . . @ @ . . @ @ @ . @ . . . @ . . . . @ . @ . . @ . @ . @ . . @ . @ . @ 
@ . . @ @ . . @ @ @ . . . . . @ . . . @ @ @ @ @ . @ @ . . . @ @ @ . . @ @ . . . @ @ . @ . @ . . @ @ 
@ . @ @ . . @ . @ @ @ . @ @ @ . @ @ . . . @ . . . . @ . @ @ . @ @ @ . @ . @ @ . . @ . . . . . @ . @ 
@ @ . . . @ . . @ @ @ . @ . @ . @ . @ . @ . @ @ . @ . . @ . . . @ . . @ . . . . @ . . @ . @ . . . @ 
@ . . @ . . @ . . @ . . . . . . . . . . . . . . . @ . @ . @ . @ @ @ . . @ @ @ . . @ . . @ . . @ @ @ 
@ @ . @ . @ . @ . . @ . @ . @ @ . @ @ . @ . @ @ . @ . . . . . . @ . . @ @ @ @ @ . @ . @ @ @ . . @ @ 
@ @ @ . . @ . . . @ . @ . . . @ . . @ @ @ . @ . . @ . @ . @ . @ . @ . @ @ @ . . . . . . @ @ . @ @ @ 
@ @ @ @ @ . @ @ . @ . . @ @ @ @ @ @ . @ . @ @ @ . . . @ . . @ @ . . . . . @ @ . @ @ . @ . @ @ @ @ @ 
@ . @ @ . . @ . . . @ . . . @ @ @ . . . . . @ @ @ . @ . . @ @ @ @ . @ . @ . @ . . @ . . . @ @ . @ @ 
@ . . . @ . . @ @ . . . @ . @ @ @ @ @ @ . @ . @ . . . @ . @ @ @ @ @ . . . . @ . @ . . @ . . . . . @ 
@ @ @ . . @ . @ . @ @ . @ @ @ @ @ @ @ . . . . @ @ . @ . @ @ @ @ @ @ @ @ @ . . @ . . @ . @ @ @ @ @ @ 
@ . . @ . . . . . . . . . @ @ @ @ @ . @ . @ @ . . . . . @ @ @ @ @ @ @ @ . . @ . @ . . . . @ . . . @ 
@ . @ . @ @ @ @ . @ . @ . . . . @ . . . . @ @ @ @ @ @ . . . @ @ @ @ @ @ @ . . . . . @ . @ @ . @ @ @ 
@ . . . . . @ @ @ @ @ . @ @ @ . @ @ @ @ . . @ . . . . . @ . . @ @ @ @ . . @ @ @ @ . @ . . . . . . @ 
@ @ @ . @ . . . @ @ . . . @ . . . @ @ . . @ . @ @ @ . @ @ @ . . . . . . @ . . . @ . . @ . @ . @ @ @ 
@ . . @ . . @ . @ . @ . @ . @ @ . . @ @ . . . . . . @ . @ . @ . @ . @ . . . @ . . . @ . . . @ @ @ @ 
@ @ . @ @ . . @ . . . . . . @ . @ . @ . @ . @ @ . @ . . . . . . . @ . . @ @ . @ . @ . @ . @ @ @ @ @ 
@ . . . . . @ . @ @ @ @ @ . . . . . . . . @ @ @ . @ @ . @ @ . @ @ @ @ . . @ . @ @ . . . @ @ @ @ @ @ 
@ . @ . @ . . . . . . . . . @ @ @ @ @ . @ @ @ @ . . . @ . @ . @ . @ . @ . . . @ @ @ @ . . @ @ @ @ @ 
@ . @ . . @ @ . @ @ . @ . @ . @ . @ . . . . . . . @ @ . . @ @ . . . . . @ @ . . @ . . . @ . . . @ @ 
@ . @ . @ . . @ . . @ @ @ . . . . . . @ . @ . @ . . . @ . . . @ @ @ @ . @ . . @ . @ . @ . . @ @ . @ 
@ @ . @ . @ . @ . @ . @ . @ . @ @ @ . @ @ @ @ . @ @ . @ . @ @ . . @ @ . . @ . @ . . . . @ . . . . @ 
@ . . . . . . . . . . . . . @ . @ @ @ . @ @ . . . @ . . . . @ @ . . @ @ . @ . . @ @ @ . . . @ . @ @ 
@ . @ . @ . @ . @ . @ @ . @ . . . @ . . . . @ @ . . . @ . @ . . . @ @ @ . . . @ . . @ . @ . . @ @ @ 
@ . . @ . . . @ . . . @ . . @ . @ . @ . @ . @ . @ @ . @ @ @ @ . @ . @ . @ @ . @ . @ . @ . @ . . . @ 
@ . @ @ @ . @ . . @ @ @ @ . . . . . . . @ . . . . . . . . @ . . . . . . . . . . . . . . . . . @ @ @ 
@ . . . . @ . . @ @ @ @ @ @ . @ @ @ . @ . @ . @ . @ . @ . . . @ @ . @ @ @ @ . @ . @ . @ . @ . . . @ 
@ . @ @ . @ @ . @ @ @ @ @ . . @ . . @ . . . @ . . . @ . . @ . @ . @ @ . . . . @ @ . . . @ . . @ . @ 
@ . . . @ @ @ @ @ @ @ @ @ . @ @ . @ . @ . @ . @ @ @ . @ . . @ . . . . . @ . @ @ . @ . @ @ @ . . @ @ 
@ . @ @ @ @ @ @ @ @ @ @ . @ . @ . . . . . . . . . . . . . @ . . @ @ @ . . @ . . . . . @ @ . . @ @ @ 
@ @ @ @ @ @ @ @ @ @ @ . . . . . @ @ . @ . @ @ @ @ @ . @ . @ @ . . . @ . @ @ @ . @ . @ . . . @ @ . @ 
@ @ @ @ @ @ @ @ @ @ . @ @ . @ . . . . @ . @ @ @ @ . . @ @ . . . @ . @ @ . . . . . @ . . @ . . . . @ 
@ @ @ @ @ @ @ @ @ . . . @ . . @ . @ . . @ @ @ @ @ @ . . . @ @ . . @ @ @ @ . @ . @ . @ . @ . @ @ . @ 
@ @ @ @ @ @ @ @ @ . @ . @ . @ @ @ . . @ @ @ @ @ @ @ @ . @ @ @ @ @ @ @ @ @ @ . . . . . @ . . @ . . @ 
@ @ @ @ @ @ @ @ @ @ . . . . @ @ @ @ . @ @ @ @ @ @ @ @ @ @ @ @ @ @ @ @ @ @ @ @ @ . @ @ @ @ . @ @ . @ 
@ @ @ @ @ @ @ @ @ @ @ @ @ @ @ @ @ @ @ @ @ @ @ @ @ @ @ @ @ @ @ @ @ @ @ @ @ @ @ @ @ @ @ @ @ @ @ @ @ @ 
3
23 22 16 42
19 26 4 18
26 29 38 17
