20 20
@ @ @ @ @ @ @ @ @ @ @ @ @ @ @ @ @ @ @ @ 
@ @ @ . . . @ . @ @ @ @ @ @ @ . . . . @ 
@ @ . . @ . . . @ @ @ @ @ @ . . @ . @ @ 
@ @ @ . . @ @ @ @ @ @ @ @ @ @ . @ . . @ 
@ @ @ . @ . . @ @ @ @ @ @ @ @ . . @ @ @ 
@ @ . . . . @ . @ @ @ @ @ @ . @ . @ @ @ 
@ @ @ @ @ . . . . . @ . @ . . . . @ @ @ 
@ @ . . @ @ @ @ . @ . . @ @ . @ . . @ @ 
@ @ @ . @ @ @ @ . . @ . @ . . @ @ . . @ 
@ . @ . . @ @ . @ . . . @ @ . @ . . @ @ 
@ . @ . @ . . . . @ @ . @ . @ . @ . . @ 
@ . . . . . @ @ . . . . . . . . @ . @ @ 
@ @ . @ @ @ . . . @ . @ . @ @ . @ . . @ 
@ @ . . . . @ . @ @ @ . @ @ . . @ . @ @ 
@ . . @ @ . @ @ . @ @ . @ . @ . . . . @ 
@ @ . . @ . @ . . . . . . . @ @ . @ . @ 
@ @ . @ . . @ . @ . @ . @ . . . @ . . @ 
@ . @ . @ . . @ . . . @ . . @ @ . @ . @ 
@ . . . . . @ @ . @ . @ @ . . . . . . @ 
@ @ @ @ @ @ @ @ @ @ @ @ @ @ @ @ @ @ @ @ 
3
16 13 1 18
12 18 13 14
5 5 6 8
