50 50
@ @ @ @ @ @ @ @ @ @ @ @ @ @ @ @ @ @ @ @ @ @ @ @ @ @ @ @ @ @ @ @ @ @ @ @ @ @ @ @ @ @ @ @ @ @ @ @ @ @ 
@ @ @ @ @ @ @ @ @ @ @ @ @ @ @ @ @ @ @ . . . . . @ . . @ @ . @ . @ @ . @ @ @ @ @ . . . . @ . @ . @ @ 
@ @ @ @ @ @ . @ @ @ @ . . @ @ @ @ @ . @ . @ . @ . . @ @ @ . . . . . . @ @ @ @ @ @ . @ . . . . . . @ 
@ @ @ @ . . . . @ @ @ @ . @ . @ @ . . . . . @ . @ . . @ . . @ @ . @ . . @ @ @ @ @ @ . . @ @ . @ @ @ 
@ @ @ @ @ . @ . . . @ . . . . . . @ . @ . @ . . . . @ . @ @ . . . @ . @ . . @ @ @ . @ . . . @ @ . @ 
@ @ @ @ @ . @ . @ . . . @ . @ @ . . @ . . @ @ @ @ . . . . @ @ . @ . . @ @ . . @ . . @ . @ . . @ . @ 
@ @ @ @ @ @ @ @ . . @ @ . . . @ . @ . @ . . . @ . . @ . @ . @ @ . @ . . . . @ @ @ . . . . @ @ . . @ 
@ @ @ @ @ @ @ . . @ @ . @ . @ . . . . . . @ . . @ . @ @ . . . . . @ . @ . @ . @ . . @ @ . @ . . @ @ 
@ @ @ @ @ @ @ . @ . . . . . . @ . @ . @ . @ . @ . . @ @ @ . @ . @ @ @ . . . . . @ . . @ . . @ . . @ 
@ @ @ @ @ @ @ @ @ . @ . @ . @ . . @ . @ . @ . . @ . . @ . . @ @ @ @ . @ . @ . @ . . @ @ @ @ @ . @ @ 
@ @ @ @ @ @ @ @ @ @ @ @ . . . @ . . @ . . . @ @ @ . @ . @ . . . @ . . . . . @ . @ . @ @ @ @ . . . @ 
@ @ @ @ @ @ @ @ @ @ @ @ @ . @ @ @ @ . @ . @ . . . . . . . . @ . . @ . @ . @ @ . . . @ @ @ @ @ . @ @ 
@ @ @ @ @ @ @ @ @ @ @ @ @ @ @ @ . @ . @ . . @ . @ . @ . @ @ . @ . @ @ . . . . @ @ . . @ @ @ @ . . @ 
@ @ @ @ @ @ @ @ @ @ @ @ @ . . . . . . . . @ @ @ . . . @ . @ . . @ . . @ . @ . . . . @ . @ @ . @ . @ 
@ @ @ @ @ @ @ @ @ @ @ . . . @ . @ . @ @ . . @ . @ . @ . . . . @ . @ . . @ . . @ . @ . . . . . . . @ 
@ @ @ @ @ @ @ @ @ @ . @ @ @ . . . @ @ @ . @ . . . . @ . @ @ @ . . @ . @ . @ . @ @ @ . @ @ . @ . @ @ 
@ . . @ . @ . . . @ . @ @ @ @ . @ @ @ . . @ @ . @ . @ . . @ . @ . . . . . . . . . . . . . @ . . @ @ 
@ @ . . . . . @ @ . . . @ @ @ @ . . . @ . @ . @ . . . . @ @ . . . @ @ . @ @ . @ @ @ . @ @ @ @ . @ @ 
@ @ . @ . @ . . . @ @ . . @ @ @ . @ . . . . . @ . @ . @ . . . @ . . . @ . . @ @ . . @ @ . @ @ @ @ @ 
@ . . @ @ @ @ @ . @ . @ . . @ @ @ . . @ . @ . @ . . @ . @ @ . @ . @ @ . . @ . @ . @ . . . . . . @ @ 
@ @ . @ @ @ . @ . @ . @ . @ . . . . @ . . . @ . . @ . . . . . . @ . . . @ . . @ . . @ . @ . @ @ . @ 
@ @ @ . @ . . . . . . . . . . @ @ @ . @ . @ . @ . . @ @ . @ . @ . @ @ . . . @ . . @ . . @ . @ . . @ 
@ @ @ . . @ . @ . @ . @ @ @ . @ @ . . . . . . . @ . @ . @ . . . . @ . . @ . @ @ . @ . @ . @ . @ . @ 
@ @ . @ . @ @ @ @ @ @ @ @ @ @ . @ @ . @ . @ @ . . . . . . @ . @ . @ @ . . @ @ . . . . . . . . . . @ 
@ . . . . . . @ . @ . @ . @ . . . . @ . . @ @ @ @ . @ @ . . . @ @ . @ . @ . @ @ . @ . @ . @ . @ . @ 
@ . @ @ . @ . . . . . . . . @ . @ . @ . @ . @ . . . . . @ @ . . . . . . . . . . . . @ . . . @ . . @ 
@ @ @ @ @ . . @ . @ . @ @ . . . . @ . . @ . . . @ . @ . . @ . @ . @ . @ . @ . @ . @ @ @ . @ @ @ @ @ 
@ @ @ @ @ @ @ . . @ @ . . . @ . @ . @ @ @ @ . @ . . . @ @ . . . @ @ . . @ . . . @ @ @ . @ . @ . @ @ 
@ @ @ @ @ @ @ @ @ @ @ @ . @ . . . . . . . . . @ @ . @ . @ @ . @ . . . @ . @ . @ . @ . . @ . . . . @ 
@ @ @ @ @ @ @ @ . . @ @ . . @ . @ . @ @ @ . @ . . . . . . . @ . . @ . . . @ . . . . @ . @ @ . @ . @ 
@ @ . @ . @ . @ @ . . . @ . . @ @ . @ @ @ @ @ @ . @ . @ @ . @ @ . @ . @ @ @ . @ . @ @ . . @ @ . . @ 
@ . . . . . . . . . @ @ @ @ @ . . . . @ @ . @ . @ . . @ . . . . @ . . . . . @ . . @ . . @ . @ @ . @ 
@ @ @ @ . @ @ . @ . . . @ @ @ @ . @ @ . . . . . . . @ . @ . @ @ . @ . @ . @ . . @ . @ . . . . . . @ 
@ @ . @ . . . @ . @ . @ . @ @ . . @ . . @ . @ . @ . @ . . @ @ . . . . . @ @ @ . . . . . @ @ @ @ @ @ 
@ . . . . @ . @ . @ . @ . . . @ . @ . @ @ . @ @ . . . @ . . . . @ @ @ @ @ @ @ . @ . @ . . . . . . @ 
@ . @ @ . @ @ @ . . . . . @ . @ . . @ . . @ . . @ @ . . @ . @ . . . . . . @ . . . @ @ . @ . @ . @ @ 
@ @ . @ . . @ . . @ @ @ . . @ . . @ . . @ . @ . @ . @ . . @ . . @ @ . @ . . @ . @ . . . . @ @ @ . @ 
@ . . . @ . . @ . @ . . . @ . . @ @ . @ . . . . . . . . @ . @ . . . @ @ @ @ . . @ @ @ . @ . @ . . @ 
@ @ . @ . @ @ . @ . . @ . . . @ . @ . @ @ . @ . @ . @ @ . . . . @ . . . . . @ . . . @ . @ . . @ . @ 
@ @ . . . . . . @ @ . @ @ @ . . . @ . . . . @ . . @ . @ @ . @ . @ @ . @ . @ @ @ . @ . @ . . @ . . @ 
@ . @ @ . @ . @ . @ . @ . @ . @ @ @ @ @ . @ . . @ . . . . @ . . . . @ @ . . . @ . @ . . @ . @ . @ @ 
@ . . . @ . . . . . . @ . @ . @ . @ . . . . @ @ . @ . @ . . @ @ @ . @ @ . @ @ . . . @ . . . . . . @ 
@ . @ . . @ . @ . @ @ . . . . . . . @ . @ @ . . . . @ . @ . . . . . . . @ . . . @ . . . @ @ @ @ @ @ 
@ @ . @ . @ @ . . . . @ @ . @ . @ @ @ . . . . @ . @ . . . . @ . @ . @ . @ @ . @ . . @ . . . . . @ @ 
@ . . . . . @ @ . @ @ . @ . @ . . @ @ @ . @ @ . @ . @ . @ . . @ . . . @ . . @ . @ . @ . @ . @ @ @ @ 
@ @ . @ . @ . @ . . . . . @ @ . @ @ @ @ @ @ . . . . . . @ . @ @ @ . @ . . @ . . . . @ @ @ . . . @ @ 
@ @ @ @ . . . . . @ . @ . . @ @ @ @ @ @ @ @ @ . @ . @ @ . . . @ . . . . @ @ @ . @ . . . . @ . @ @ @ 
@ @ @ @ @ . @ @ . . @ . . @ @ @ @ @ @ @ @ @ . . @ @ @ @ @ . @ @ @ . @ . @ @ @ . . @ @ . @ @ . @ @ @ 
@ @ @ @ @ @ . . . @ @ . @ @ @ @ @ @ @ @ @ @ @ . . . . . . @ . . . . . @ @ @ @ . @ @ . . . . @ @ @ @ 
@ @ @ @ @ @ @ @ @ @ @ @ @ @ @ @ @ @ @ @ @ @ @ @ @ @ @ @ @ @ @ @ @ @ @ @ @ @ @ @ @ @ @ @ @ @ @ @ @ @ 
3
40 42 5 46
35 1 14 35
35 45 23 26
