12 12
@ @ @ @ @ @ @ @ @ @ @ @ 
@ . @ @ . . . . . @ @ @ 
@ . . @ @ . @ . @ @ @ @ 
@ @ . . . . . @ @ @ @ @ 
@ . . @ @ . @ . @ @ @ @ 
@ @ . . @ @ . . . @ @ @ 
@ . . @ @ . @ . @ . @ @ 
@ @ . . . . . . . . . @ 
@ . . @ @ . @ . @ . @ @ 
@ @ . . . @ . . . @ @ @ 
@ @ . @ . @ @ . @ @ @ @ 
@ @ @ @ @ @ @ @ @ @ @ @ 
3
9 7 5 2
2 1 3 6
7 6 4 5
