12 12
@ @ @ @ @ @ @ @ @ @ @ @ 
@ @ @ @ @ @ @ . . . @ @ 
@ @ @ @ @ @ . . @ @ . @ 
@ @ @ @ @ @ @ . . . . @ 
@ @ @ @ . . . . @ . @ @ 
@ @ @ @ @ . @ . . @ @ @ 
@ @ @ @ @ @ . . @ . @ @ 
@ @ @ @ @ . @ . . . . @ 
@ @ @ @ . . . . @ . @ @ 
@ @ @ @ . @ . @ @ @ @ @ 
@ @ @ @ @ . . . @ @ @ @ 
@ @ @ @ @ @ @ @ @ @ @ @ 
3
9 4 9 6
7 5 4 4
2 10 8 5
