100 100
@ @ @ @ @ @ @ @ @ @ @ @ @ @ @ @ @ @ @ @ @ @ @ @ @ @ @ @ @ @ @ @ @ @ @ @ @ @ @ @ @ @ @ @ @ @ @ @ @ @ @ @ @ @ @ @ @ @ @ @ @ @ @ @ @ @ @ @ @ @ @ @ @ @ @ @ @ @ @ @ @ @ @ @ @ @ @ @ @ @ @ @ @ @ @ @ @ @ @ @ 
@ . @ @ @ . @ @ @ . @ @ @ @ @ @ @ . . . @ @ . . . . @ . @ . @ . . @ . @ . @ @ @ . . . . @ @ @ @ @ @ @ . @ @ @ @ @ @ @ @ @ @ @ @ @ @ @ @ @ @ @ @ @ @ . . @ @ @ . . @ . . @ @ @ @ @ @ @ @ @ @ @ @ @ @ @ @ 
@ . . @ . . . @ . . . . @ @ @ @ . . @ @ . @ @ . @ . . . . . . @ . . . . . @ @ . @ @ @ . @ @ @ . . @ . . . . . @ @ @ @ @ @ @ @ @ @ @ @ @ @ @ @ @ @ @ . @ . @ . @ . @ . @ @ @ @ @ @ @ @ @ @ @ @ @ @ @ @ @ 
@ @ . . @ . @ . @ . @ . . @ @ . . @ . @ . . . @ @ . @ . @ @ . . @ @ . @ . . . . . . . . . @ . . @ . @ . @ @ . . @ @ @ @ @ @ @ @ @ @ @ @ @ @ @ @ @ . . . . . . . . . . @ @ @ @ @ @ @ @ @ @ @ @ @ @ @ @ @ 
@ . @ . @ . @ . @ . . @ . @ . @ . . . . . @ @ . . @ . . @ . @ . @ . @ . @ . @ . @ . @ . @ @ @ . . . @ . . @ . @ . @ . @ @ @ @ @ @ @ @ @ @ @ @ @ @ . @ @ . @ . @ . @ @ @ @ @ @ . @ @ @ @ @ @ @ @ @ @ @ @ 
@ . . . . . . . . . @ @ @ @ . . . @ . @ @ @ @ @ . . . @ . . . . . . . . . @ . . . @ . @ . @ @ . @ @ . @ @ @ . . . . . . @ @ @ @ @ @ @ @ @ @ @ @ @ @ @ @ @ @ @ . . . . @ @ @ @ . . @ @ @ @ @ @ @ @ @ @ @ 
@ . @ . @ . @ . @ . . . . @ . @ . @ @ @ @ @ @ @ @ . @ . @ . @ @ . @ @ . @ . @ . @ @ . @ . . @ . @ . . . @ . . @ . @ @ @ . @ @ @ @ @ @ @ @ @ @ @ @ @ @ @ @ @ @ @ @ @ . . @ @ . @ . @ @ @ @ @ @ @ @ @ @ @ 
@ @ . . @ . . @ . @ . @ @ @ . @ . @ @ . . @ @ @ @ @ . . . @ . . @ . . . . . . . @ . . . . @ . . . @ @ . . @ . @ @ . . . . @ @ @ @ @ @ @ @ @ @ @ @ @ @ @ @ @ . @ . @ . @ . . . . . . @ @ @ @ @ @ @ @ @ @ 
@ @ @ . @ . @ . . . . . . . @ . . . @ @ . @ . @ . @ @ @ . . . @ . @ @ . @ . @ . @ @ @ . @ . @ @ . . . . @ . . . @ @ . @ . @ @ @ . @ @ @ @ @ @ @ @ @ . @ . . . . . . . . @ @ @ . @ . @ @ @ @ @ @ @ @ @ @ 
@ @ @ @ . @ @ @ @ @ . @ . @ . . @ @ . . . . . . . . @ @ . @ . . . @ . @ . . @ . . @ . . . . . . @ @ @ . . @ . @ @ @ . @ . . @ . . . @ @ @ @ @ @ @ . . . . @ . @ . @ . @ . . . @ . . . @ @ @ @ @ @ @ @ @ 
@ @ @ . . . @ . . @ . . @ @ @ . . . @ @ . @ . @ @ @ . . @ . @ @ . @ . . @ @ . . @ . . @ . @ @ . . . . . @ . . . @ @ @ . . @ @ @ . @ . @ @ @ @ @ . . @ @ . @ . @ . @ . . . @ @ . @ . @ @ @ . @ @ @ @ @ @ 
@ @ . @ . @ . . @ . @ . . @ . @ @ . . . @ . . . . . @ . . . . . . @ . @ @ . @ . @ @ . . @ . . . @ . @ . @ @ @ . @ @ . @ . . . @ . . . . @ @ @ @ @ . . @ @ . @ . . . @ . @ . . . . . . @ . . . @ @ @ @ @ 
@ . . @ . . @ . . . @ . @ . . @ . @ . @ . @ . @ @ @ @ @ . @ . @ . . . . . . . . . . @ @ . . @ . . @ . . . . @ . . . . . . @ . @ @ @ . @ @ @ @ . . . @ @ . . . @ . @ @ . . @ @ @ @ . @ . @ @ . . @ @ @ @ 
@ @ . . . @ . . @ . . . . . @ . . . . . . . . . . . . . @ . . . @ @ @ @ @ . @ . @ @ . @ @ @ . . @ @ @ . @ . @ @ @ . @ @ . . @ . . . . . @ @ . . @ . . . . @ @ . @ @ . . @ @ @ @ @ . @ . . . . @ . @ @ @ 
@ . @ . @ . @ . @ @ @ @ @ . @ @ . @ @ @ @ . @ @ @ @ @ . @ @ @ @ @ @ . @ . @ . . . . . . . @ @ @ @ @ . . @ . . @ . @ . @ . @ . . @ . @ . . @ @ @ @ @ . @ . . . . . . @ @ @ @ @ @ . . . . @ . @ . . @ @ @ 
@ . . . . . . @ . @ . @ . . @ . @ @ @ . . @ @ @ @ @ . . @ . @ @ @ . . . . . . @ @ . @ . @ @ . @ @ . @ . @ . @ . . . . @ . @ . @ . @ @ . @ @ @ @ @ @ @ . . @ . @ . @ @ @ @ @ @ . @ . @ @ . @ @ . @ @ @ @ 
@ . @ . @ @ . @ . @ . . @ . . . . @ . . @ . @ @ @ . @ . . . . @ @ . @ @ @ . @ . @ . . @ . . . . . . . . @ . . @ . @ @ . . . . . . . . @ @ . @ @ @ @ . @ . @ . @ . @ @ @ @ @ @ . . . @ . . . . . . . @ @ 
@ @ . . @ . @ . . . @ . . . @ @ @ @ @ . @ . . @ . . . @ @ . @ . . . . @ @ . @ . . . @ @ @ . @ @ . @ . @ @ @ . . . . @ . @ . @ . @ . @ . . . . @ @ @ . . . . @ . @ . @ @ @ @ @ @ @ . . . @ @ @ @ @ @ . @ 
@ . @ . . . . @ @ . . . @ . . . . @ . . . . @ . @ @ . . . . . . @ . @ . @ @ . @ @ . . . @ @ . @ @ . @ @ . . . @ @ . . . . @ @ @ . . . . @ @ . . . @ . @ . @ . . @ . . . @ @ @ . . . @ . . . . . . . . @ 
@ . . @ @ . @ @ @ @ @ . @ . @ @ @ @ . @ @ @ . . @ @ @ . @ . @ . @ . . . . @ . . . . @ . @ . . . . . . . @ @ . @ @ @ @ . @ @ @ . . @ . @ . @ . @ @ . @ . . . . @ . @ . @ . @ . @ . @ . @ . @ . @ @ @ . @ 
@ @ . @ . . @ @ @ . . . . @ . . . @ . @ . . . @ . @ . @ . @ @ @ . . @ @ . . @ . @ . . @ . @ . @ . @ . @ . . . . @ . . . . . . @ . @ . @ . @ @ @ . . . @ . @ @ . . . . . . . . . . . . . @ . . . . . @ @ 
@ . . . @ . @ @ . @ . @ . @ @ . @ . . . . @ @ @ . . . . . . . @ @ . . @ . @ @ @ . . @ . . . . . @ . @ . . @ . @ . @ @ @ . @ . . @ . . . . . . . @ . @ . . . . . @ . @ . @ . @ . @ . @ @ . @ @ . @ . . @ 
@ . @ . . . . . . . . . @ . @ . . @ . @ . . @ . . @ . @ @ . @ . . @ @ @ . . @ . @ . @ @ . @ @ . . . . @ @ @ @ @ . . @ . @ . . @ @ @ . @ @ . @ @ . . . @ . @ @ @ @ . . @ . . . @ @ @ . . . . . . . @ . @ 
@ . @ @ . @ . @ . @ . @ . . . . @ @ @ . . @ . @ . . @ . . @ @ . @ . @ @ . @ @ . . . . @ . @ . . @ @ @ @ . @ . . @ . . . . @ . . @ . @ @ @ . @ . @ . @ . . . @ . . @ @ @ @ . @ @ . . . @ @ @ @ . @ @ . @ 
@ @ @ . @ . . @ @ . . . @ . @ . @ @ @ @ . @ . . . @ @ @ . . . . . . @ . . @ @ . @ . @ @ . . @ . . @ @ . . . @ . . . @ . @ . @ . . . . @ . @ @ . . . . . @ @ . @ . . . @ @ . . . @ . @ . . . . . @ . . @ 
@ . . . . . @ . . @ . @ . . . @ @ @ @ @ . @ . @ . . @ . @ @ . @ @ . . . @ . . . @ . . @ . @ . @ @ . . @ . @ . @ @ . @ @ @ . @ . @ @ . @ . . @ . @ . @ @ . . . . @ @ . @ . . @ @ @ @ @ @ @ . @ @ @ @ . @ 
@ @ . @ @ . . @ . . . . @ . @ . @ @ @ . . @ @ . . @ . . @ @ @ @ . . @ . . @ @ . . @ . @ . . . . @ . @ @ . . . @ . . . . @ . . . . . @ . . @ . . . @ @ @ . @ . @ . . . . @ . . @ @ . . @ . . . . . . @ @ 
@ @ @ . . . @ . @ @ @ . @ . . . . . . @ . . . @ . . @ . @ @ @ @ @ . @ . @ . . . @ @ @ . @ . @ . . . . . @ @ . . . @ . @ . @ . @ . @ . @ . @ @ . @ . @ . . . @ @ @ . @ . @ @ @ . . . @ @ @ . @ . @ @ @ @ 
@ @ @ @ @ . . . @ . . . @ . @ . @ . @ . @ . @ @ @ . . . . @ @ @ @ @ @ @ . @ @ . . @ . . . @ . . @ . @ . @ . . @ @ @ @ . . . . . @ . . . . . . . . . . @ . @ . @ @ @ . . . . @ . @ . . @ . . . @ @ @ @ @ 
@ @ @ . @ @ . @ @ @ @ . @ @ . . . @ @ . . . . @ . . @ . @ @ @ @ @ @ @ . . . . . @ . @ . @ . @ . . @ @ . . @ . @ . @ @ . @ . @ . @ . @ . @ . @ . @ @ @ . . @ . @ @ . @ . @ . @ @ @ @ . @ @ . @ @ @ @ @ @ 
@ . . . @ . . . @ . . . @ . @ . @ . . @ @ . @ . @ . @ @ @ @ @ @ @ @ @ @ @ @ @ . . . . . . . . . @ . @ @ @ . . . . . . @ @ @ . . . . . @ . @ . . . . @ . @ . . . @ . . . . @ @ @ @ . . . @ @ @ @ @ @ @ @ 
@ @ . @ . @ . @ . . @ . . . @ . . . @ @ . . . . . . @ @ @ @ @ @ @ @ @ . . . @ @ . @ . @ @ . @ . . . . @ . @ . @ . @ . . @ . @ . @ @ @ . . . @ @ @ @ . . . @ . @ . @ . @ @ . @ . . . @ . @ @ @ @ @ @ @ @ 
@ . . . . @ @ @ . @ . @ @ . . . @ @ . . @ @ . @ @ . . @ @ @ @ @ @ @ . @ @ . . . @ . . . @ @ . . @ . @ @ . @ @ . . . @ . @ . . . . . @ . @ @ @ @ @ @ . @ . . . . . . . . . . . . @ @ . @ @ @ @ @ @ @ @ @ 
@ @ . @ . . . . @ . . @ . @ . @ . @ @ . . . @ . . . @ . @ @ @ . . . . @ . . @ . @ . @ @ @ . @ . @ . @ . . . . @ . @ . @ . @ . @ . @ @ . . . @ @ @ . . @ . @ . @ . @ . @ . @ @ . . @ . . @ @ @ @ . @ @ @ 
@ @ @ @ @ . @ . . @ . . . . . . . . @ @ . @ @ @ @ . . . @ @ @ @ . @ . . @ . @ @ . @ . . . . . . . @ @ . @ . @ . . . . . . . . . @ . @ . @ @ . @ @ @ @ . . . @ . . . @ @ . . . @ . @ . @ . @ @ . . . @ @ 
@ @ . @ . . @ @ . . @ @ . @ . @ . @ . . . . . . . . @ @ @ @ @ @ @ . @ . . . . . . . . @ . @ . @ . @ @ @ . . . @ @ . @ @ . @ . @ @ . . . . . . . . @ . @ . @ . @ @ . . . @ . @ . @ . . . . . @ @ . @ . @ 
@ . . . @ @ . . @ . . . @ . . . @ @ . @ @ . @ @ @ . @ @ @ @ @ @ . . . . @ @ . @ . @ . . @ . @ . . . @ . @ @ . @ . @ . @ . @ . @ . . @ @ . @ @ . @ @ . . . . . . @ . @ . . @ . . . . @ . @ . . . . . . @ 
@ . @ . . . . @ . @ . @ . @ . @ . . . . @ @ . . . . . . @ @ @ . @ @ @ . . @ @ @ @ . @ @ . . . @ . @ . . . . . . . @ . . @ . . . @ . . . @ . @ @ @ . @ @ . @ @ @ . @ @ @ . @ . @ @ . @ @ . . @ @ . @ . @ 
@ @ . @ . @ . @ . . . . . . . . @ @ . @ @ . . @ . @ @ . . @ . . @ . @ @ @ . @ . @ . @ @ @ @ . . . . @ . @ @ . @ @ . . @ . @ . @ . @ . @ @ . @ . . . @ . . @ . @ . @ @ @ @ . @ . . . @ @ @ . . . @ . . @ 
@ . . . . @ . @ @ @ . @ . @ @ . . @ . @ . . @ @ @ . . @ . @ @ . . . . @ . . . . . . . @ . . @ . @ . . . . @ @ @ @ @ . . . . . . . . . . . . . . @ @ @ . @ @ . . . . . @ . . . @ @ . . @ @ . @ . @ @ . @ 
@ @ . @ @ @ . . . . . @ . @ . @ . @ @ . @ . . @ . . @ . @ @ @ . @ . @ . @ . @ . @ . @ . @ . @ @ . @ . @ @ . @ @ . . . @ @ . @ . @ . @ . @ @ . @ @ . . . . @ @ . @ . @ @ @ . @ . @ . @ . @ . . @ . . . @ 
@ @ @ . . . . @ . @ . . @ . . . . . . . . . @ . @ . . . . @ . . . @ . . . @ . . . @ . . . . . @ . . . @ . . @ @ @ @ . @ @ @ . . @ . . @ @ . . @ . @ @ . @ @ . . . @ @ @ . . . . @ . . . . @ . @ @ @ . @ 
@ @ @ @ . @ . @ . @ . @ . @ . @ . @ @ @ @ . . . . . @ @ @ . @ . @ . @ . @ . @ . @ . @ . @ @ @ . @ @ . . @ . . @ . . . @ @ @ @ . . @ @ @ @ @ . @ . @ . . @ . @ . @ @ @ . @ . @ . @ . @ . @ . . @ . @ . @ 
@ @ @ @ @ @ @ . . . @ . . . @ @ @ @ @ . . . @ @ . @ . . . . . . . . . . . . . . . . . . @ @ @ . @ . @ . @ . @ . @ @ . . @ . @ @ . @ . @ . . @ @ . @ @ . . . . . . @ @ . . . . @ . . . @ @ @ @ . . . @ @ 
@ @ @ @ @ @ @ @ . @ . . @ . . @ @ @ . . @ . . . @ . @ . @ @ . @ . @ . @ . @ @ @ @ @ @ . . . . . . . . . . . . . @ . @ . . . . @ @ . . . @ . . . . . . . @ @ . @ @ . @ @ @ . @ . . @ @ . @ @ . @ . @ . @ 
@ . @ @ @ . . @ @ . @ @ @ @ . @ . @ . @ . @ @ . @ . @ @ . @ @ @ @ . @ . @ . . . . . . . @ . @ @ . @ . @ . @ @ . . . . @ @ . @ @ . @ . @ . @ @ . @ @ @ . . . @ . . . . @ . . . . @ . @ . @ @ . . . . . @ 
@ . . @ @ . @ . @ . @ @ @ . . @ . . . @ . . . . . . . . . . . . . . . . . . @ @ @ @ @ @ @ @ . . . . @ . @ @ . . @ @ . . . . . . . . . . . . @ . @ . @ . @ @ . @ @ . @ . @ @ . @ @ . @ . . . . @ . @ . @ 
@ . @ . . . . . @ . . @ . @ . @ @ . @ @ @ @ . @ . @ . @ . @ . @ . @ . @ @ . . @ . @ . @ @ @ @ @ @ @ . . . . . @ . . @ . @ . @ @ . @ . @ . @ @ @ . . . . @ @ . . . . . . . . . . . . . . @ . @ . @ @ @ @ 
@ . @ . @ . @ . @ . @ . . . . . . @ . @ . . . @ . . @ . @ . . . @ @ @ . . . @ . . . . @ @ @ . . . . @ @ @ @ @ . @ . . . . @ . . . . @ @ @ . @ @ @ . @ . . @ . @ . @ @ @ . @ . @ . @ . @ . . . . . @ @ @ 
@ . . . . @ . . . . . . @ @ . @ @ . . . . @ . . @ . @ . . . @ @ . @ @ @ @ @ . @ . @ . . @ @ @ . @ . . . . . . . . . @ . @ @ @ @ . @ . @ . . . @ . @ @ . @ . . . @ @ @ @ @ . . . @ . @ . @ . @ . @ . @ @ 
@ @ . @ @ . @ . @ . @ . . @ . . . . @ . @ . . @ . . . @ . @ . . . @ . . . @ . @ @ @ . @ . @ . @ . @ . @ . @ . @ . @ . . . @ . . . . . @ . @ @ . . . . . . . @ @ @ @ @ @ @ @ . @ . . . . . . @ . . . . @ 
@ @ . . . . @ @ . @ . @ @ . @ @ . @ . . @ @ . . @ . @ @ @ . . @ . . . @ . . . . . . . . . . . . . . . @ . . @ . . . @ . @ @ . @ . @ . . . . . . @ . @ @ . @ @ @ @ @ @ @ @ @ @ @ @ . @ . @ . . @ . @ . @ 
@ . . @ . @ @ . . . . . . . . . . @ @ @ . . . @ @ @ . . . . @ . @ . @ . @ @ @ . @ . @ @ . @ . @ @ . @ . . @ @ . @ . . @ . . . . @ . . @ . @ . @ . . @ @ . . @ @ @ @ @ @ @ . . @ . . @ . @ . @ @ . . @ @ 
@ @ . . @ . @ @ . @ . @ . @ . @ . . . @ . @ . . @ @ @ @ . @ @ . . . @ . . . . . @ . . @ @ @ @ . . . . @ . @ @ @ @ @ . @ @ @ . @ . @ . . @ . @ . @ . . . @ . @ @ @ @ @ @ . @ . . @ . @ @ . . . . @ . . @ 
@ . . @ . . . @ @ . . . @ @ @ . . @ @ @ @ . . @ @ @ . . @ . @ @ @ @ @ . @ . @ @ @ . @ @ . @ @ . @ . @ @ . @ @ . @ . @ . . @ . @ . @ . @ . . . . . @ @ . . @ @ @ @ . @ . . . @ . . @ @ . @ @ @ . . @ . @ 
@ . @ . . @ @ . @ . @ . . . @ . @ @ @ @ @ @ . . @ . @ . . . . . . . . . . @ . . . . . . . @ @ . . @ @ . . @ . . @ . @ @ . @ . @ . @ . @ . @ . @ @ @ . . @ . @ . @ . @ . @ @ @ . @ . @ . . . . . @ @ @ @ 
@ @ . @ . . . . . @ . @ . @ . @ . @ . . @ @ . @ . . . . @ . @ @ . @ @ . @ @ @ . @ . @ @ . @ . . @ @ @ @ . . @ . . . . . . . . . . . @ . @ . . . @ @ . @ . . @ . @ . . . . . . . . . . @ @ @ @ . . @ @ @ 
@ . . . @ @ . @ . . . . . . . . . . . @ @ @ @ . @ . @ . . @ . . . @ . . @ . @ @ . . @ . @ . @ . . @ @ . . @ @ @ @ . @ . @ @ . @ . @ . . . . @ @ . . @ . . @ . . . . @ . @ . @ . @ . @ @ @ @ @ @ . @ @ @ 
@ @ @ . @ . @ . @ @ @ @ . @ . @ @ @ @ . . . . . . . @ @ @ @ @ . @ . @ . . . . @ @ . @ . . . . . @ . @ @ @ @ @ @ @ @ @ @ . . . . @ . . @ @ @ . @ . @ . @ . @ . @ . @ @ @ . . . @ . . @ @ @ @ @ . . . @ @ 
@ @ . . . . . . . . . . . @ . . . @ @ @ . @ @ @ @ . @ . @ @ . . @ . @ . @ . @ . . @ @ @ . @ @ . . . . @ @ @ @ @ @ @ @ @ . @ . @ . @ . @ . @ . . . . . . . . . @ @ @ @ . @ @ . . @ . . . . . . @ . @ @ @ 
@ . @ @ @ @ . @ . @ . @ @ . @ . @ @ @ . . @ . . @ @ . . . . . @ . . . . . @ . . @ . . . . @ . . @ . @ @ @ @ @ @ @ @ @ . . @ . . . . . . . . . @ . @ . @ @ @ . @ . @ @ . . @ . @ @ @ @ . @ . @ . . . @ @ 
@ . . . . . @ . @ . @ . @ . @ . @ @ @ @ . . @ . . . . @ . @ @ @ @ . @ . @ . @ . . @ . @ . @ @ . . @ . @ @ @ @ @ @ @ @ @ . @ . @ . @ @ . @ @ @ @ . . @ . @ . @ . . . @ @ . . @ @ @ @ @ . @ @ . @ @ @ . @ 
@ @ . @ @ . . . . . . . . . . @ @ @ @ . . @ @ @ @ . @ @ . . @ @ . @ . . @ . . @ . @ . @ @ . . . @ . . @ @ @ @ . @ @ @ @ @ . . . @ . . . @ . @ . @ . . . . . @ . @ @ . @ . @ . @ . @ . @ . @ . . . . . @ 
@ @ @ @ . @ . @ . @ . @ . @ . @ . @ . @ . . . . @ @ @ @ . @ @ . . . . @ . . @ . . . . @ . . @ . . . @ @ @ @ . . @ @ @ @ @ @ . @ . @ @ . . . . . @ . @ @ @ . . . . . . . . . . . . . . . . . . @ . @ . @ 
@ @ . @ . . . . @ . . @ @ . . . . . . . . @ . @ . @ @ @ . @ . @ @ @ . . @ . . . @ . @ @ . @ . . @ . . @ @ @ @ . @ . @ @ @ @ @ . . . . . @ . @ @ . . . . . @ . @ . @ @ . @ @ . @ . @ . @ @ . @ . @ . . @ 
@ . . . @ . @ @ . @ . . . @ . @ . @ . @ . @ . . . . . . @ . . . . . . @ . @ @ . . @ . @ @ @ @ . . @ . . @ @ . . . . . @ @ @ @ @ @ . @ . . @ @ @ @ . @ . @ . . . @ @ . . . @ . . @ @ @ . . @ . . @ @ . @ 
@ @ . @ . . @ @ . @ . @ @ @ @ . . . @ . . . @ . @ . @ . @ @ @ . @ . @ @ . @ @ . @ @ . . . @ . . @ @ . @ @ @ @ @ . @ @ @ @ @ @ . @ @ . . @ . @ @ @ @ @ @ @ @ . @ . . @ . @ . @ @ . @ @ @ . @ @ . . . @ @ 
@ . . . . @ . . . . . @ . @ . @ . @ @ @ . @ . @ @ . . @ . @ @ @ @ @ @ . . . . . @ . . @ @ @ @ . . . @ @ @ @ @ . . . @ @ @ @ . . . @ @ . . . . . . . . . @ . . . . @ . . . . . . . . . . . . @ . @ @ . @ 
@ . @ . @ . . @ @ . @ . . @ . . . @ @ @ . . . . . @ . . . . @ . @ @ @ @ . @ @ . . . @ @ . . @ @ . @ @ @ @ @ @ @ . @ . @ @ @ @ @ . . @ . @ . @ . @ @ @ @ . @ @ @ @ . @ . @ . @ . @ . @ . @ . @ . @ . . @ 
@ . . @ . @ . . @ @ @ @ . . . @ . . @ . @ . @ . @ . . @ . @ @ . @ @ @ @ @ . . @ . @ . @ . @ . . . . @ @ @ @ @ @ . . . @ . . . @ . @ . @ . . @ . . . @ . . . . . . . . @ . . @ . . @ @ . . @ . . @ @ . @ 
@ @ @ . . @ . @ . . @ @ @ @ . @ . @ @ . . . . @ @ @ . . @ . . . . @ @ @ . @ . @ @ . . . . . . @ . @ @ @ @ @ @ . @ . @ . @ . @ . . . . @ @ . . @ @ . . . @ @ . @ . @ . . @ @ @ . @ . . . @ @ @ . . . . @ 
@ . . @ . . . @ @ . . @ . . @ . . . @ @ @ . @ . @ @ . @ . @ @ . @ . @ . . . . . @ @ . @ . @ . @ @ @ @ @ @ @ . . . . . . . . . @ . @ . . . . @ @ @ @ . @ @ . @ . . . @ . . . . @ @ @ @ . . @ . . @ . @ @ 
@ . @ . @ @ @ . . . @ . @ . @ . @ @ . . . . . . . . @ @ . . . . . . . @ . @ . @ . @ @ . . @ . @ . @ @ @ @ @ @ . @ . @ . @ @ . @ @ . . @ . @ @ @ . . @ @ . . @ @ . @ @ . @ . @ . @ . @ . @ @ @ . . @ @ @ 
@ . . . . . . . @ . . . . . . . . @ @ . @ . @ . @ . @ . . @ @ . @ @ . . @ . . . . . @ . @ @ . . . . @ @ @ @ @ . . @ . . @ . . @ . @ @ . . @ @ @ . @ @ . @ . @ . . . . @ . . . . . . . @ @ @ . . @ . . @ 
@ . @ . @ @ @ . @ . @ . @ . @ . @ . . @ . . . @ @ . @ @ . @ @ @ . . . @ @ @ . @ . @ . @ @ . . @ . @ @ @ @ @ @ @ . @ @ . . @ . . . . @ @ . . @ . . . . . . . . @ . @ @ @ @ . @ . @ . @ . @ . @ . @ . @ @ 
@ . @ @ . . @ . . @ @ @ . @ . . . . @ @ @ . @ . @ . @ @ @ @ @ . @ @ . . @ . . . @ . . @ . @ . . @ @ @ @ @ @ @ . @ @ @ @ @ @ @ . @ . @ @ @ . . . @ @ @ @ @ @ @ @ @ @ . . . . . @ . . . . . . . . . . . @ 
@ . @ @ @ . . . @ . @ . . . @ . @ . @ @ . . . . . @ @ @ @ @ @ . . . . @ . @ . @ . @ . @ . . . @ @ @ . @ @ @ . . @ @ @ . . @ . @ . . @ @ @ . @ . . . . . . . . @ . @ @ . @ . @ @ @ . @ . @ . @ . @ . @ @ 
@ @ . . . . @ . . . @ @ . @ . . @ @ . @ @ . @ @ . . . @ . @ . @ . @ . . . . . . . . . . . @ . . @ . . . @ @ @ . . . . @ . . . . @ . . . . . . @ . @ . @ . @ @ @ . @ . @ . . . . . @ @ . @ . . @ @ @ @ @ 
@ . @ . @ . @ . @ @ . . . . @ . . @ . . . . @ . . @ . . . @ . . . . @ . @ . @ . @ . @ @ @ . . @ . @ . @ . @ . @ . @ . @ . @ . @ @ @ . @ @ . @ . @ @ . @ @ @ . @ . . . . @ . @ @ . . . @ . . @ . . @ @ @ 
@ . . @ . . @ @ @ @ @ . @ . . @ . . @ @ . @ @ @ @ @ @ . @ @ . @ . @ @ @ . . . @ . . . @ . @ . . . . . . . . . . @ . . . @ @ . . @ . @ . . . . . . . @ . @ . . @ @ . @ . . . . . @ . @ . @ @ @ . @ . @ @ 
@ @ . @ @ . . . @ @ . @ . @ . . . @ @ @ @ . @ @ @ @ @ . @ @ @ . . @ . @ @ . @ @ @ . @ . . . . @ . @ . @ . @ . @ . @ . @ . @ . @ . . . . @ . @ . @ . @ . @ @ . . . @ . @ . @ . @ @ . . . . . . . . . . @ 
@ . . . @ . @ @ @ @ . . . . . @ . @ . . . . . @ @ @ . . . . @ @ . . . . . @ @ @ @ . @ @ . @ . . @ @ @ @ . . @ @ . . . . . . . . . @ . @ @ @ . . . @ . . . @ . @ . . . . @ @ @ . . . @ . @ . @ . @ . @ @ 
@ @ . @ . @ @ . @ . . @ . @ . . @ @ @ . @ @ @ @ @ @ @ . @ . . . @ . @ @ @ @ @ @ @ @ . . . @ . @ . . . . @ @ . . . @ . @ @ . @ . @ . . @ @ . @ . @ @ @ . @ . . . @ @ @ @ @ @ . @ . @ . . . @ . . . @ . @ 
@ . . . . . . . . . @ @ @ . . @ @ @ . . . @ @ @ @ @ @ . . @ @ . @ . @ . . . @ @ @ . @ . @ . . @ @ . @ . . @ @ @ @ . . . . @ . @ . . @ . . . . . . @ . . . . @ . @ . . @ @ . . . . . @ . @ @ @ . @ @ . @ 
@ . @ . @ @ . @ . @ . @ @ @ . . @ @ @ . @ @ @ @ @ . @ @ @ @ . @ . @ @ . @ . @ @ . . . @ . . @ @ @ @ . . @ @ . . @ @ . @ . @ . @ @ . . @ . @ @ . @ . @ . @ @ . @ @ @ . . . @ @ . @ . @ @ . . . . @ . . @ 
@ @ . @ @ @ @ . . @ . @ @ . @ . . . @ . . @ @ @ . . . . . . . . . . . . . @ . @ @ . @ . @ . . @ @ . @ . @ . @ . @ . @ . @ . . @ . @ . @ . @ . . . . . . . . . . . . @ @ . @ . . @ @ . @ @ @ . @ . @ . @ 
@ . . @ @ @ . @ . @ . . . . . . @ @ @ . @ . @ . @ . @ . @ @ . @ . @ . @ . . . . . . . . . . @ @ . . . . . . . . . . @ . @ @ . . . . . @ . @ @ . @ . @ @ . @ . @ . @ . . . . @ . . . . . . @ . . . . . @ 
@ @ . @ @ . . . @ @ @ . @ . @ . . . . . . . @ . . @ . . . . @ . . . @ . @ . @ @ @ @ @ . @ . . @ @ @ @ @ . @ @ . @ . . . . @ @ . @ @ . . @ . . . . @ . . @ . . . @ . @ @ . @ . @ @ . @ @ @ . . @ . @ . @ 
@ . . . @ @ . @ @ @ @ @ . . @ . @ . @ . @ @ . . @ . @ . @ . . @ . @ . . . . @ @ . . . @ @ @ . @ @ @ . @ @ . @ . . @ . @ . . . @ . . . @ . . @ . @ @ . @ . @ @ . . . . . . . . @ . @ . @ @ @ . @ . . @ @ 
@ @ . @ @ @ . @ @ @ @ @ @ . @ . @ . . @ . @ @ . . . @ @ @ . @ . @ @ @ . @ . . . @ . @ @ @ . . . . . . @ . . . @ . @ . @ @ @ . @ @ @ . . @ . . @ @ @ . . . . . . @ . @ @ . @ . . . . . @ . . @ @ . @ @ @ 
@ @ . @ . . . . @ . @ @ . @ . . . @ . . . . @ @ @ . . @ @ @ @ . . @ @ @ . . @ @ . . . . @ @ . @ . @ @ . @ . @ . @ @ . @ . . . @ . @ @ . . @ @ . . . @ . @ . @ . . @ . @ . . @ . @ . @ . @ . . . . . @ @ 
@ . . . @ @ . @ . . . . . . . @ . . @ . @ . . . @ . @ @ @ . . . @ . @ . @ @ @ . . @ . @ @ @ @ @ . . . . . . . . . . @ @ @ @ . . . . . . @ @ . . @ . . @ @ @ . . @ @ . . . @ . . . @ . . @ . @ . @ @ @ @ 
@ . @ . . . . . . @ . @ @ @ . @ . @ . . . @ @ @ . . . @ . @ @ . . . @ . . . . @ . . @ @ @ @ @ . . @ . @ . @ . @ . @ @ @ . . . @ . @ @ . . . @ @ . @ . . . . . @ . . . @ . @ @ . @ @ . @ . @ . @ @ . @ @ 
@ @ . . @ @ . @ . . @ . . . . @ @ . . @ . @ . @ @ . @ . . . . . @ @ . @ . @ . . @ . @ @ @ @ . @ . . @ . . . @ @ . . @ . . @ . @ @ . . . @ . @ . . . . @ . @ . @ @ . @ . . . @ . . . . . . . . . . . . @ 
@ . @ . @ . @ . . @ . @ . @ . . . @ . . @ . . . . . . . @ . @ . . . . . . . @ . . . . . . . . . . @ . @ @ . . . @ . . @ . @ @ . . . @ . . @ @ @ . @ . @ . @ . . @ . @ @ . @ . @ . @ . @ . @ . @ @ . @ @ 
@ . @ @ @ . . . @ . . . . . @ @ . @ . @ . . @ . @ . @ . @ @ @ @ . @ . @ . @ @ @ . @ . @ . @ . @ . . . . . @ . @ . . @ @ @ . . . @ . @ . @ @ @ @ . @ @ . . @ . @ @ @ . . . . . . @ . . . @ @ . . . @ @ @ 
@ . . . . . @ . @ @ . @ . @ @ @ @ . . . @ . @ . . @ @ @ @ @ @ @ @ . . . @ @ @ . . . @ . . @ @ . . @ . @ . @ . . @ . . . . @ . @ . @ . . . @ @ @ @ @ @ . @ . . . @ . . @ . @ . @ @ @ . @ @ . . @ . @ @ @ 
@ @ . @ . @ . . @ @ @ . . @ @ @ @ @ . @ @ @ . . @ @ @ @ @ @ @ @ @ @ . @ @ @ . . @ @ . @ . @ . . @ @ @ @ . . @ @ . . @ . @ . . . . . @ . @ @ @ @ @ @ @ @ . . @ . . @ @ . . . @ . @ . @ @ . @ . . @ @ @ @ 
@ @ @ @ @ . . @ . . . . @ @ @ @ @ . . . . @ @ . . @ @ @ @ @ @ @ @ @ @ @ @ @ @ . @ . . . . @ @ . @ @ @ @ . @ @ @ @ . . @ @ @ . @ . @ . . . @ @ @ @ @ @ @ @ . @ . @ . . . @ . . . . . . . . . @ . @ @ @ @ 
@ @ @ @ @ @ @ @ @ @ @ @ @ @ @ @ @ @ @ @ @ @ @ @ @ @ @ @ @ @ @ @ @ @ @ @ @ @ @ @ @ @ @ @ @ @ @ @ @ @ @ @ @ @ @ @ @ @ @ @ @ @ @ @ @ @ @ @ @ @ @ @ @ @ @ @ @ @ @ @ @ @ @ @ @ @ @ @ @ @ @ @ @ @ @ @ @ @ @ @ 
3
87 98 73 64
5 54 26 83
3 51 55 43
