25 25
@ @ @ @ @ @ @ @ @ @ @ @ @ @ @ @ @ @ @ @ @ @ @ @ @ 
@ . . . . . @ . @ @ . . @ @ @ @ @ @ @ @ @ . @ . @ 
@ . @ . @ @ . . . . @ . . @ . @ . @ @ @ @ . . . @ 
@ @ . . . . @ . @ . @ . @ @ . . . . . @ . . @ @ @ 
@ . . @ . @ @ . . @ . . . . @ @ . @ @ . @ . . . @ 
@ @ . @ . . . @ . . . @ . @ . . . @ . . @ . @ . @ 
@ . . . @ @ @ . @ . @ . @ . . @ . . @ . . . @ . @ 
@ . @ . @ . . . . . @ . . . @ . . @ @ . @ @ @ . @ 
@ . @ @ . @ @ @ @ . . @ @ . . @ . . . . @ . @ @ @ 
@ . . @ . . . . @ . @ . @ . @ @ . @ @ . . . . . @ 
@ . @ . @ . @ @ . . . . . @ @ . . . . @ . @ . @ @ 
@ . . . . . @ @ @ @ @ . @ @ . @ . @ . @ @ . . @ @ 
@ . @ . @ . . @ . . @ . @ . . . . . @ . . @ . . @ 
@ . . @ . . @ . . @ . . . @ @ @ . @ @ . @ . @ . @ 
@ . @ . @ . @ . @ . @ @ . @ . . . . . . . . @ . @ 
@ . @ . . . . . . . . . . . . @ . @ . @ @ @ @ @ @ 
@ . . @ . @ . @ @ @ . @ . @ . @ @ @ . @ @ @ @ @ @ 
@ . @ @ . @ @ @ @ @ @ . . . @ @ @ @ . @ @ @ @ @ @ 
@ . @ . . @ @ @ @ @ . @ . @ . @ . @ @ . . @ @ @ @ 
@ . . @ . @ @ . . . . . . . . . . . . @ . . @ @ @ 
@ @ . . @ . . . @ @ @ . @ . @ . @ . @ . . @ . @ @ 
@ . . @ @ @ . @ @ . @ @ . . @ @ . @ . @ . . . . @ 
@ . @ @ @ . . . @ . @ . @ . . . . . . . . @ . @ @ 
@ . . @ @ @ . @ . . . . . . @ . @ . @ . @ . . . @ 
@ @ @ @ @ @ @ @ @ @ @ @ @ @ @ @ @ @ @ @ @ @ @ @ @ 
3
8 10 15 13
15 3 14 14
9 9 6 3
