50 50
@ @ @ @ @ @ @ @ @ @ @ @ @ @ @ @ @ @ @ @ @ @ @ @ @ @ @ @ @ @ @ @ @ @ @ @ @ @ @ @ @ @ @ @ @ @ @ @ @ @ 
@ @ @ . @ . @ . . @ @ @ @ @ @ @ @ @ @ . @ . @ @ @ . @ @ . . . @ @ @ @ @ @ @ @ @ @ . . . @ @ . . . @ 
@ . . . . . @ . @ . @ @ @ @ @ @ @ @ @ . . . . @ . . @ @ . @ . . . @ @ @ @ @ @ @ . . @ . . @ . @ . @ 
@ . @ . @ . @ . . . . . @ @ @ @ . @ . . @ @ . . @ . . . @ . . @ @ . . @ @ @ @ . @ . . @ @ . . . @ @ 
@ . . @ @ @ . . @ . @ . . @ @ @ . @ @ . @ @ @ @ @ @ @ . . @ . . . @ . @ . @ . . . . @ . @ @ . @ . @ 
@ . @ . @ . @ . @ @ . . @ @ @ @ . @ . . . . . @ @ . . . @ . . @ @ @ . . . . @ @ @ . . . . @ . . . @ 
@ . . . . . @ . . @ . @ @ @ @ @ . . . @ . @ . . . @ @ . @ . @ . . . . @ . @ . @ . . @ . @ @ . @ @ @ 
@ . @ @ . @ . . @ @ . @ @ @ @ @ . @ . . @ . @ . @ @ @ . . . . @ . @ @ @ . . . . @ . @ . . @ . . . @ 
@ . . @ . . @ . @ @ @ . @ . @ @ @ . . @ . . . @ @ @ . @ . @ . @ . @ @ @ @ . @ . . . . @ @ . . @ . @ 
@ . @ . @ @ . . . . . . @ . . @ @ . @ @ . @ . @ @ . . . . @ @ . . . @ @ @ . . @ . @ . @ . @ . . @ @ 
@ . . . @ . @ . @ . @ @ . @ . . @ . . @ . . @ . . @ . @ . . @ . @ @ . @ . . @ @ . . @ . . @ . @ @ @ 
@ . @ @ . . . . . @ @ @ . . @ . . . @ @ . @ . @ . @ . . @ . @ . . @ . . @ @ @ @ @ @ @ @ . @ . @ @ @ 
@ . @ . @ . @ . @ . . @ . @ . @ @ . . . . . . . . . @ @ @ . . . @ . . @ @ @ @ @ @ @ @ . . . . . . @ 
@ . @ . . @ . . . @ . @ . . . . . . @ . @ . @ @ @ @ . @ . . @ @ . @ . . @ @ @ @ @ @ @ @ @ . @ @ . @ 
@ . @ . @ . @ . @ . . . . @ . @ . @ @ @ @ @ . . . . . . . @ . @ . . . @ . @ @ . . @ @ @ . . . . @ @ 
@ . . . . . . . . . @ . @ . . . @ @ @ @ @ . @ @ . @ @ @ . . . . . @ . . . . . . @ . @ . @ @ . @ . @ 
@ @ . @ . @ . @ . @ . @ . @ . @ @ @ @ @ @ . . @ @ . . @ . @ . @ @ @ . @ . @ @ @ . . . . . . . . . @ 
@ @ . . @ . . @ . . . @ . . . @ @ @ @ @ . . @ . . @ . . . . @ . . @ @ @ . @ . . . @ @ . @ @ . @ @ @ 
@ . . @ @ @ . . @ @ . @ @ . @ . @ @ @ . @ . . . @ @ @ @ . @ . @ . . . . @ . @ . @ . @ @ @ . @ . . @ 
@ @ . . @ @ @ @ @ @ . @ . @ . . . @ . . . . @ . . @ . . . . . . . @ @ . . . . . . . . @ . . . @ . @ 
@ . . @ . @ . @ @ @ . . . . . @ @ . @ @ @ . . @ @ . . @ @ @ . @ @ . . @ . @ @ @ @ . @ @ @ . @ . . @ 
@ @ . . . @ . @ @ @ . @ . @ . @ . . . . . @ . . . . @ @ . . @ . @ . @ @ . . @ @ . @ @ @ . . @ @ . @ 
@ . . @ @ @ . . @ . @ . . . @ . @ . @ @ . . . @ @ . . @ @ . . . @ . @ . @ @ . . . . @ . @ . . . . @ 
@ @ . @ @ . . @ @ . . @ . @ @ . @ @ . . . @ . . @ . @ . . @ @ . . . . . . @ @ @ @ . @ . @ . @ @ @ @ 
@ . . . . @ . . . @ . . . . . . @ . . @ @ . . @ . . . . @ . . @ . @ @ . @ . . @ . . . . . . . . . @ 
@ @ . @ . @ . @ @ . @ @ . @ . @ . . @ . . . @ . @ . @ . @ . @ . . @ . @ @ . @ . . @ . @ @ @ . @ @ @ 
@ . . . @ . . @ @ . . @ . @ . @ . @ . @ . @ . . . . . @ . . . . @ . . . @ . @ . @ . @ @ . . @ . @ @ 
@ . @ @ . @ . @ . . @ . @ @ . @ . . . @ . . @ . @ . @ . . @ @ @ . . @ @ . . . . . . . @ . @ . . . @ 
@ . . @ . @ . . @ . . . . @ @ . . @ @ @ @ . @ @ . . . . @ @ @ . . @ . @ . @ . @ . @ . . . . . @ . @ 
@ @ . . . . . @ . . @ . @ @ @ @ . . . @ @ @ @ . @ . @ @ . @ . @ . . . . . . @ @ . @ @ @ . @ . . @ @ 
@ . @ . @ . @ @ . @ . @ @ @ @ @ @ . @ @ @ . . . . . . . . . . . . @ @ @ @ @ @ . @ . . @ @ . @ . . @ 
@ . @ @ . . @ . . . . . . @ @ @ @ @ @ . . @ . @ . @ @ @ @ . @ @ . . . . . . @ . . @ . . @ . @ @ . @ 
@ . @ . @ . . . @ @ @ . @ . @ @ @ @ . @ . . . . @ @ . . @ @ @ . @ . @ . @ . @ . @ . @ . . . . . @ @ 
@ . . . . . @ . . . @ . . . . @ @ . . . @ @ . @ @ . . @ @ @ @ . @ . . @ @ . . . . . . . @ @ @ . . @ 
@ . @ @ @ . . @ . @ . . @ . @ . . @ . @ . . . . @ @ . . @ @ . . @ . @ . . . @ . @ @ . @ . @ @ . @ @ 
@ @ . . @ . @ . @ @ @ . . @ . . @ . . . . @ . @ . . @ . . . . @ . . @ . @ . . @ . . . @ . . . @ @ @ 
@ . @ . . . . . . @ . . @ @ @ . . @ . @ @ . @ . . @ @ . @ . @ @ . @ @ @ . . @ . . @ . . . @ . . @ @ 
@ . . . @ . @ . @ @ @ . @ @ . @ . @ . . @ . . @ . . . . @ @ . @ @ . @ . @ . @ @ . . @ . @ . . @ @ @ 
@ . @ @ @ @ @ . @ @ @ @ . . . . . . . @ . . @ . . @ . @ @ . . . @ . . . . . . @ . @ . . @ @ . @ . @ 
@ . . . @ . . @ . . @ . @ @ @ . @ . @ . @ . @ . @ . @ . . . @ @ . @ @ . @ . @ . @ @ @ . . @ . . . @ 
@ . @ @ . @ . . @ . . . @ @ @ @ @ . . . . . . . . . @ @ . @ . @ . . . @ @ . . . . . @ @ . @ @ @ @ @ 
@ . . @ . . . @ . @ . @ . @ . . . . @ . @ . @ . @ . . . . . . . . @ @ . . . @ . @ @ . . . . . . . @ 
@ . @ . . @ @ . . . . . . . . @ . @ . @ @ @ . @ @ @ . @ . @ @ . @ . @ @ @ . . @ . @ @ @ . @ . @ . @ 
@ . . . @ . @ . @ @ . @ @ . @ @ . . . . . . . @ @ . @ @ . . . @ . . . . . . @ . . . . @ @ . . . @ @ 
@ . @ @ . . . . . @ . @ @ @ . . . @ @ . @ . @ @ . . @ . . @ @ @ @ . @ . @ . . . @ . @ . . @ @ . . @ 
@ . @ @ . @ @ . @ @ @ @ . . . @ . . . @ @ @ . @ @ . @ @ . @ @ . @ . . @ . . @ . @ @ @ . @ @ @ . @ @ 
@ . . . . . @ . @ . @ @ . @ . . @ . @ @ . . . . . . . . @ . . . @ . @ . @ . . @ @ . . . . @ . . . @ 
@ . @ . @ @ @ . . . @ @ @ . . @ . . . . . @ @ @ @ @ @ @ @ @ @ . . . @ . . . @ . @ . @ . @ . @ . @ @ 
@ . . @ @ @ @ @ . @ @ @ @ @ . . @ . @ @ . . . . . . . . @ @ @ @ . @ . . @ . . . . . . @ @ . . . . @ 
@ @ @ @ @ @ @ @ @ @ @ @ @ @ @ @ @ @ @ @ @ @ @ @ @ @ @ @ @ @ @ @ @ @ @ @ @ @ @ @ @ @ @ @ @ @ @ @ @ @ 
3
11 6 42 9
19 41 27 41
15 38 36 15
