100 100
@ @ @ @ @ @ @ @ @ @ @ @ @ @ @ @ @ @ @ @ @ @ @ @ @ @ @ @ @ @ @ @ @ @ @ @ @ @ @ @ @ @ @ @ @ @ @ @ @ @ @ @ @ @ @ @ @ @ @ @ @ @ @ @ @ @ @ @ @ @ @ @ @ @ @ @ @ @ @ @ @ @ @ @ @ @ @ @ @ @ @ @ @ @ @ @ @ @ @ @ 
@ @ . . @ @ @ @ . . @ . . . @ . . . . . @ . . @ . @ @ @ . @ @ . @ @ . @ . @ @ @ @ @ @ @ @ @ @ @ @ @ @ @ @ @ @ @ @ . @ @ @ @ . @ @ @ @ . . . @ @ @ . . @ . . @ . @ @ @ @ . @ . . . @ . @ @ . . . @ @ @ @ 
@ . @ . @ @ @ . @ . . @ @ . . @ . @ @ @ . . @ . . . @ . . . . . . . . . . @ @ @ @ @ @ @ @ @ @ @ @ @ @ @ @ @ @ . . . . . @ . . . @ @ @ @ . @ . @ @ @ . . . @ . . . @ . . . . . @ @ . . . . . @ @ @ @ @ @ 
@ . . . . @ . . . . @ . @ @ . . . . . . . @ @ @ @ . . @ . @ @ @ . @ @ @ . . . @ @ @ . @ @ @ @ @ @ @ @ @ @ @ . @ . @ . @ . @ . @ @ @ @ . . . . . @ . . @ . @ @ . @ . @ @ @ . @ . . . @ . @ @ . @ @ @ @ @ 
@ @ @ . @ . @ @ @ . . . . . @ @ . @ . @ . . . . @ . @ . @ . . . @ @ @ . . @ @ . @ @ . . @ @ @ @ @ @ @ @ @ . . . @ . . . . . . @ @ @ @ @ . @ @ @ . @ . . @ . . . . . @ . @ . @ @ . @ . @ . . . . @ @ @ @ 
@ . . . . . . . @ . @ . @ @ @ . . . @ @ @ @ @ . @ . . . . @ . @ . @ . @ . . . . . @ . @ @ @ @ @ @ @ . @ . @ . @ . @ . @ . @ @ . @ @ @ . . @ . @ . . . @ . . @ . @ @ . . . . . . . . . @ . @ . @ . @ @ @ 
@ . @ @ . @ . @ . @ . . . . . @ . @ . @ @ @ . . @ . @ @ . . . . . . . @ . @ . @ @ . . @ @ @ @ @ @ @ . . . . . . . . @ . . . @ . @ @ . @ . @ . . . @ @ . @ @ . . @ @ . @ @ . @ . @ . @ @ @ . . . . . @ @ 
@ . @ @ @ . . . . @ @ @ . @ . . . . . . @ @ . @ . . . @ . @ @ @ @ @ . @ . @ . @ @ . @ @ @ @ @ @ @ . . @ @ . @ . @ @ . @ . @ . . . @ . . . . . @ @ . . . . . @ . . . . . @ . . @ . . @ @ . @ . @ . @ @ @ 
@ . @ @ . @ . @ . . . @ @ . @ . @ . @ . . @ @ . @ . @ . @ . . . . . @ . . . @ . . . . @ @ @ @ . . @ . . @ . . @ @ . . . . . . @ @ . . @ . @ @ . @ @ @ . @ . @ . @ . @ @ @ . @ @ @ @ . . . @ . . @ @ @ @ 
@ . . . . . @ . @ . @ . . . @ . . @ . @ . @ . . . . . . . @ . @ . @ @ . @ @ . @ @ . @ . . @ . @ . . . @ . @ @ . . @ . @ . @ @ . . . @ . @ @ . . . @ . . @ @ . . . @ @ @ . @ @ @ @ @ @ @ . @ . @ . . . @ 
@ @ . @ . @ . . . . . @ @ . . @ @ . . . . . . @ @ . @ . @ . . . @ . @ . @ @ . @ @ . @ . @ @ . @ . @ . . . . . @ . . . . @ @ @ . @ . . . . . @ . @ @ . @ . @ @ . @ . @ . . @ @ @ @ @ @ . . . . . . @ . @ 
@ . @ @ @ . @ . @ . @ @ . . @ @ . @ . @ . @ . . @ @ @ @ @ @ @ . . . . . . . . . . . . . . . . @ @ . . @ . @ @ @ . @ . @ . @ . . . @ @ . @ . @ . . . . . . . . . . . . @ . . . . @ . @ @ . @ . @ @ . @ @ 
@ . . . . . . . . @ . . @ . @ . . . . . @ @ . @ . . . . @ . @ . @ @ . @ @ . @ @ . @ . @ @ . @ . . @ . @ . @ @ . @ . . . . . @ . @ . . @ . @ . . @ @ @ . @ . @ @ @ @ @ @ @ @ . @ . . @ . . @ @ . @ . @ @ 
@ . @ . @ @ @ . @ . @ . . . . @ . @ . @ @ @ . . . @ @ . . . . . . . @ @ . @ @ . @ . @ . @ @ . . @ . . . @ @ @ . . @ . @ @ @ . . @ . @ . . . @ . . @ @ . @ . @ . @ @ @ @ . @ . . @ . . @ . @ . . . . @ @ 
@ . . @ . . . . . . . @ @ . @ @ @ . . . . @ . @ @ . @ @ . @ . @ @ . . . . . . . . . . . . . @ . . @ . @ . @ . . @ . . @ . . . @ . . @ @ . @ . . @ . . @ @ @ . . @ @ . . . . . @ . . @ . . . @ @ . @ @ @ 
@ . @ @ @ @ @ . @ @ @ @ . . @ @ @ @ . @ @ . . . @ . . @ . @ . . . @ . @ . @ @ @ @ . @ . @ @ . . @ . . . . . . @ . . @ . @ . @ @ @ . @ . . . @ . . @ . @ @ @ @ . . @ . @ . @ @ @ @ . . . @ @ @ @ . . @ @ 
@ . @ @ @ @ . . . @ . @ . @ . @ @ @ @ @ @ . @ @ . . @ @ @ . . @ . . @ . . . . @ . @ . @ @ . @ . @ @ . @ @ @ @ . @ . @ . . . @ @ @ . . . @ @ . . @ . . . @ @ @ . @ . @ . . @ . @ . . @ @ . @ . @ . @ @ @ 
@ @ @ @ @ @ @ . @ . . . . . . . @ @ . @ . . . . . @ @ . @ @ . @ . @ . @ @ @ @ . . @ . @ @ . @ . @ . . . @ . . . . . . . @ @ . @ . @ @ . @ . . @ @ @ . @ . @ . . . . . @ . . . . . @ . . . . . . . . @ @ 
@ @ @ @ @ @ @ . @ @ @ . @ @ @ . @ . . . @ . @ . @ . . . @ @ @ @ @ @ . . . . @ . @ . . . @ . . . . @ @ . . . @ . @ @ . @ . @ . . . @ @ . @ . @ . @ . . @ . @ @ . @ @ . @ @ @ . @ @ . . @ . @ . @ . @ @ @ 
@ @ @ @ @ @ . . . . @ . . @ @ . . . @ . . . . @ @ @ @ . . . @ @ . . . @ . @ . . @ . @ . @ @ @ . @ @ . . @ @ . @ @ @ @ @ . . @ @ . . . . . . . . . @ . . . @ @ . @ @ @ @ . . . @ @ . @ @ @ . @ . @ . @ @ 
@ @ @ . @ . @ @ . @ @ . @ . @ @ . @ . @ @ . @ . @ . @ . @ @ . @ @ @ . @ @ @ @ . . . @ . @ . . . @ . @ . . @ . . @ @ . . . @ . . . @ @ . @ . @ . @ . @ . @ @ . . . . @ @ @ @ . . . . @ @ . . @ . . . . @ 
@ . . . @ . . @ . . @ . . . . @ . @ . @ . . . . . . . . . . . . @ . . @ . . @ . @ . . @ . . @ @ @ . . . @ . . @ . . @ @ . @ . @ . . . @ @ . @ . . . . . . . @ @ . @ . @ . @ . @ @ . . @ . @ . @ . @ . @ 
@ @ @ . . . @ . . @ . . @ @ @ . @ . . . @ . @ . @ . @ . @ @ . @ . @ . . @ . . . @ . @ @ @ . . . @ @ @ . @ . @ . @ . . . . . @ . . @ @ @ @ @ . . @ . @ . @ . @ @ . . . . . . . @ @ @ . . . . . . . . @ @ 
@ @ . @ . @ . @ . . @ . . @ . . @ . @ . . . @ @ . . @ . . . @ . . . @ . . . @ @ . @ @ @ @ @ . @ . . . . . . . . . . @ . @ . @ @ . . . @ . @ @ . . @ . . . @ . . . @ . @ @ . @ . . . . @ . @ @ @ . @ @ @ 
@ . . . . . . @ . @ . @ @ . @ . . @ . @ @ . . @ @ . . @ . @ . . @ @ . . @ @ . . . . @ @ @ . . . . @ . @ . @ . @ . @ @ @ @ @ . . . @ @ . . . @ . @ @ @ . @ @ . @ . . @ @ @ @ @ @ . @ . . @ @ @ . . . . @ 
@ . @ @ . @ . @ . . . . . . . . @ . . @ . . @ @ @ @ . . @ . . @ . @ . @ . @ . @ . @ @ @ @ @ . @ . . @ @ . . @ @ @ @ @ . @ . @ . @ . @ . @ . . @ @ @ @ @ @ @ @ . . @ . @ @ @ @ @ @ . . @ . @ . @ . @ . @ 
@ . . @ @ @ . . @ @ @ . @ @ @ . . . @ . @ . . @ @ @ @ . @ @ . @ . . . . . @ @ . . . @ @ @ @ @ @ . @ . . . @ . . @ @ . . . . . . @ . . . . @ @ . @ @ @ . @ @ . @ . . . . @ @ @ @ @ @ . . . . . @ . . @ @ 
@ . @ @ @ . . @ @ @ @ @ @ . . . @ . . . . . @ . @ @ @ @ @ . . @ . @ @ @ . @ . @ . @ @ @ @ @ @ @ . @ . @ . . @ . @ @ . @ @ @ @ . . . @ @ @ . . . . @ . . @ . . . . @ . @ @ @ @ @ @ @ . @ . @ @ . . @ @ @ 
@ . @ @ @ @ . . @ . @ . . @ @ . . @ @ @ . @ . . . . . @ @ @ . . . @ @ . @ . . @ . . @ @ @ @ . . . . @ . @ . . . . . @ @ @ . @ . @ . . . . @ @ . @ . . @ . @ . @ @ . @ @ @ @ @ @ @ @ @ @ @ @ @ @ . . . @ 
@ . . @ @ . @ . . . . . @ . . . @ @ @ . . . . @ @ @ . . @ . . @ . @ . . . . @ . . @ . . @ . @ @ @ . @ . . @ . @ . @ @ @ @ . . . . @ . @ @ . . . @ @ . . . . . . @ . @ @ @ @ @ @ @ @ @ @ @ @ @ @ @ . @ @ 
@ . @ @ @ . . @ . @ @ . @ @ @ . @ . . . @ . @ . . @ . @ . . @ . @ . @ . @ @ @ @ . @ @ . @ . . @ . . @ . @ . @ @ @ @ @ @ . . @ . @ . . . @ . @ @ . @ . @ . @ . @ . . . @ @ @ @ @ @ @ @ @ @ @ @ . . . . @ 
@ . @ @ @ @ . . . . @ . . @ @ @ . @ @ . @ . @ . @ @ . . @ . . . . . . . . . @ . . . . . . . @ . @ . @ . . . . @ @ @ @ @ @ . . @ @ @ . @ . . @ . . @ . . @ @ . @ . @ . @ @ @ @ @ @ @ @ @ @ @ . . @ . @ @ 
@ . . @ @ @ . @ . @ . . @ @ @ @ . . . . . @ . . . . @ . . . @ . @ . @ . @ . @ @ @ @ . @ @ . . . . . @ . @ . @ . @ @ @ @ @ . @ . @ . @ @ @ . . @ . @ . @ @ @ @ . . . @ @ @ @ @ @ @ @ @ @ @ @ . @ @ . . @ 
@ . @ . @ . @ . . @ @ . . @ @ @ . @ @ . @ . @ . @ . @ . @ . @ @ @ @ . @ @ @ @ . . . @ @ . . @ @ @ @ . . . @ . . . @ @ @ . . . . . . . @ @ . @ . . @ . . . @ . @ . @ . @ @ . @ @ @ @ @ @ @ @ @ . @ @ . @ 
@ . . . @ . @ @ . . @ @ . @ . . @ . . . @ . . @ @ . . . @ . . . . . . . @ . . . @ @ . . @ . . @ @ @ @ . @ . @ . @ @ @ . @ . @ @ . @ . . . . . . @ . . @ @ . . . . . . . . . . . . @ @ @ @ @ @ . . . . @ 
@ . @ @ . . . . . @ . @ . . @ . . . @ . . . @ . . @ @ . . @ . @ . @ @ . @ . @ . @ @ . @ . @ . . . @ . . . . . . . @ @ . . . . . @ @ . @ . @ . @ @ . @ . . . @ . @ . @ . @ . @ . @ @ @ . . @ @ @ . @ . @ 
@ @ @ . @ @ . @ . . . @ . @ @ @ . @ . . @ @ @ @ . . @ . @ @ . @ . . . @ . . @ . . . . . . . . @ @ . @ . @ @ @ @ @ . . . @ . @ @ . . @ @ . . @ @ . . . . @ @ @ @ @ . @ . . @ . @ @ @ . @ . . @ @ @ . . @ 
@ @ . . . @ . @ . @ @ . @ @ @ @ @ . @ . . @ @ . . @ . @ . @ . @ . @ . . @ @ @ @ . @ @ . @ @ . . . . . . . @ . . @ . @ @ . @ @ . @ . . . @ @ . . @ . @ @ @ . @ @ @ . . @ @ . . . @ . . . . @ @ @ @ . @ @ 
@ . @ . @ @ @ . . . . . . @ @ @ @ . @ . @ . . @ . . . @ . . @ . . . @ @ @ @ @ @ . @ . . @ . . @ @ . @ . @ . . @ . . . @ . . @ . @ . @ @ . . . @ . . . @ @ . . @ @ . @ . . @ . @ . @ . @ . . @ . . @ . @ 
@ . . . . . . @ . @ @ @ @ @ @ @ . . . . . @ . @ @ . @ @ @ . @ @ @ . . @ @ @ @ @ @ . . @ . @ . . @ @ . . . @ . @ . @ @ . . @ . . . . @ @ . @ @ @ . @ . . . . @ . @ . . @ . . . . . . . @ @ @ @ @ . . . @ 
@ @ @ @ @ @ . . . . @ @ . . @ . @ @ @ . @ . . . @ . @ @ . . . . @ . @ @ @ @ @ @ . @ @ . . @ . @ . . @ . @ . . . . . @ . @ . @ @ . @ . . . . . . . . @ . @ . . . . @ . . . @ . @ . @ @ . . . . . @ . @ @ 
@ . . . . . . @ . @ . . . @ . . . @ . . . @ . @ . . . . @ . @ @ . . . @ @ @ . . . . . @ . @ . . . @ . @ @ @ @ . @ @ . . . . . . . . . @ @ @ . @ . @ . @ . @ @ @ @ @ @ . @ @ . . @ . @ . @ @ . @ . . @ @ 
@ . @ . @ . @ @ . . @ @ . . @ . @ . @ . @ . . . . @ @ . @ . . @ @ @ @ . @ . . @ @ . @ . . . . @ . @ . . . . @ . . @ . @ @ @ . @ . @ . . . . @ . . @ . . . . . . . . @ @ @ . @ @ . . . . . . @ @ . @ . @ 
@ . @ . . @ . . @ . @ . @ . . . . . . . @ @ . @ . . @ @ . . @ . . @ . . . @ @ . . . @ @ @ @ . . @ . . @ . @ . . @ . . . . . @ . @ @ . @ . @ . . @ @ . @ @ . @ . @ . . @ . . . . . @ . @ . @ . @ . @ . @ 
@ . @ . @ @ @ . . . . . . @ @ @ @ . @ . . @ . @ . @ . . @ . @ . @ . @ . @ . @ . @ . . . . @ . @ @ @ . @ . @ . @ . . @ @ @ . . . . . @ . @ . . @ . @ @ @ @ . @ @ @ @ . . @ @ . @ @ . . . @ @ . . . . . @ 
@ @ . . . @ . @ @ . @ @ . @ . . @ . . @ . @ @ . . . @ . . . . . . . . . . . . @ . . @ . @ . . . @ . . . @ . . @ . @ . . . @ . @ @ . . . @ . @ @ . . . @ . . . . . @ @ . @ . . . @ . @ @ @ . . @ . @ . @ 
@ @ @ . @ @ . . . @ @ . . . @ . . @ @ . . . . @ . @ . @ @ . @ @ . @ @ . @ @ @ @ @ . @ . . @ . @ . @ . @ . @ . @ . . . @ @ . @ @ @ @ . @ . @ . @ . @ @ . @ . @ . @ @ @ . @ @ . @ . @ . @ @ . @ . @ . . @ 
@ @ @ @ . . @ . @ @ . @ . @ . . @ . @ @ @ . @ . . . . @ . . @ @ @ . . . @ . @ @ @ @ . @ . . . . . . . . . . . . . @ . . @ . @ . @ . @ . . . . . . . . . . . . @ . . . . . . . . . . . . . . . . . @ . @ 
@ @ @ . . @ . . . . . . . . . @ . . . . @ . . @ . @ . @ @ . . @ . @ @ @ @ . . @ @ @ . . . @ . @ @ . @ . @ . @ . @ . . @ . . . . . . . . @ . @ . @ . @ @ . @ . @ @ . @ . @ @ . @ . @ . @ @ @ @ @ . @ . @ 
@ . . . @ @ . @ @ @ @ . @ @ . . . @ . @ . . @ @ . @ @ . . . @ . . . @ . . . @ . @ @ . @ . @ . . . @ . . @ . . @ . @ . . . @ . @ . @ . @ @ @ . . . @ @ @ . . @ @ @ @ . . . . @ . . @ . . @ . @ . @ . @ @ 
@ @ . @ @ . @ . @ . . @ . @ @ . @ . @ . @ . @ . . @ . @ @ . . . @ @ . @ @ . @ . . . . @ . . @ @ . . @ @ @ @ . @ . @ . @ . . @ . . @ . . @ @ @ . @ . @ . . @ @ @ @ . @ . @ @ @ @ . . @ . . . . . . . . @ 
@ . . . . . . . . . @ . . . . . . . . . . . . @ . @ . . @ . @ . . . . . . . . . @ . @ . . @ @ @ @ @ @ . @ @ . . . . @ . . @ @ @ . @ . @ @ @ @ @ @ . . . @ @ . @ . . . @ @ @ @ . . @ @ . @ . @ . @ . @ @ 
@ . @ @ . @ @ . @ . . . @ . @ . @ . @ . @ . @ . . @ . @ . . . @ . @ . @ . @ . @ . @ . @ @ . . @ . . @ . @ @ . @ . @ . @ @ . @ . . . @ . . @ @ @ @ @ @ . . @ . @ . @ . . @ @ . . @ . . . @ . . @ . . . @ 
@ . . . @ @ . . . @ . @ . . . @ . . @ @ . . . @ . . . . @ . @ . . @ . . @ . . . . . . . @ . @ . @ . @ . @ . @ . . . . . . . . @ @ . @ . @ @ @ @ @ @ . . @ @ . . @ . . @ . . @ . @ @ @ . @ . @ . @ . @ @ 
@ @ . @ @ . @ . @ . @ @ . @ . . @ @ @ @ @ . @ . @ . @ . @ . @ @ . @ . @ @ . @ . @ . @ . . . . . . . . . . . . @ @ . @ . @ . @ . . . . . . . @ @ @ @ @ . . . @ . . . @ . @ . . . . . @ . @ . . . . @ . @ 
@ @ . @ . . . @ . . . . . @ . @ . @ @ @ @ . . . . . . @ . . . @ @ . . . . @ @ . . @ @ . @ . @ . @ . @ . @ . @ . . @ . . @ . . @ @ @ . @ @ @ @ @ @ @ . . @ . @ @ @ . @ . . @ @ @ @ . @ . . @ . @ . . . @ 
@ @ @ @ @ . @ . @ @ . @ . . @ . . . @ @ . @ @ . @ @ . @ @ . @ . . @ . @ . . . @ . . . @ . . . @ @ . . @ . . . . @ @ @ . . @ . . @ . @ . @ . @ . @ @ . @ . @ . . . . . . @ @ @ . @ @ . @ @ . . @ @ @ @ @ 
@ @ . . . . . . @ @ . . @ . . @ . @ . . . . . . . @ @ . . . @ . @ . @ @ . @ @ . . @ . . @ . @ . @ @ . @ @ . @ . @ @ @ @ . . @ . . . . . . . . . . @ @ @ . . . @ . @ . @ @ @ . . . @ . . . @ @ . . . . @ 
@ @ @ @ . @ @ . . . @ . @ @ @ . . . @ . @ . @ @ . . @ . @ . . . . . . . @ . . . @ . . @ @ . . . . . @ @ . . . @ @ @ . . @ . . @ @ @ @ @ @ @ @ @ . . @ . . @ @ . . . @ . @ . @ . @ . @ . @ . @ . @ @ . @ 
@ @ @ . @ @ . . @ @ @ @ . @ . @ . @ . . . @ @ . . @ @ @ . . @ @ . @ . @ . @ @ @ @ @ . . . @ . @ . @ @ . . @ @ . . . . @ . @ @ . . . . . @ @ @ @ @ @ . @ . @ @ @ . @ @ . . . . . . . . . . . . . . @ @ @ 
@ . . . @ . @ . @ . . . . . . . . . . @ @ . . @ . . @ . . @ . . @ . . . . . @ . @ . . @ . @ . . @ . . @ @ . . @ @ @ . . . . . . @ . @ . . . . . . . . . . . @ @ . @ . . @ . @ @ . @ . @ . @ @ . @ @ @ @ 
@ @ @ . @ . . . . . @ . @ . @ . @ . @ @ @ @ . @ . @ . @ . . @ . . @ . @ @ . . . . @ . @ @ . . @ @ . @ @ . @ . . . . . @ . @ . @ @ . @ . @ . @ . @ . @ . @ @ . . @ . @ . @ @ . . @ @ . @ . . . @ @ @ @ @ 
@ . . . . . @ . @ . @ @ . @ . . @ . @ @ @ . . . . . . . . @ . . @ . . . . @ @ . @ . . . . @ . . . . . . . . . @ . @ . @ @ . . . @ @ @ @ . . . @ . . . @ . @ . @ . . . . . . . @ @ @ @ . @ @ @ . @ . @ @ 
@ . @ @ . @ . . . @ . . . . @ @ . . . . . @ @ @ . @ @ . @ . @ . @ @ . @ @ @ @ @ @ @ @ . @ @ . @ @ . @ . @ . @ @ @ . @ @ @ @ . @ @ @ @ . @ . @ . @ . @ . . . . . . @ . @ . @ . . . @ . . . . . . . . . @ 
@ . . @ @ . . @ @ . . @ @ . . . . @ @ . @ . . . . @ @ . . . . . . @ . @ . @ @ @ @ @ @ @ @ . . @ . . . @ @ . @ @ @ . @ @ @ . . @ @ @ . . . . . . @ @ . . @ . @ . @ . . . @ . . @ . @ . @ @ . @ @ . @ . @ 
@ . @ . . @ @ . @ @ @ @ . @ . @ . . @ . . @ @ . @ @ . @ @ . @ . @ . @ . . . @ @ @ @ @ . . @ . . @ @ . . . @ . @ . . . @ . @ . . @ @ @ . @ @ . @ . @ . @ . @ @ @ . @ . @ @ @ . @ . . . @ . @ @ @ @ @ @ @ 
@ @ @ @ . . . . . . . . . . . @ . @ . . @ . . @ . . . . . . @ . . . . @ . @ . @ @ @ . @ . @ @ @ . . @ . @ @ . @ . @ . . . . . @ . @ . @ . . . . . @ . . . . @ @ . . . @ @ @ . . @ . @ . . @ @ @ @ @ @ @ 
@ @ @ @ @ . @ @ @ @ . @ . @ . . @ @ @ . . . @ @ @ . @ . @ . . @ . @ . . . . . . . . . . . . @ . . @ . @ @ . . @ @ @ @ . @ . @ . . . . . . @ . @ @ @ . @ . @ @ @ @ @ . @ @ . @ @ . @ @ . @ @ @ @ @ @ @ @ 
@ . @ . @ @ . @ . . . . @ . @ @ @ @ . @ . @ @ @ . . @ @ . . @ . @ @ . @ @ @ @ @ . @ . @ . @ . @ . . . @ . . @ . . . . . . @ @ @ . @ . @ @ . . @ . . . . @ @ @ @ @ @ @ @ @ . . . . . . . . @ . @ . @ . @ 
@ . @ . . . . . @ . @ . . . . . @ . . . . . . . @ . @ @ @ . . . . . @ . @ . @ @ . . @ @ . @ . . . @ @ @ . @ . @ @ . @ . @ @ @ @ . . @ @ @ @ . @ . @ . @ . @ @ @ @ @ @ @ . @ . @ . @ . @ . . . . . . . @ 
@ . . . @ . @ . @ . @ . @ . @ . @ @ @ . @ . @ @ @ @ . . . . @ . @ . . . . . . . @ @ @ . . . @ @ . . @ . . . . . . @ @ . @ . @ @ . @ @ @ @ @ @ . . . @ . . . @ @ @ . @ . . . . . @ . . @ . @ @ @ . @ . @ 
@ @ . @ @ @ . . . . . @ . . @ @ @ @ @ @ . @ . @ @ @ . @ . @ . . . @ . @ @ . @ . . @ @ @ . @ @ . . @ . @ . @ . @ @ @ @ @ . . . . @ . @ @ @ @ @ @ . @ . @ . @ . @ . . . @ . @ . @ @ @ . . @ . . . . . @ @ 
@ @ @ . @ . @ . @ @ . . @ . @ . @ @ @ . . . . @ . @ @ @ . . @ . @ . . @ @ . . @ . @ . . . @ @ @ . . . @ . . @ @ @ @ @ . @ . @ @ . . . @ @ @ @ . . . . . . . . . @ . @ . @ @ . @ . . . @ . @ . @ . @ . @ 
@ @ . . . . . . . . @ . @ . . . @ . . . @ @ . . . . . . . @ . . @ @ . . . @ . . @ . @ @ . . @ . . @ @ @ . @ . . . @ . . . . . . . @ . . @ . . @ . @ . @ . @ . @ . . . . @ . . . @ @ @ . . . @ . . . . @ 
@ @ @ . @ . @ . @ . @ . @ . @ @ . @ @ @ . . . @ . @ . @ . . @ @ . . . @ . . @ . . . . . @ . . @ . . . . . . . @ . @ . @ @ . @ . @ @ @ @ . @ . . . . @ @ . . @ . @ . @ . @ @ . @ . @ . @ . @ . @ . @ . @ 
@ . . . @ . . @ . . . @ @ @ @ @ . @ . . . @ . . @ . @ . . @ . . . @ . @ @ . . @ @ . @ . @ . @ . @ . @ @ . @ @ . . @ @ . @ . . @ . @ . @ . . . @ . @ @ @ @ . . . . . . @ . . . . . . . . . . . . @ @ @ @ 
@ . @ @ . . @ @ @ @ @ . @ . @ . . @ . @ . @ . @ @ . . . @ @ @ . @ @ . @ . @ @ @ . . . @ @ . . . . . . @ . @ @ @ . . . . . . @ . . . . . . @ . . @ @ @ @ @ . @ . @ . @ . @ @ . @ . @ @ . @ @ . @ @ @ . @ 
@ . . . @ . @ @ . . . . . . @ . @ . @ . . @ . @ . @ . @ @ @ . @ . . . . . . @ . @ . @ . . . @ . @ @ . @ @ @ @ @ @ . @ . @ . . . @ . @ . @ . . @ . @ @ @ @ . . @ . . . . . . . . @ . . . @ . . . . . . @ 
@ . @ . @ @ @ . @ . @ . @ . . . . . . . @ . . . . . @ @ @ . . . . @ . @ @ . @ . . . . @ @ . . @ @ . . . . . @ @ . @ @ @ . @ . @ . @ . @ . @ . . . . @ @ . . @ @ @ . @ . @ @ . @ @ . @ . . @ . @ . @ . @ 
@ . . @ @ @ . . @ @ . @ . . @ . @ . @ . . @ . @ @ @ @ . . . @ . @ . . . . @ . @ @ . @ . @ . @ . @ @ . @ . @ @ . . . . . . @ @ . . . . . . @ . @ . @ @ @ @ . . @ @ . . @ @ @ . @ . @ @ . @ . . . @ . . @ 
@ . @ . @ . @ . @ . . . . @ . . . @ . . @ @ . . . . . @ @ @ . . @ @ . @ . . . . @ . . . @ @ . . . . . . @ @ . @ . @ . @ . . . . @ . @ . @ @ . @ @ @ . @ . @ . @ @ @ . . . . @ . . . . @ @ @ . @ @ @ . @ 
@ . . . @ . . . . . @ @ @ @ @ . @ @ @ . . @ @ @ . @ . . @ @ . @ . . . . @ . @ @ . . @ . . . @ @ . @ @ . . . . . . . @ @ @ . @ . @ . . @ @ . @ @ . . . @ . . @ @ @ @ . @ . @ . . @ @ . . . . @ @ @ . . @ 
@ @ . @ @ @ . @ @ . . . . @ @ @ @ @ @ @ @ . . . . . @ @ . . . @ @ . @ . . @ . @ @ . . @ . @ @ . . @ . . @ @ @ @ . @ @ @ . @ @ @ . . @ . . . . . . @ . . @ . @ @ @ @ . . @ . . @ @ . . @ . @ @ . . @ . @ 
@ @ @ . @ @ @ . . . @ . @ @ @ @ @ @ @ @ @ @ . @ @ . . @ . @ @ . . . @ . @ . . . . . @ @ @ . @ . @ @ @ . . . . . @ . @ @ . @ . @ @ . . . @ . @ . @ . @ @ . . . @ @ @ . @ . @ . @ @ @ . . @ @ . . @ . . @ 
@ @ @ . . . . . @ . . @ @ @ @ @ @ @ @ @ @ @ . @ . . @ . . @ . @ . @ . @ . @ @ @ . @ . @ . . @ @ @ . . . @ . @ . . . . . . . . . @ @ . @ @ @ . . . . . . . @ . . @ @ @ . . . . @ @ @ @ . @ @ @ . . @ . @ 
@ @ . @ . @ . @ . . @ . @ @ . . @ @ . . @ @ . @ @ . . @ @ @ . . . . . . . . . @ . . . . . @ . . . @ @ . @ @ @ . @ . @ @ . @ . @ @ @ @ @ @ . @ . @ . @ . @ @ @ @ . @ . @ . @ . . @ @ @ @ . @ @ . @ . @ @ 
@ . . . @ . . . @ . . . . . @ . . . . @ . @ @ . @ . @ . . . . @ . @ . @ . @ . @ . @ . @ . . . @ . @ . . . . . @ . . . . @ @ . . @ @ @ @ . . . . . @ . . . . . . . . . . . . @ . . @ @ @ . @ @ . @ . . @ 
@ @ @ . @ @ . @ @ . @ . @ . @ @ @ . @ . . . . . . @ @ @ . @ . . @ @ . @ @ . . @ . . @ . . @ . @ @ . @ . @ . @ . @ . @ . . . @ . . . . . @ . @ . @ @ @ @ . @ . @ . @ . @ . @ @ . @ @ @ @ . . . . . . @ @ 
@ @ @ . . . . @ . . . @ @ . . . . . . . @ . @ . @ @ @ . @ . . @ . . . . . @ . . @ . @ . @ @ . . . . @ . . @ . . . . . @ . @ . @ . @ . @ @ @ . . @ @ . @ . . @ . . @ . . @ . . . @ . @ . . @ . @ . @ . @ 
@ @ . @ @ . @ . . @ @ . @ . @ @ . @ . @ . . @ @ . @ . . . @ . . @ @ . @ . @ . @ @ . . @ @ . @ . @ . @ . @ @ . @ . @ @ . . . . . @ . @ . @ . @ . @ @ . . . @ . @ . . @ . @ @ @ . . . . . @ . @ . . . . @ 
@ . . . . . . @ . . . . @ . . . @ @ @ @ @ . @ . . . . @ . . . @ . . . . @ @ @ @ @ @ . . . . . @ @ . @ @ . @ @ . . . @ @ . @ . @ . . . . @ . . . @ @ @ . @ . . @ . @ @ . . @ @ @ . @ . @ . . @ . @ @ @ @ 
@ @ . @ @ . @ @ . @ . @ . @ . @ . @ @ @ @ @ . @ . @ @ @ @ @ . . @ @ . @ . @ @ @ @ @ @ . @ @ . . . @ . @ . . @ @ . @ @ . . @ @ . @ . @ @ . @ @ @ . @ . . . @ . @ @ @ . . @ . @ @ @ . . @ . @ . @ . @ @ @ 
@ @ . . @ @ . . . . @ . . . @ @ . . @ @ @ . . . . @ . . . . . @ @ @ . . . . @ @ @ @ @ . . @ . @ . . . . . @ @ . . . . @ . . . . . . . . . . . . . . @ . @ . . . . @ . @ . . @ @ . @ . . . . . . . . . @ 
@ . . @ . @ @ @ . @ . @ . @ . @ . @ @ @ . @ . @ . . @ . @ . @ @ @ . . @ . @ . @ . @ @ . @ @ . . @ @ @ . @ . @ @ . @ @ . . @ . @ . @ . @ . @ . @ . @ @ . . . @ @ . @ . . @ . . . . @ @ . @ @ @ . @ . @ @ 
@ @ . @ . . . . . . . @ . @ . @ . . . . . @ . @ . @ @ @ . . @ @ @ . @ . . . . . . . . @ . . . @ . . @ . . . . @ . @ @ @ . . @ . . . @ . . @ . . @ @ . . @ @ @ @ . @ . @ . . @ . @ @ . . . . . @ . @ @ @ 
@ @ @ . . @ . @ . @ . . . . . . @ @ @ @ . @ . . @ @ @ @ @ . @ @ . . @ @ . @ . @ . @ @ . . @ . . . @ @ . @ . @ . @ @ @ @ . @ @ @ . @ @ @ . . @ . . @ @ . . . @ . @ . . @ . @ . @ . . @ . @ . @ @ . @ @ @ 
@ @ . @ . @ . @ . . @ . @ . @ . @ . . . . . . @ @ @ @ . @ . . @ @ . . @ . . @ @ @ @ @ @ @ . . @ . . . @ . . . . . . @ . . @ @ @ @ @ @ @ . @ . . @ @ . . @ . . . @ @ . . . . . . @ . @ @ @ . . . . @ @ @ 
@ . . . . @ @ . . @ . . . @ @ @ . @ @ . @ @ @ @ @ @ . . . . @ . . . @ . . @ . @ . @ . @ . @ . . @ . @ @ @ . @ . @ @ . @ . . @ @ @ @ @ @ @ . . @ @ @ @ . . @ . @ . @ @ . @ . @ . . . @ . . . @ . @ @ @ @ 
@ @ . @ . . @ . @ . . @ . @ @ @ . . . . . . . @ @ @ @ . @ . . @ @ . @ @ . . . . . . . . . @ . @ . . @ @ @ @ . . . . . @ . @ @ @ @ @ @ @ @ . @ @ @ @ . . @ . . . . . @ @ @ . @ . @ . . @ @ . . @ @ @ @ @ 
@ @ @ @ @ @ @ @ @ @ @ @ @ @ @ @ @ @ @ @ @ @ @ @ @ @ @ @ @ @ @ @ @ @ @ @ @ @ @ @ @ @ @ @ @ @ @ @ @ @ @ @ @ @ @ @ @ @ @ @ @ @ @ @ @ @ @ @ @ @ @ @ @ @ @ @ @ @ @ @ @ @ @ @ @ @ @ @ @ @ @ @ @ @ @ @ @ @ @ @ 
3
64 36 39 44
62 36 19 29
17 64 10 9
