50 50
@ @ @ @ @ @ @ @ @ @ @ @ @ @ @ @ @ @ @ @ @ @ @ @ @ @ @ @ @ @ @ @ @ @ @ @ @ @ @ @ @ @ @ @ @ @ @ @ @ @ 
@ @ @ @ @ @ @ . @ . @ . @ . @ . @ . . . @ . @ @ . . . . @ . . . @ @ @ . @ . . @ @ @ @ @ . . . @ @ @ 
@ @ @ @ @ @ . . . . . . . . . . . @ . @ . . . . @ @ . @ . @ . @ @ @ . . @ . @ @ @ . @ @ @ . @ @ @ @ 
@ @ @ @ @ . . @ . @ . @ . @ . @ . . . . @ . @ . . . . . . . . @ . @ @ . @ . . @ @ . . @ . . . @ @ @ 
@ @ @ @ @ @ . . @ . . . @ . . @ @ . @ . . @ @ @ . @ . @ . @ . . . . @ . . . @ . @ . @ . @ . @ . @ @ 
@ @ @ @ @ . . @ @ . @ @ @ @ . @ . @ . . @ . . . . @ . @ . @ . @ . @ @ @ . @ . . . . . . . . . . . @ 
@ @ . @ . @ . . . @ . . @ . . . . . @ . @ . @ . @ . @ . . . @ @ @ @ @ . . . . @ . @ . @ . @ @ . @ @ 
@ . . . . . . @ @ @ . @ . @ . @ . @ . . . @ @ @ . . . @ @ . . . @ @ . . @ . @ @ . @ . . @ @ @ @ @ @ 
@ @ . @ . @ @ @ . . . @ . @ . @ @ . @ @ . @ @ . @ @ . @ . @ . @ @ @ @ . . @ @ . @ . @ . . @ . . @ @ 
@ @ @ . . @ . . @ @ . . . . @ . . . . . . . @ . . . . . . . . . @ @ @ . @ @ . . . . . . @ . @ . @ @ 
@ @ . @ . . . @ . @ @ @ . @ . @ . @ . @ . @ . @ . @ . @ . @ . @ @ @ . . . . @ . @ . @ . . . . . . @ 
@ . . @ . @ . . . . . . . @ . . @ . @ @ . @ . . . . @ @ @ . . . @ . . @ . @ @ @ @ @ . . @ @ . @ . @ 
@ . @ . . . @ . @ . @ @ . . @ . . . @ . . . @ . @ @ . @ . @ . @ . @ . . @ @ @ . @ @ @ . . @ . . @ @ 
@ . . @ @ . . @ . . . . @ @ . @ . @ . @ . @ . @ @ . . . . . . . . . . @ . @ . . @ @ @ . @ . . @ . @ 
@ @ . . . . @ . @ . @ . @ . . . . . . . . . . . . . @ @ @ . @ @ . @ . . . . @ . @ @ @ @ . @ . . . @ 
@ @ @ . @ . . . . @ . . . @ . @ . @ . @ . @ . @ @ . @ @ @ . . . @ . . @ . @ @ . . @ @ @ . . . @ . @ 
@ @ . @ . . @ . @ . @ . @ @ @ . . @ @ . . . @ . . . . @ . @ @ . . @ . . @ @ . . @ . @ @ @ . @ . . @ 
@ . . . @ . . @ @ . . . . @ @ @ . @ @ @ . @ . @ @ @ . @ . . . @ @ . @ . . @ @ . . . . @ @ . . @ @ @ 
@ @ @ . @ . @ @ . @ @ . @ . @ . @ . . . . . . . @ . . . . @ @ . . . . . @ @ . @ @ . @ . @ . @ @ @ @ 
@ . . . . . . . . . . @ @ . @ . . @ . @ . @ @ @ . @ . @ . . @ . @ . @ . @ . . @ . . . . . @ @ @ @ @ 
@ @ @ . @ . @ . @ . @ @ . . @ . @ @ @ . . @ . . . . . . @ . @ @ . . @ . . @ . . @ . @ . @ @ . @ @ @ 
@ @ . . . @ @ @ @ @ . . . @ . . . @ . @ . @ . @ . @ . @ . . @ @ @ . @ . @ . @ . . . @ . @ . . . @ @ 
@ . . @ . . @ . @ . @ @ . @ @ . @ . . . . . @ @ @ . . . @ @ . @ @ @ . . @ . . . @ . @ @ . @ . @ . @ 
@ @ . @ . @ . . . . @ . . . @ . . @ . @ . @ @ . @ @ . @ . . . . @ @ @ . . @ . @ . . . @ . . . @ . @ 
@ . . @ @ . @ @ . @ . @ . @ . @ . @ @ . . @ . . . @ . @ @ @ . @ @ . . . @ @ @ . @ . @ . @ @ . @ . @ 
@ . @ . . . @ @ . . . @ . . . . . . . @ . . @ . @ . @ . . . . . . . @ . . . . . . . . . . . . . . @ 
@ @ . . @ . @ . @ @ . @ @ . @ . @ . @ @ @ @ . . . . . . @ . @ . @ . . @ . @ . @ . @ @ . @ . @ . @ @ 
@ @ . @ . . . . @ . . . . @ @ @ . . @ @ @ . . @ . @ @ @ . . @ @ . . @ . . . @ . . . @ . @ @ . . . @ 
@ . @ . @ . @ . . @ . @ @ . @ . @ . @ @ @ @ . @ @ @ @ @ @ @ @ . @ . . @ . @ . @ . @ @ . @ . @ . @ @ 
@ . . . @ . . @ . . . . . . @ . . . @ @ @ @ @ @ @ @ @ @ @ . . . . . @ . . . . @ . . . @ . . . . . @ 
@ . @ . . @ @ . @ . @ . @ . . @ @ . @ @ @ @ @ @ @ @ @ @ @ @ . @ @ @ . @ . @ . . @ . @ @ @ . @ . @ @ 
@ @ . @ . @ . . @ @ . @ . @ . @ . . @ @ @ @ @ @ @ @ @ @ @ @ . . . . . . @ . @ . . @ . @ . . @ @ @ @ 
@ . . . . . @ . . . . . . . . . @ . . @ @ @ @ . . @ @ @ @ . . @ @ . @ . . . . @ @ . . . @ . . . @ @ 
@ . @ . @ . . @ . @ . @ . @ @ . . @ . . @ @ . @ . @ . @ . @ . . . @ @ @ . @ . . . . @ @ @ @ @ . . @ 
@ . @ @ . . @ . @ @ @ . @ @ @ . @ . . @ . . . . . . . . . . . @ . . @ @ . . @ @ . @ @ @ . . . . @ @ 
@ . @ . @ . @ . . @ . . . @ . . . . @ . @ . @ . @ . @ . @ . @ @ @ . . . @ @ @ @ . . . . @ . @ . . @ 
@ @ . . . . . . @ . @ @ . @ @ . @ . . . . @ . . @ @ . @ . . . @ @ . @ . . @ . . . @ @ . @ . . @ . @ 
@ . . @ . @ @ . @ . @ @ . @ . @ @ @ . @ . . . @ @ @ . @ @ . @ . . . @ . @ @ @ . @ @ . . . @ @ . . @ 
@ @ @ @ . @ . . . . . . . . . . . . . . @ . @ . . . . . . . . @ @ . . @ . . @ . . . @ . @ @ @ @ . @ 
@ . @ . @ @ . @ . @ . @ @ . @ @ @ . @ @ . . @ @ @ . @ . @ . @ @ . . @ . @ . @ . @ . @ . . @ . . . @ 
@ . . . . . . . @ . . . . @ @ @ @ . . @ . @ . . . . . @ . . . @ @ . . . . . @ @ @ @ . . @ @ . @ . @ 
@ . @ . @ @ . @ @ @ . @ . . @ @ @ @ . . @ . . @ @ . @ . @ . @ @ . . @ . @ @ . @ @ @ @ . . . @ . . @ 
@ @ @ @ . . . @ . . . . @ . . @ @ @ @ . @ . @ . . . . . . @ @ @ @ . . @ . . . . @ @ . . @ . . @ . @ 
@ @ @ @ @ . @ @ @ @ . @ @ . @ @ @ @ @ @ . . @ . @ . @ . @ . . . . . @ . @ @ . @ . @ @ . . @ @ . . @ 
@ @ @ @ @ @ . . . . . . . @ @ @ @ @ @ @ @ @ . . @ @ . . . @ . @ . @ @ . . . . . . . . @ . . . @ @ @ 
@ @ @ @ @ @ @ @ . @ . @ . . @ @ @ @ @ @ @ @ @ . . @ @ . @ . . @ . . . . @ . @ @ @ @ @ . . @ . @ . @ 
@ @ @ @ @ @ @ @ @ . . @ . @ @ @ @ @ @ @ @ @ @ . @ @ @ . @ . @ . . @ @ . . @ . @ . @ . @ . . @ . . @ 
@ @ @ @ @ @ @ @ . @ . @ @ @ @ @ @ @ @ @ @ @ . . @ @ . @ @ . . @ . . . @ . . . . . . . @ . @ @ . @ @ 
@ @ @ @ @ @ @ @ . . . @ @ @ @ @ @ @ @ @ @ . . @ . . . . . . @ @ . @ . . @ . @ . @ . @ . . . . . . @ 
@ @ @ @ @ @ @ @ @ @ @ @ @ @ @ @ @ @ @ @ @ @ @ @ @ @ @ @ @ @ @ @ @ @ @ @ @ @ @ @ @ @ @ @ @ @ @ @ @ @ 
3
13 5 46 42
33 31 7 3
40 22 9 26
