100 100
@ @ @ @ @ @ @ @ @ @ @ @ @ @ @ @ @ @ @ @ @ @ @ @ @ @ @ @ @ @ @ @ @ @ @ @ @ @ @ @ @ @ @ @ @ @ @ @ @ @ @ @ @ @ @ @ @ @ @ @ @ @ @ @ @ @ @ @ @ @ @ @ @ @ @ @ @ @ @ @ @ @ @ @ @ @ @ @ @ @ @ @ @ @ @ @ @ @ @ @ 
@ @ @ @ @ @ . . @ . . . . @ . . . @ . . . . @ @ @ @ @ . . . . . . @ @ @ @ @ @ @ @ . @ . . @ . @ . . . . . . . . @ . @ @ @ . . . . . . @ @ @ . @ @ . @ @ @ @ . . . . @ @ @ . . . . @ @ @ @ @ @ @ @ @ @ @ 
@ @ @ @ @ . . @ . @ . @ . . . @ . @ . @ . @ . @ @ @ @ @ @ . @ . @ @ @ @ @ @ @ . . . . @ . . . @ @ . @ . @ . @ . @ . . @ . @ . @ . @ . @ @ . . . . . . . @ . . @ @ @ @ @ . @ . @ @ . @ @ @ @ @ @ @ @ @ @ 
@ @ @ @ @ @ . . . . . . @ @ @ . @ @ @ . . . . . @ . . . . @ @ . . @ . @ @ @ . @ . @ . . . @ @ @ @ @ . . . @ . . . . @ . . . . . @ @ @ . @ @ . @ . @ . @ @ . @ @ . . @ . . @ . . . . @ . @ @ @ @ @ @ @ @ 
@ @ @ @ @ . . @ . @ @ @ @ @ . . . @ . . @ . @ . . . @ . @ . . @ . . . . @ . . . @ @ . @ . @ . @ @ @ @ . @ @ @ . @ @ . @ . @ . @ . @ . . . . . . @ . @ @ . . . . . @ @ @ . @ . @ . @ . . @ @ @ @ @ @ @ @ 
@ @ @ @ . @ . . @ . . @ @ . @ . @ . . @ . . . @ . @ . . @ . @ . @ . @ . . . @ . @ @ @ . . @ . . @ . @ @ @ @ . . @ . . . @ . . . . . @ . @ . @ . . . . . @ . @ . @ @ @ . . @ . @ @ @ . @ . @ @ @ @ @ @ @ 
@ @ @ . . . . @ . . @ @ . . . . . . @ . . @ . . @ . @ . @ . @ . @ @ . . @ . . @ . @ . @ . @ . @ . . . . @ . @ . @ @ . @ . @ . @ . @ @ @ . . . @ . @ . @ @ . . @ . . @ @ . @ . . @ . . . . . @ @ @ @ @ @ 
@ @ . @ . @ . . @ . . . . @ . @ . @ . . @ @ @ @ . . . . . . @ . @ . @ . . @ . @ . @ . @ . . . @ . @ . @ . . . . . . . . . . . . @ @ @ @ @ . @ . @ . @ @ @ . @ . @ . @ . . @ . @ . . @ . @ @ . @ @ . @ @ 
@ . . @ @ . . @ @ @ . @ . @ @ . . . @ . . @ . . @ @ @ . @ @ . . . . . . @ . @ . . . . . @ . @ . . . @ @ . @ . @ . @ . @ . @ . @ . @ @ @ . . . . . . . @ . . @ . . . . @ . @ . . . @ @ . . . . . . . @ @ 
@ @ . . @ @ . @ . @ . @ @ . . . @ @ . . @ . . @ @ @ . . . @ @ @ @ . @ . @ . . . @ @ @ @ . . . . @ @ . . . @ @ @ @ . . . @ . . . . . @ . . @ . @ . @ . . @ . . . @ . @ . . @ . @ @ . . @ @ . @ . @ . . @ 
@ @ @ . . . . . . @ . . . @ @ . @ . @ . @ @ . . . . . @ . @ @ . . @ . . . . @ . . . . @ . @ @ . . . @ @ @ @ @ @ @ @ . @ . @ . @ . @ . @ . @ @ @ @ @ @ . @ . @ . . @ @ . @ @ . . . . @ . . . . @ . @ . @ 
@ . @ @ @ @ @ @ . . . @ @ . @ @ . . . . @ @ @ @ . @ . . @ . . . @ . . @ . @ . . @ . @ . . @ @ @ @ . @ . @ @ @ @ @ @ @ . . @ . . @ @ . . . . . @ @ . . @ @ . . @ . . . . . @ . @ . @ . @ @ @ @ . . @ @ @ 
@ . . . . . . . . @ . @ @ . @ . @ . @ . @ @ . . @ . . @ . @ @ . . @ . . @ @ @ @ @ @ . @ . @ @ . . @ . . . . @ @ @ @ @ @ . @ . @ . @ @ . @ . @ @ @ @ . . . . @ . @ . @ @ . @ . @ @ . . . @ . @ . @ @ @ @ 
@ @ @ @ . @ . @ . . @ . . . . . . . @ . . . . @ @ @ . . . @ . . @ . . @ @ @ @ . @ . . . . . @ @ . . . @ @ . . @ @ @ @ @ . . . . . . . @ . . . @ @ . . @ . @ . . . . . @ @ . . . . @ . @ . . . . . @ @ @ 
@ . @ . . . @ . . @ . @ . @ @ . @ . @ . @ . @ @ . . . @ @ . . @ . @ . . @ @ . . @ @ . @ . @ @ . @ @ . . @ . @ @ . . @ @ @ . @ . @ . @ . @ . @ . @ @ . @ @ @ @ . @ . @ @ . . @ @ @ . . . . @ . @ . @ @ @ 
@ . . @ . @ @ . @ . . . . . . @ . @ . . . @ @ @ @ @ . @ @ @ . . . . . @ @ . @ . . @ . @ . . @ . . . . @ @ @ @ @ . @ . @ @ . . @ . . . . . . . . . . . . . @ @ @ . . . . @ . @ . @ . @ @ @ . @ . @ . . @ 
@ @ . @ @ . . . @ @ . @ . @ @ . . . . @ . . . . . @ . . @ . @ @ @ @ . . @ . . . @ @ @ @ . @ . @ . @ . @ @ @ @ @ . @ . . . @ @ . @ . @ . @ @ @ @ . @ . @ @ . @ . @ . @ . @ . . . . . @ . @ . @ . @ . @ @ 
@ . . . . . @ . . . @ . . @ . @ @ @ . . @ . @ @ . @ . @ @ . . . @ @ . @ @ @ @ . @ @ @ . . . . . @ . . . @ @ @ . . . . @ . . . . . . @ @ . . . . @ . @ . @ . @ . @ . . @ . . @ . @ . . . . . . . . . . @ 
@ @ . @ . @ . . @ . @ @ @ . . . . . . @ . . . . @ @ . . . . @ . . @ . . @ . . . . @ . @ . @ . @ . @ . @ @ @ . @ @ . @ . . @ @ . @ . . . @ . @ . . . @ . . . @ . . . @ @ @ . . @ @ @ @ . @ @ @ @ . @ . @ 
@ . . @ . @ @ . . @ @ @ @ . @ . @ @ . @ @ . @ . @ . . @ @ . . @ . @ . @ . @ @ . @ . . . . @ @ @ . . . @ @ @ . @ @ . @ . @ . . @ . . @ @ . . @ @ @ . . @ . @ @ . @ . @ @ . . @ @ @ @ @ . . . . @ . . @ @ 
@ @ . @ . . . @ . @ @ @ @ @ . . @ . . . @ . . @ @ @ . @ . . @ . @ . . . . @ @ . . @ @ @ . . @ . . @ @ . @ . . @ . . @ . @ . @ @ . @ . . . @ . . . @ @ . . @ . @ @ @ @ @ @ . . @ @ @ . @ . @ . . @ . . @ 
@ @ @ . @ . @ @ @ @ @ @ @ . @ . . @ . @ . @ . . . @ @ @ @ . . . . @ @ @ . @ . . @ . . @ . @ . @ . @ . . . @ . . . @ @ . . . . . @ @ @ . @ @ @ @ . @ . @ . @ . . @ . @ @ @ @ . @ . . . . . . @ @ . . @ @ 
@ @ @ . . @ . @ @ @ . @ . . . . @ @ @ . . . @ . @ . . @ . . @ . @ . . . . . @ . . . @ . . . . . . . . @ @ @ . @ @ . . @ . @ @ . . @ . . . @ @ . . @ . @ . . . @ . . . . @ . . . @ @ . @ . @ @ @ . @ . @ 
@ . . @ . @ . . @ . . . . @ . @ @ @ . @ . @ . @ @ @ . . . @ . @ @ @ . @ @ . . . @ @ . . @ @ . @ @ . @ @ @ . . @ . . @ . @ @ . @ @ . . @ @ @ . @ . . . . . @ . . @ @ . @ . @ . @ . @ @ . . . @ . . @ . @ 
@ @ . . . . . @ . @ @ . @ @ @ . . . . . . @ . . @ . @ . @ @ . . @ @ @ . . @ @ . . . @ . @ . @ @ . @ @ @ . @ . . @ . . . @ . . . @ @ . . . @ . . @ . @ @ . . @ @ . @ . . . . . . . . @ @ . @ . @ @ @ . @ 
@ . . @ . @ . . . . @ . . @ . @ . @ @ @ . . . @ . . @ . @ . . @ @ @ . @ . @ . @ @ . . . @ . . . . . @ . . . . @ . . @ @ . . @ @ . . @ @ . . . @ . @ . . . @ . . . . . @ . @ . @ . @ . . . . . . . . . @ 
@ @ . . @ . . @ @ . @ . @ . . . . . @ . . @ . . @ . @ . . @ . . @ . . @ . . . . @ . @ @ . @ . @ . @ . @ . @ . @ . @ . @ . @ . @ . @ @ @ . @ @ . . . @ @ . @ . @ . @ . . @ . . . @ . @ @ . @ . @ . @ . @ 
@ @ . @ . @ . . . @ @ @ . @ . @ . @ @ @ . @ @ @ . . @ . @ @ @ . . @ . . @ @ . @ @ . @ . . . @ . . . . @ @ . . . . . . . . . . . . . . . . . . . @ . . . . . . . @ @ . @ . . @ . . . . @ @ @ . . @ @ @ @ 
@ @ @ . . . . @ @ . @ . . . @ . . . @ @ . . . . @ . . . . @ . . @ @ @ . . . . . . . . @ . @ . @ @ . @ . @ @ . @ . @ @ @ . @ . @ . @ . @ . @ . @ . . @ . @ . @ . . @ @ . @ @ @ @ . @ . @ . . @ @ @ @ @ @ 
@ @ . @ @ . @ @ @ . . @ . @ @ @ . @ @ @ . @ @ @ . @ . @ @ . @ . . . . @ @ @ . @ @ . @ . . . . . . . . . . . . . @ . . @ . . @ @ . . @ . @ @ @ . @ . @ . . @ . . @ . . . @ . . @ @ . . . . @ . @ @ @ @ @ 
@ . . . . . . @ . . @ . . . @ . . . @ . . @ . . . . . . @ . @ @ . @ . @ @ @ @ . . . . . @ . @ . @ @ @ @ . @ . @ . . @ . . @ @ . . @ @ . . @ . . . . . @ . . @ @ . @ . @ @ @ . . @ @ . @ . . . . . @ @ @ 
@ @ . @ . @ . @ @ . . @ . @ . @ . @ @ @ . @ . @ . @ . @ . . @ . . . @ @ . @ @ @ . @ . @ @ @ @ . . . . . @ . @ . @ . . @ @ @ @ @ . @ . . @ . @ . @ . @ @ . @ @ . . @ . . @ @ . @ . @ . . @ @ . @ . . . @ 
@ @ @ @ @ . . @ @ @ . . . . . . @ @ @ . . @ @ @ @ . . . . @ @ . @ @ @ @ . . @ . . @ . . @ . . . @ . @ @ @ . @ . . . @ . . @ @ . . . @ . . . @ . @ . . . @ . . @ . . . @ . @ . . . . @ @ . . . . @ . @ @ 
@ @ . @ . @ . . . . . @ @ @ . @ . @ . @ . . . @ @ @ . @ @ . @ . @ . . @ . @ . @ @ . . @ . . @ @ . @ @ . . . . . @ @ . . @ @ @ @ @ @ . . @ . @ @ @ . @ . . . @ . @ . @ . . . . @ . @ . . . @ . @ @ @ @ @ 
@ . . . . . . @ . @ @ . . . . . . . . @ @ @ . . @ . . . @ . . . . . @ . . . . @ . @ . @ . @ . . . . . @ @ . @ @ . @ . @ . @ @ @ @ @ @ . @ . @ . @ @ @ @ . @ . . . . . . @ @ @ . @ . . @ . . @ @ @ @ @ @ 
@ . @ @ . @ . . @ @ @ @ . @ . @ . @ @ . @ . . @ @ . @ @ . @ . @ @ . . . @ . @ . . . . . @ @ @ @ . @ . @ @ . . . . . . . . . @ @ @ @ . . . @ . . . . @ . . . . @ . @ . @ . . . . . @ . @ . @ @ @ @ @ @ @ 
@ . @ . . @ . @ @ @ @ @ @ . . . @ @ @ . . @ . . @ . @ . . . @ . . . @ . @ @ @ . @ . @ . @ . . . . . @ . . . @ @ @ . @ . @ @ @ @ . . @ . @ . @ @ . @ . . @ @ . . @ @ @ @ @ . @ @ . @ . . @ @ @ @ @ @ @ @ 
@ . . @ @ . . @ @ @ @ @ @ @ @ @ @ @ . . @ . . @ . . . @ . @ @ . @ . . @ @ . . . . @ . . . . @ . @ @ . . @ . . . @ . . @ @ @ @ . @ . . . . . . @ . . @ . @ . @ . . . @ @ . . . . @ . . @ . @ @ @ @ @ @ @ 
@ . @ @ @ @ . . @ @ @ @ @ @ @ . @ . . @ . @ . . @ . @ @ . . . @ @ . @ . @ @ . @ @ . @ . @ @ . @ @ @ . @ . @ . @ @ @ @ @ @ @ @ . . . @ . @ @ @ . . @ . @ . . . @ @ @ . . @ . @ . . @ . @ . . @ @ @ @ @ @ 
@ . . @ @ . @ . . @ @ . . @ . . @ @ . @ . . . @ . . . . . @ . @ . . . . . @ . . . . . @ @ . . @ @ . . @ . . @ @ @ @ @ @ @ @ @ . @ . . @ . . @ . @ . . . @ . @ . @ @ . @ . @ @ @ . . . . @ . @ @ @ @ @ @ 
@ . @ @ @ . . . @ . @ . @ . @ . @ . . . @ @ . . @ . @ . @ . @ . . @ . @ @ . . @ @ . @ @ . @ . . . @ . @ . @ . @ . . @ @ @ @ @ @ . . @ . . @ @ . . . @ @ . . . . . . . . . . @ @ . @ . @ @ . . @ @ @ @ @ 
@ @ @ @ @ @ @ . . . . . . . @ . @ @ . @ @ . . @ . . @ . . . . @ . . @ @ @ @ . @ . @ @ @ . . . @ . . . . . @ . . @ . . @ @ @ @ @ . @ . @ . . . . @ . @ . . @ @ . @ @ . @ @ @ . . @ . . . . . @ @ @ @ @ @ 
@ @ . @ . . . . @ . @ . @ . . . . . . @ . @ . . . @ @ @ . @ . @ . @ @ . @ . . @ . . . . @ @ . . @ @ . @ @ @ . @ @ . @ . . @ @ @ . . . . @ . @ @ . @ @ @ . @ . . . . @ @ @ . . @ . @ @ . @ @ . @ @ . @ @ 
@ . . . @ . @ . . @ . . @ @ @ . @ . @ . . . @ . @ . @ @ . . @ . . . @ . . @ . @ . @ . @ . @ . @ . . @ @ . . . @ . . . . @ @ . . . @ . @ . . @ . . . @ . . . @ @ @ @ . @ . @ . @ . @ @ @ @ @ . @ . . . @ 
@ . @ . . . @ . @ @ . @ . . @ . . @ . . @ @ . . . . . @ @ @ . @ . @ . @ . . . . . @ . . . . . . . @ . . @ @ . @ @ @ @ . @ . @ . @ . @ @ . @ . @ . @ . @ . @ . . . . . . . . . . . . @ . . . . @ . @ . @ 
@ . . @ . @ @ @ . . @ . @ . . . @ @ @ . @ . . @ @ @ . @ . . . . . . . . @ . @ . @ . @ . @ . @ @ @ . @ . @ . . . . @ . . . . . . . . . . . . . . . . . . . . . @ . @ . @ . @ . @ . @ @ @ @ . @ . . . @ @ 
@ @ . . @ @ @ @ @ . @ . . @ . @ @ @ . . . @ . @ @ @ @ @ @ . @ @ . @ @ . @ @ . . . . . @ @ @ @ @ . . @ . . @ . @ . . . @ . @ . @ . @ @ . @ @ . @ . @ . @ . @ . @ @ . . . @ . . . @ @ @ . @ . . . @ . . @ 
@ . . @ @ @ @ @ . . . . @ . . @ @ . @ . @ . . . @ @ . @ . @ . @ . . @ . . . @ . @ @ . . . @ @ @ @ . . . @ . . . @ . @ . . . @ . . . . @ . @ . . @ @ @ @ @ . . . . @ . @ @ @ . @ . @ . . . . @ . @ . @ @ 
@ @ @ @ @ @ @ @ @ . @ . . @ . @ . . . . . . @ @ . . . . . . . . @ @ . . @ . . . . . @ . @ . @ @ @ @ . @ . @ @ . . @ . @ . @ . @ . @ . @ . . @ . @ @ @ @ . @ . @ . @ . @ @ . . . . . @ @ . @ . . . @ @ @ 
@ @ @ @ @ @ @ @ @ @ @ @ . . . . @ @ @ . @ @ . . . @ . @ . @ . @ @ @ @ @ @ @ @ . @ @ . @ . . . . . . . . . . . . @ @ . @ . . . . @ . . @ . @ @ @ . @ . . . . . @ . . @ . . @ . @ @ . @ @ @ . @ . @ @ @ @ 
@ @ @ @ @ . @ . @ @ @ . @ . @ . @ . @ . . @ @ . @ @ @ . . . @ @ @ . @ @ @ . . . . . . . @ . @ @ . @ @ @ @ . @ @ . . . . . @ @ . @ @ @ . . . . . . . @ @ . @ . @ . @ @ @ . . . . . @ . . . . . . . @ @ @ 
@ @ @ . @ . . . . @ . . @ @ . . @ . . @ . . . @ . @ . @ . @ . @ . . . @ . @ . @ . @ . @ . . . . @ @ @ . . @ . . . @ @ @ . @ . @ . . @ @ . @ . @ . @ . @ @ . . . @ @ @ @ . @ . @ @ @ @ @ . @ @ . @ @ @ @ 
@ . . . . . @ . @ . @ . @ . @ . . . @ . @ @ . @ . . . . . @ . @ @ @ . . . . . . @ . @ . . @ . @ @ @ @ . @ . @ . @ . . . @ . . @ @ . . . . @ . @ . . . . @ @ . @ @ @ @ . @ . @ @ @ @ @ @ @ . . . . . . @ 
@ @ . @ . @ . . . . . . . . . . @ @ . . . . . . . @ . @ . . . . @ . @ . @ . @ . . . . @ . . @ . . . . . . . . . @ . @ . . @ . @ . @ . @ . @ @ . @ @ . @ @ @ @ @ @ @ . . . . . @ @ @ @ @ @ @ . @ . @ . @ 
@ . . . @ @ . @ . @ @ @ @ . @ . . @ . @ @ @ . @ . @ . @ . @ @ @ . . . @ . . . @ . @ . @ . @ @ @ . @ . @ . @ @ . . @ . @ . . . . . . . . @ @ @ . . . @ @ @ @ @ @ @ @ . @ . @ . @ @ @ @ @ @ @ . @ @ . . @ 
@ . @ . . . @ . . @ . . . @ @ . @ @ @ . . @ @ @ @ . @ @ . @ . . @ . @ . @ . @ . @ @ @ . . . @ . . @ @ . . @ @ . @ . . . @ . @ . @ . @ @ @ @ @ @ @ . . . @ @ @ @ @ @ @ . . @ . @ . . @ @ @ @ @ . @ . @ @ 
@ . @ . @ @ @ @ . . @ . @ @ . . . @ . @ . . @ . . . @ . . @ @ . . . . . . . . . . @ . @ . @ . @ @ . . . @ . . @ . @ @ . @ @ . . @ . @ . @ @ @ @ @ . @ @ . @ @ @ @ @ @ @ . @ . . @ . @ @ @ . . . . . . @ 
@ . @ . . @ @ @ . @ @ . @ . @ @ . . . . . @ . @ @ . @ @ . @ @ . @ . @ @ @ . @ @ . . . . . . . . @ . @ @ . @ . . . . @ . . . @ . . @ . . @ @ @ @ . . . @ . @ @ @ . . @ @ @ . @ . @ . . @ . . @ @ . @ . @ 
@ . @ . @ @ @ . @ . . . . . . . . @ . @ . @ . @ . . . @ . . . . @ . . . . @ . . . @ . @ @ . @ @ @ @ . . . . @ @ . @ @ . @ @ . . @ . . @ . @ . @ . @ @ @ . . @ . . @ . @ . . . . . . @ . . @ . . @ @ @ @ 
@ . @ . @ @ @ . . . @ @ . @ . @ . . @ . . . . . @ . @ . @ . @ @ @ . @ . @ @ @ @ . . @ . @ . . @ @ @ . @ . @ . . . . . . @ . @ . . . @ . . @ . @ . . @ . . @ . @ . . . . @ @ @ . @ . . @ . @ . @ . . . @ 
@ @ . . . @ . @ @ @ . . . . @ @ . @ @ . @ . @ . . . . . . . @ . @ @ . @ @ @ . @ . @ @ . . @ @ . @ . . . @ @ @ @ @ @ @ . . . . . @ @ . . @ . . @ . @ . . @ @ . @ . @ @ @ . @ @ @ . @ . . . . . . . @ . @ 
@ @ @ . @ . . . . . . @ . @ . . . . @ . . @ @ @ . @ . @ @ . . . . @ . . @ @ . . @ @ . @ . @ . . @ . @ @ . . @ . . . . . @ . @ . . @ . @ @ @ . . . . . @ @ @ . @ . . . @ . . @ . . @ . @ @ . @ . @ . . @ 
@ @ @ @ @ @ . @ . @ . . @ . . @ . @ . @ @ . @ . @ . . @ . . @ @ @ . . @ . @ . @ . @ . . . . . @ . . . @ . @ . @ @ . @ . @ @ @ . @ . . . . . @ . @ . @ . @ . . @ . @ . @ . @ . @ . . . . @ . @ @ . @ . @ 
@ @ @ @ @ @ @ @ @ . . @ . @ @ . @ . . . . . . . . . @ . @ . @ . @ . @ . . . . . . . @ . @ @ . . @ . @ . . . . . @ @ @ @ @ . . . . . @ . @ @ . . @ . . . @ @ . @ . @ @ . . . . . . @ . @ . . @ . . . @ @ 
@ @ @ @ @ @ @ @ @ @ . . . . @ . . @ . @ @ . @ @ . @ . . @ . . . . . . . @ . @ . @ . . @ . @ @ . . . . . @ @ @ @ @ @ @ @ . @ . @ . @ . @ @ @ . @ . @ . @ . . . @ . . @ @ . @ . @ @ @ @ @ @ . . . @ @ . @ 
@ @ @ @ @ @ @ @ @ @ @ . @ @ . . @ @ . . . @ @ @ @ . @ . @ . @ . @ . @ . @ . @ . . @ . @ . . . . @ . @ . @ . . . @ @ @ . . . . @ . @ . . . . . . . . @ . . @ @ . . @ . @ . @ @ . . @ @ @ . . @ . . . . @ 
@ @ @ @ @ @ @ @ @ @ . @ . . . @ . @ @ . @ @ @ @ . . @ . @ . . @ . . . @ @ . @ . @ . . . . @ @ @ . @ . @ . @ . @ . @ . @ . @ . . @ . . @ @ @ @ @ @ @ @ @ . . @ @ . . . . . @ @ . @ . @ . @ . . @ . @ @ @ 
@ @ @ @ @ @ @ @ @ @ . @ @ . @ . . . . . . @ @ . @ . . . @ . @ @ @ . @ @ . @ @ @ . @ . @ . . . . . . . . . . . . . . . . @ . . @ . . @ . . . @ . . . @ @ @ . . . . @ . @ . . . . . . . . . @ . . @ @ @ @ 
@ @ @ @ @ @ @ @ @ . . . . . . @ . @ . @ . . . . @ . @ . . . . . @ . . . . . . . . . @ . . @ . @ . @ @ @ . @ . @ . @ . @ . @ . @ . @ . @ @ . . @ @ . @ . @ . @ . @ . . @ @ . @ . @ . @ . @ . @ @ @ @ @ @ 
@ @ @ @ @ @ @ @ @ @ @ @ @ @ . . . . @ @ @ . @ @ . @ . @ . @ . @ . . @ . @ @ . @ . @ @ @ . . @ . . . . @ @ @ . . @ @ . . . . . . . . . . @ . @ . . . . . . . . @ @ @ . @ . . @ . @ @ @ @ . . . . @ @ @ @ 
@ @ @ @ @ @ @ . @ . . . . . . @ @ @ . @ @ . . @ . . . . . . @ @ @ @ . . . . @ . . . @ @ . @ @ @ . @ . . @ . @ . . . @ . @ . @ @ . @ @ . . . . . @ . @ . @ . @ @ @ @ @ . @ @ . @ . . @ . @ . @ @ . @ @ @ 
@ @ @ @ @ @ @ . . . @ @ . @ . @ @ . . . . . @ @ @ . @ @ . @ . @ . . @ . @ @ . @ . @ @ @ @ @ . . @ @ @ . . . . @ . @ . . . @ @ . . . @ . @ @ . @ . . . @ @ @ . @ . . . . . . . . . @ . . . . . . . . . @ 
@ @ @ @ @ @ @ . @ . . @ @ . . . . @ . @ . @ @ @ @ @ . @ . . . . @ . . . . @ . @ . . . . . . . @ @ @ . . @ @ . . @ . @ . @ . @ @ . @ @ . . . @ . @ @ @ . @ . . . . @ . @ @ . @ . @ . . @ @ . @ @ . @ . @ 
@ @ . @ . @ . @ @ . @ . . @ @ . @ @ @ . . @ @ @ @ @ . . @ . @ @ . . @ . @ . . . . @ . @ @ . @ . @ @ @ . @ @ . @ . . . . . . . @ . . . @ @ . . . . . . . . . @ . @ . . . @ . . @ @ @ . . @ . . @ . @ @ @ 
@ . . . . . . . . . . . @ @ @ . . @ . @ . @ . @ @ @ @ . @ @ . . @ . @ . . @ . @ . @ . . @ . @ . . @ . . . . @ @ . @ @ . @ @ . . @ @ @ . @ . @ . @ . @ . @ @ . . . @ @ @ @ . @ @ . . . @ . @ @ . @ . . @ 
@ @ . @ . @ @ . @ . @ @ . @ . @ . @ . . @ @ . @ @ @ . . . @ @ . @ @ . . @ @ @ . . . @ . . @ . . @ . @ . @ . . . @ @ @ @ . . @ . . . . . . @ @ . . @ @ @ @ . . @ @ @ . . . . @ . @ @ . . . . . . . @ . @ 
@ @ @ . . . . @ . . . @ . . . . . . . @ . . . . @ . @ . @ @ . . . . . @ . . @ @ . @ . . @ . . @ @ . @ . . @ @ . @ . @ . @ . @ . @ . @ @ . @ @ . @ . @ @ . @ . @ . @ @ . @ . . . . . . @ @ @ . @ . @ . @ 
@ @ @ @ . @ @ . @ . @ . . @ . @ . @ @ . @ @ . @ . . . . @ @ @ . @ @ . @ . @ @ @ @ @ @ . . . @ . . . . . @ . . . . . . . . . . @ . . @ @ . . . @ @ . @ . . . . . . . @ . @ . @ . @ @ . . . . @ . . . . @ 
@ @ @ . @ . . . . . @ . @ . . @ . . . . @ . . . @ @ @ . . @ . @ . . . . . . @ @ . @ . @ @ . @ @ @ @ . @ @ @ . @ . @ . @ . @ . . @ @ . . . @ . . . . @ @ . @ . @ . @ @ . . @ . . @ @ . @ . @ @ @ . @ . @ 
@ @ . . . . @ . @ . . @ @ @ . . @ . @ @ @ . @ . @ . . . @ . . . . @ . @ . @ . . . . . @ . @ . . @ @ . . . @ @ . . . @ @ . . @ @ @ @ @ @ . @ . @ . @ @ @ @ . . . @ . . . @ @ @ . . . @ @ @ @ @ @ @ . . @ 
@ @ @ . @ . @ . @ . @ . @ . @ . @ . @ . @ @ @ . . @ @ . . @ @ @ @ . . . @ @ @ . @ @ . @ . @ @ . @ @ . @ . . . @ . @ . @ . @ . @ . @ @ . . . @ . @ @ @ . . @ . @ @ @ . @ . . @ . @ @ . . @ . . . @ @ . @ 
@ @ @ . @ . . @ . . . . @ . . . @ . . . . @ . @ . @ . @ . @ . @ . @ . @ @ . @ . @ @ . . . . . . . . . . @ @ . @ . . . @ . . . . . . @ @ @ . . . . @ . . @ . . . . . @ . . @ . . @ . . @ . @ . @ . @ @ @ 
@ @ @ . @ . @ @ @ . @ . . @ . @ @ @ . @ @ . . . . . . . . . . . . . . . . . . @ . . . @ . @ . @ . @ . @ . @ @ . . @ . . @ @ . @ @ . . . . @ . @ . @ @ . . @ . @ . @ . @ . . . @ . @ . . . . . . . . . @ 
@ @ @ @ . . @ @ . . . @ @ . . . @ . @ @ . @ . @ . @ . @ . @ . @ . @ . @ . @ @ @ @ . @ . . @ . . @ . . . . . . @ . . @ . . . @ . . . @ . @ . . . @ @ @ . @ @ @ . @ . . @ @ @ . . . . . @ @ @ @ @ . @ . @ 
@ . @ . @ . . . @ . @ . @ @ . @ @ . @ . . . . @ . . @ . . . @ . @ @ @ . @ . @ @ @ @ @ @ . @ @ @ @ @ . @ . @ . . @ . . @ @ . @ @ . @ @ @ . . @ @ @ . . . . . @ . @ @ . . @ . . @ . @ . . . . . @ . . @ @ 
@ . . . . . @ @ . . . . . . @ . . . . @ @ . @ . . @ @ @ . @ @ . . . @ . . . . @ @ . @ @ @ . . . . . . . @ . . @ @ @ . . . @ @ . @ . @ . @ . . . . @ @ . @ . @ . @ . . @ . @ @ . . . @ @ . @ @ . @ . . @ 
@ @ . @ @ . . @ . @ . @ @ @ @ @ . @ . @ . @ . . @ . . . . . . @ . @ @ . @ @ . @ . . @ @ . . @ @ . @ . @ . @ @ . @ @ @ . @ . @ . @ . @ . . @ . @ @ @ . . . @ . . . @ . . . . . @ . @ . @ @ . @ . . @ @ @ 
@ @ @ . . . @ . . . @ . @ . @ . @ . . . . . . @ @ @ . @ . @ . . . . . . . @ @ . @ . . . @ . . . @ . . . . . . . @ @ . . . . . . . . . @ . @ . . . . @ . @ . @ . @ . @ @ . @ @ . . . . . . . . . @ @ . @ 
@ @ . . @ @ . . @ @ . . . . . . . . @ @ @ . @ @ @ @ @ . . . @ . @ @ @ @ . . . . . . @ . . @ . @ @ @ . @ . @ . @ . @ @ . @ . @ . @ . @ . . . . @ @ . . . . . . . . . . . . . @ @ . @ @ . @ . @ . @ . . @ 
@ . @ . . . @ . @ @ @ . @ . @ . @ . @ . @ . . @ @ @ . . @ . . @ @ @ . . . @ . @ @ . . @ @ . . . @ @ @ @ . @ . . . . @ . . @ @ . . @ . . @ @ . @ . . @ . @ . @ . @ @ . @ . @ . . . . . @ @ . @ . . @ . @ 
@ . . . @ . @ @ @ @ . . . @ . . . @ . . . . @ . @ @ @ . . @ . @ @ @ @ . @ . @ . . . @ . . @ . @ . @ . . . . @ . @ . @ . @ . @ . @ . @ @ . @ @ @ @ . . @ . @ . . @ @ . @ . @ @ @ . @ @ @ @ @ @ @ . @ . @ 
@ . @ . . @ . @ @ @ @ . @ . @ @ . @ . @ @ . . . @ @ . . @ . . @ @ @ . . . . @ . @ . @ . @ @ . @ . . . @ . @ . @ . @ . . . . . @ . . . . . . . . . @ . . . . @ . . . @ @ @ . . . @ . @ @ @ @ @ . . . . @ 
@ @ . . @ . . . . . . . @ . @ . @ @ . @ . . @ . . . @ . . @ . . @ . @ @ . @ . @ . . . . . . @ . @ . @ . . . . @ . @ @ . @ @ . . . @ . @ . @ . @ . . @ . @ . @ . @ @ . @ . @ . @ . . . @ @ @ @ @ . @ . @ 
@ @ . @ @ @ . @ . @ @ . @ . . . . . . . @ . . @ . @ @ . @ . . @ @ . . . . @ . . @ . @ @ . @ . . . . @ @ . @ @ @ . @ . . . . @ . @ . . . @ @ . . @ . @ . @ @ . . . . . . . . . . @ . @ . @ @ . @ . . @ @ 
@ . . @ @ @ @ . . @ . . . @ . @ . @ . @ @ @ . . @ @ @ . @ @ . . @ . @ @ . . . @ . . . . @ @ @ @ . @ . . . . . . . . @ . @ @ @ . . @ @ @ . @ . @ . . . @ @ @ @ . @ . @ . @ . @ . . . . . . . . @ . @ . @ 
@ @ . . @ @ . @ . @ @ . @ . @ . . . @ . . . . @ . @ @ @ . . . @ . . @ @ . @ . . @ . @ . . . . @ . @ . @ . @ @ @ . @ . . . . . @ . . . . . . @ . . @ @ @ @ @ @ . . @ . . . @ @ . @ @ . @ . @ @ @ @ . . @ 
@ . @ @ . . . . . . . @ . . . . @ . @ @ . @ . . . . @ @ @ @ @ . . @ . . . . @ . @ . @ . @ @ @ . . @ . @ @ . @ @ @ . @ . @ . @ . . @ . @ . @ @ @ . @ @ @ @ @ . @ @ @ . @ . . . @ . . . @ . . @ @ . @ . @ 
@ . . . . @ @ . @ . @ @ @ @ @ . @ . . . @ . @ @ . @ @ @ @ @ @ @ . . @ . @ @ . @ . . . @ . @ @ @ . @ @ . @ . . @ @ . . . @ . @ @ . . @ @ @ @ @ @ @ @ @ @ @ . . . . . . @ @ . @ . @ @ @ @ @ . . . . . . @ 
@ @ @ . @ . . . @ . @ @ @ @ @ @ . . @ . . . . . @ @ @ @ @ @ @ @ @ . @ . . . . @ . @ . . . . . @ . . . . . . @ . . . @ @ . . . . @ . . @ @ @ @ @ @ @ @ @ @ @ . @ . @ . . @ . . . . . . @ . . @ . @ . @ @ 
@ @ @ @ @ @ @ @ @ @ @ @ @ @ @ @ @ @ @ @ @ @ @ @ @ @ @ @ @ @ @ @ @ @ @ @ @ @ @ @ @ @ @ @ @ @ @ @ @ @ @ @ @ @ @ @ @ @ @ @ @ @ @ @ @ @ @ @ @ @ @ @ @ @ @ @ @ @ @ @ @ @ @ @ @ @ @ @ @ @ @ @ @ @ @ @ @ @ @ @ 
3
51 34 71 88
1 28 81 79
23 28 41 55
