12 12
@ @ @ @ @ @ @ @ @ @ @ @ 
@ @ . @ . @ . @ . @ . @ 
@ . . . . . . . . . . @ 
@ . @ . @ . @ . @ . @ @ 
@ . @ @ . . @ . @ . . @ 
@ @ . . . @ . . . @ . @ 
@ . . @ . @ @ . @ . @ @ 
@ @ @ . @ . . . . . @ @ 
@ . @ . . @ . @ . @ . @ 
@ . . @ . . . @ . . . @ 
@ @ . . . @ . @ . @ . @ 
@ @ @ @ @ @ @ @ @ @ @ @ 
3
3 3 7 5
2 1 1 2
2 6 10 8
