12 12
@ @ @ @ @ @ @ @ @ @ @ @ 
@ . @ . @ . @ . @ @ @ @ 
@ . . . . . . . . . @ @ 
@ . @ @ @ @ @ . @ . . @ 
@ . . . . @ . . @ . @ @ 
@ . @ . @ . @ @ @ @ . @ 
@ @ . . . . . . . . . @ 
@ @ @ . @ . @ @ @ . @ @ 
@ @ @ . . @ . . . . . @ 
@ @ @ @ @ . . @ @ . @ @ 
@ @ @ @ @ @ . @ . . . @ 
@ @ @ @ @ @ @ @ @ @ @ @ 
3
6 8 2 3
7 3 5 10
9 6 4 2
