12 12
@ @ @ @ @ @ @ @ @ @ @ @ 
@ @ @ . . . . . . . @ @ 
@ @ @ @ . @ . @ . @ . @ 
@ @ @ . . . @ @ @ . . @ 
@ @ . @ . @ . @ @ @ . @ 
@ . . . . . . . . . . @ 
@ @ . @ @ @ . @ . @ . @ 
@ . . @ @ @ @ @ . @ @ @ 
@ @ . @ . @ . @ @ . . @ 
@ . . . . . . . . . @ @ 
@ @ . @ . @ . @ . @ @ @ 
@ @ @ @ @ @ @ @ @ @ @ @ 
3
9 9 10 4
5 5 7 8
4 6 10 8
