50 50
@ @ @ @ @ @ @ @ @ @ @ @ @ @ @ @ @ @ @ @ @ @ @ @ @ @ @ @ @ @ @ @ @ @ @ @ @ @ @ @ @ @ @ @ @ @ @ @ @ @ 
@ . . . @ . @ @ @ @ @ @ @ . . . @ @ . . . . @ . . @ @ @ @ . @ . . . . . . . . . @ @ @ @ @ @ @ @ @ @ 
@ . @ . @ . . @ @ @ @ @ @ @ @ . @ @ @ . @ . @ @ . . . @ . . . @ . @ @ . @ . @ @ @ @ @ @ @ @ @ @ @ @ 
@ @ . . . . @ . @ @ @ @ @ @ . . @ @ . . @ . @ . . @ . . @ . @ . . @ . . . @ @ @ @ @ @ @ @ @ @ @ @ @ 
@ . . @ . @ . . . @ @ @ @ @ @ . . . @ @ . . . @ @ . . @ . . @ @ . . @ . @ @ @ @ @ @ @ @ @ @ @ @ @ @ 
@ @ @ . . . @ . @ @ @ . @ . @ . @ @ @ . @ @ . @ . @ . . . @ @ . . @ . @ @ @ @ @ @ @ @ @ @ @ @ @ @ @ 
@ . . @ @ . @ . . @ . . . . . . . . . . . . . . . . . @ . @ . @ . . . . @ @ . @ @ @ @ @ @ . @ @ @ @ 
@ @ . . . . . . @ . . @ . @ . @ @ . @ . @ @ . @ . @ . . @ . . . . @ @ . @ . . . @ @ . @ @ . @ @ @ @ 
@ @ @ @ @ . @ . . . @ . @ . . . @ @ @ @ . . . . @ . @ . . @ . @ @ . . @ . . @ . @ . . . . . . @ @ @ 
@ @ . . @ @ . @ . @ . . . @ . @ . . @ @ . @ . @ . . @ . @ @ . . @ @ . . @ @ . . @ . @ . @ . @ @ @ @ 
@ . @ . @ . . . @ @ . @ @ . @ . @ . . . . . @ . @ . . . . . @ . . . . @ . . @ . . @ @ @ . . @ @ @ @ 
@ . . . @ . @ . @ . . . @ . . . . @ . @ @ @ . . . @ @ . @ @ . . @ . @ . . @ . . @ . @ @ @ . @ @ @ @ 
@ . @ @ @ @ . . . @ . @ . @ @ . @ @ @ . @ . @ @ . @ . . @ . @ . @ @ @ @ . @ . @ . . . @ @ . . @ @ @ 
@ . @ . @ . . @ . . . . . @ . . @ @ @ . . . . @ . . @ . . . @ . . . @ . . . . . . @ . . @ . @ @ @ @ 
@ . . . . . @ @ . @ . @ . . @ . . @ . @ @ . @ . @ . @ . @ @ @ @ . @ . @ . @ @ @ @ . . @ . . . . @ @ 
@ @ . @ . @ . . @ . . . @ @ . . @ . . . . . . . . . . . . @ . . . . . . . . @ . @ @ . . . @ @ @ @ @ 
@ @ . @ . @ . @ @ @ . @ . . . @ . @ . @ . @ . @ . @ . @ . . . @ @ . @ . @ @ . . . . @ . @ @ . . @ @ 
@ . . . @ . . . @ . . @ . @ @ . . @ @ . . @ @ . @ @ @ @ . @ . . @ . . @ . @ @ . @ . . @ @ @ . @ @ @ 
@ . @ @ . @ . @ @ @ . . . @ . @ . @ . @ @ . . . . . . . . @ . @ @ @ @ @ . . @ . . @ . . @ . . . @ @ 
@ . @ . . . . . @ @ @ @ . . . . . . . . . . @ . @ . @ @ . @ . . @ . . @ . @ . @ . @ . @ . . @ @ . @ 
@ . . @ @ @ . @ . @ . . . @ . @ . @ @ . @ . . @ @ @ . @ @ . . @ @ . @ . . . . . . . @ . @ . @ @ . @ 
@ . @ @ @ . . . . . . @ . . @ @ @ . . . @ . @ @ @ . . . @ @ . @ @ . . . @ . @ . @ . . . . . . . . @ 
@ @ . . . . @ . @ . @ . . @ . . @ . @ @ . @ @ @ . @ @ . @ @ . @ @ . @ @ . @ . . . @ . @ @ . @ . @ @ 
@ @ @ . @ . . @ @ @ @ . @ . @ . @ . @ . . . @ . . . . . . . . . . . . . . . @ @ . . @ . . . . @ @ @ 
@ @ @ @ . . @ . @ @ . @ . . . . . @ . @ . @ . @ . @ . @ @ . @ . @ . @ . @ @ . . @ . . @ . @ . @ @ @ 
@ @ @ @ . @ . . @ . . . . @ . @ . @ . . . . . . . @ @ . . . @ . @ . . @ . @ . @ . @ @ . @ @ . . @ @ 
@ @ @ @ . . @ . . @ @ . @ . @ . . . @ . @ @ . @ @ . . . @ @ @ . . @ . . . . . . . @ . . @ . @ . . @ 
@ @ @ @ @ @ @ . @ . @ . . . . @ @ . . . . . @ @ @ . @ . @ . . . @ . . @ . @ @ @ . . . @ . . @ . @ @ 
@ @ @ @ @ . @ . @ . . . @ . @ @ . @ @ . @ @ @ . @ @ . . @ . @ . @ @ . . @ . . . @ . @ . @ . . @ @ @ 
@ @ @ . . . . . . . @ . @ @ . . . . @ . . @ . . . @ @ @ @ @ . . . . @ @ . @ . @ . . . . . . @ @ @ @ 
@ @ @ @ . @ . @ . @ . . @ . @ @ . @ @ @ . @ @ . @ . @ . @ . @ . @ @ . @ . @ . . @ @ @ @ @ . . @ @ @ 
@ @ @ @ @ . @ . . @ . @ . . @ . . . @ . . @ . . . . . . . . . . . . . . . . @ . . . . @ . @ @ @ @ @ 
@ @ @ @ . . . . @ . . . @ . @ @ . @ . . @ . . @ @ . @ . @ . @ . @ @ . @ . @ @ @ . @ . . . . @ @ @ @ 
@ @ @ . @ . @ . . @ . @ . . . . . . . @ . @ . . . @ . . @ @ . . . . @ @ @ . . . @ . . @ . @ @ @ @ @ 
@ @ . . . . @ . @ . . . @ . @ @ . @ . . . @ @ . @ @ @ @ . . . @ . @ . @ . @ . @ . @ . . @ @ @ @ @ @ 
@ @ @ . @ . @ @ @ @ . @ @ @ . . @ @ . @ . . . @ . @ . @ @ @ . @ . . . . . . . . . . . @ @ @ @ @ @ @ 
@ @ @ @ @ @ @ @ @ @ . . @ @ @ . . . . @ . @ . @ . . . . @ . . @ . @ @ @ . @ . @ . @ @ @ @ @ @ @ @ @ 
@ @ @ @ @ @ @ @ @ @ @ @ @ @ . . @ @ . . @ . @ . . @ @ @ . @ . @ . @ . @ @ . . . @ @ @ @ @ @ @ @ @ @ 
@ @ @ @ @ @ @ @ @ @ @ @ @ @ @ . @ . . @ @ . . . @ @ . . . . . . @ . . . @ @ @ . . @ @ @ @ @ @ @ @ @ 
@ @ @ @ @ @ @ @ @ @ @ @ @ @ @ @ @ @ . @ . @ . @ . . . @ . @ . @ . @ . @ . @ @ . @ . @ @ @ @ @ @ @ @ 
@ @ @ @ @ @ @ @ @ @ @ @ @ @ @ @ @ @ @ . . . . . . @ . . @ . . . . . . . . . @ . . . . @ @ @ @ @ @ @ 
@ @ @ @ @ @ @ @ @ @ @ @ @ @ @ @ @ @ @ @ @ . @ . @ . . @ . @ . @ @ . @ . @ @ . . @ . @ @ @ @ @ @ @ @ 
@ @ @ @ @ @ @ @ @ @ @ @ @ @ @ @ @ @ @ @ @ @ . . . @ @ . . . . . @ . . @ @ @ @ . . @ @ @ @ @ @ @ @ @ 
@ @ @ @ @ @ @ @ @ @ @ @ @ @ @ @ @ @ @ @ @ @ @ . @ @ @ @ @ . @ . @ @ @ @ @ @ @ @ @ @ @ @ @ @ @ @ @ @ 
@ @ @ @ @ @ @ @ @ @ @ @ @ @ @ @ @ @ @ @ @ @ @ @ @ @ @ @ @ @ @ @ @ @ @ @ @ @ @ @ @ @ @ @ @ @ @ @ @ @ 
@ @ @ @ @ @ @ @ @ @ @ @ @ @ @ @ @ @ @ @ @ @ @ @ @ @ @ @ @ @ @ @ @ @ @ @ @ @ @ @ @ @ @ @ @ @ @ @ @ @ 
@ @ @ @ @ @ @ @ @ @ @ @ @ @ @ @ @ @ @ @ @ @ @ @ @ @ @ @ @ @ @ @ @ @ @ @ @ @ @ @ @ @ @ @ @ @ @ @ @ @ 
@ @ @ @ @ @ @ @ @ @ @ @ @ @ @ @ @ @ @ @ @ @ @ @ @ @ @ @ @ @ @ @ @ @ @ @ @ @ @ @ @ @ @ @ @ @ @ @ @ @ 
@ @ @ @ @ @ @ @ @ @ @ @ @ @ @ @ @ @ @ @ @ @ @ @ @ @ @ @ @ @ @ @ @ @ @ @ @ @ @ @ @ @ @ @ @ @ @ @ @ @ 
@ @ @ @ @ @ @ @ @ @ @ @ @ @ @ @ @ @ @ @ @ @ @ @ @ @ @ @ @ @ @ @ @ @ @ @ @ @ @ @ @ @ @ @ @ @ @ @ @ @ 
3
32 19 40 22
5 3 23 19
32 7 18 39
