50 50
@ @ @ @ @ @ @ @ @ @ @ @ @ @ @ @ @ @ @ @ @ @ @ @ @ @ @ @ @ @ @ @ @ @ @ @ @ @ @ @ @ @ @ @ @ @ @ @ @ @ 
@ . @ @ . . @ . @ @ @ @ @ @ @ @ @ . . . . . . @ @ . @ . . @ . . @ . . @ . . @ . . @ . . @ . . @ @ @ 
@ . . . . @ . . . @ @ @ @ @ @ . . @ . @ . @ . @ . . . . @ . @ . @ . @ @ @ . . . @ . @ . @ . @ . @ @ 
@ @ . @ . . @ . @ . @ @ @ @ . @ . @ @ @ @ . . . @ . @ . . . . . . . @ @ . @ @ . . . . . . . . . . @ 
@ @ . @ . @ . . . . . @ . . . . . @ @ @ . @ . @ @ . . @ . @ . @ . @ . . . @ . . @ @ . @ . @ @ . @ @ 
@ . @ . . . @ . @ . @ @ @ . @ @ . . @ . . . . . @ . @ . @ @ . . @ . @ @ . . @ . @ . . . @ . . . . @ 
@ . . @ @ . . . @ . @ . @ @ . . . @ @ @ . @ . @ . . . . @ . . @ . . . @ @ . . . . @ @ @ . @ @ . @ @ 
@ @ . . . @ @ . . @ . . . @ @ @ . . @ @ @ . . @ . @ . @ . @ @ . . @ @ . @ . @ . @ . @ . . @ @ @ @ @ 
@ @ @ @ . . . . @ @ @ . @ . @ . @ . @ @ . @ . @ . . @ @ . . @ @ . . @ . . @ . . @ . . . @ . @ . @ @ 
@ . @ . @ . @ . . @ . . @ . . . . . . . . . . @ . @ @ . . @ . . . @ . . @ . @ . . @ @ . . . . . . @ 
@ . . . . @ . . @ . @ . @ @ . @ . @ . @ . @ . . . . . . @ . @ . @ . @ . . . . . @ @ . . @ @ . @ . @ 
@ @ @ . @ . @ . . . . . . @ . @ @ . . @ @ . @ . @ @ @ . . . . . . . . . @ @ . @ . . @ . . . @ @ . @ 
@ . @ . @ . @ . @ @ . @ @ . @ . @ @ @ . . . . . . . @ . @ . @ . @ . @ . . @ @ @ @ . . . @ @ . @ @ @ 
@ . . . . . . . . @ @ @ . . . . . @ . . @ @ . @ . @ . @ @ . . @ . @ . . @ . . @ . . @ @ . @ . . @ @ 
@ . @ . @ @ . @ @ @ . . @ . @ @ @ . @ . . . @ . @ . . . @ . @ @ . . @ . @ . @ . @ . @ @ . @ . @ . @ 
@ . @ . . . @ @ . . @ . . . . . . . . . @ . @ . @ @ . @ @ @ . . . @ . @ . . @ . . . . . . . . . . @ 
@ . . @ @ . . @ @ . . @ @ . @ . @ . @ @ . . . . . . . . @ @ @ @ . . . @ . @ . . @ . @ @ @ . @ @ . @ 
@ . @ @ @ . @ @ . @ . @ . . . @ . . @ @ @ . @ . @ . @ . @ @ @ @ . @ @ . . . . @ @ . . . . @ . . @ @ 
@ . @ @ . . . . . . . . @ @ . . @ . @ @ @ @ . . . @ . . @ @ @ . . . . @ . @ . . . @ @ @ . @ @ . . @ 
@ @ . @ @ . @ . @ @ @ . . . @ . . @ @ @ @ @ @ . @ @ @ @ . @ @ . @ . @ . . . @ . @ . . @ @ . . . @ @ 
@ @ . . . @ . . . @ . @ @ . . . @ . @ . @ @ @ . . @ @ @ . . @ @ @ . . @ . @ . @ @ . @ . @ @ @ . . @ 
@ . @ . @ . . @ @ @ . . @ . @ . . . . . @ . . . @ @ @ @ . @ @ @ . @ . @ . . . @ . . . . . @ . . @ @ 
@ . . . @ @ @ @ . . @ . . @ . . @ @ . @ . . @ @ . @ @ . . . . @ . . . @ . @ . . . @ . @ @ . @ . . @ 
@ @ @ . @ . . . @ . @ . @ . @ . . . @ @ @ . @ @ . . . @ . @ @ . @ @ . . . . @ . @ . . . @ . . . @ @ 
@ @ . . . @ @ . . . . . . . . @ . @ @ @ . @ . . . @ @ . . . . . @ . @ . @ @ . @ @ @ @ @ . . @ @ @ @ 
@ . @ . @ @ . @ . @ . @ . @ . @ . . @ . . . @ @ . @ @ . @ . @ @ . . . . . . . . . . @ . @ . . . @ @ 
@ . . . . . . . . @ . @ @ . . . . @ . @ . @ . @ . @ @ . @ . @ @ @ . @ @ @ . @ . @ . . . . . @ @ . @ 
@ . @ . @ . @ . @ . . . . @ . @ . . . . . . . . . . . . . @ . . . . . . @ . . @ . . @ . @ . . . . @ 
@ @ . . @ @ . . . @ . @ . . @ . . @ . @ . @ . @ . @ . @ . @ . @ . @ . @ @ . @ . @ @ @ . @ . @ . @ @ 
@ @ @ @ @ @ @ . @ . . @ . @ @ @ @ . @ . . @ @ . @ . @ . . . . @ . @ @ . @ . . . . . . @ . . . @ @ @ 
@ @ @ . @ @ @ . . @ . @ @ . . @ . . . @ . . . . . . @ @ . @ . @ @ @ . . @ @ . @ @ @ . . @ @ . @ . @ 
@ @ . . . . @ . @ . @ . . . @ . . @ . . . @ . @ . @ . . . . @ . . . . @ @ . . . . . @ . @ . . @ . @ 
@ @ @ . @ @ . . . . . @ . @ . . @ . @ . @ . . . @ . . @ . @ @ . @ @ . . . @ . @ . @ . @ @ @ . . . @ 
@ @ . . . @ @ . @ . @ . . . @ . @ . . . . @ . @ . @ . . @ @ @ @ . . . @ @ @ . @ . . . . @ @ . @ . @ 
@ @ @ . @ . . @ . . @ @ . @ . @ . . @ . @ . . . . . @ . @ @ @ @ @ @ . . @ . @ . @ . @ . . . @ . . @ 
@ @ . . . . @ @ @ . . . . . . . @ @ . . @ . @ . @ @ @ @ . @ @ @ @ . @ . . . . . . @ . . @ @ @ @ @ @ 
@ . . @ . @ @ . . . @ . @ . @ . . @ @ . @ . @ . @ . . . . . . . . . . . @ . @ @ . . @ . . . . . @ @ 
@ @ . . @ @ @ @ . @ . . . @ @ @ @ @ . . @ . @ . . . @ @ @ @ @ @ @ @ @ @ @ @ . @ . @ . . @ @ . @ @ @ 
@ . @ . . @ @ @ . @ @ . @ @ @ . . . @ . @ . @ . @ . . . . . . . . . . . . . . . @ @ @ . . . @ . @ @ 
@ . . . @ @ . . . @ . . @ . . @ @ . . @ . . . @ . . @ . @ @ . @ . @ . @ . @ . @ . @ . . @ @ . . . @ 
@ @ @ . . . . @ . . @ . @ @ . @ . @ . @ @ . @ . @ . . @ @ . . . @ . . . @ . . . . . @ . . . . @ . @ 
@ . . . @ . @ . . @ . @ . . . . . . . . . . . . @ @ @ . @ @ . @ @ @ . @ @ @ . @ . @ . . @ . @ . . @ 
@ @ @ . . @ . . @ . . @ @ . @ @ @ . @ @ . @ @ @ @ @ . . . . . @ @ . . @ . . . . @ . @ . . @ @ . @ @ 
@ @ @ . @ . @ . . @ . . . . @ @ @ @ . @ . . . . @ . @ @ . @ . . . @ @ . . @ . @ . . . . @ @ @ @ . @ 
@ @ . @ . . . . @ . @ @ . @ . . . . . . . @ . @ . . . @ . @ @ . @ @ @ @ . . @ @ . @ . @ . @ . . . @ 
@ @ . @ . @ @ . . . @ . . @ . @ . @ . @ . @ . . . @ . @ . . . @ @ @ @ . . @ @ @ @ @ . . . . . @ @ @ 
@ . . . . @ . . @ @ . . @ . . . @ . . . @ . . @ . @ . @ . @ @ @ @ @ @ @ @ @ @ @ @ @ . @ . @ . . . @ 
@ @ . @ . @ . @ @ @ . @ . . @ @ @ @ . @ . @ . . @ . @ @ . . . . @ @ @ @ @ @ @ @ @ @ . . @ . . @ . @ 
@ . . . @ . . . @ . . @ . @ @ @ @ . . . . . @ . . . @ . . @ @ . @ @ @ @ @ @ @ @ @ @ . @ @ . @ . . @ 
@ @ @ @ @ @ @ @ @ @ @ @ @ @ @ @ @ @ @ @ @ @ @ @ @ @ @ @ @ @ @ @ @ @ @ @ @ @ @ @ @ @ @ @ @ @ @ @ @ @ 
3
16 23 27 11
36 30 29 38
5 31 37 43
