20 20
@ @ @ @ @ @ @ @ @ @ @ @ @ @ @ @ @ @ @ @ 
@ . . @ . @ . . . @ . @ . . . @ @ @ @ @ 
@ @ . . . . @ @ . @ . . @ . @ . @ @ @ @ 
@ @ @ . @ . . . . . @ . . . . . . @ . @ 
@ @ @ @ . . @ . @ . @ @ . @ . @ . . . @ 
@ @ @ @ @ . . @ @ . . @ . . @ . . @ . @ 
@ @ @ @ . . @ . . @ . @ . @ . @ . @ @ @ 
@ . @ @ . @ . . @ . . . . . . . @ @ @ @ 
@ . @ . @ . @ . . @ @ . @ @ . @ @ @ @ @ 
@ . . . . . . . @ @ . . . . @ @ @ @ @ @ 
@ @ @ @ @ @ @ . @ . @ . @ @ @ . . @ @ @ 
@ . . . . @ . . . . . . . . @ . @ . @ @ 
@ @ . @ . . . @ @ . @ . @ . . . . . . @ 
@ . . . @ @ . @ . @ . . . @ . @ . @ @ @ 
@ @ . @ . . @ . . . @ . @ . . . @ @ @ @ 
@ . . . @ . . @ . @ @ @ . @ . @ @ @ @ @ 
@ . @ . @ . @ . . . . . . . . @ @ @ @ @ 
@ . @ . . . @ @ . @ . @ . @ . . @ @ @ @ 
@ . @ . @ . @ @ . @ . . @ . . @ @ @ @ @ 
@ @ @ @ @ @ @ @ @ @ @ @ @ @ @ @ @ @ @ @ 
3
12 11 7 15
11 8 7 14
2 2 2 3
