50 50
@ @ @ @ @ @ @ @ @ @ @ @ @ @ @ @ @ @ @ @ @ @ @ @ @ @ @ @ @ @ @ @ @ @ @ @ @ @ @ @ @ @ @ @ @ @ @ @ @ @ 
@ @ @ . @ @ @ @ @ @ . . @ . @ . . . . @ . @ @ . . . @ . @ @ @ . @ . @ @ @ . @ . @ @ @ @ @ @ @ @ @ @ 
@ . . . . @ @ . @ . @ . . . . @ . @ . . . . @ . @ . . . . @ . . @ . . @ . . . . @ . @ @ @ @ @ @ @ @ 
@ @ . @ . . . . . . . @ @ . @ @ @ @ . @ . @ . @ . @ . @ . . @ . @ . @ . @ . @ @ . . . @ . @ @ @ @ @ 
@ . @ . . @ . @ . @ . . . . . . . @ . . @ . . . . . @ . . @ . . @ . . . @ . @ . . @ @ . . . @ @ @ @ 
@ . @ . @ . . . @ . . @ . @ . @ . . . @ . . @ @ . @ . @ . . . @ @ . @ . @ . @ @ . . @ . @ @ @ @ @ @ 
@ . . . . @ . @ @ @ . @ . @ @ . . @ @ . @ @ . @ . . . @ . @ . @ . . . @ @ . @ . . @ @ . . @ @ @ @ @ 
@ . @ . @ @ @ @ @ . @ . @ @ @ @ . @ . . . . . . . @ . @ . . @ . . @ . @ @ . . . @ . @ . @ @ @ @ @ @ 
@ . @ . @ @ . . . . . . . @ @ . . . . @ . @ @ . @ . . . . @ . @ @ @ . . . @ @ . @ . . . . @ @ @ @ @ 
@ . @ @ @ . . @ @ @ . @ . @ @ . @ @ . . @ . . @ . @ @ @ . . . . @ . . @ . . . . . . @ @ . @ @ @ @ @ 
@ . . . . @ @ . @ . @ . . . . . . . @ @ @ @ . @ . . . . . @ . @ . @ . @ @ . @ . @ . @ @ @ @ @ @ @ @ 
@ . @ . @ @ @ . . . . . @ . @ . @ . . . @ . . @ @ @ . @ . . @ . . . . . @ . . @ @ @ @ @ @ @ @ @ @ @ 
@ @ @ @ @ @ @ @ . @ @ . @ . @ @ @ @ . @ @ @ . . . @ @ @ . @ . @ . @ @ @ . @ . . @ @ @ @ @ @ @ @ @ @ 
@ @ @ @ @ @ @ @ @ . . @ . . . . . @ @ @ @ . . @ . @ . . . . . @ . . . . . . @ @ @ @ @ @ @ @ @ @ @ @ 
@ @ @ @ @ @ @ @ . @ . . @ . @ . @ . . @ . . @ . @ . @ @ @ @ . . . @ . @ . @ @ @ @ @ @ @ @ @ @ @ @ @ 
@ @ @ @ @ @ @ . . . @ . . . . @ @ . @ @ @ . . . . . @ . . . . @ @ @ . . @ @ @ @ @ @ @ @ @ @ @ @ @ @ 
@ @ @ @ @ @ . @ . @ @ @ . @ @ . . . . . . . @ . @ @ @ @ . @ . . . . @ . @ @ @ . @ @ @ @ @ @ @ @ @ @ 
@ @ @ @ @ . . . . @ @ @ . @ @ @ . @ . @ @ . . @ @ @ . . . . @ @ . @ @ @ . @ . . . @ @ @ @ @ @ @ @ @ 
@ @ @ @ . @ . @ . . @ @ @ @ @ @ @ . . @ . . @ . @ . . @ . @ @ . @ . . . . . @ . @ @ . . @ @ @ @ @ @ 
@ . @ . . @ @ . . @ . @ @ @ @ @ @ @ . @ @ . . . . @ . . @ @ @ . @ . @ . @ . @ . @ @ . @ . @ @ @ @ @ 
@ . @ @ . @ . @ . . . @ @ @ @ @ @ @ . @ . . @ @ @ @ . @ . @ @ . . @ @ @ @ . . . . @ . . . @ @ @ @ @ 
@ . . . . . . . . @ . @ @ @ @ . . . . . @ . . . @ . . . . . . . @ . @ . . @ . @ @ . . @ . @ @ @ @ @ 
@ @ . @ . @ . @ . @ @ @ @ @ @ . @ @ @ @ . . @ @ . @ . @ . @ . @ . . . . @ @ . . . . @ . @ @ @ @ @ @ 
@ . @ . . . @ . . . @ @ @ @ . @ . . . . @ . . . . @ . . @ @ @ . . @ @ @ @ @ . @ @ @ . . @ @ @ @ @ @ 
@ . . @ . @ . @ . @ . @ . @ . @ . @ @ . . . @ @ @ @ . @ . @ @ @ . . . @ . @ . @ . @ . @ . @ @ @ @ @ 
@ @ . @ @ . . . . . . @ . . . . . . @ . @ . @ . . . . . . . . . . @ . . . . . . . . . . . . . @ @ @ 
@ . . @ @ @ . @ . @ . . @ @ @ @ . @ . @ @ @ @ @ . @ . @ . @ @ . @ . @ @ @ . @ @ . @ @ . @ . @ @ @ @ 
@ @ . @ @ @ @ . . @ . @ . . . @ . . . . @ @ @ . . . @ @ @ @ . . . . . . . @ @ @ . @ @ . . @ @ @ @ @ 
@ . . . . @ . . @ @ . . . @ . . . @ . @ . @ . @ . @ . @ . @ @ . @ . @ . @ . @ . @ @ @ . @ @ @ @ @ @ 
@ @ . @ . @ . @ @ @ @ @ . @ @ . @ . . . . . . . . . . . . . @ . . @ . . . . . . . @ . @ . @ @ @ @ @ 
@ . @ . . . . . @ @ @ @ @ . . . @ @ . @ @ . @ . @ @ . @ . @ . . @ . @ @ . @ . @ . . . . . . @ @ @ @ 
@ . . . @ @ . @ @ @ @ @ @ @ @ @ . . . . @ @ @ . . . @ @ . @ @ . . . . . @ . @ . @ @ . @ . @ @ @ @ @ 
@ . @ . @ @ . @ @ @ . @ @ @ . . . @ . @ . @ @ . @ . . . @ . . @ @ . @ . . . @ . @ @ . . @ @ @ @ @ @ 
@ . . @ . . . @ @ . . . @ . . @ . @ . . . . . @ @ . @ @ . @ . . . . @ . @ . . . . . @ @ @ @ @ @ @ @ 
@ . @ . @ . @ . @ @ . @ . @ . @ @ . . @ . @ @ . . . . . . . @ . @ . . @ . . @ @ . @ @ . @ @ @ . @ @ 
@ . . . @ @ . . . . . . . . . . . @ . . @ @ @ @ . @ . @ . @ . @ . . @ . @ @ . . . @ . . . @ . . . @ 
@ . @ . . @ @ @ . @ . @ . @ . @ @ . . @ @ @ @ @ @ . . . @ . . . @ . . . . @ @ . @ . @ . @ . @ . @ @ 
@ . . @ . . . . @ . . . @ . . @ . @ . @ @ @ @ @ @ @ . @ @ @ @ . . . @ . @ @ . . . . . . . . . . . @ 
@ . @ @ . @ . @ @ @ . @ @ @ @ . . . . . @ . @ @ @ @ @ @ @ . . . @ . @ @ . @ @ . @ . @ @ . @ . @ . @ 
@ . . . @ @ . @ . . . @ . . . . @ @ . @ . . @ @ . @ . @ . @ . @ . . . . . @ @ @ . . . @ . . @ @ . @ 
@ . @ @ @ @ @ @ . @ @ . . @ @ . . . @ . @ . @ . . . . . . . @ . @ . @ . @ @ @ @ . @ @ @ @ . . . @ @ 
@ . @ . @ . @ . @ . . @ . . @ . @ . . . . . . @ @ . @ . @ . @ . . . . @ @ @ @ @ @ @ @ @ @ . @ @ @ @ 
@ @ . . . . . . . @ . . @ . . @ . . @ @ . @ . @ @ @ @ @ . . . . @ . @ @ . @ @ @ @ @ @ @ @ @ . . @ @ 
@ . @ . @ . @ . @ . . @ @ . @ . . @ @ . . . @ @ @ . @ . @ . @ @ @ . . @ . @ @ @ @ @ . . @ . . @ . @ 
@ . . . . @ . . @ . @ . . . . @ . . . @ . @ . @ . . . . . . @ @ @ @ . . . . . @ @ @ @ . . @ . . . @ 
@ . @ . @ . @ . . . . . @ . @ @ . @ . @ . . . . @ . @ . @ @ @ @ . @ . @ @ . @ . @ . @ . @ . @ . @ @ 
@ @ . . @ . @ @ . @ . @ . . @ . . . @ @ @ @ . @ . . . @ @ . . . . . . @ @ . . . . . . . . . . . . @ 
@ @ @ . . . . @ @ . . . @ . . @ . @ . @ . @ @ @ @ . @ @ . . @ @ . @ . . . @ . @ @ . @ . @ @ @ . @ @ 
@ @ . . @ . @ @ @ @ . @ . . @ . . . . . . . . @ @ @ @ @ . @ . . . . @ . @ . . @ @ . . @ . . . . . @ 
@ @ @ @ @ @ @ @ @ @ @ @ @ @ @ @ @ @ @ @ @ @ @ @ @ @ @ @ @ @ @ @ @ @ @ @ @ @ @ @ @ @ @ @ @ @ @ @ @ @ 
3
23 31 45 22
40 40 5 9
11 9 33 13
