100 100
@ @ @ @ @ @ @ @ @ @ @ @ @ @ @ @ @ @ @ @ @ @ @ @ @ @ @ @ @ @ @ @ @ @ @ @ @ @ @ @ @ @ @ @ @ @ @ @ @ @ @ @ @ @ @ @ @ @ @ @ @ @ @ @ @ @ @ @ @ @ @ @ @ @ @ @ @ @ @ @ @ @ @ @ @ @ @ @ @ @ @ @ @ @ @ @ @ @ @ @ 
@ . . @ . @ @ @ . @ @ . @ . @ @ . . . . @ . . @ . . @ @ . @ . . @ . . . @ . . . @ @ @ . @ @ @ . . @ . @ . @ . . @ @ @ @ @ @ @ @ @ @ @ @ @ @ @ . @ . . @ . . . @ . @ @ @ @ @ @ @ . . @ . . @ @ @ @ @ @ @ 
@ @ . @ . . @ . . . . . . . @ . @ @ @ . . . @ . . @ . . . . @ . . @ @ . . @ . @ . @ . . @ @ @ @ . . . @ . @ @ . @ . @ @ @ @ @ @ @ @ @ @ . @ @ . . . @ . @ @ . . . . . @ @ @ @ @ . @ @ . @ @ @ @ @ @ @ @ 
@ . . @ . @ . @ @ . @ . @ . . . . . . . @ . . @ . . @ @ @ . @ @ . @ @ @ . . . . . . @ . @ @ @ . . @ . . . . . . @ . @ @ @ @ . @ @ @ @ @ . @ @ @ @ . @ . . . . @ . @ . . @ . . . . . . . . @ @ @ @ @ @ @ 
@ @ . . . . . . . . @ . . @ . @ @ . @ . @ @ . . @ . @ . @ . . @ . . @ . @ @ . @ . @ @ . . @ . . @ . @ . @ @ @ @ . . @ . @ . . . @ @ . . . . @ . @ . @ . @ @ . . @ . @ . . @ . @ . @ @ . @ @ @ @ @ @ @ @ 
@ @ @ . @ . @ @ . @ . . @ @ @ @ @ @ @ @ . . @ . . . . . @ . @ . @ . . . . @ . . @ @ . . @ @ @ . . . . @ . @ . @ @ . @ . @ @ . @ . . @ @ . @ . . . . . . @ . @ @ . . . @ @ . . . @ @ @ @ . @ @ @ @ @ @ @ 
@ . . . . @ @ @ @ . @ . . @ . @ . @ @ @ . @ . . @ . @ . . . . . . @ @ @ . @ . @ @ @ @ . . @ . . @ . @ . . . . @ . . . . . . . . . @ @ @ . . . @ . @ @ . . . . . . @ @ @ . @ @ . . @ @ . . . @ @ @ @ @ @ 
@ . @ . @ @ @ @ @ . . @ @ . . . . @ @ . . @ @ . . @ @ @ . @ . @ . . . . . . . . @ . . . @ . @ . . @ @ . @ @ . @ . @ @ . @ . @ @ . @ @ . . @ . . @ . @ @ . @ @ . @ . @ . . @ . . @ . . @ . @ @ @ @ @ @ @ 
@ @ . . @ @ @ @ . @ . @ . @ . @ . @ . @ . . @ . @ @ @ @ @ @ @ @ . @ . @ . @ . @ . @ @ . . . . . @ . . . . @ @ @ . @ . @ @ . . . @ @ @ @ . @ @ . . . . . @ @ @ . @ . . @ . . @ . . . @ . . . @ @ @ @ @ @ 
@ @ @ . . @ @ @ . . . . . . . @ . . . . @ . . . . @ @ @ @ @ . . . @ @ . . @ . . . . . @ @ . @ . . . @ . @ @ @ . . . . . @ @ @ . . . . . . . . @ @ . @ . . . @ @ . . @ . . @ . . @ @ . @ . @ . @ @ @ @ @ 
@ @ . . @ . @ . @ . @ @ . @ @ . . @ @ @ . . @ . @ . @ @ @ @ @ . @ . . . @ . . @ @ . @ @ @ @ . . @ . . @ . @ @ @ . @ . @ . . . @ . @ . @ . @ . . @ . . @ @ @ . @ . @ @ @ . . @ . . . . @ . . . . @ @ . @ 
@ . @ . . . . . . @ . . . . . @ . . . @ @ @ . @ . . . @ @ @ . . @ @ . @ . @ . @ . @ @ @ @ @ . @ . @ @ . . . @ . . . @ @ @ . @ . @ . @ . . @ . @ . . @ @ . . . . . . @ . @ . . . @ . @ @ . @ @ . . @ . @ 
@ . . . @ . @ . @ . . @ . @ @ . . @ . @ . @ . . @ @ . . @ @ @ . @ @ @ . . . . . . . @ @ @ . . . . . @ . @ @ @ @ . @ . @ . . . . . . . @ @ @ @ @ @ . . @ . @ . @ @ @ . . @ . @ . . @ . . . . @ @ @ . . @ 
@ . @ . . @ @ @ @ . @ @ @ @ @ @ . @ @ . . . @ . . . . @ @ @ @ @ @ @ @ . @ . @ . @ . . @ . . @ . @ . . . . @ @ . . . . . @ . @ . @ . @ . . @ . . . . @ @ @ @ . . . . @ . . @ . . @ . . @ . @ . . . . @ @ 
@ @ . . @ @ @ . @ . @ @ . @ @ . . . . @ @ . . @ . @ . . @ @ @ @ . @ @ @ . . @ @ . . @ @ @ . . @ . @ . @ . . . @ . @ @ . @ . . @ @ @ @ . @ @ @ . @ . . @ . @ @ @ @ . . . @ . @ . @ . @ @ @ . @ . @ . @ @ 
@ @ @ . . . @ . @ . @ . . . @ . @ @ @ . . @ . @ @ @ . @ . . @ . . . @ . @ . @ @ @ . @ @ . . @ . . @ @ @ @ . @ . . . @ . @ . @ . @ . @ . . @ . @ . . @ . . @ . . . . @ . @ . . . @ . . @ @ . . @ @ . . @ 
@ . . . @ @ . . . @ . @ . @ . . . . . @ . . . . @ @ . . . @ . @ . @ . . . . . @ @ . @ . @ . @ @ . @ . @ @ @ . @ . @ . . @ . . . @ . . @ . . . . @ . . @ . @ @ @ . @ @ . . . @ @ @ . @ . . . @ . . . @ @ 
@ @ . @ @ . @ . @ . . . . . . @ . @ . @ . @ . @ . @ . @ @ . . . . . . @ @ . @ @ @ . . . . . @ . . . . . @ . . . . @ . @ @ . @ . @ . @ . @ . @ . . . @ @ . @ . . . @ . . @ @ . . . . . @ @ . . @ . @ @ @ 
@ @ @ @ . . . . . . @ . @ @ . . @ . . @ @ . . . . . . . . . @ . @ . @ . . . @ . . . @ . @ @ . @ @ @ . @ . @ . @ . @ @ @ . . . @ . . . . . @ @ @ . @ . . . . . @ @ . @ . . @ @ . @ . @ @ @ . @ @ . . . @ 
@ @ . @ @ @ . @ . @ @ @ @ . . @ . @ @ @ @ @ . @ . @ . @ @ . . @ @ @ @ @ . @ @ @ @ . @ . . @ . . . . . . . . @ . . . . . @ . @ . @ . @ @ @ . @ . . @ . @ . @ . @ . . . . @ @ @ @ . . . @ . . . . . @ . @ 
@ . . . @ . . @ . . @ @ . @ . . . @ @ @ @ . @ . . . @ . . . @ @ @ @ . @ . . @ @ @ @ . . @ . . @ . @ @ . @ @ . @ . @ @ . . . @ . . . @ . . . @ @ . . @ . . . @ . @ . @ @ @ @ @ @ @ . @ @ @ @ . @ @ . @ @ 
@ @ . @ . @ . @ @ . @ . . . . @ @ . @ . @ . @ @ . @ @ @ . @ @ @ @ . . . @ @ @ @ . @ . @ . . @ . . @ . @ . @ . . . . @ . @ . @ @ @ . . @ . @ . @ . @ . @ . @ . . . . . @ . @ @ @ @ . . @ . @ . . @ . . @ 
@ . . . . @ . . . @ @ @ . @ . . . . . . . . @ @ . @ @ @ @ . @ @ . @ . @ @ @ @ @ . . . . . @ @ @ @ . . . . . . @ @ @ . @ . @ @ . . . @ . . . . @ @ . . . . . @ . @ . @ . . . @ . . @ . @ . @ . @ . . @ @ 
@ @ @ @ . . @ @ @ @ . @ @ . . @ . @ @ . @ . . @ . @ @ @ . . . . . . . . @ @ @ @ @ @ . @ @ . @ @ . . @ . @ @ . @ . @ . . . . . @ @ . @ . @ . @ @ @ @ @ . @ . . @ @ . . . @ @ . @ . . . @ . @ . . . @ . @ 
@ @ @ . . @ @ @ @ . . . @ @ . @ . . @ . . @ . @ . . @ . @ @ @ @ . @ . @ . @ @ @ . . . . @ . . @ @ @ . . . . @ . . . . @ . @ @ . . . . . . @ @ @ @ . . . @ . @ . . . @ @ . . . . @ @ . @ . . . @ @ . . @ 
@ @ . @ . @ @ @ . @ . @ . . . . @ . . @ . . @ . @ @ . . @ @ . @ @ . . . . . @ @ . @ . @ @ . @ . @ . @ . @ . . @ . @ @ . @ @ @ . @ . @ . @ @ @ . @ . @ @ . . . @ @ . . @ @ @ @ . . @ . . @ . @ . . @ . @ 
@ . . . . . . . . . . . . @ . @ . . @ @ @ . . . @ . @ . . @ . @ . . @ @ @ @ @ @ @ . . @ . . . . . . . . . @ @ @ . . @ . . @ . @ . . @ @ @ @ . . @ . . @ @ @ . @ . . @ . @ . @ . @ @ . @ . . . . @ @ . @ 
@ @ . @ . @ @ . @ . @ . @ . @ @ . @ @ @ @ @ . @ . . . . @ . . @ @ . @ @ . . @ @ . @ . . @ . @ @ . @ . @ . @ . @ . @ . . @ . . . @ . . @ @ . . @ . @ @ . . . @ . @ . . . . . . . @ @ . @ @ . @ . @ . . @ 
@ . . @ . @ . @ . . . @ . . @ . @ @ @ @ @ . @ . @ . @ . . . @ @ @ . . . @ . @ . . . . @ . . . @ . . @ @ @ . . . . . . @ . . @ . @ . @ . @ @ . @ . . . . @ . . . . @ . @ @ @ @ . @ . . @ @ . @ . . @ . @ 
@ . @ . . @ . . @ . @ @ @ . . . . @ . . @ . . . . @ . . @ @ @ @ . @ . @ . . . @ . @ @ . . @ @ . @ @ . @ . @ . @ . @ @ . . @ @ @ . . . . . . . . . @ @ . @ . @ @ . . . . . @ . @ @ @ . @ @ @ . . @ . . @ 
@ . . @ @ @ @ . . . . . . . @ . @ . @ . @ . @ . @ . . @ @ @ @ . . . . @ . @ . . . . @ . @ . . . . @ . . . . . . @ . @ . @ @ @ . . @ @ . @ @ @ @ @ @ @ @ . @ . . . @ . @ . . . . @ . . . . @ @ . . @ . @ 
@ @ @ @ @ . . @ . @ @ . @ . @ @ . . . . . . . @ . @ . . @ . . @ . @ . . @ . @ @ . @ . . . . @ . @ . @ @ . @ . @ . . . . . . . @ . @ @ . . . @ . . @ @ . . . @ . @ . . . @ . @ @ . @ . @ . . . @ . . . @ 
@ @ . @ . @ . @ @ . @ . @ @ . . @ @ . @ @ . @ . . @ . @ @ @ . . @ . . @ . . . . . . . @ . @ . @ . . . . @ . . . . @ . @ . @ @ . . . @ . @ . @ . @ . @ @ . @ . @ @ @ @ . . @ . . . . @ . @ @ . @ . @ @ @ 
@ . . . . . . . . . @ . @ . @ . @ . @ @ . . . @ . . . . @ @ . @ . @ . @ @ . @ @ . @ @ . @ @ . . . @ . @ . @ . @ @ . @ @ @ @ . @ . @ . @ @ @ . . . . . @ . . . @ @ @ . . @ @ . @ . @ . . @ . . @ . . @ @ 
@ . @ @ . @ . @ @ . . . . . . . . . . @ @ . @ . @ @ @ . @ . . @ . @ . @ @ @ . . . @ . . . . . @ @ . @ @ . . . . . . . @ . . . . . . . . . @ @ . @ . @ . . @ @ . . . @ . . @ @ @ . . @ . . @ . @ . @ @ @ 
@ @ . . . @ . . @ . @ . @ . @ @ . @ . . @ . . . . @ . . . @ . . . . . . @ . @ . @ . @ . @ @ @ . . . . . . @ @ @ @ . @ @ @ . @ @ . @ . @ . . . . . @ . @ . . . . @ @ @ @ . . @ . @ . @ @ . . . . . . . @ 
@ @ @ . @ . . @ @ . . @ . @ @ . . @ @ . @ @ . @ . @ . @ . @ @ @ @ @ . @ . . . . @ . @ . . . . . @ @ . @ . . . . @ @ @ @ @ . @ . . . @ @ @ @ . @ @ . . @ . @ . @ @ @ . . @ @ . . @ . @ . @ @ @ . @ . @ @ 
@ @ @ @ . . @ @ @ @ @ @ . . . @ . @ . @ . . @ . . . @ @ . @ @ . . . . . @ @ @ . . . . . @ . @ . . @ @ . . @ @ @ . . @ @ @ . . @ . @ @ . . . @ . @ @ . . . @ . . . @ . @ @ @ . @ . . . . . . . . . @ @ @ 
@ @ . . . @ @ . @ @ . . @ . @ . . . . . . @ . @ . @ @ . . . . @ @ . @ . . @ . . @ . @ . @ . . @ @ . . @ . @ . . @ . @ @ @ @ @ . . . @ . @ @ @ . . . . @ . . @ . @ @ . . @ . . . @ @ . @ . @ @ @ . @ @ @ 
@ @ . @ . @ . . @ . . @ . . @ @ . @ @ @ . . . . . . @ @ . @ . . @ . @ . @ . . @ . @ @ @ . . @ @ . . @ . @ @ . @ . . @ @ @ @ @ @ . @ . . . . @ @ @ . @ . . @ . @ . @ . @ @ @ . @ . . . @ . . @ . . . . @ 
@ @ . @ . . @ . . @ . @ @ . . . @ @ @ @ . @ . @ . @ @ @ @ @ @ . . @ . . . @ . . . . @ . @ . . @ @ . . . . . . . @ . . @ @ @ @ . . . @ . @ . @ @ @ @ . @ . . . . . . . . @ . . . @ @ . . @ @ . @ . @ . @ 
@ . @ . @ @ . . @ . . @ . . @ . @ @ @ . @ . @ @ . . . . . . . . @ . . @ @ . . @ . @ @ . @ . @ . . @ . @ . @ . @ . . @ . @ @ . @ . @ . @ . . . @ . . . . @ @ @ . @ . @ @ . @ @ . @ . . @ @ . . . . . @ @ 
@ . . . @ . . @ . @ . @ . @ . . @ @ @ . . . @ . @ @ . @ @ @ @ . @ @ . . . @ . . @ @ @ . . . @ . @ . . @ @ . . @ . @ . . @ . . . . . . . . @ @ . @ @ @ . . . @ @ . . . @ . . . . @ @ @ @ @ @ @ . @ . . @ 
@ @ . @ . . @ @ . @ . . @ . @ . . @ . @ @ . @ . @ . @ @ . @ @ . . @ @ @ . @ . @ . @ @ @ . @ . . . @ @ . . . @ . . . . @ @ @ . @ . @ . @ . . . . . @ . @ . @ @ . @ . @ . . @ . @ @ @ @ @ @ @ @ @ . . @ @ 
@ . . . @ . @ . . . . @ . . . . @ . . . . . @ . . . . @ . . . . @ . . . . . . . . . @ @ @ . @ . @ . . . @ . . . @ . @ @ @ . . . @ . . . @ @ . @ @ @ . . . . . . . . . . @ . . @ @ @ @ @ . . @ . @ . @ @ 
@ @ . @ . . . @ @ @ . . @ . @ . . . @ @ @ . . . @ @ @ . @ @ @ . . @ . @ @ @ . @ . @ @ . . . . . @ @ @ . . @ . @ @ @ . @ . @ . @ @ @ . @ . . . @ @ @ @ @ . @ @ . @ . @ . @ @ . . @ @ @ . @ . @ . . . . @ 
@ . . . @ @ . . . . . @ . @ . @ @ @ . @ . @ . @ @ . . . @ . @ . @ . @ . . @ @ . . . . . @ @ . @ . @ @ @ @ . . . @ . . . . . . @ @ @ . @ . @ . @ @ @ . @ . . . @ . . @ @ @ @ . @ @ . . . . . . @ . @ . @ 
@ @ @ . . . @ @ @ @ . . . @ . @ @ . . . . . . . . . @ . . . . . . . . @ . . @ . @ . @ . . . @ . . . @ @ . @ . @ . @ . @ . @ . . @ . @ . @ . . . . @ . . . @ @ . @ . @ . @ . @ @ . . @ @ @ . @ . @ @ . @ 
@ @ @ @ @ . @ @ @ . . @ @ . . . @ . @ @ @ . @ . @ . . @ @ . @ @ . @ . . . @ @ @ . . @ . @ @ . @ . @ . @ . . . . . . @ . . . @ . . . . . . @ . @ @ . . @ . @ . . . . . . @ . . @ @ . @ . . . . . . . . @ 
@ @ @ @ . . . @ . @ . @ @ . @ @ . @ @ @ @ . @ @ . . @ @ . . . @ @ @ @ @ . . @ . . @ . . . . . . . . . . @ @ . @ @ . @ . @ @ . @ @ . @ @ @ @ . @ . . @ . . . @ . @ . @ @ @ . @ . @ @ @ . @ . @ . @ . @ @ 
@ . . . @ . @ . . . . @ . . . . . @ @ . . @ . . @ @ . @ @ . @ @ . @ . . . @ . @ @ . @ . @ @ . @ . @ . @ @ @ . @ . @ . @ . . . . . . . @ . . . . @ . . @ . @ @ @ . . . . . . . . . . . . . @ @ @ @ . . @ 
@ . @ . . . . @ . @ . . @ @ @ . @ . @ @ . . @ . . . . . . @ @ . . . . @ . @ . @ @ . . . @ @ @ @ . @ . . @ . . . . . . @ . @ . @ @ . @ . @ . @ @ @ @ . @ . . @ . @ . @ . @ @ @ . @ . @ @ @ @ @ @ @ . @ @ 
@ . @ @ . @ . . @ @ @ . . @ . . . . @ . . @ @ . @ . @ . @ . @ @ . @ . @ . . . . . . @ . . @ . . . . @ . @ @ @ @ . @ . @ . @ . @ . . @ . . @ @ @ @ @ @ @ @ @ . . . . . @ @ @ @ @ @ @ @ @ @ @ @ . . . . @ 
@ . . @ @ . @ . . @ . . @ @ @ . @ @ @ @ . . @ @ . @ . . @ . . . @ . @ . @ @ @ . @ . @ . @ . . @ . @ . . . . . . . . @ @ . @ @ @ @ . . . @ @ @ @ @ @ @ @ @ . @ . @ . @ . @ @ @ . @ @ @ @ @ @ . . @ @ . @ 
@ . @ @ . . @ . @ . @ . @ @ . . . @ @ @ . @ . @ . . . @ @ . @ @ @ . @ . . @ . . @ @ . . . @ @ @ @ @ @ . @ @ @ . @ . @ @ @ . @ @ . . @ @ . @ . @ @ @ @ @ . . . . @ . . . @ @ @ . . @ @ @ @ @ @ . . . @ @ 
@ . @ . @ . @ . . . @ . . @ @ @ . . @ . . . . @ . @ @ . . . . . . . . . @ . @ . . . @ @ . @ @ @ . @ . @ @ @ . @ . . @ @ . . @ . @ . @ @ . . . @ @ @ . . @ . @ @ . . @ @ . @ . . @ . @ @ @ @ @ @ . @ @ @ 
@ @ . . . . . . @ . @ @ . . @ . . @ . . @ . @ . . @ @ @ . @ . @ . @ @ . . . . . @ . . @ . @ @ @ . @ . . @ . . . @ @ . . @ . . . . . . . . @ @ . . . @ . . @ . . . @ @ @ . @ @ . . . . @ @ @ @ . @ @ @ @ 
@ . . @ @ @ @ @ . . . . . @ . @ . @ . @ . @ . @ . @ . . @ . . @ . . . @ @ @ . @ . . @ @ . . . . . . . @ @ @ . @ . @ . @ @ @ @ . @ . @ . @ . . @ . @ . . @ @ @ @ . . @ . . . @ . @ @ . @ @ @ @ . @ @ @ @ 
@ . @ @ . @ . @ . @ @ @ . . . . . . . . . . . . . . . @ . @ @ . . @ . @ @ @ @ @ @ . @ @ . @ @ @ @ . @ . @ . . . . . . . @ . . @ @ . @ @ @ . @ @ . @ @ . . @ . @ . @ . @ . @ . . . . @ . . . . . . @ @ @ 
@ . @ @ . . . . . . . @ @ . @ . @ @ . @ . @ @ . @ @ . . . . @ @ . . @ @ @ @ @ @ @ @ @ . @ @ @ . @ . . . . @ . @ @ @ . @ . . @ @ . . . . . . @ . . . @ . @ . . . . . . . . . @ . @ . @ . @ . @ @ . @ @ @ 
@ . . @ . @ . @ . @ @ . . @ . @ . . @ . @ . . @ @ . . @ @ . . @ @ . . @ @ @ @ @ @ @ . . @ @ . . . . @ . @ . @ . @ . . . . @ @ @ @ . @ . @ . . @ . @ . . . . @ @ @ @ @ . @ @ . . . @ . @ @ @ . @ . . @ @ 
@ . @ . @ . . @ . @ @ . @ . . . . @ . . @ . @ @ . @ . @ . @ @ . . . @ . . @ @ @ @ @ . @ @ . @ @ @ . @ @ . . . . . @ . @ . . @ @ . . . @ @ . @ . . . . @ . @ . . . . . @ @ . . @ . . . . @ . . . @ . . @ 
@ . . . . @ . @ . @ . . @ @ . @ . . . @ . . . @ . @ . . . . . @ @ . . @ . @ @ @ @ . . . . . . @ . . . . . @ @ . @ . @ . . @ . . . @ . . @ @ @ @ @ @ . . @ @ @ . @ @ . . @ . @ . @ @ @ @ . @ . @ . @ . @ 
@ . @ @ @ . @ @ . @ . @ @ @ @ . . @ . . . @ . . . @ @ @ . @ @ @ @ @ . @ . @ @ @ . . @ . @ . @ . @ . @ @ . . . @ . . . @ . . @ . @ . @ . @ . @ . . @ . @ . @ . . . @ . @ . . . . @ @ @ @ . @ . . . . . @ 
@ . @ @ . . . . @ . . . @ @ . @ . @ @ . @ . . @ . . . @ . . @ . @ . . . . . @ . @ @ @ @ . . . . . . . @ . @ @ . @ . @ . @ . . @ . . . . . . . @ . . . . . . @ . @ . @ @ @ . @ @ @ @ @ . . @ . @ @ @ @ @ 
@ . . @ . @ . @ . @ @ . . . . . . @ . . . @ . @ . @ @ . . @ . . . @ . @ @ @ . . . . . @ . @ @ @ @ . @ @ . . . . . . . . . @ . . @ @ . @ @ . @ . . @ @ @ @ @ . . . . @ @ @ . . . @ @ . @ . . . @ . @ . @ 
@ . @ . @ . . . . . . . @ . @ . @ . . @ @ . @ . . @ . @ . @ @ . @ . @ @ . @ . @ @ @ . . . . . @ . . . @ . @ . @ @ . @ . @ @ . @ @ @ . @ . . @ . @ . @ @ @ . @ @ . @ . . . . @ . . . . . . @ . . . . . @ 
@ @ . . . . @ . @ . @ @ . . . @ @ @ . . . . @ @ . . . . . . . . . . . . . . @ @ . @ @ @ . @ @ . @ . @ @ . . @ @ . . . @ @ . . . @ . @ . @ . . . . . . @ @ . . . . . . @ @ @ . @ . @ @ . @ . @ @ @ @ @ @ 
@ @ @ @ . @ . @ . @ . @ @ . @ @ @ @ @ . @ . @ . . @ @ . @ . @ . @ . @ @ @ . . @ . . . . @ @ . . . . . @ . @ @ @ @ @ . @ . @ . @ . . . . . . @ @ . @ . . @ . @ @ . @ . . . . . . @ . . . . . . . . . . @ 
@ @ . . . . . . . @ . . . @ @ @ @ @ @ @ @ @ . @ . . @ @ . . @ . @ @ . . @ . @ . . @ . @ @ @ @ . @ . @ . . @ . @ @ @ @ . . . . . . @ @ . @ @ . . @ @ @ @ . . . @ . . @ . @ . @ . @ . @ . @ @ @ @ @ @ . @ 
@ . . @ . @ . @ . . . @ @ . @ @ @ @ @ . . . . . . @ . @ @ . @ @ @ @ @ . @ . . . @ . @ @ . @ . @ . . . @ @ . . . @ @ . . @ . @ . @ . . . . @ . @ . @ @ @ @ . @ . @ . . @ @ . . @ . . . @ @ @ . . . . @ @ 
@ . @ . . . @ @ . @ . . . . . @ @ . . . @ . @ @ . @ . @ @ @ @ @ @ @ . . . . @ . @ . @ . . . . . . @ . @ . @ . @ @ . . @ . . @ @ . . @ . @ . . . . @ @ @ . . . . @ . @ . @ . @ . @ . @ @ @ . . @ . @ @ @ 
@ @ . @ . @ . @ @ . @ @ . @ . @ @ @ @ . @ . . @ . . . . . @ . . @ . @ @ . @ . . . . . @ @ . @ . @ . . . . . . . @ . @ @ . @ . . @ . . @ . . @ @ @ . @ @ @ . @ @ @ . . . . @ . . @ @ @ . . @ . . @ @ @ @ 
@ . . . . . . . @ . . . @ @ @ . @ @ @ @ . . @ @ @ . @ @ @ . . @ @ . @ @ @ . @ . @ @ @ @ . @ . @ @ @ . @ . @ . @ @ @ @ . @ . . @ . . @ . @ . . . @ . . @ . . . . @ . @ . @ @ @ . . @ . . @ @ . @ @ . @ @ 
@ . @ @ @ . @ @ @ . @ . . @ . . @ @ @ @ @ . @ @ @ . @ . . . @ @ . . . @ . . . . . . . . . . . . . . . @ @ . . . @ . . . . . @ . @ . . . . . @ @ . . @ . @ . @ @ . . . @ @ @ . . @ . @ . . . . . . . . @ 
@ . . . @ . @ . @ . @ . @ . . @ @ @ @ @ @ . . @ @ @ . . @ . . @ @ . @ . . @ . @ . @ . @ @ @ . @ . @ @ . . @ . @ . @ @ . @ . . . @ . @ . @ @ . @ . @ . . . . . @ . @ . @ @ @ @ . . . . . @ @ @ . @ . @ @ 
@ @ . @ @ @ . . . . . @ @ @ . @ @ . @ . @ @ @ @ @ . @ @ . . @ @ . . . . @ . . . @ . @ @ @ @ @ . @ . @ . @ @ . . . . @ @ . . @ @ . . . @ . . . @ . @ . @ @ . @ . @ . @ @ @ . . . @ . @ @ . @ @ @ . . @ @ 
@ @ . @ @ @ @ . @ . @ @ @ . . . . . . . . @ @ @ . . @ . @ . . . @ . @ . @ @ . @ . . @ @ @ @ . . . . . . . . . @ . @ . @ . @ . @ . @ @ . @ @ . . . . . . @ . . . . . . . @ @ @ . . @ . . . . @ . @ . @ @ 
@ . @ @ @ @ . . @ . . . . @ . @ . @ @ . @ . @ . @ . . . . . @ @ @ . @ @ . . . @ . @ . @ @ . . @ @ @ . @ . @ . @ . @ . . . . . . . . . . . . . @ @ @ @ @ . @ . @ . @ @ . @ @ @ . @ . @ @ @ . . . . . . @ 
@ . . . @ . . @ . . @ . @ . @ @ @ . . . . . . . @ . @ . @ . . . . @ @ . . @ . . . . . . . @ . @ . . . @ @ . . . @ . . @ @ @ @ . @ . @ @ . @ . . . . . . . . @ @ @ . @ @ . @ @ . . . . @ @ @ . @ @ . @ @ 
@ . @ @ . . @ . @ . @ . @ . @ @ @ @ @ . @ . @ . . . . @ . @ @ . @ @ @ . @ . . @ . @ . @ @ . @ . . @ . @ . . @ . @ @ . @ @ . . . . @ . @ @ . @ . @ . @ . @ . . @ @ . . . . . @ . @ @ @ . @ . @ . @ . . @ 
@ . . @ . @ . . @ @ . . . . . @ @ @ . @ . . @ . @ . @ . . @ . . . @ @ @ @ . @ . . @ @ . . . . . @ . . . @ . @ . . . . . . @ @ @ . . . . . . . @ . . . @ @ @ . . . . @ . @ . . . . . . . . . . . @ . @ @ 
@ . @ . @ . @ . @ . . @ @ . @ @ . @ . . @ @ . @ . . . @ . . @ . @ @ @ . @ . @ @ @ . @ . @ . @ . . @ . @ . @ . @ @ . @ . @ . . . . @ @ . @ . @ . @ . @ @ @ @ . @ . @ @ @ @ . @ . @ . @ @ . @ . @ . . . @ 
@ . . . . . . . . @ @ . . . . . . @ . @ . . . . . @ @ . . @ @ . . @ . . . @ @ @ . . . @ . . @ @ . . @ @ . @ . @ . . . @ @ . @ . @ @ . . . @ @ . @ . . . . . @ @ . . @ . . . . @ . . . @ . . @ @ @ @ . @ 
@ @ . @ @ @ . @ . @ @ @ @ . @ @ . . . . @ . @ . @ . . @ . . . . @ . @ . @ . @ . @ . @ . @ . . @ . @ . . . . . @ . @ @ @ @ @ . . . . @ @ . . . . @ . @ . @ . . . @ . . @ @ . @ @ @ . @ @ . @ @ @ @ @ @ @ 
@ @ . @ . @ @ . . . . @ @ @ . @ . @ . @ @ . . @ . @ . . @ . @ . . . . . . . . . . . . . . . @ . @ @ . @ . @ @ @ . @ @ @ @ . @ @ @ . . @ . @ . @ @ @ . @ @ . @ . . @ . . @ . . @ . . . . @ @ @ @ @ @ @ @ 
@ . . . . . . @ . @ . @ . . . . @ @ . @ . @ @ . . . . @ @ @ . @ . @ . @ . @ . @ . @ @ . @ . . . . @ @ . . . @ @ @ @ @ @ @ . @ @ . . @ @ . @ . . . . . . . @ @ . @ @ . @ @ . @ @ @ . @ @ @ @ @ @ @ @ @ @ 
@ @ . @ . @ . @ . @ . . . @ . @ @ . . . . @ . @ . @ . @ @ . . . . . @ . . . @ . . . @ @ . . @ . @ @ . . @ @ . @ . @ @ @ . . @ @ @ . @ . . . @ . @ . @ @ @ @ . . . . @ . @ @ . @ . @ @ @ @ @ @ @ @ @ @ @ 
@ . @ . . . @ . . . @ . @ . . . . @ . @ . . . @ . @ . @ . @ @ @ @ . @ @ . @ @ @ . @ . . @ @ . . @ . @ . . . . . . . @ @ @ . @ @ . @ . . @ . . @ . . . . @ . @ . @ . . . . . . . . @ @ @ @ @ @ @ @ @ @ @ 
@ . @ . @ . @ . @ . . @ @ @ . @ . @ @ . . @ @ . @ . . . . . . . . . . . @ @ @ . . . . @ . . @ . . . . . @ . @ . @ @ . . . . . . . . . @ . . @ @ @ . @ . . . . @ . . @ . @ @ @ . @ @ @ @ @ @ @ @ @ @ @ @ 
@ . . @ @ @ . @ @ . @ @ @ @ @ . . . . @ . @ @ . @ @ . @ @ . @ . @ . @ @ @ @ . @ . @ @ . @ . @ . @ @ . @ @ . . @ @ . @ @ @ . @ @ . @ . @ @ . . @ . . . @ . @ . @ @ . . @ @ @ @ @ @ @ @ @ @ @ @ @ @ @ @ @ 
@ . @ . @ . . @ . @ @ @ @ @ . @ . @ . . . . . . . . . @ . @ . . . @ @ @ . . . @ @ . . . . . . . @ @ . . . @ . . . . . . . @ . . @ . . . @ @ . @ @ @ . @ . @ . . . @ . @ @ @ @ @ @ @ @ @ @ @ @ @ @ @ @ @ 
@ . . . . @ . . . . @ @ @ . . . . @ . @ . @ . @ . @ . @ . . @ . @ . @ @ @ @ . . . . @ . @ . @ . . . @ @ . @ . @ . @ . @ . @ @ . @ @ . @ @ . . . . . @ @ @ @ . @ . @ @ @ @ @ @ @ @ @ @ @ @ @ @ @ @ @ @ @ 
@ . @ @ @ @ @ . @ . @ . . @ @ . @ @ . @ @ @ @ . . @ . @ @ . . . . . @ @ @ @ . @ . @ . . . @ . . @ . @ . . . @ . @ . . . @ . . . . . . . . @ . @ . @ @ @ @ . . . @ . @ @ @ @ @ @ @ @ @ @ @ @ @ @ @ @ @ @ 
@ . . @ . @ . . . @ @ @ . . . . @ . . . @ @ @ . @ . @ . . . @ . @ @ @ @ @ . @ . . . @ . @ @ @ . . @ @ @ . @ @ . @ @ . @ @ @ . @ . @ . @ . @ . . @ @ @ @ @ @ . @ . . . @ @ @ @ @ @ @ @ @ @ @ @ @ @ @ @ @ 
@ . @ . . . @ . @ . @ . @ @ @ @ . @ . @ . @ . @ . . . . @ @ . . . . @ @ @ . @ @ . @ . @ . . . . @ @ . @ @ . . . . . @ @ @ @ @ . . . @ . . @ . @ . @ @ @ . . . . . @ . @ @ @ @ @ @ @ @ @ @ @ @ @ @ @ @ @ 
@ . . . @ . . . . . . . . . . . . . . . . @ . . . @ @ . @ . @ . @ @ . @ . . . . . . . . @ . @ . . . . . . . @ . @ @ @ @ @ @ @ @ . @ @ @ @ . . . . . @ @ @ @ . @ . @ @ @ @ @ @ @ @ @ @ @ @ @ @ @ @ @ @ @ 
@ . @ . . @ . @ . @ . @ . @ . @ @ @ . @ @ . @ @ . . . @ . . . . @ . . . . @ . @ . @ . @ @ @ . . @ @ . @ . @ . @ @ @ @ @ @ @ @ @ @ @ @ @ @ @ . @ . @ @ @ @ @ @ . . . . @ @ @ @ @ @ @ @ @ @ @ @ @ @ @ @ @ 
@ . @ . @ @ @ . . @ . . @ . . . . . @ . . . . . . @ . . @ . @ . . @ . @ . . @ @ @ . . . . @ @ . . . @ @ . . . . . . @ @ @ @ @ @ @ @ @ @ @ @ @ @ . . . @ @ @ @ @ . @ . @ @ @ @ @ @ @ @ @ @ @ @ @ @ @ @ @ 
@ @ @ @ @ @ @ @ @ @ @ @ @ @ @ @ @ @ @ @ @ @ @ @ @ @ @ @ @ @ @ @ @ @ @ @ @ @ @ @ @ @ @ @ @ @ @ @ @ @ @ @ @ @ @ @ @ @ @ @ @ @ @ @ @ @ @ @ @ @ @ @ @ @ @ @ @ @ @ @ @ @ @ @ @ @ @ @ @ @ @ @ @ @ @ @ @ @ @ @ 
3
39 93 33 91
65 41 39 98
23 75 37 56
