50 50
@ @ @ @ @ @ @ @ @ @ @ @ @ @ @ @ @ @ @ @ @ @ @ @ @ @ @ @ @ @ @ @ @ @ @ @ @ @ @ @ @ @ @ @ @ @ @ @ @ @ 
@ . . @ . . . @ . . . . . . . . . . . . . @ . . @ . . . . @ @ @ . @ @ @ . @ @ @ @ @ @ @ @ @ @ @ @ @ 
@ @ . . . @ . @ . @ . @ . @ @ . @ . @ @ . @ . @ @ @ . @ . . @ . . . @ . . . @ . @ @ @ @ @ @ @ @ @ @ 
@ . @ @ . @ . . @ . . . @ . . . @ . @ . . . . . @ @ @ . . @ . @ @ . . @ . @ . . @ @ @ @ @ @ @ @ @ @ 
@ . @ . . @ . @ @ @ @ @ . @ . @ . . . @ . @ . @ @ @ . @ . . . . . @ . . . . @ . . @ . @ @ @ @ @ @ @ 
@ . . @ . . @ @ @ . @ . . . . @ @ . @ @ @ . . . @ . . . . @ @ . @ @ @ . @ . . . @ . . . @ @ @ @ @ @ 
@ @ . @ . @ . @ . . . @ . @ . @ . . . @ . . @ . @ . @ @ . . . @ @ @ @ . . @ . @ . . @ . @ @ @ @ @ @ 
@ . . . . . . . @ . @ . @ @ . . @ . @ @ @ . . @ @ @ @ @ . @ . . @ @ @ . @ . . @ @ . . @ @ . . @ @ @ 
@ . @ . @ . @ @ . . @ . @ @ @ @ . . . @ . . @ . @ . . @ . @ . @ . @ . @ @ @ . @ . . @ . @ . @ @ @ @ 
@ . @ @ . . . @ . @ . . . @ . . @ . @ . @ . . . . . @ . @ . . . . . . @ @ @ . @ @ . . . @ . @ . . @ 
@ . . @ @ . @ . . @ @ . @ @ . @ . @ . . @ . @ . @ . . . . . @ . @ @ @ . @ . . . . . @ @ . . @ . @ @ 
@ . @ @ . . . . @ . . . @ . . @ . . @ . . @ @ @ . . @ . @ . . @ @ @ @ . . @ @ @ @ . @ . @ . . . . @ 
@ @ . . . @ @ @ . @ . @ . @ . @ @ . . . @ @ @ @ . @ . . . @ . . @ . . @ . @ @ @ @ . . . . @ @ . @ @ 
@ @ @ @ . . @ . . . . . . . . . @ . @ . . @ @ @ @ . @ . @ . . @ @ . @ . . . @ @ @ @ . @ . . . . . @ 
@ . . . . @ . @ . @ . @ . @ . @ . @ . . @ @ @ @ . . . . . @ @ . . . @ @ . @ @ @ @ @ @ @ . @ @ . @ @ 
@ @ . @ . . . @ @ . . . @ . . . . . @ . . . @ . @ . @ @ . . . . @ @ . . . . . @ @ @ @ . . . @ . . @ 
@ @ @ . . @ . . . @ . @ . @ . @ @ . . . @ . . . @ @ . @ . @ . @ . @ . @ . @ @ @ @ @ . @ . @ @ . @ @ 
@ @ . @ . . @ . @ @ @ . . . . . . @ . @ @ @ . @ . . . . @ . . . . @ @ . . @ @ @ @ . . . . . @ . . @ 
@ . . . . @ @ @ @ @ . @ . @ . @ . . @ @ @ . . @ . @ @ . . @ @ @ . . . . @ @ . @ . @ . @ @ @ . @ . @ 
@ @ @ @ . . @ @ @ . . . . @ . @ . @ @ @ @ @ . . . . @ . @ . . . . @ @ . . . . . . . . . . . . . @ @ 
@ @ . @ . @ . @ . @ . @ . @ . . @ . @ @ . . @ . @ . . @ @ @ . @ . @ . . @ . @ . @ @ . @ @ . @ . . @ 
@ @ . . . . . . . . . . @ . . @ @ . @ . @ . . . . @ . @ @ @ @ . . . @ . . @ @ @ . . @ . @ @ . @ @ @ 
@ @ @ @ . @ . @ . @ . @ . @ @ . @ . @ . . . @ . @ @ . . @ . @ @ . @ . @ @ @ @ @ @ . . . @ . . . . @ 
@ @ . @ . . @ . @ . . @ . @ . . . . @ @ . @ . . . @ @ . . . @ . . . . . @ @ @ @ @ . @ @ . @ . @ . @ 
@ . . @ @ . . . . @ . . . . . @ . @ @ . . . @ . @ @ @ . @ @ . @ . @ @ @ . . @ @ . . @ . . . . . @ @ 
@ @ . . . @ . @ @ . @ . @ . @ . . . . @ . @ @ . . . @ . . . . . . @ . @ . @ . . . @ . @ . @ . @ @ @ 
@ @ . @ . . @ @ . . . . . @ . @ . @ . @ . @ . . @ . . @ @ . @ @ . . . . . . @ @ . . . . . . @ @ @ @ 
@ @ @ . @ . . . . @ . @ @ . . . . @ @ . @ . . @ @ @ . @ . . . . @ . @ . @ . . . . @ @ @ @ @ @ @ @ @ 
@ . @ . . . @ @ @ . . . @ @ . @ . @ @ . . @ . @ @ . . @ @ . @ @ . . @ . . @ . @ . . . . . . @ @ @ @ 
@ . . . @ . @ . @ @ . @ @ . . @ . @ @ @ . . . . @ @ . . @ . @ @ @ . . @ . . @ @ . @ @ @ . @ @ @ @ @ 
@ @ @ . @ @ . . . . . . . @ . @ . . . . @ . @ . . @ . @ . . @ @ @ . @ @ . @ . @ @ @ @ . . . . @ . @ 
@ @ @ @ . . . @ . @ . @ . @ @ . . @ . @ . . @ . @ . . @ @ . . . . @ . @ . . . @ . @ . @ . @ . . . @ 
@ . . . . @ . . @ . . . @ @ @ @ . . @ @ @ . @ . . @ @ @ . . @ . @ . . . @ @ . . . . . . @ @ . @ @ @ 
@ . @ . @ . . @ . @ . @ @ @ @ . . @ @ @ @ @ . . @ . @ @ . @ . @ . @ @ . . . . @ . @ . @ . . . . . @ 
@ . @ @ . . @ @ . @ . . @ @ . @ . . . . . @ @ . . . . . @ . . . . @ . @ @ . @ @ @ . @ . . @ . @ . @ 
@ @ . . . @ . . . . . @ . . . . @ . @ @ @ . . . @ . @ . @ @ . @ . . . . . . @ @ @ . . @ . . @ @ @ @ 
@ @ . @ . . @ . @ @ . . @ . @ . . . @ @ @ . @ . . @ @ @ @ @ @ . @ . @ . @ . @ . . @ . @ . @ @ @ @ @ 
@ . @ . . @ @ @ @ . . @ . @ . @ @ . . @ @ . @ . @ @ @ @ @ @ @ . @ @ . @ @ @ . . @ . . . @ @ @ @ @ @ 
@ . . @ . . @ @ . @ . . . . . . . @ . . @ @ @ . . @ @ @ @ @ . . . . . @ @ . @ . . . @ . . @ @ @ @ @ 
@ @ . . @ . @ . . @ . @ @ . @ . @ . . @ . . . . @ . @ @ @ . @ . @ @ @ . . . . . @ @ . . @ . @ . @ @ 
@ . . @ . . @ @ . . . . . @ @ . . @ . @ @ . @ . @ . . . . . . . . . . . @ . @ @ . @ @ . . . . . . @ 
@ @ . @ @ . @ . @ @ . @ . . . @ . . @ @ @ @ . . . . @ @ . @ @ . @ . @ . @ . . . . . @ @ @ . @ . @ @ 
@ . . . . . . . . @ @ . . @ . . @ @ . @ @ . @ @ . @ . . @ . . . . @ @ @ @ . @ . @ . . . . @ @ . . @ 
@ @ @ . @ . @ @ @ @ @ @ . . @ . . . . . . . @ @ . . . @ . @ @ @ @ . @ . @ . . @ . . @ . @ . . . @ @ 
@ @ @ @ . . . . . . @ . . @ . . @ @ @ . @ @ . . . @ . . . . . . . . . . @ . @ . @ . . @ . @ . @ @ @ 
@ @ @ @ @ . @ @ . @ @ @ . . @ . @ . . . . @ . @ . @ . @ . @ @ @ @ . @ . @ @ . . @ . @ . . . . . @ @ 
@ @ @ @ @ @ . . @ . @ . @ . . @ . @ @ . @ @ @ . . @ . . @ . @ . @ . . @ @ . @ . @ . @ @ . @ . @ @ @ 
@ @ @ @ @ @ @ . @ . . . . . @ @ . @ . @ . @ . @ . . @ . . . . . . @ . . . . . . . @ . . . @ . @ @ @ 
@ @ @ @ @ @ . . . . @ . @ . . . . . . . . @ . . . @ . . @ . @ @ . . @ . @ @ @ . @ @ @ . @ . . @ @ @ 
@ @ @ @ @ @ @ @ @ @ @ @ @ @ @ @ @ @ @ @ @ @ @ @ @ @ @ @ @ @ @ @ @ @ @ @ @ @ @ @ @ @ @ @ @ @ @ @ @ @ 
3
13 27 5 35
46 46 4 36
4 26 16 21
