100 100
@ @ @ @ @ @ @ @ @ @ @ @ @ @ @ @ @ @ @ @ @ @ @ @ @ @ @ @ @ @ @ @ @ @ @ @ @ @ @ @ @ @ @ @ @ @ @ @ @ @ @ @ @ @ @ @ @ @ @ @ @ @ @ @ @ @ @ @ @ @ @ @ @ @ @ @ @ @ @ @ @ @ @ @ @ @ @ @ @ @ @ @ @ @ @ @ @ @ @ @ 
@ @ @ . . . @ . . @ @ @ @ @ @ @ . @ . @ @ . . . @ . . @ @ . . . . . . @ @ @ @ . @ @ @ @ @ @ . @ . @ . @ . @ . . @ . @ . @ @ @ @ . @ @ @ . @ @ @ . @ . . @ . @ . @ . @ . . @ . @ @ @ @ . . . . . @ . . @ 
@ @ . @ @ . @ . @ @ @ @ @ @ @ . . . . @ . . @ @ . @ . . @ . @ @ . @ @ @ @ @ . . @ @ @ @ @ . . . . . . . . . . @ . . . . . . @ . . . . . . . @ . . @ @ . @ . . . . . . @ . . . . @ @ . . @ @ . @ . . @ @ 
@ . . . @ . . . . @ @ @ @ @ @ @ . @ @ . @ . . @ . . . @ . . @ @ . . @ . . . @ . @ @ . @ . @ . @ @ @ @ @ . @ @ . @ . @ . @ @ . @ @ . @ @ . @ @ @ . @ . . . @ . @ @ @ . . . @ . @ . . @ @ . . . @ @ . . @ 
@ @ . @ . @ @ . @ @ @ . @ @ @ . . . . . . . @ @ @ @ . . @ . @ . . @ . @ . @ . . . . . . . . . @ @ @ @ @ @ . . . . . @ . @ . . @ . @ . @ . . . . . . @ @ . . . @ . . . @ . . @ @ @ . . . @ @ . . . . @ @ 
@ . . . . . . . . @ . . . . . @ @ . @ . @ . . . . . . @ . @ . @ . . . . . . . @ . @ @ . @ @ . @ @ @ . @ . . @ . @ @ . @ . @ . @ . . . . . @ . @ . @ . . @ @ . @ . @ . @ . @ @ . . @ . @ . . @ . @ @ . @ 
@ . @ . @ . @ . @ . @ . @ @ @ @ @ @ . . . @ . @ . @ . . . . . . . @ @ @ . @ . @ @ . . @ . . @ . . . . @ . @ . . @ . . . . . . . . @ @ . @ . @ . . @ . @ . @ @ . @ @ @ . . . . @ . . . . . @ . . . @ . @ 
@ . @ . . @ . . . . . . @ . . @ @ @ @ . @ @ @ @ @ . . @ . @ . @ . . . @ @ @ . @ . . @ . @ . . @ @ . @ . . . @ @ . . @ . @ . @ @ . . @ @ @ . . @ . @ . . . @ . . . . . . @ @ @ @ . @ . @ @ . @ . @ . . @ 
@ . @ . @ . . @ . @ @ . . @ . . @ @ @ @ @ @ @ @ . . @ @ . . @ @ @ . @ @ . . . @ . @ . . . @ . . . . . @ . @ @ @ @ . @ . . @ . @ @ . . . . @ . . @ . . @ @ . @ . @ . @ @ . . . . . @ . @ . . . . . . @ @ 
@ . @ @ @ @ @ . . @ @ . @ . . @ . @ @ . @ @ @ . @ . . @ . @ @ @ . @ @ . @ . @ @ . @ . @ . . . @ . @ @ . . . @ . . . @ . @ . . . @ . @ . @ . @ . @ . @ . @ . . . @ @ @ . @ @ . @ . . @ . . @ @ . @ . . @ 
@ . . . @ . @ @ . @ . . . . @ . . . @ . . @ . . @ . @ . @ . @ @ . . @ . . @ @ @ . . . . @ . @ @ . . @ @ . @ . @ . @ @ @ @ . @ @ . @ . . @ . . . . . . . . . @ @ . . . . . . @ . . @ . @ . . @ . . @ . @ 
@ . @ @ @ . @ @ @ . . @ @ . . . @ . @ . @ @ @ . @ . . . @ . @ @ @ . . . @ . @ . @ . @ @ . @ @ @ . @ @ @ . . . . . @ @ . . . . . . @ @ . @ . @ . @ . @ @ @ @ . . @ . @ @ . @ . @ . . . . . @ @ @ . @ . @ 
@ @ . . . . . @ @ @ . @ @ . @ @ . @ . . . @ . . . . @ . @ . @ . . @ . @ . . @ . . . @ . . . . . @ . . . . @ . @ @ @ @ @ . @ . @ . . @ @ . . . @ @ @ @ . @ . @ . . . . @ @ . . . @ @ . @ . @ @ . . . @ @ 
@ . @ @ @ . @ . @ . @ . @ . . . . . @ . @ @ . @ @ . @ @ @ . . @ . . . . . @ . @ @ . . . @ @ . @ @ @ @ @ . . @ @ @ . . @ . . @ . . @ . @ @ . @ . . . . . @ . @ . @ . @ @ @ @ . @ @ @ @ . . . @ @ . @ . @ 
@ . . . . . . . . . . . @ @ . @ @ . . . . . @ @ . . @ @ . . @ . . @ . @ @ . . . . . @ @ . @ @ . . . . . . @ . @ @ @ . . @ @ . @ . . . . . . . . @ . @ @ . . . @ @ . . . . . . @ @ @ @ @ @ . . @ . . . @ 
@ @ . @ @ . @ . @ . @ . . @ @ @ @ . @ . @ . @ . @ . @ . @ . . @ . . @ @ @ . @ . @ . . . . @ @ @ @ @ . @ @ @ . @ @ @ . @ @ . . @ . @ @ . @ @ @ @ . . . @ @ . @ . . . @ . @ . @ @ @ @ @ @ @ . @ . . @ . @ 
@ @ @ . . @ . . . @ . @ . . @ @ . @ . . @ . @ . @ . . . . . @ . . @ . . @ . @ @ @ @ @ . @ @ @ @ @ . . @ . . . . . . . @ . @ . @ . . . @ . . . . @ . @ . . . . . @ @ . @ . . @ . . @ @ @ . . . @ . @ . @ 
@ @ @ . @ @ . @ @ . . . . @ . @ . . @ . . @ @ . @ . @ @ . @ . . @ . . @ . . @ . . @ . @ @ @ @ @ . @ . @ . @ . @ . @ . @ . . . . . @ @ . @ @ . @ . @ @ @ . @ @ . . @ . . @ . . @ . @ . . @ . @ @ @ . @ @ 
@ . @ . . . @ . . @ . @ . @ . . . @ . @ . . @ . . . . @ @ . @ . . . @ . @ . . @ . . . @ @ @ @ . . . . . . . @ . . @ . . @ . @ @ . . . . . . . . . . . @ . @ . . @ . . @ . @ @ . . . . @ . . . @ . . @ @ 
@ . . . @ @ . @ . @ @ . . . @ . @ . . . . @ . @ @ . @ . . . . . @ @ . . . . @ . @ . @ . @ @ @ . @ @ . @ . @ @ . @ @ . @ . @ . . . @ . @ . @ @ . @ . @ . @ . @ . . . @ . . . @ . @ @ @ . . @ @ . @ . . @ 
@ @ . @ @ . . . . . @ @ . @ . . . . @ . @ . . @ . . . @ . @ @ . @ @ . @ @ @ . . . . . . . . . . @ @ . @ . @ @ @ . . . @ . . @ @ . . @ @ @ @ . @ . @ @ . . . . . @ @ . . @ @ . . @ @ @ @ . @ @ . @ . @ @ 
@ . . . . @ @ @ . @ @ . . . @ . @ . @ @ @ @ . . @ . @ . . @ . @ @ @ . . . . . @ . @ @ @ . @ . @ @ . @ . @ . @ . . @ @ @ @ . . . @ . . @ . . . . . . . @ @ . @ . @ @ . @ @ @ @ . . . @ . . . . . . . . @ 
@ @ @ @ . @ . . . . . @ . @ . . . @ . . @ . . @ . . . . @ @ . . @ . . @ . @ @ . . . . . @ . . @ . . . . . . . @ @ @ @ @ @ . @ . @ . @ @ . @ . @ . @ @ @ @ . @ . . . . . . . @ . @ . . . @ @ @ @ . @ @ @ 
@ @ . . . . @ @ . @ @ @ . . . @ . . . @ @ @ . @ . @ . @ . @ . @ @ . @ @ . @ @ @ . @ . @ @ @ @ . @ . @ . @ @ . @ @ @ @ @ @ . . @ @ . . . @ . . . @ . @ @ @ @ . . @ . @ @ @ @ . @ . . @ . . . . . @ . . @ 
@ . @ @ @ . . . . . . . @ @ . . @ . @ @ @ . . . . @ @ . . . . @ @ . . . @ . . @ @ . @ @ @ . @ . . . @ . . . @ @ @ @ @ @ . @ . @ . . @ . @ @ . @ . . @ @ @ . . @ . @ . . . @ . . . @ @ . @ @ @ @ . . @ @ 
@ . @ @ . @ @ @ . @ @ . @ . . @ . @ @ @ @ @ @ @ . @ @ @ . @ . . @ @ . @ . @ . @ . . . @ . . . . @ @ . @ . @ @ @ @ @ @ . . . . . . @ @ @ . @ . . @ . . @ . . @ . . . @ . @ . @ . @ . . @ @ @ . @ . @ . @ 
@ . @ @ . @ . @ . . . @ . @ . . . . @ @ @ . @ . . . @ @ @ . . @ . . . . . . . . . @ @ . @ . @ . . . . . @ @ @ @ @ @ @ @ . @ . @ @ . @ . . . @ . . . @ . . @ . @ . @ . . . . . . . . @ . @ . . . . . . @ 
@ . . . . . . . @ @ . . . . @ @ . @ . @ . . . . @ @ @ . . . @ . @ . @ . @ @ @ . @ . @ . . @ @ . @ . @ @ . . @ . @ @ @ @ @ @ . @ . . . @ . @ @ @ @ . . @ . . . . . . @ . @ . @ @ @ . . . . . @ @ @ @ @ @ 
@ . @ . @ . @ . @ . @ @ @ . . . . @ . . . @ . @ @ @ . @ . @ . . . . . @ @ @ @ @ . . @ . @ @ @ . . @ . @ @ . . . . @ @ @ . . . . . @ @ @ . . @ . . @ . @ . @ . @ @ . . . . @ @ . . . @ . @ . . . . . . @ 
@ @ @ . @ . @ . . . . . . @ @ @ . . . @ @ . @ @ @ . . @ . . @ . @ . @ . @ . @ @ @ . @ . . . . @ . . . . . . @ @ @ @ @ . @ @ . @ @ . . . . @ @ @ . . . . . . @ @ . . @ . @ @ @ @ @ . . @ @ . @ . @ @ . @ 
@ . . @ . @ . @ . @ . @ . @ . @ @ . @ @ @ . . @ . @ . . . @ . @ @ . . . . . . . . . . . @ . @ . . @ @ . @ . . . . @ . . . @ . . . . @ . @ @ @ @ . @ . @ . @ @ @ @ @ . . . @ @ @ @ @ @ . . @ . . . . @ @ 
@ @ . . . . . . . . @ . . . . . . . . @ . . @ . . @ . @ @ . . . . . @ @ @ @ . @ . @ . @ @ @ @ . @ @ . . @ . @ . @ . @ . @ . . @ @ @ . @ @ @ @ @ . @ . . @ . @ . @ @ @ . @ @ @ . @ . @ . @ . @ . @ . . @ 
@ . @ . @ . @ @ . @ @ @ @ . @ . @ . @ . @ . . . @ @ . . . . @ @ @ . . . . @ @ . @ . @ . @ . . . @ . @ @ . @ @ @ @ . . . . . @ @ . . . . @ @ @ . . . @ . . . . . . @ . @ . @ . . . . . . . . . @ . @ . @ 
@ . . . @ @ @ @ @ @ @ @ . . @ @ . . . . . . @ . @ . . @ . @ . . . . @ @ . . . . . . . . . . @ @ @ . . @ . . @ . . . @ @ @ . @ . @ @ . @ . @ . @ . @ @ @ . @ . @ . @ . @ . @ . @ . @ @ . @ @ . . . . @ @ 
@ @ @ . . @ @ . @ . @ @ . @ . @ . @ . @ @ @ . @ . @ . @ . . @ . @ . . @ @ @ . @ . @ . @ . @ @ . @ . @ . @ . . @ @ . . @ @ @ @ . @ . . . . . . . . . @ . . . @ . . . . . . . . . @ . . @ @ . . @ . @ @ @ 
@ @ @ @ . @ . . @ . . . @ . . . . . @ . . . . . . . . . @ @ . @ . @ . @ . . @ . @ . . . @ . . . . . @ . . @ . @ . . @ . @ @ . . @ @ . @ @ . @ . @ . . @ @ @ @ @ . @ . @ @ @ @ . . . @ . . @ . . @ @ @ @ 
@ @ @ @ @ . @ . . @ @ . @ @ . @ @ @ @ @ . @ . @ @ . @ . @ . . . . . @ . . @ . . . @ @ . @ . @ @ . @ . @ . . . . @ . . . . . @ . . . . . . @ @ @ . @ @ @ @ . @ @ @ @ @ @ @ . . . @ . . @ . . . @ @ @ @ @ 
@ @ @ @ @ . . . @ @ . . @ @ . . @ . . . @ . . @ . @ @ @ . @ . @ . @ . @ . . . @ . . @ . . . . @ @ . . @ . @ . @ @ @ @ . @ @ . @ . @ . @ @ @ @ . . @ @ @ @ . . . . @ @ @ @ . @ . @ . @ . @ @ . . . @ @ @ 
@ @ @ @ . . @ . . . @ . . @ . @ . @ . @ . . @ @ . . @ . . . . . @ . . . . @ . @ . @ . @ . @ . . @ @ . . @ . . . @ @ . . @ . . @ @ . . . @ @ @ . @ . @ . @ . @ . @ @ @ @ @ @ . . . @ . . . @ . @ @ @ @ @ 
@ @ . . @ @ . @ @ . . . @ . . . . . . . @ . @ @ . @ . @ . @ . @ . @ . @ . . @ @ . . . . @ . @ . @ . . @ . @ . @ . @ . @ . @ . @ . @ . @ . @ . . . . . . . . . @ @ @ @ @ @ @ . @ . . @ @ . . @ . @ . . @ 
@ . . @ . @ . @ . @ . @ . . @ @ . @ @ . @ . . . . . . . @ . . . . . @ . @ . @ @ @ @ . @ . . @ @ . @ . . . . . . . . . . . . . . . . . . . @ @ . @ . @ . @ . @ . @ @ @ @ @ @ . @ . @ . . . @ . . . @ . @ 
@ @ . . . . . . . . . . . @ . @ @ . . @ . . @ . @ . @ . @ . @ . @ @ . . @ . . @ @ @ . . . @ . . . @ . @ @ @ . @ . @ . @ . @ . @ . @ @ . @ @ @ . . @ @ @ . . @ . @ @ @ @ @ . @ @ @ @ . @ . . @ . @ . . @ 
@ @ @ . @ . @ . @ @ . @ . @ . . @ . @ . @ . . @ . . @ @ . . @ . . . . @ . . @ . @ . @ . @ @ @ . @ . . . @ . @ . . @ . @ . . @ @ . @ @ @ . @ . . @ . @ @ @ @ . . . @ @ @ . . . . @ . @ . @ . . . . @ . @ 
@ . . . @ . @ @ . . . . @ @ @ . . . . . . . @ . @ . @ . . @ @ @ . @ @ @ @ . . . . . . @ . . . . . @ . @ @ . . . @ . . . @ . . . @ @ @ @ . . @ . . . . . @ . . @ @ . @ . @ @ . @ . . . . @ @ @ . @ . . @ 
@ . @ . . @ . . @ @ . @ . @ . . @ . @ . @ . . . . @ @ . @ . @ @ . . @ @ . . @ . @ @ . @ @ @ . @ . . . @ . @ . @ . @ . @ @ @ . @ @ @ . @ . @ . . @ . @ @ . . @ @ . . @ . @ . . . . @ @ . @ . @ . . @ . @ 
@ . . @ . . @ . @ . . . . . @ . . @ @ @ . . @ @ . . . . . . . . @ @ . . . @ . @ @ @ @ . @ @ @ . . @ . @ . . @ . . . @ . @ @ . . @ . . . . . . @ @ . @ @ . @ . @ @ . @ . . . @ @ . @ @ . . . . @ . . . @ 
@ . @ . . @ . . . @ . @ @ . @ . @ . @ @ @ . . @ . @ . @ . @ . @ @ @ . @ . @ . . @ @ @ . . @ . . @ . @ @ . @ . . @ @ @ . . @ . @ . @ . @ . @ @ . . @ @ @ . . . . . . . @ @ . @ @ . . . @ . @ . . . @ @ @ 
@ @ . . @ . @ . @ . . @ . @ . . . . . @ . . @ @ @ . . . @ . . . . . @ . . . . @ @ @ . . @ . @ . . . . . . . . @ . . . . @ . . . . @ . . @ @ @ . @ . @ . . @ . @ . @ . . @ . @ . . @ . @ . @ . @ . . . @ 
@ . . @ . . . . . @ . . . . @ . @ . @ . . @ @ @ . @ . @ . @ . @ @ @ . @ . @ @ . . . @ . @ . . . @ . @ . @ @ @ . . @ @ . . @ . @ @ . . @ . @ @ . . . . . @ . . . @ . . @ . @ . . @ @ @ @ . @ . . @ . @ @ 
@ @ @ @ . @ . @ . @ . @ . @ @ . @ @ @ @ . . . . . @ . @ . . . . @ . . . . . @ . @ . . . @ . @ @ . @ . . @ @ . . @ @ @ @ . . @ @ . @ . . . . . . @ @ @ @ . . @ . @ . @ . . . @ . . @ . @ . @ . @ . . . @ 
@ @ @ @ @ . @ . . . . . @ . . . . @ @ @ @ . @ . @ @ @ . . @ . @ @ @ . @ . @ @ @ @ . @ . @ . . @ . . @ @ @ @ @ . . @ @ . . @ @ . . . . @ . @ @ . . . . @ @ . . @ . @ @ @ . @ . . @ . . . . @ . . @ . @ @ 
@ @ @ @ . . . . @ . @ . . @ @ . @ . @ @ @ @ @ @ . . . . @ . . @ @ . . @ . @ @ @ @ . @ . . . @ . . @ . @ @ @ . . @ . . @ . @ . @ . @ . @ . @ . @ @ @ . @ @ @ @ . . . @ . . @ @ . . @ @ @ . @ . @ @ . . @ 
@ @ @ @ @ . @ @ . @ @ . @ . @ . @ . @ @ @ @ @ . @ @ @ . . @ . @ @ . @ . . @ @ @ . @ . @ . @ . @ . @ . @ @ . @ . @ . @ . @ @ . . . . @ . @ @ . @ . . @ @ . . . @ . @ . . @ . . . @ . @ . . . @ . . . @ @ 
@ @ @ @ @ @ @ . . @ . . . . . . . . . . . @ . . @ . @ @ @ @ @ . . @ . . @ . @ . . . . . . . . . . . . . . . . . . . . . . @ . @ @ . . . . . . . @ . . . . @ . @ . . . @ . . @ @ . . . @ . @ . @ @ . . @ 
@ @ @ @ . @ . @ . . . @ @ . @ . @ . @ @ . @ @ . . . . @ . @ @ @ . . @ . @ . . . @ @ . @ @ @ . @ . @ . @ . @ . @ @ . @ . @ @ . . . @ . @ . @ @ @ . @ @ . @ . @ . @ . @ . @ . . . . @ @ . . . . . . @ . @ 
@ . @ . . . . . @ @ . . @ . . @ . . . . @ @ . . @ . @ . . . @ . . @ . . . . @ . @ @ . @ @ @ @ . . . @ @ . . @ @ @ . . @ . . . @ . @ @ . @ . . . . . . . . . . . . . . . . . @ . @ @ @ @ . @ @ . @ . . @ 
@ . @ @ @ . @ . @ @ @ . @ . @ @ @ . @ @ @ . @ . . @ . . @ @ . @ . . . @ . @ . @ @ . @ . @ @ . @ . @ . @ @ @ . @ . @ . . . @ . @ @ . @ . . . @ @ . @ . @ . @ . @ @ . @ @ . @ @ @ . @ . . . . @ . . @ . @ 
@ . . . @ @ . . . @ . . . @ @ . @ . @ . . . . . @ . @ . . . . . @ . @ . . . . . . . . . . . . . @ . . . . . . . . @ . @ @ . . . . . . . @ . @ . . . @ @ . . @ . . . @ @ . . . . . . @ . @ . @ . @ @ . @ 
@ @ @ . @ . @ . @ @ @ . @ @ @ . @ . . @ @ . @ @ . . . . @ . @ . . . @ . @ . @ . @ @ . @ @ . @ . . . @ . @ @ . @ . @ @ . . . @ . @ . @ . @ @ @ @ . @ . @ . @ @ @ @ . . . @ . @ . @ @ . . @ @ @ @ . @ @ @ 
@ . . . . . . . . . . . . @ . . . @ @ . . . . . . @ . @ . @ @ @ @ @ @ @ . @ . . . . @ . @ . . @ . @ . @ @ @ @ . . . . @ . @ @ @ @ . @ . . @ . . . . . . @ . @ . . . @ @ @ . . @ @ @ @ . @ . @ @ . . . @ 
@ . @ . @ . @ . @ . @ . @ @ @ . @ . . . @ @ @ . @ @ @ . . . . . . . @ @ . . @ . @ . . . @ . @ . . . . @ @ @ . @ . @ @ @ @ @ @ . . @ . . @ @ @ @ . @ @ . . . @ . @ . @ . @ . @ . @ @ @ . @ . . . . @ . @ 
@ . . @ @ @ . . @ . @ . . . . . . . @ . . . @ @ . @ . . @ @ @ @ . @ @ @ @ . . . @ . @ . . @ @ @ . @ @ . @ @ . @ @ . @ @ . @ @ @ . @ @ @ . @ . @ . . . @ . @ . . @ . . . @ . . . @ @ @ @ @ . @ . @ . @ @ 
@ . @ @ @ . @ . . @ . . @ . @ @ @ . @ @ @ @ @ . . . . @ @ @ @ . @ @ @ @ . . @ . . @ . . @ . @ . . . . . . . . . . . . . . . . . . . @ . . . . . @ @ @ . @ . @ . . @ . @ @ . @ . . @ @ . . . . @ . . . @ 
@ @ . . . . . . @ @ @ . . @ . . . . . . . . . . @ @ @ @ @ @ . . @ @ . @ @ @ @ . @ . @ @ @ . . @ . @ . @ @ @ . @ . @ . @ @ . @ . @ . . . @ @ . @ @ @ @ . @ . . @ @ . . . . @ . . @ . . @ @ . @ . @ . @ @ 
@ @ @ . @ . @ . . @ @ . @ @ @ . @ . @ . @ . @ . . . @ . @ . @ . . . . . . @ @ @ . . . . . . @ . @ @ @ . @ . . . @ . . . . @ @ . . @ . @ @ @ . . @ @ @ . @ . @ @ @ @ . @ . . @ @ . @ . . . . . . . . . @ 
@ @ @ @ . . . @ @ . . . . @ . @ . . @ . . @ . . @ . . . . . . . @ @ @ @ @ @ @ @ @ @ @ @ @ . . . . . . . . @ . @ @ . @ . @ . @ . @ @ . . @ . . @ . @ . . . . . @ . . . . @ . . @ . . . @ @ @ . @ . @ . @ 
@ @ @ @ @ . @ @ . @ @ . @ @ . @ @ @ @ . @ @ @ . @ . @ . @ . @ . . . . . . @ . @ . . . . . . @ . @ . @ . @ . @ @ @ . @ . . . @ . . . @ @ @ @ . . . . . @ @ . @ @ @ @ . @ . . @ @ @ @ . @ . @ . . @ . . @ 
@ @ @ @ @ @ . . . . . . . . . . . . . @ . @ . . . @ @ @ @ @ @ . @ . @ . @ @ . . @ @ @ . @ . @ . . @ . . @ . . @ @ . @ . @ . . @ . @ . . @ . . @ . @ . . . @ @ . @ . . . @ . . @ . . . . . . @ @ @ @ . @ 
@ @ @ @ @ . @ . @ @ . @ . @ @ . @ @ . . . @ @ . @ . @ . @ @ . . . @ . @ . @ . @ . @ . . . @ . . @ @ @ . . . @ . @ @ . . . @ . . @ . @ . @ @ . @ @ . @ . @ . @ . . @ @ @ @ . @ . . @ @ @ . @ . @ @ @ @ @ 
@ @ @ @ . . @ @ . . . @ . . @ . . . @ . @ . . @ . . . . . @ @ . @ @ . . . . . . . . @ . @ @ @ @ @ @ . . @ @ . . . . @ . @ . . @ @ . . . . . @ . @ . . @ @ . @ . @ . @ . . . . @ . @ . . @ @ . @ @ . . @ 
@ @ @ . @ . @ @ . @ . @ . @ . . @ @ . @ . . @ @ @ . @ . @ . . . . . . @ @ . @ . @ @ . @ . @ . @ . @ . @ . @ . @ . @ . . . @ . . . . @ . @ . . . . @ . . . . @ . . . @ . @ . @ @ . . @ . . . . . . . @ @ 
@ @ . . . . . @ . @ @ @ @ @ @ . . . . @ . @ . @ . @ . . @ . @ @ . @ . . @ @ . . . . . . . . . . . . . . . . . . @ . @ @ . . @ . @ @ . . . @ @ @ . @ . @ @ . . . @ @ . @ @ @ . . . @ . . @ . @ . @ @ @ @ 
@ . @ . @ . @ . . . @ @ @ @ . . @ @ . . . . . . . . @ . . . @ . . @ . @ @ @ @ . @ @ . @ . @ . @ @ @ @ . @ . @ . . . @ . @ @ @ @ @ @ @ . @ . . @ . . . . @ . @ . . . . . @ . @ @ . @ . @ . @ . @ . . @ @ 
@ . . . . @ . @ @ @ . @ @ @ @ . . @ . @ . @ . @ . @ . @ @ . . @ . . @ @ @ @ @ . . . @ . . . @ @ @ @ @ @ . . @ . @ . . . . . . . @ @ @ @ @ @ . . . @ . @ . . . @ . @ . @ . . . . . . . . . . . @ . @ . @ 
@ . @ @ . . . . . @ . @ @ @ @ @ . @ . . @ @ @ . . @ . . @ . @ . . @ @ @ @ @ @ @ . @ @ @ . @ @ @ @ @ @ @ @ . . @ . @ @ . @ @ . @ . @ @ @ @ @ @ . @ . @ . @ . @ @ . @ . . . @ @ @ . @ . @ . @ . . . . . @ 
@ . . . @ . @ . @ . . @ . . @ . . . @ . . . . @ . . . @ @ @ @ . @ @ @ @ @ @ @ @ @ @ @ @ @ @ @ @ @ @ @ @ . @ . . . . . @ @ @ @ @ . . @ @ @ @ @ @ . . @ . @ . . . @ @ . @ . @ . . @ @ @ @ . @ . @ . @ . @ 
@ . @ . . @ @ . . . @ . . @ . . @ . . @ . @ . . @ . @ . @ @ . @ @ @ @ @ @ @ @ @ @ @ @ @ @ @ @ @ @ @ . . . . . @ @ . @ @ @ @ . . . @ . @ @ @ @ @ @ . . . . . @ . . . @ . . . . @ @ @ @ @ . . @ . . . @ @ 
@ . . @ . . . @ . @ . @ . @ @ . . @ . . @ . . @ @ . . . . . . . @ @ @ @ @ @ @ @ @ @ @ @ @ @ @ @ @ . . @ . @ . . . @ @ @ @ . . @ . @ . . . . @ @ . . @ . @ . . @ . @ @ @ . @ . @ @ @ . . . @ @ @ . @ @ @ 
@ . @ . . @ @ . . . . . . . . . @ @ @ @ . @ . . . @ . @ . @ . @ @ @ @ . @ @ @ @ @ @ @ @ @ @ @ @ @ @ . . @ . . @ . @ @ @ . . @ . @ @ . @ . @ . @ @ . . @ @ @ @ @ . . @ . . . @ . @ . . @ . . . . @ @ . @ 
@ . . @ . . . @ . @ . @ . @ @ @ . @ @ @ . . . @ . . @ @ @ . . . @ @ . . @ @ @ @ @ @ @ @ @ @ @ @ @ @ . @ @ . @ . @ . @ . @ . . . . . . . @ @ . @ . @ . . @ @ @ @ . @ @ @ . @ @ . . @ . @ . @ @ . . . . @ 
@ . @ . @ . @ @ . . @ . . . . . . . @ . @ . @ @ @ . @ @ . @ . @ @ . @ . @ . @ @ @ @ @ @ @ @ @ @ @ @ @ . . . . . . . . . . . @ . @ . @ @ . . . . . . . @ @ . @ . @ . @ @ @ @ @ @ . @ @ . . @ @ @ @ . @ @ 
@ . @ . @ . @ @ . @ . @ . @ . @ @ . @ . . . @ . @ @ . @ . @ . @ . . . . . . @ @ @ @ @ @ @ @ @ @ @ @ @ @ @ . @ . @ . @ @ . @ . . . @ @ . . @ . @ . @ . . . . . . . . . . . . . . . . . @ @ @ @ . @ . . @ 
@ . . . . @ @ . @ @ . @ . . @ . . . @ . @ . . . . @ . @ . . . @ . @ . @ . @ . @ . @ @ @ @ @ @ @ @ @ @ @ . @ @ . . @ . @ . @ @ @ @ . @ . @ . . . @ . @ . @ @ . @ @ . @ @ . @ . @ . @ @ . @ @ . . . . @ @ 
@ . @ . @ @ . . . . . . . @ . @ @ @ @ @ . . @ @ . . . @ @ @ . . @ . @ . . . . . . @ @ @ @ @ @ @ @ @ @ . . . . @ @ . . @ . . . . . . . @ @ @ @ . @ . . . @ . . . . @ . @ . . @ @ . . . . . . @ . @ . . @ 
@ . @ @ . @ . @ . @ . @ . . . . . @ @ @ . @ . . . @ . . . . @ . . . . . @ . @ . @ @ @ @ @ @ @ @ @ . @ . @ @ . @ . @ . . . @ . @ . @ . . @ @ @ @ . . @ . . @ . @ . . . . @ . . . @ . @ @ . @ . @ . . @ @ 
@ @ . . . @ @ . . @ @ . . @ @ @ . . @ @ @ @ @ @ . . @ @ . @ @ @ . @ . @ . . . @ @ @ @ @ @ @ @ @ . . . @ @ @ . . . @ @ . @ . @ . . . @ @ @ @ @ @ . @ . . @ . @ . @ @ @ @ . @ . @ @ @ . . @ . . . @ . @ @ 
@ @ @ . @ . . @ @ . . @ . . @ . . @ . @ @ @ @ @ @ . . . @ @ @ @ @ . . . @ . @ @ @ . @ @ @ @ @ @ @ . @ . @ . . @ . . . . @ . @ @ . @ . @ @ @ @ @ @ . . @ . . . . . . . . . @ @ . @ . @ . @ . @ . @ . . @ 
@ . . . . . @ @ @ @ . . . @ . @ @ . . . @ @ @ @ @ @ . @ @ @ @ @ @ @ . @ . @ @ @ . . . @ @ @ @ @ . . . . . @ . @ . @ @ . . . . . @ . . . . @ @ @ @ @ . @ . @ . @ @ @ . @ . . . . . . . . . . . @ . . @ @ 
@ . @ . @ . . . @ . . @ . . . . . @ @ . @ @ @ @ @ @ . . @ @ @ @ @ . . . . @ . . @ . @ . @ @ @ @ . @ . @ . . . . @ @ . . @ . @ . . . @ . @ @ @ @ @ @ @ . @ . . . . @ . . @ . @ @ . @ @ @ @ @ @ . @ . . @ 
@ . . @ @ @ @ . @ . @ @ @ . @ @ . @ . . . @ . @ @ . . @ @ @ @ @ @ @ . @ . @ @ . . . . . . @ @ . . . @ . . @ . @ @ @ @ . @ . . @ . @ . . . @ @ @ @ @ @ . . @ . @ @ . @ @ . @ @ . . @ . . . . . . @ . @ @ 
@ @ @ . . . . . . . . @ . . @ @ . . @ . @ . . . @ @ . @ @ @ @ @ @ . . . @ @ @ @ . @ . @ @ @ @ @ . @ . @ . @ . . @ @ @ @ . . @ . @ . @ . @ @ @ @ @ @ . @ . . . . @ . . . . . @ . @ . . @ @ @ . @ . . @ @ 
@ . . . @ . @ . @ . @ . @ . . . @ . . . . @ . @ . @ @ @ @ @ @ @ . . @ @ @ @ @ @ @ . . . @ @ . . . @ . . @ . . @ @ @ @ @ @ . . . . . . @ @ @ @ @ @ @ . . @ @ . @ . . @ . @ . . @ . @ . . . @ @ . @ @ . @ 
@ . @ @ . . @ . . @ @ . @ . @ @ @ @ . @ . . . . . . @ @ @ @ @ @ @ @ @ @ @ @ @ @ @ @ @ . . . @ . @ @ . @ . @ . . @ @ @ @ @ . @ . @ . @ @ @ @ . @ . . . @ @ . . . . @ . @ . @ . . . . . @ . . . . . . . @ 
@ @ @ @ @ . @ . @ . . . @ . @ . @ @ . @ . @ @ . @ . @ @ @ @ @ @ @ @ @ @ @ @ @ @ @ @ . . @ . @ @ . . . . . . . @ @ @ @ @ . @ @ . . @ . @ @ @ . . @ @ . . . . @ @ . . . . . . @ . @ . @ . . @ . @ @ . @ @ 
@ . . . . . @ . . @ @ . . . @ . . @ . . @ @ @ . . @ @ @ @ @ @ @ @ @ @ @ @ @ @ @ @ @ @ . @ @ . . @ . @ @ . @ . @ @ @ . @ . . . @ . . . . @ . . @ . @ . @ . @ . . . @ . @ @ . @ . . @ @ @ . . @ . . . . @ 
@ @ . @ . @ . . @ . . . @ . @ @ . . . @ @ @ @ @ @ @ @ @ @ @ @ @ @ @ @ @ @ @ @ @ @ . . . . . . @ . @ . . @ . . @ . @ . @ @ . @ . @ . @ . . @ . . . . . . @ . . @ . . @ @ @ @ . . @ @ @ . . @ @ . @ . @ @ 
@ . . . @ @ @ . @ . @ . . @ @ . . @ . @ @ @ @ @ @ @ @ @ @ @ @ @ @ @ @ @ @ @ @ @ @ @ @ @ . @ . . . @ . @ . @ . . . . . @ . . . . . . . @ . . . @ . @ . @ @ @ . @ . @ . @ @ . @ @ @ @ @ @ @ @ @ . @ . @ @ 
@ @ @ . . @ . . . @ . . @ . . @ . . @ @ @ @ @ @ @ @ @ @ @ @ @ @ @ @ @ @ @ @ @ @ @ @ . @ . . @ @ . . . . . . . @ . @ . @ @ . @ . @ . @ . @ . @ . . . @ @ @ @ . @ . . . . . . . . @ @ @ @ @ @ @ @ . . . @ 
@ . . . @ @ @ @ . @ @ . . @ . . . @ @ @ @ @ @ @ @ @ @ @ @ @ @ @ @ @ @ @ @ @ @ @ . . . . . @ @ @ @ . @ @ . @ . . @ @ @ . . . @ @ . . @ . . . @ @ . @ @ @ @ @ @ @ @ @ . @ @ @ @ . . @ @ @ @ @ @ @ @ . @ @ 
@ @ @ @ @ @ @ @ @ @ @ @ @ @ @ @ @ @ @ @ @ @ @ @ @ @ @ @ @ @ @ @ @ @ @ @ @ @ @ @ @ @ @ @ @ @ @ @ @ @ @ @ @ @ @ @ @ @ @ @ @ @ @ @ @ @ @ @ @ @ @ @ @ @ @ @ @ @ @ @ @ @ @ @ @ @ @ @ @ @ @ @ @ @ @ @ @ @ @ @ 
3
17 82 90 81
16 96 13 93
31 32 24 70
