10 10
@ @ @ @ @ @ @ @ @ @ 
@ . @ . @ . @ @ @ @ 
@ . @ . . . . . @ @ 
@ . . @ . @ . @ @ @ 
@ . @ . . . @ @ @ @ 
@ . . . @ . @ @ @ @ 
@ @ @ . . @ . . . @ 
@ . @ . @ . @ . @ @ 
@ . . . . . . . . @ 
@ @ @ @ @ @ @ @ @ @ 
3
8 4 8 1
7 3 3 2
5 2 3 6
