50 50
@ @ @ @ @ @ @ @ @ @ @ @ @ @ @ @ @ @ @ @ @ @ @ @ @ @ @ @ @ @ @ @ @ @ @ @ @ @ @ @ @ @ @ @ @ @ @ @ @ @ 
@ @ @ @ @ @ @ @ @ @ @ @ @ @ @ @ @ @ @ @ @ @ . @ @ @ @ @ @ @ . . @ @ @ @ @ @ . . . . . . . . . . @ @ 
@ @ @ @ @ @ @ @ @ @ @ @ @ @ @ @ @ @ @ @ @ @ . . . @ @ . @ . . @ . @ @ @ . . . @ . @ @ . @ . @ . . @ 
@ @ @ @ @ @ @ @ @ @ @ @ @ @ @ @ @ @ @ @ @ @ . @ . @ . . . @ . . . . . . @ @ . . @ @ . @ . . . @ @ @ 
@ @ @ @ @ @ @ @ @ @ @ @ @ @ @ @ . @ @ @ @ . . @ . @ @ . @ . . @ . @ . @ @ . . @ @ . . . @ . @ @ @ @ 
@ @ @ @ @ @ @ @ @ @ @ @ @ @ @ . . . @ @ @ . @ . @ . @ . . @ . . @ . @ @ . @ . @ . @ . @ . @ @ . @ @ 
@ @ @ @ @ @ @ @ @ @ @ @ @ @ . @ . @ . @ . . . . . . . . @ @ . @ . . . @ . @ . . . . . . . . . . @ @ 
@ @ @ @ @ @ @ @ @ @ @ @ . . . . . . . . . @ . @ . @ . @ . . . . . @ @ . . . . @ . @ @ @ . @ . @ @ @ 
@ @ @ @ @ @ @ @ @ @ @ @ @ . @ @ . @ . @ @ . . . @ . . @ @ . @ @ @ @ . . @ . @ @ @ . @ . @ @ @ @ @ @ 
@ @ @ @ @ @ @ @ @ . . @ @ @ @ @ @ @ @ . . @ . @ @ . @ @ . . . . @ @ @ . @ . . . . . . . . @ @ @ @ @ 
@ @ @ @ @ @ @ @ . @ . . @ @ @ @ . @ . @ . . . . . @ @ @ @ . @ @ . . @ . . @ . @ . @ @ @ . . @ @ @ @ 
@ @ @ @ @ @ @ . . . @ . . @ @ @ . . . . @ . @ . @ . . @ @ . . @ . @ . @ . . @ @ @ . . @ . @ @ @ @ @ 
@ @ . @ @ . @ @ . @ . . @ @ @ . @ @ . @ . @ . . @ . @ . @ . @ . . . . . . @ @ @ . . @ . @ @ . @ @ @ 
@ . . . . . . @ . @ @ . @ @ . . @ @ . . . . @ . . . . . . . . . @ . @ . @ . @ . . @ @ . . . . . . @ 
@ @ @ . @ . @ . . . @ . . . @ . . . @ @ . @ @ . @ @ . @ . @ @ @ . @ . . @ . . @ . . . . @ . @ . @ @ 
@ . . . @ . . . @ @ @ @ . @ . @ @ . @ . . . @ . . @ @ . . . . . . . @ @ @ @ . . . @ @ @ . . . @ @ @ 
@ . @ @ . . @ @ @ @ @ . . . . . . . . @ . @ . . @ . . @ @ @ @ . @ . . . @ . . @ . . . @ @ . @ @ @ @ 
@ @ . . @ . . . @ @ . @ . @ . @ . @ . . . @ @ . . . @ @ @ @ . . . @ . @ . @ . @ @ . @ @ @ @ @ @ @ @ 
@ . @ . . . @ @ . . . . . . @ . @ . @ @ . . @ . @ @ . @ @ @ @ . @ @ . . . . . . @ @ @ @ @ @ @ @ @ @ 
@ . . @ @ . . . @ @ . @ . @ . . . . . @ . @ @ . . . . . @ @ . . . . @ . @ . @ . . @ @ @ @ @ @ @ @ @ 
@ @ . . . @ . @ . @ @ . . . @ @ . @ . . . @ . . @ @ . @ @ @ @ . @ . . @ @ @ . . @ @ @ @ @ @ @ @ @ @ 
@ . @ @ . . . . . . @ . @ . @ . @ @ @ @ . . @ . . . @ . . @ . . . @ @ @ @ . @ @ @ @ @ @ @ @ @ @ @ @ 
@ . . . . @ . @ . @ . . @ . . . . @ . . @ . @ . @ . @ . @ . @ . @ @ . @ . . . @ @ @ @ @ @ @ @ @ @ @ 
@ . @ @ @ @ @ . . . @ . . @ . @ @ @ . @ . . . . . @ @ . . . . @ . @ . @ @ . @ . @ @ @ @ @ @ @ @ @ @ 
@ . . @ . @ . @ . @ . @ @ . @ @ @ . . . . @ . @ . . . . @ @ @ @ . . . . . . . . . @ @ @ @ @ @ @ @ @ 
@ . @ . . @ . . . . . . . . . . @ @ . @ @ . @ . . @ @ . . . . @ @ . @ @ . @ @ @ . . . @ @ @ @ @ @ @ 
@ @ . @ . . @ @ . @ . @ . @ @ . . . . . . . @ @ . . @ . @ @ . @ @ @ @ @ @ . @ . . @ . @ @ @ @ @ @ @ 
@ . . . . @ . . . . @ @ @ @ @ . @ . @ . @ . . . @ @ . @ @ . @ . @ . @ . . . . @ . @ @ . . @ @ @ @ @ 
@ @ . @ @ @ @ @ . @ . . @ . @ @ @ . . @ @ @ . @ . @ . . . . . . . . . . @ @ . . . . @ . @ . @ @ @ @ 
@ . . . . @ . @ . . . @ . . . . . @ . . @ @ . . . . . @ @ @ @ . @ @ @ . @ . . @ @ . . . . . . . . @ 
@ @ . @ . @ . @ . @ @ . @ . @ @ @ . @ @ . . . @ . @ . . @ . . . @ @ @ . @ @ . @ @ . @ . @ . @ . @ @ 
@ . . @ @ @ . . . . @ . @ . @ @ @ . . . @ @ . @ @ @ . @ . . @ . . . . @ . . @ . . . . @ . . . @ @ @ 
@ @ . . @ . @ @ . @ . . . . . . . . @ @ . . . . . . @ . . @ @ @ @ . @ . . @ @ @ @ . @ . @ . @ @ @ @ 
@ @ @ . . . . . . . . @ . @ @ . @ @ . . @ @ . @ @ . . @ @ . @ @ . @ @ . @ @ . @ . . @ . . @ @ @ @ @ 
@ @ @ @ @ . @ . @ @ @ @ @ @ @ @ @ . . @ @ @ @ . . . @ @ @ . . . . . @ . . . . . @ @ . . @ @ @ . @ @ 
@ @ @ . . . . @ @ . . @ @ @ @ @ . . @ . @ @ . . @ . . @ @ . @ @ @ . . . @ @ @ @ . @ . @ . @ . . . @ 
@ @ . @ . @ @ @ . @ . . @ @ @ . @ . @ . @ @ @ @ @ . @ . . . . @ . . @ . . . . . . . . . . . . @ @ @ 
@ . . . . . . . . . . @ . . . . . . . . . @ @ @ @ . . @ @ . @ . @ . . @ . @ . @ . @ . @ . @ . . . @ 
@ . @ . @ . @ . @ @ . . . @ . @ . @ . @ . . @ @ @ . @ @ . . . . . @ . . @ . . @ . . @ @ . . @ @ . @ 
@ @ . . @ @ . . @ . @ . @ . @ . . @ . . @ . . @ @ . @ . @ . @ @ @ @ . @ . . @ . . @ . . @ . . . @ @ 
@ @ @ . @ . @ . . . . @ . . . @ . . @ @ @ @ . . . @ @ . @ . @ . @ @ @ . @ . @ . @ @ @ . @ . @ . @ @ 
@ @ @ @ . . . . @ . @ @ @ @ . @ @ . . . @ . . @ . @ . . @ . . . . @ . . . @ @ @ . @ . . @ . . @ @ @ 
@ @ @ @ @ . @ . @ . . . . . . . . @ . @ . @ . . @ . @ . @ . @ . @ . . @ . . @ . . @ @ . @ . @ @ @ @ 
@ @ @ @ . @ @ . . @ . @ . @ @ @ . @ @ . . . . @ . . . . . . @ @ . . @ . . @ @ @ . . @ . @ . . @ @ @ 
@ @ . . . . . . @ @ . . @ . . . @ @ @ @ . @ . . . @ @ @ . @ . . . @ . @ @ . @ . . @ . . . @ . @ @ @ 
@ . @ . @ @ @ . . . @ . . . @ . . @ @ @ @ @ . @ @ @ @ @ . . . @ . . . . . . . @ . . . @ @ . @ @ @ @ 
@ . . . . @ . . @ @ . . @ @ @ . @ . @ @ . @ . @ @ @ @ @ . @ @ . @ @ @ . @ . @ . @ . @ . @ . @ @ @ @ 
@ . @ . @ @ . @ @ @ @ . . @ . . . . . . . . @ @ @ @ @ . . . @ . @ @ @ @ . . . . . . . . . . . @ @ @ 
@ @ . . @ . . . @ @ @ @ . @ @ . @ . @ . @ . @ @ @ @ @ @ @ . . . . @ @ @ @ . @ . @ . @ . @ . @ @ @ @ 
@ @ @ @ @ @ @ @ @ @ @ @ @ @ @ @ @ @ @ @ @ @ @ @ @ @ @ @ @ @ @ @ @ @ @ @ @ @ @ @ @ @ @ @ @ @ @ @ @ @ 
3
45 9 37 15
37 8 29 37
48 21 18 5
