100 100
@ @ @ @ @ @ @ @ @ @ @ @ @ @ @ @ @ @ @ @ @ @ @ @ @ @ @ @ @ @ @ @ @ @ @ @ @ @ @ @ @ @ @ @ @ @ @ @ @ @ @ @ @ @ @ @ @ @ @ @ @ @ @ @ @ @ @ @ @ @ @ @ @ @ @ @ @ @ @ @ @ @ @ @ @ @ @ @ @ @ @ @ @ @ @ @ @ @ @ @ 
@ @ @ . . . @ @ . @ . @ @ . @ . @ @ @ @ . . . . . @ . . . @ . . . @ @ @ . @ @ @ @ @ @ @ @ @ @ @ @ @ @ @ @ @ @ @ @ @ @ @ @ @ @ . @ . . . . . @ . @ @ . @ . . . . . . . . . . . @ @ @ . . @ . . . @ @ @ @ 
@ . @ . @ @ @ . . @ . . . . . . . @ @ @ @ . @ @ . . @ . @ . . @ . . @ . . . @ @ . @ @ @ @ @ @ @ @ @ @ @ @ @ @ @ @ @ @ @ @ @ . . . . @ @ @ @ . . . @ . @ @ . @ @ @ @ . @ @ . @ @ @ @ . @ . @ . @ . @ @ @ 
@ . . . @ . @ . @ @ . @ . @ @ . @ @ @ @ @ . @ . . @ . . . @ . @ . @ . @ . @ . . . . @ @ @ @ @ @ @ @ @ @ @ @ @ @ @ @ @ @ @ . @ . @ . . . . . @ . @ . . . @ @ @ . . . @ @ . . . . @ . . . . . . . . . @ @ 
@ @ . @ . . . . . . @ @ . . @ . . @ @ @ . @ . @ . . . @ @ . @ . . . . . . . . @ . @ @ @ @ @ @ @ @ @ @ @ @ @ @ @ @ @ @ @ . . . . @ @ . @ . @ @ . @ @ @ . @ . . . @ . . . @ . @ @ . @ . @ @ . @ @ . @ @ @ 
@ @ . @ . @ . @ . @ @ @ . @ . @ . @ . @ . @ . . . @ @ . . . @ @ @ @ . @ . @ . @ . . @ @ @ @ @ @ @ @ @ @ @ @ @ @ @ @ @ @ @ . @ @ . @ . . @ @ @ . . . . . . @ . @ @ . @ @ . . . . . @ . . @ . . . @ . @ @ 
@ . . @ . @ @ . . @ @ . @ . . @ . @ . . . @ . @ . . . . @ . @ . . @ . . @ . . . @ . @ . @ @ @ @ @ @ @ @ @ @ @ @ @ @ @ . . . . @ . . @ . . @ @ @ . @ . @ @ . . . @ . @ . . @ @ @ . @ . @ . . @ @ @ . . @ 
@ @ . . @ . . @ . . . . @ @ . @ . @ @ . @ . @ . . @ . @ . @ @ @ . . @ @ . @ . @ . @ . . @ @ @ @ . @ @ @ @ @ @ @ . @ . . @ . @ . . @ @ . @ . @ . . . @ @ . . @ @ . @ @ . @ . @ @ @ . . . @ . @ @ @ . @ @ 
@ . . @ . @ . . @ . @ . . @ . . . . . . . . . . @ @ . . . . @ . . @ . . . . . . . . @ . . @ . . . . @ . @ @ @ . . . @ @ . . . . @ . . @ . . . @ . @ . @ . @ . @ . @ . . . . . @ . . @ @ . . . @ @ . . @ 
@ . @ . . . @ . @ . @ . @ @ @ . @ . @ @ @ . @ @ @ @ @ . @ @ @ @ . . . @ . @ @ @ @ . . . @ . @ @ . @ . . . @ . @ . @ @ . @ . @ @ . . @ . . @ @ @ . . . . . . . . . . @ . @ @ @ . @ . . @ @ . @ . . . @ @ 
@ . . @ @ . . . @ @ . . . @ . . @ . @ @ . . @ @ @ @ . @ @ . @ . . @ . . @ . @ @ @ . @ . . . @ . . . . @ . @ . . . . . . . . . @ . @ . @ . @ @ @ . @ . @ . @ . @ . @ . . . @ @ . @ . @ . . . . @ @ . . @ 
@ @ . @ . @ @ . . . @ . @ @ @ . . @ @ @ @ @ @ @ @ . . . . . . . @ . . @ @ . . @ . . @ . @ @ . . @ . @ . . @ . @ . @ . @ @ . @ @ . @ . @ . . @ . . . @ . @ @ @ @ @ . @ . @ . . . . . . @ @ . @ @ . @ . @ 
@ @ . . . @ . @ @ . . . @ @ . . @ . @ @ @ @ @ @ @ @ . @ . @ . @ @ @ . . . @ . . @ . @ . . @ @ @ . @ . . @ . @ @ . . @ . . . . @ . @ . @ . @ @ @ @ . @ . @ @ @ @ . . . . . @ @ . @ . @ . @ @ . . . . . @ 
@ . @ @ . . . . . @ @ . . @ @ . . . . @ @ @ @ @ @ @ @ @ . @ @ @ @ @ @ @ @ . . @ . @ @ . @ . @ . . . @ . . . . . @ @ . . @ . @ . . . . @ . . @ . . . @ . . . @ . @ . @ . @ . @ . . @ . . . . . @ @ . @ @ 
@ . . . @ . @ @ . @ . . @ . @ . @ . @ @ @ @ @ @ @ @ @ @ @ @ . . @ @ @ . . @ . . . @ . . . . @ @ . @ . . @ @ . @ @ . @ . . @ . . @ @ . @ . @ @ @ . @ @ @ @ . . . . @ . . @ . @ . @ . . @ . @ . . . @ . @ 
@ @ . @ @ @ @ . . . @ . @ . . . . @ @ @ @ @ @ . @ @ @ @ . @ @ . @ @ @ . @ . @ @ . . @ . @ . . @ . . @ . . . @ @ . . . . @ @ @ . . @ @ . . . @ . . . @ @ . . @ . @ . . @ . . . . . . @ . @ @ . @ . . . @ 
@ . . . . @ @ @ @ . . . . . @ @ @ @ @ @ @ @ @ . . . @ . . . . . @ @ @ . @ . . . . @ @ @ . . @ . @ . @ . @ . @ . @ . @ . . @ . . @ . . @ . @ . @ . @ . @ @ . . @ . . @ . . @ . @ . @ . . @ . . @ . @ . @ 
@ . @ @ @ . @ . . . @ . @ . . @ @ @ @ @ @ @ @ @ . @ . . @ . @ @ . @ . . @ . @ @ . . @ . @ . . . . . . . . @ . . @ @ . . @ . @ . . @ . . . @ . . . . . . . . @ . @ . . @ . . @ @ @ . . @ . @ . @ . . @ @ 
@ . . @ . . . . @ . . @ . . @ @ @ @ @ @ @ . @ . . . . @ . @ @ @ . . @ . @ . @ @ @ . . . . . @ . @ @ @ . @ . @ . @ . @ . . . . . @ . @ @ . . . @ . @ @ @ . @ @ . . @ . . . @ @ @ . . @ . . @ . . @ . @ @ 
@ @ . . @ @ . @ . . @ @ @ . @ @ @ @ . @ . . . @ . @ . @ . @ @ @ . @ . . . @ . @ . @ . @ . @ @ @ . . . . . . . . . . . . @ @ . @ . . . . @ @ . . @ . . . @ @ . . @ . . @ @ . @ . @ . . . @ @ @ @ @ @ @ @ 
@ @ . @ . @ @ . . @ . @ . . @ . . @ . . @ @ . . . . @ . . . @ . . . . @ . . . @ . . @ . . . . . @ @ @ . @ . @ . @ @ @ . . . @ . @ . @ @ . @ . @ . @ @ . . . @ . @ . @ @ . . . . . . @ @ . @ . . @ @ @ @ 
@ @ . . . . @ . @ . . . . @ @ . @ @ . @ . . . @ @ @ . @ . @ . @ . @ @ . . @ @ @ @ . @ @ . @ . @ . . @ . . @ @ @ . @ . . @ . @ . @ . @ . . . . . . . . @ . @ . . @ . . . @ @ . @ @ . . @ . . . @ @ @ @ @ 
@ . @ @ @ . . @ @ @ . @ . . @ . . . . @ . @ . @ . . . . . . . . . . @ . @ . @ @ . . . . . . @ @ @ . . @ @ @ @ . . . @ . . @ . . . . . . @ @ . @ . @ @ @ . . @ . . . @ @ . . @ . . . @ . . @ @ . @ @ @ @ 
@ . @ @ @ . @ @ @ @ . @ . @ . @ . @ . @ . . @ @ @ . @ @ . @ . @ . @ @ . @ . . @ . @ . @ . @ @ @ . . @ @ . @ . @ @ . . . @ @ @ . @ . @ . @ @ @ . . . @ @ . @ . @ . @ . @ . @ . @ @ . @ . @ . @ . . @ @ @ 
@ . @ @ . . . @ . . @ . . . . . @ . . @ . @ @ @ @ . . @ . . @ . @ @ . . @ . @ @ @ . . . @ @ @ @ @ . @ . . . . . . @ @ . . @ @ @ . . . @ . @ . @ @ . @ . . . . . . . . . . . . . . . . . . . . . @ @ @ @ 
@ . @ . @ . @ . . @ . . @ . @ . . @ . . . @ @ . . . @ . @ @ . . . @ @ @ . . . @ @ @ . @ @ @ @ @ . . . @ @ . @ @ . @ . . @ . @ . @ . @ . . @ . . . @ . . @ @ . @ . @ . @ . @ . @ . @ . @ @ . @ . @ @ . @ 
@ . . . . . . . @ . @ . . @ @ . @ . @ . @ . @ @ . @ @ . . @ @ . @ . @ @ @ . @ . @ . @ . @ @ @ . . @ @ . @ @ @ . . . @ . . . @ . @ . . @ . . @ . @ . @ . . @ . . @ @ @ . . . @ . . @ @ @ . . . @ @ . . @ 
@ @ . @ . @ @ . . . . . @ . . @ . . . . . . . . . . . . @ . @ . @ . @ @ . . . . . . . . . @ . @ . . @ . . . . @ @ . . . @ . @ . @ . @ . @ . . . . . . . @ . . @ @ @ . @ . @ . @ . . @ . @ . @ . . . @ @ 
@ . . . @ . @ . @ . @ . . @ . . @ . @ . @ . @ . @ . @ . . . . . . . @ . @ . @ . @ @ @ . @ @ . . . @ . . @ . @ @ @ . @ . . @ . . . . . . . @ . @ . @ @ @ @ @ . . . . . @ @ . . . @ . . . . @ @ . @ . @ @ 
@ @ @ @ . . . @ . @ . @ . . @ . . . . @ . . . @ . . @ . @ . @ . @ . . . . . . @ . . . @ @ @ @ @ . @ . @ . @ @ @ @ @ . @ . . @ . @ . @ @ @ . . @ . . @ . . @ . @ . @ . @ @ @ @ . . . @ . @ . @ . . @ @ @ 
@ @ @ . @ @ . @ . . . . @ . @ @ . @ . . @ . @ . . @ . . . @ . . . @ @ @ . @ . . . @ . @ @ @ . @ . . . . . @ @ @ @ . . . . @ . . @ . . @ . @ . @ . @ . . @ @ . . @ . @ @ . @ @ @ @ . . @ @ . . . @ . @ @ 
@ @ @ . . @ . . . @ @ . . . . . @ . . @ @ @ . . @ @ @ . @ . @ . @ . . @ @ . . @ @ @ . @ . . . @ . @ . @ . . @ @ . @ . @ . @ @ . @ . @ @ . . . . @ . @ . . . @ . . . @ . . . . . . . @ . . . @ @ . . @ @ 
@ @ @ @ . . @ @ . . @ . @ . @ . @ . @ . @ . @ . . . @ . . . . @ . @ . . . @ . . . . @ . . @ . . . . @ . . @ @ . . . @ . . . @ @ . . @ . . @ @ . . . . . @ @ @ . @ @ . . @ . @ . @ . @ . @ @ . @ . @ @ @ 
@ @ @ @ . @ . @ @ . . @ . . . @ . . . . . . . @ . @ @ . @ @ . . . . . @ @ . . @ . @ @ @ @ . . @ . @ @ @ . @ @ @ . @ . @ . @ . . @ . . @ . . @ @ . @ @ @ . . @ . @ . . @ . . . @ . . . . . . . . . . . @ 
@ @ @ . . . . @ @ . @ . @ . @ . @ . @ . @ @ @ . @ . . . @ @ @ @ @ . @ . @ @ . @ @ @ @ @ @ @ . . @ @ . @ @ . . . . . . . . . . @ . . @ . . @ . . . @ @ . . @ . @ . . @ . . @ . . @ . @ . @ @ . @ . @ . @ 
@ @ @ @ . @ . @ @ @ . . . . . . . . . @ @ @ . . . @ @ . . @ . @ . . @ . . @ . . @ @ @ . @ . . @ @ . . . @ @ @ @ @ . @ @ . @ @ @ @ . . @ . . @ @ @ . @ . @ @ . . @ . . @ . @ @ . @ . . @ . @ . . @ . . @ 
@ @ @ . . . @ @ . @ @ . @ . @ . @ @ . . . @ . @ . @ @ @ @ . . . @ . @ . @ @ . @ . @ @ . . @ . . . . @ @ @ . . @ @ @ . . . @ @ @ @ . @ . . @ . @ . . @ . . @ . @ . @ @ . . . . @ . . @ @ . @ . @ @ @ @ @ 
@ @ . @ . @ @ . . . . . . @ . . . @ . @ @ . . @ . . @ . . @ @ . @ @ . . . @ . . . . . @ . . @ @ @ . . @ . . @ @ @ . @ @ . . @ @ @ . . @ . . . . @ . @ . @ . . @ . @ @ @ . @ @ . @ . . . . . @ . @ @ . @ 
@ . . . . . @ . @ . @ @ @ . @ . @ @ . . . . @ . . @ . @ . . @ . @ . @ . @ . @ @ . @ . @ @ . @ . @ . @ . @ . @ . . . . @ . @ @ @ . . @ . . @ @ @ . . @ . . @ . . . . @ . . . @ . @ . @ . @ . . . @ . . @ 
@ . @ @ . @ . @ @ @ . . . . . . . @ . @ . @ @ @ . . . . . @ . . . . . . . . . @ @ . . . @ . . . . . . . . . @ . @ . @ . . . @ . @ . . @ . . . . @ . @ . @ @ . @ . @ @ @ . @ . . . . . @ @ . @ @ . @ . @ 
@ @ . . . . . . @ @ @ . @ . @ . @ @ @ . . @ @ . . @ @ @ . @ @ . @ . @ . @ . @ . . @ . @ @ @ . @ @ . @ . @ . @ . @ @ @ . @ @ . . @ . @ @ . @ . @ . . . . @ . . . @ @ @ @ @ . @ . @ @ @ . . @ @ @ . . . @ 
@ @ @ . @ . @ . . . @ @ @ @ . . . . . @ . @ @ @ . . @ @ . . . @ @ @ @ @ . . @ . @ . @ @ @ @ @ @ . . . @ @ @ . . . @ . . . @ . @ @ . . @ . @ . @ @ @ . @ . . @ @ . @ @ @ . . @ @ . . @ . @ . @ . . @ @ @ 
@ @ @ @ @ . @ @ . @ @ @ @ @ @ . @ . @ @ @ @ @ @ . @ . . . @ . @ . . @ @ @ . . . . . . @ @ @ . . @ @ . . @ . @ . @ . . @ @ . . @ . . @ . . . @ @ @ @ . . . @ . @ . . @ @ @ . @ @ . @ . . . . . @ . . @ @ 
@ . . . . . . . @ . @ @ @ @ . . . @ @ @ @ . @ . @ @ @ @ . @ @ . @ . . @ . . @ @ @ . @ . @ @ . @ . . . @ . . @ . @ . @ . @ . @ @ @ . . @ . @ @ @ @ @ . @ @ . . @ . @ . @ . . . @ . . . @ . @ @ . . @ . @ 
@ @ . @ . @ . @ . . @ . @ . . @ @ @ . . . . . . @ . . @ . . . . . . @ . @ . @ @ @ . @ . @ @ . @ . @ @ . @ . . . . . . . . . . @ . . @ . . . . @ @ . . . @ . @ @ . . . . @ . @ . @ . @ . . @ . . @ . . @ 
@ . @ @ @ . . . @ . . . . @ @ . @ @ . @ . @ @ . . . @ . @ . @ @ @ . . . . . . @ @ @ . . @ @ . . . . . . . . @ . @ . @ . @ . @ . . @ . @ . @ . @ . @ . @ . . . . . @ . @ @ . . . . . . @ @ . @ . . . @ @ 
@ . @ @ . @ @ . . . @ . @ . @ . @ @ @ @ @ @ . . @ @ . . . @ . . @ @ @ . @ . @ . @ @ . @ . . . @ . @ . @ . @ @ @ . @ @ . @ @ . @ . . . . . . @ @ . . . . . @ @ @ . @ . . @ @ @ . @ . @ . . . @ . @ . . @ 
@ . . . . . . . @ . . @ . . @ . . @ . @ . @ . @ . . . @ @ . . @ . @ @ @ . . . . . . . . @ @ . @ . . @ @ . . . . . . @ @ . . . . @ . @ . @ @ . @ . @ . @ @ @ . . . . @ @ @ @ . @ . . . . @ @ @ . . @ . @ 
@ @ @ . @ . @ @ . . @ . @ . . . @ . . . . . . . . @ @ . @ . @ . . . . . @ . @ @ . @ . @ @ . . . @ . . . @ . @ . @ . . . @ @ @ . . . . @ @ @ . . . . @ . @ @ @ @ . @ @ @ . . . . @ . @ @ . @ @ . @ . @ @ 
@ @ @ @ . . @ . . @ . . . @ . @ . @ . @ . @ @ @ @ . @ . @ . . . @ . @ . . . . . @ . . @ . @ . @ . . @ . . @ . . . @ . @ . . . @ @ . @ . @ @ . @ @ @ @ . . @ . @ @ @ . @ @ @ @ . @ . . . . @ . . . . . @ 
@ @ @ @ @ @ . @ . . @ @ . . . . . . . . @ . . . . . . . . . @ . . @ . . @ @ @ . @ @ @ . . . . . @ @ @ . @ . @ @ @ @ . . . @ @ . . . . . . . . . . @ @ . @ @ . . . . . . . . . . . @ . @ @ . @ . @ @ . @ 
@ @ @ @ . . . . . @ @ @ . @ . @ @ @ . @ . @ @ . @ . @ . @ . @ . @ @ . @ . . . @ . . . @ @ . @ . . @ . . . . @ @ @ @ @ @ @ . . . @ . @ @ . @ . @ . . @ . . . . @ @ @ @ . @ @ @ . @ . . . @ . . @ . . . @ 
@ @ @ @ @ @ . @ . . @ . @ . @ . . . . . . . . . . @ . . @ . @ @ @ . @ @ . @ @ @ @ . @ . @ @ . . @ . @ @ @ @ @ @ @ @ @ @ @ . @ @ . @ . . . . @ @ . @ . . @ . @ . . @ . . @ . . . . @ . @ . . @ . @ @ . @ 
@ @ @ @ . . @ . . @ . . . . . . @ @ . @ @ . @ @ . @ @ . . @ @ . . . . @ . . . @ @ . . . . . @ . . . . @ @ @ @ @ @ @ . @ . . . . . @ . @ . @ . @ . @ . @ @ @ @ . @ . @ @ @ . @ . @ @ . . @ . . . . . . @ 
@ @ @ @ . @ . @ . @ . @ . @ . @ @ . . . @ . . @ @ @ @ . @ . . . @ . @ . @ @ . . . . @ @ . @ . . @ . @ . @ @ @ @ @ . . . . @ @ . @ @ @ . . . . . @ @ . . @ . . . . . . @ @ @ . . . . @ . . . @ @ . @ @ @ 
@ @ @ @ . @ . . . . @ @ @ @ . @ . . @ @ . @ @ @ @ @ @ @ @ . @ @ . . @ . @ . . @ . @ . @ @ @ @ . @ . . . . @ @ @ @ @ . @ @ @ @ @ @ @ @ . @ @ . @ . @ . @ . @ @ . @ @ . . @ @ @ . @ . . @ @ . . . @ @ @ @ 
@ . . @ . . . @ . @ @ @ @ . @ @ @ . @ @ . . . @ @ @ @ @ @ @ @ @ @ . . . . @ . @ . . . . @ @ @ @ . . @ . @ @ @ . . . . @ @ @ @ @ @ @ @ @ . @ . @ . . . . . . . . . @ @ @ @ @ @ . . @ @ . @ . @ . . @ @ @ 
@ . @ . . @ @ . . . @ @ . . . @ . . . @ @ . @ @ @ @ @ @ @ @ @ @ . @ @ . @ @ . . @ @ @ @ . @ @ . . @ @ @ . @ . . @ @ @ . . @ @ @ . @ @ . . @ . @ @ @ . @ @ . @ . @ @ @ @ @ @ . . @ . @ . . @ . . @ . @ @ 
@ . . @ . . . @ . @ @ . @ . @ . @ . @ . @ . . @ @ @ @ @ @ @ @ . . . @ . . . . @ . @ . . . @ @ . @ . . @ . . @ . @ . @ . @ . @ @ . @ . @ . . @ . . . . @ @ @ . @ @ @ @ @ @ @ @ . . . . . @ @ @ . . . @ @ 
@ @ . @ @ . @ . . . @ . . . . . . . . . @ . @ @ @ @ @ @ @ @ . @ . @ . @ @ @ . . . . @ @ . . . . . . @ @ @ . . . . . . . . . . @ . . . . . @ . @ @ @ . . @ . . . @ @ @ . @ @ @ @ . @ @ . . @ . . @ @ . @ 
@ @ . . . @ @ @ . @ . . @ . @ . @ . @ @ . . @ @ @ @ @ @ @ @ . . . . . . . . @ @ . @ @ . . @ . @ . @ . @ @ @ @ . @ . @ . @ . @ @ @ . @ @ . @ . @ . @ . @ @ @ . @ @ @ . . . @ . . . . . @ @ . @ . . . . @ 
@ . @ @ . . @ . . . @ @ . . . @ . . . . @ . . @ @ @ @ @ @ @ @ @ . @ . @ . @ . @ . . . @ . @ . . @ . . . . . . . @ . @ . . @ @ @ @ @ . . . . . . . @ . . @ . . @ @ . . @ . . . @ . @ @ . . . . . @ . @ @ 
@ . @ . . @ @ @ . @ @ @ @ . @ . @ . @ . @ . @ . @ @ @ @ @ @ . . . @ . . @ @ . @ . @ . @ . . @ . @ . @ @ @ . @ . . @ @ . @ @ @ @ @ . . @ . @ @ . @ . . @ . @ . @ . @ . . @ . @ @ . . . @ @ . @ . @ . @ @ 
@ . . @ . @ @ @ . @ @ . . @ . . @ . . @ . . . . . @ @ @ . . @ @ . . @ . . @ . @ . . @ . . @ @ @ . . . @ @ @ @ @ @ . . @ @ @ . @ @ @ . @ . @ . @ . @ . . . . . . . . @ @ @ @ . . . @ @ @ @ @ . . . @ @ @ 
@ @ . @ . . @ . . @ . @ . @ @ . . . @ . @ . @ . @ @ @ . @ . . @ . @ . @ @ @ . @ . @ . @ . . @ . . @ @ . @ . . @ @ . @ @ @ . . . @ @ @ @ . . . . . . . @ . @ . @ @ @ @ @ @ @ @ @ . . . @ @ . @ . @ . @ @ 
@ . . . . @ @ @ . @ . . . @ . @ @ . @ . . . @ @ . @ . . . . @ @ . . . . @ . . @ . @ . @ . @ . . @ . . . . @ . . . . . @ @ @ . @ . @ @ @ @ . @ . @ . @ @ @ . @ @ @ @ @ @ . @ @ @ @ . @ @ . . . . . . . @ 
@ @ . @ . . . . . . . @ @ . . @ . . . @ @ . . @ . . @ . @ @ @ . . @ . @ @ @ . @ . @ . . . . . @ . . @ @ . . . @ . @ . . . . . . . . @ . . . . @ . . . . . . . @ @ @ @ . . @ @ @ . @ @ . @ @ @ . @ . @ @ 
@ . @ . @ . @ . @ @ . . . @ . . @ @ . . . . @ @ @ . . . . @ @ @ . @ . . . . . @ . . @ . @ . @ . . @ @ . . @ @ . @ . . @ . @ . @ @ @ . @ . @ @ @ @ . @ . @ . @ . . . . @ . . @ . . . . . . . . . . @ @ @ 
@ . . . @ . . @ @ @ @ @ . . @ . . @ . @ . @ . @ . @ . @ . . . . . . @ . @ . @ @ @ . . . @ . @ . @ @ @ . @ @ . . . @ . . @ . @ . . . . . . @ @ @ @ @ @ @ . @ . @ . @ . . . @ . @ . @ . @ . @ @ . @ @ @ @ 
@ @ . @ @ . @ @ @ @ @ . @ . @ . @ . . @ @ . . . . @ . @ . @ @ @ . @ . @ @ . @ @ @ . @ . @ @ . . . @ . . @ . @ . @ . @ . @ . @ @ . @ . @ @ @ @ @ @ @ @ @ . . . @ @ @ . @ . . . . @ . @ @ @ @ @ . @ @ . @ 
@ @ . . . @ @ @ @ @ . . . . . . . @ . @ . @ . @ . . @ @ . . @ . . . . @ @ @ @ @ @ . . @ . . @ . @ . @ @ . . . . . . . @ . . . . . . @ @ @ @ @ @ @ @ . . . @ . @ . @ @ . . @ @ . @ . . . @ @ @ . . . . @ 
@ . . @ . @ @ @ @ . . @ @ . @ @ . . . . . . @ . . @ . @ . @ . @ . @ @ @ @ @ @ @ . . @ . @ . . . . . . . . @ . @ . @ . . @ @ . @ . @ @ @ @ . . @ @ @ . @ . . @ . . . @ @ . . . @ @ . @ . . @ . . @ . @ @ 
@ . @ . . . @ @ @ @ @ . . @ . @ @ . @ @ . @ . @ . . . . . . . . @ @ @ @ @ @ @ . @ . . . . . @ @ @ @ . @ . . @ @ . . @ @ @ . . . @ @ @ @ . @ . . @ @ @ . . @ . @ . @ @ . . @ . @ . . @ @ . @ . @ . . @ @ 
@ @ . @ @ . . . @ . . @ . . . . . @ @ . . . . . . @ @ @ @ . @ . . . @ @ @ @ @ . @ . @ . @ . . . . . @ . . @ . @ @ @ . @ . @ . @ . @ @ . . @ . @ . @ . . @ . . . . . @ @ . . @ . . @ . . @ . . . @ . @ @ 
@ . . . . . @ @ . . @ . . @ . @ @ . @ @ . @ @ . @ @ @ @ @ @ @ @ . @ . @ @ @ . . . . @ . . @ @ @ @ @ @ @ . . . . . . . . . . . . . @ @ @ . . . . . @ . @ . . @ . @ @ @ @ . @ . @ . @ . @ . @ . @ . @ . @ 
@ . @ . @ . . . @ . @ . @ . . . @ . . . . @ . @ @ @ @ . . . @ . . . . . @ . @ . @ . . @ @ . @ . . . @ @ . @ . @ . @ . @ . @ . @ . . @ @ @ . @ @ @ @ . . . @ . . . @ . . . . . . . . . . . . . . . . . @ 
@ @ @ @ . @ @ . @ . @ @ . @ . @ . @ . @ . . . . @ @ . @ . @ . @ @ . @ . . . . @ . . @ . . . . @ . @ . . . . @ . . . @ . . @ . . @ . @ @ . . . @ . . . @ . @ @ . @ @ @ @ . @ . @ . @ . @ . @ @ . @ . @ @ 
@ . @ . . . . . . . . . . . . . . . . . @ @ . @ . @ . . . . . @ @ @ . . @ @ . . @ . . @ @ . @ . . . @ @ . @ @ @ . @ . @ @ . . @ . . @ . @ . @ . @ . @ . @ . @ . . @ @ @ . @ @ . . @ . @ . . . @ @ . . @ 
@ . . @ . @ . @ . @ . @ . @ . @ . @ . @ @ . . . . . @ @ . @ @ . @ . @ . . . @ . @ . @ . @ . @ . @ @ . @ @ . @ @ @ . . . . @ @ . @ @ . . . . . . . . . . . . @ . @ . . . . . . @ . . @ . . @ . . . @ @ @ 
@ @ . . . . @ . . @ @ . . @ @ . . @ @ @ @ @ @ . @ @ . . . . . . . . . @ @ . @ @ . . . . . . . . . . . . @ . . @ . @ . @ @ . . . . . . @ @ @ @ @ @ @ @ @ . @ . . @ @ . @ @ @ @ . @ @ @ @ . . @ . @ @ . @ 
@ . . @ . @ @ @ @ . . . @ . . @ . @ . @ @ @ . . . . . @ @ @ @ . @ . @ . @ @ . @ @ . @ . @ . @ . @ . @ @ @ . @ . . . . . . . @ @ . @ . . . . . . . . . . @ @ @ @ . @ . . @ . . . @ @ @ . @ . @ . . . . @ 
@ . @ . . . . . . @ . @ . . @ . . . . . @ . @ . @ @ . . . . . @ . @ . . . . . . . . @ . . @ @ . . @ @ @ . . . . @ . @ . @ . @ . @ @ @ . @ . @ . @ @ . @ . @ @ @ . @ . @ . @ . @ . @ @ . @ . @ . @ . @ @ 
@ @ . @ . @ @ @ . . @ . @ . @ @ . @ . @ . . . . . . @ . @ . @ @ . @ . @ @ . @ . @ @ @ @ @ @ . @ @ @ @ @ @ . @ @ . @ . . @ . . . . @ @ . . @ . . @ @ . . . . . . . . . . . . . . . . . . . @ . . @ . . @ 
@ @ . . . . @ . . @ @ . . . . . @ @ @ . @ . @ . @ . . @ @ . . . . . . . . @ . @ @ @ . . . . . . . . @ . . . . . . @ @ . . @ . @ @ @ . . @ @ @ . . @ . @ . @ . @ @ . @ . @ @ . @ . @ @ . @ @ . @ . @ . @ 
@ . . @ . @ . @ @ @ . @ . @ @ . @ . . . . . @ . @ . @ @ @ . @ @ . @ @ @ @ . . . @ . . @ . @ . @ . @ . . @ . @ . @ . . . @ . . . . @ @ @ @ @ . . @ @ . . @ . . . . @ . @ @ @ . . @ @ . . . . @ @ . . @ @ 
@ . @ . . . . . . . . . @ @ . . . . @ . @ . . @ . . . . . @ . . . @ . @ . @ . @ . @ . @ . @ @ . . @ . @ . @ . @ . . @ . @ @ . @ . . . . . . @ @ . @ @ @ . @ . @ . @ . @ @ @ . @ @ @ @ . @ @ . @ . @ . @ 
@ . @ @ . @ . @ . @ . @ . . . @ @ @ . . @ @ . @ . @ . @ @ . @ @ . . . . . . . . . . . . @ . @ @ . . . . . @ . . . @ . . . @ @ . @ . @ . @ . . . . . . @ . . . . @ @ . . @ . . @ @ @ @ @ . . . . . . . @ 
@ @ @ @ @ . . . @ @ @ @ @ @ . . . . @ . @ . . @ . @ . . . . . @ @ . @ . @ @ . @ . @ . @ . . . . . @ . @ @ @ @ @ . . @ . @ . . . . . . @ . . @ . @ . @ . @ @ . @ . . . @ @ @ . . . . @ . . @ . @ . @ . @ 
@ @ @ @ @ @ . @ @ @ @ @ . . . @ . @ . . . @ . @ . . @ . @ . @ . . . . @ @ . . @ @ . @ . . @ . @ . . @ @ . @ . @ . @ @ @ . @ @ . @ . @ @ @ . . @ . . . . . @ @ @ @ . @ . @ @ . @ . @ . @ . . @ . @ . @ @ 
@ @ @ @ @ @ . . @ @ @ . . @ . . @ . @ . @ . . @ . @ . . @ @ @ @ @ . @ @ . @ @ . . . @ . @ . . @ @ @ @ . . . . . . . @ @ . @ . @ @ . . . . @ . . @ . @ @ . . . @ @ . . . . . @ . . . . . . @ . . . . . @ 
@ @ @ @ @ @ . @ @ @ @ @ @ . . @ @ . . . . @ . @ . . @ . . . @ . . @ . . . . . . @ @ @ . . @ . . @ @ . . @ @ . @ . @ . . . @ . @ . @ . @ . . @ . . @ . . . @ . . . . @ . @ . . @ . @ . @ @ . @ . @ @ @ @ 
@ @ @ @ @ @ . . @ @ @ @ @ @ . . . @ @ . @ @ . @ . @ . . @ @ @ . @ @ @ . @ . @ . @ . @ . @ . @ @ @ @ . @ . . @ . . . @ @ . @ . . . . . . @ . . @ . . @ @ . @ . @ . @ . . . @ . . @ @ . . . . . . . . . @ 
@ @ @ @ . @ . @ . @ @ @ @ @ @ . @ @ . @ @ . . @ . @ @ . . . . . @ @ @ @ . . . @ . . . @ . . . . @ . . @ . @ . @ . @ . @ . . @ @ . @ . @ @ . @ . @ . . . @ . . . @ . . @ . . @ . . . @ @ @ . @ . @ @ @ @ 
@ @ @ . . @ . . . . @ @ @ @ . @ . . . @ . @ @ . @ @ . @ . @ . @ . @ @ @ @ . @ . . @ . . @ @ . @ . @ @ @ . . . . . . . . . @ . . . @ . . . @ @ . @ . @ @ @ @ . @ @ @ . @ . @ . @ . @ @ @ . . @ . . . . @ 
@ @ @ @ . . . @ @ . . @ @ . . . . @ . . . . . . . . . . . @ . . . . @ @ . . @ . @ @ @ . @ . . . . . @ . @ . @ . @ @ @ . @ @ @ . @ . . @ . . . . . @ . . . . @ . @ . @ @ . . . . @ . @ . @ @ @ . @ @ @ @ 
@ @ @ @ @ . @ @ . . @ . . . @ @ . @ . @ @ . @ @ @ . @ @ . . @ . @ . . . @ . . . . @ . @ @ @ . @ . @ . . . @ . . . . @ @ @ @ @ @ @ @ @ . . @ . @ . . . @ @ . . . . . . . @ . @ . . . . . . . . @ @ @ @ @ 
@ @ @ @ . . . . @ . . @ . @ . . . @ @ . . . @ @ . . @ @ . @ @ @ . . @ . . . @ . @ . . . @ . . . @ . . @ @ @ @ . @ . . @ @ @ @ @ @ @ @ @ . . @ . . @ . . . @ . @ . @ . @ . . . @ . @ . @ . @ . . . @ . @ 
@ @ @ . . @ @ . @ @ . . @ . . @ . . . @ . @ . . . @ . . . @ @ . @ . . @ . @ . @ @ @ . @ . @ . @ . @ . . @ @ . . . @ . . @ @ @ @ @ @ @ . . @ @ . @ . . @ @ . @ . @ . . @ @ . @ . . . @ . . . @ . @ @ . @ 
@ @ @ @ . . @ . . . @ . . @ . @ . @ @ @ . . @ . @ . . @ . @ . . . . @ . . . . . . . . . . . . . . . . @ @ @ @ . @ . . @ @ @ @ @ @ @ @ . @ @ @ @ @ @ . . . . . . . @ . . . @ @ @ . @ @ @ . @ . . . . . @ 
@ @ @ @ @ @ @ @ @ @ @ @ @ @ @ @ @ @ @ @ @ @ @ @ @ @ @ @ @ @ @ @ @ @ @ @ @ @ @ @ @ @ @ @ @ @ @ @ @ @ @ @ @ @ @ @ @ @ @ @ @ @ @ @ @ @ @ @ @ @ @ @ @ @ @ @ @ @ @ @ @ @ @ @ @ @ @ @ @ @ @ @ @ @ @ @ @ @ @ @ 
3
81 3 53 91
73 9 31 52
61 14 51 8
