12 12
@ @ @ @ @ @ @ @ @ @ @ @ 
@ @ @ . . . . . @ . . @ 
@ @ @ @ . @ . @ @ @ . @ 
@ @ @ . . @ @ @ @ @ . @ 
@ @ . @ . . . . . . . @ 
@ . . . . @ . @ . @ . @ 
@ @ . @ . . @ . . . @ @ 
@ @ @ . . @ . @ @ . . @ 
@ . . @ . . . . . @ @ @ 
@ @ . . . @ . @ . . . @ 
@ @ @ @ . . @ @ . @ @ @ 
@ @ @ @ @ @ @ @ @ @ @ @ 
3
5 3 8 4
7 3 6 2
10 5 5 4
