50 50
@ @ @ @ @ @ @ @ @ @ @ @ @ @ @ @ @ @ @ @ @ @ @ @ @ @ @ @ @ @ @ @ @ @ @ @ @ @ @ @ @ @ @ @ @ @ @ @ @ @ 
@ @ @ . . . @ . . . @ . . . @ . . . . @ . @ @ @ @ @ @ @ @ @ @ . . @ @ @ @ . @ . . @ . . . @ @ @ @ @ 
@ @ @ @ . @ . . @ . . @ . @ . @ . @ . . . . @ . @ @ @ @ @ @ . @ . @ @ . . . . . @ . @ @ . . @ . @ @ 
@ . @ @ . @ @ . . @ . . . . . @ @ . . @ . @ @ . . . . . @ . . . . . . . @ . @ . @ . @ . @ . @ . . @ 
@ . . . . @ @ . @ . @ @ . @ . . . @ . . @ @ @ @ @ . @ . . . @ . @ . @ . . @ . . . . . . . . . . @ @ 
@ @ . @ . . . . . . . . @ @ . @ . @ . @ @ @ @ @ @ @ . @ @ @ . . . @ . . @ @ @ . @ . @ . @ . @ . @ @ 
@ @ @ @ . @ . @ . @ @ . @ @ @ . @ . . . @ @ @ @ @ . . . . @ @ . @ . @ . @ @ @ @ . . @ . @ @ . . @ @ 
@ . . . . . @ . @ @ . @ . @ @ . . @ . @ @ @ @ @ . @ @ . @ . @ @ . . . . @ @ @ @ . @ . @ @ @ @ . . @ 
@ . @ . @ . . . . . . . . . . @ . . . . @ @ @ . . @ . . . . . @ . @ @ . @ @ @ @ @ . . @ @ @ @ . @ @ 
@ . @ @ @ . @ . @ . @ @ . @ @ @ @ @ . @ @ @ . @ . @ @ . @ @ . . @ . @ . @ @ @ @ . @ . @ . @ . . @ @ 
@ . . . . @ @ . . @ @ @ @ . . @ . . . . @ @ . . . . @ . . @ . @ . . . @ . @ @ . . . . @ . . @ . . @ 
@ . @ . @ . . @ . @ . . . . @ . @ . @ . . . @ @ . @ . . @ . @ @ @ . @ . . . . @ @ @ . . . @ . @ . @ 
@ @ . . . . @ . . . @ @ . @ . . @ @ @ . @ . @ @ . . @ . @ . . @ . . . . @ @ @ @ @ @ @ @ . . . . . @ 
@ . . @ @ @ @ @ . @ @ . . . . @ . . . . . @ . @ @ . . . . . @ . @ . @ . . @ @ @ @ @ . @ . @ @ @ . @ 
@ @ . . . @ @ . . @ . @ . @ @ @ @ . @ @ . . . . . @ @ . @ . @ . . . . @ @ @ @ @ @ @ . @ . . @ . . @ 
@ . @ @ . . @ . @ . . . . . @ @ @ @ . . @ @ . @ @ @ . . . @ @ . @ @ @ @ . @ @ . @ @ . @ @ . @ . @ @ 
@ . . . . @ . @ . @ @ @ . @ @ . @ @ @ . . @ . . @ . @ . @ . . . . @ @ . . . . . . @ . . . . . @ @ @ 
@ . @ @ . @ . @ . . . . . . @ . @ @ . @ . @ . @ . . . . . . @ . @ . . @ @ @ @ . @ . . @ . @ @ . . @ 
@ . @ @ . . . @ @ @ @ @ . @ @ . @ . . . . . . . @ . @ . @ . @ . @ . @ . @ . @ . @ @ . . @ . @ @ . @ 
@ . @ . . @ @ . . @ @ @ . . @ . . @ . @ @ @ @ . . . . @ @ @ @ . . . . . . . @ . . . . @ . . . . . @ 
@ @ . @ . . @ . @ . @ . @ . @ . @ . @ . . . . . @ . @ @ @ @ @ . @ @ . @ @ . . @ @ @ . . @ @ . @ . @ 
@ @ . . . @ . . . . @ . . . . . . . . @ . @ . @ . . . @ . @ . . . . @ . @ . @ @ @ @ @ . . . . . @ @ 
@ . . @ . . @ @ . @ . @ @ . @ @ @ . @ @ @ . . . @ . @ @ . . @ . @ . . . . @ @ @ . @ . @ . @ . @ @ @ 
@ . @ @ @ . . . . . . . . . . @ @ . @ @ @ @ . @ @ . . . . @ . . . @ @ . @ @ @ . . @ . . @ . . @ @ @ 
@ @ @ @ @ @ @ . @ @ . @ @ . @ . . @ @ @ . @ @ @ @ @ . @ . @ @ . @ @ . @ @ @ @ @ . @ . @ . @ . . @ @ 
@ @ @ @ @ @ @ @ @ @ @ . . . . @ . . @ . . . @ @ @ . @ . . . . @ @ . . . @ @ @ @ . . . . . . . @ . @ 
@ @ @ @ @ @ @ @ @ @ @ @ . @ . . . @ @ @ . @ . @ . . . @ @ . @ . @ @ @ . @ . @ . . @ . @ . @ . @ . @ 
@ @ @ @ . @ @ @ @ @ @ @ @ . @ . @ @ @ . . . . @ . @ . . . . @ . . @ @ . . . . @ . . @ @ @ @ @ @ . @ 
@ @ @ . . . @ @ @ . . @ . . . . @ . . @ . @ . . @ . . @ . @ . . @ . @ @ @ . @ . @ . @ @ . . . . . @ 
@ @ . @ . @ . @ @ @ . . @ @ @ . . @ . @ @ . @ . . @ . . @ . . @ . . . . . . . . . . . @ @ @ . @ . @ 
@ . . . . . . . @ . . @ . @ . @ . . . . . . @ . @ . . @ . @ . . . @ @ @ . @ @ @ . @ @ @ . . @ . . @ 
@ @ @ @ . @ . @ . @ . . . . . . @ . @ . @ . . . . @ . @ . . . @ . . . . @ @ @ @ @ @ . @ . @ . @ . @ 
@ . . @ @ . . . . . . @ . @ . @ . @ @ @ . @ @ . @ . . . . @ . @ @ @ . @ . . @ @ . @ . @ . . . . . @ 
@ @ . @ . . @ @ . @ . . @ . . @ . @ @ . . . . . . . @ . @ . @ . @ . @ . @ . . . . . . . . @ . @ @ @ 
@ . . . @ @ . . @ @ . @ @ @ . . . @ @ @ . @ . @ @ . . @ . . . . . . . . . . @ . @ @ @ . @ @ @ @ @ @ 
@ . @ . @ @ . @ . . . @ @ . . @ . . @ . @ @ @ . . . @ . . @ . @ . @ . @ . @ @ . . . @ . @ @ . @ @ @ 
@ @ @ . @ . . . . @ . @ @ @ . . @ @ . . . @ . . @ @ . . @ . . . @ . . . @ . . . @ . . @ . . . . . @ 
@ . . . @ . @ . @ . . . . . @ @ . @ @ . @ . @ . . . . @ . @ . @ . @ . @ @ . @ . . @ . . @ @ . @ . @ 
@ . @ . . @ @ @ . @ . @ . @ @ . . . . . . . . . @ @ . . . . @ @ . @ @ . @ @ . . @ . @ . . . . @ . @ 
@ @ . . @ . @ . . . . . @ @ @ @ . @ @ @ @ . @ @ . . @ @ . @ @ . . @ . . . @ @ . . . @ @ @ . @ @ . @ 
@ . @ . . . . . @ . @ . @ . . . . . . . @ @ @ @ . @ @ . . . . @ . @ . @ @ . @ . @ . . @ @ @ . . @ @ 
@ . @ . @ . @ . . @ . . . @ . @ @ . @ . @ @ @ . . . @ @ . @ . . . @ . . . . . @ @ . @ @ @ . @ . . @ 
@ . . . . @ . . @ @ @ @ . . . @ . @ . @ . @ . @ . @ . @ @ . . @ . @ . @ . @ @ . @ . . . . . . . @ @ 
@ @ @ . @ . . @ . @ . . . @ . . . . . . . . . . . . . . . @ @ . @ . . . @ . . . . @ . @ . @ . @ @ @ 
@ @ @ . . @ . . . . @ . @ @ @ @ @ @ . @ . @ . @ . @ . @ . . . . . @ . @ . @ @ . @ . @ @ . . @ @ @ @ 
@ @ @ @ @ . . @ . @ . @ . @ . . . . . @ . . @ . . . @ . . @ . @ . . . . . . . . . . . @ . @ @ @ @ @ 
@ @ @ @ @ @ . . @ @ . . . . . @ @ . @ @ . @ @ . @ @ @ @ . . @ . . @ . @ @ @ @ @ @ @ @ @ @ @ @ @ @ @ 
@ @ @ @ @ @ @ . @ @ @ . @ . @ . . . . @ . @ @ @ @ @ @ . @ . @ @ . . @ @ @ @ @ @ @ @ @ @ @ @ @ @ @ @ 
@ @ @ @ @ @ . . @ @ @ . @ . @ . @ . @ @ @ @ @ @ @ @ . . . . @ . . @ @ @ @ @ @ @ @ @ @ @ @ @ @ @ @ @ 
@ @ @ @ @ @ @ @ @ @ @ @ @ @ @ @ @ @ @ @ @ @ @ @ @ @ @ @ @ @ @ @ @ @ @ @ @ @ @ @ @ @ @ @ @ @ @ @ @ @ 
3
25 19 19 40
7 40 20 22
14 24 30 20
