50 50
@ @ @ @ @ @ @ @ @ @ @ @ @ @ @ @ @ @ @ @ @ @ @ @ @ @ @ @ @ @ @ @ @ @ @ @ @ @ @ @ @ @ @ @ @ @ @ @ @ @ 
@ . . . . . @ . . . @ @ @ @ . @ . . . @ . . . @ @ @ @ @ @ @ @ @ @ @ @ @ . . @ @ @ @ @ . . . . @ @ @ 
@ . @ . @ @ . @ @ . . @ @ . . . @ @ . . . @ @ . @ . @ . @ @ @ @ @ @ . . . @ . @ @ @ . @ . @ @ . @ @ 
@ . . @ @ @ . @ @ . @ . . @ . @ @ . @ @ . @ @ . . . . . @ . @ @ @ . @ @ . . . @ @ . . . . . . . . @ 
@ . @ . @ . . . . . . . @ . . . @ . @ . . . @ . @ . @ . . . . @ . . @ . . @ @ . . @ . @ . @ . @ @ @ 
@ . . . . . @ @ @ . @ . . @ . @ . . . @ . @ . . . @ . @ . @ . . @ . @ @ . . . @ . @ . @ @ . . . . @ 
@ . @ @ @ . @ @ . . . @ . . . . . @ . @ . . . @ . . . . @ @ @ . @ . . @ . @ @ . . . . . @ . @ . @ @ 
@ . . . . @ . . @ . @ @ @ . @ . @ @ . . . @ @ . . @ . @ @ . @ @ . . @ @ . . . @ . @ . @ @ @ . @ @ @ 
@ . @ . @ @ . @ . @ . @ . @ . . @ @ @ @ . @ @ . @ . @ . @ . @ @ @ . . @ . @ @ . . @ . . @ . . . @ @ 
@ . @ @ . . . . . . . @ . . @ . . . @ . . . @ . . . . . . . . @ . . @ . . . @ . @ . . @ . @ . @ . @ 
@ @ @ . . @ . @ . @ @ @ . @ . @ @ @ . @ . @ . . @ @ . @ . @ @ . @ . . @ . @ @ @ . @ . . . . . . . @ 
@ @ . @ . . @ @ . . @ @ . . . @ @ . . . . . @ . . . @ @ @ @ . . . . @ . . . @ @ . . . @ . @ . @ . @ 
@ . . . . @ @ . @ @ @ . . @ . @ @ @ @ . @ . . @ . @ @ @ . @ @ . @ . . @ . @ @ @ @ @ . . @ @ @ . . @ 
@ . @ @ . . @ . . @ @ @ . . @ . @ @ @ @ . . @ @ @ @ @ . . @ . @ . @ . . . . . . @ . . @ . @ . @ @ @ 
@ @ . . . @ . @ . @ @ @ @ . . . . @ @ . @ . @ @ @ @ . . @ . . . . . @ . @ . @ . @ @ . . . . . . . @ 
@ . . @ . . . . . . @ . . . @ . @ @ . . . . @ @ . . . @ . @ @ . @ . @ . @ @ . . @ . . @ . @ . @ @ @ 
@ @ @ . . @ . @ . @ . @ @ . . @ @ @ @ . @ . @ . @ . @ . . . @ . @ . . @ @ . @ . . . @ . @ @ @ . . @ 
@ . . . @ . . @ . . . . . . @ . @ . . @ . . . . . . . @ . @ @ @ . . @ @ . . . @ @ . . . . @ . . @ @ 
@ . @ @ @ @ . . @ @ @ @ @ . . . . . @ . @ . @ @ . @ . . . . @ . @ . @ . @ . @ . @ . @ . @ @ @ . @ @ 
@ . . . @ . . @ @ @ @ . . . @ . @ . . . . . . @ . . @ @ @ . . . . . . . . . . . . . @ @ . @ . . . @ 
@ @ @ @ . @ @ @ @ @ . . @ . @ @ . @ . @ . @ @ . . @ @ . . . @ . @ . @ @ . @ . @ @ . . . . . @ . @ @ 
@ . . @ . @ . @ . @ @ . . @ . . . . . @ . @ . @ . . . @ . @ @ . . @ . . . . @ . @ . @ . @ . . . . @ 
@ . @ . . . . . . . . . @ @ @ @ @ @ . . @ . . . . @ @ @ . @ . . @ . @ . @ @ . . . . @ @ . . @ . @ @ 
@ . . . @ . @ . @ . @ @ . @ . @ . . . @ @ @ . @ . . . . @ @ @ . . . . @ @ . @ . @ @ @ @ @ . . @ @ @ 
@ . @ . . @ . @ . @ . . . . . . . @ . . . . @ @ . @ . @ @ @ . . @ . @ . . . . . @ @ @ @ @ . @ @ @ @ 
@ . @ @ @ . . . . . . @ . @ . @ . . @ . @ @ . . . . @ @ @ @ @ . . @ @ . @ . @ . @ . @ @ . . . @ @ @ 
@ @ @ @ @ @ @ . @ . @ . @ . . @ . @ . . @ . @ . @ . @ @ @ @ @ @ @ @ @ @ . . @ . . . . . @ . @ @ @ @ 
@ . . . . . . . . @ . . . . @ . . @ @ @ @ . @ . . @ @ @ @ @ @ @ @ . @ @ @ @ . @ . @ @ @ . @ @ @ @ @ 
@ @ . @ @ . @ . @ . @ . @ . @ @ . @ . . . . . . @ @ @ @ @ @ @ @ . . @ @ . . . @ . . . @ . . @ @ @ @ 
@ . @ . . @ . . . . . @ . . . . @ . . @ . @ . @ . @ @ @ @ . @ @ @ . . . @ . @ . . @ @ . . @ @ @ @ @ 
@ . . . @ @ @ . @ . @ @ @ @ . @ @ @ @ @ @ . . . . . @ @ . . . @ . . @ . . . . . @ . @ . @ . @ @ . @ 
@ . @ . @ . . . . @ . . @ @ @ @ @ @ . @ @ @ . @ . @ . . @ . @ . @ . . @ . @ @ . . . . . . . . . . @ 
@ . . @ @ @ @ . @ . @ . @ @ @ @ @ . . @ . . . . @ . . @ @ . . . . @ @ @ . @ . . @ . @ @ . @ @ . @ @ 
@ . @ @ @ . . . . . . . . @ @ @ . @ . @ @ @ . @ @ . @ . . . @ . @ @ @ @ @ . . @ . @ . @ @ @ . . . @ 
@ . . @ . . @ . @ . @ . @ . @ . . . . . @ @ @ @ . . @ . @ @ @ . . @ . . @ @ . @ . . . . @ . @ . @ @ 
@ . @ . . @ @ . @ . . @ . . . @ @ @ . @ . @ . . @ . . . . @ . . @ @ . @ . @ @ . @ @ . @ . . . . . @ 
@ . @ . @ . . . . @ . @ @ . @ . . @ . @ . @ . @ @ . @ @ @ . @ . . . . . . . . . . . . . @ @ . @ . @ 
@ . . . @ @ @ . @ @ @ @ . . @ . @ . . . . . . . . . . . . . . @ @ . @ @ @ @ . @ . @ @ @ @ . . @ . @ 
@ @ . @ . . . . . @ . . . @ . . . . @ . @ . @ . @ . @ . @ . @ . . @ @ @ . . @ . @ . . . @ @ @ . . @ 
@ @ . @ @ . @ . @ . @ @ . . . @ . @ . @ . . @ . @ . . @ @ . @ @ . . @ . . @ . . . . @ @ . @ . @ . @ 
@ . @ . @ @ . . . . . . . @ @ @ @ @ . . @ . . @ @ @ . . . @ @ . . @ . @ . @ . @ . @ @ . . . . . . @ 
@ . . . . . @ . @ @ @ @ . . . . . . . @ @ @ . . . . @ . @ . @ @ . . . . . . . . @ @ . @ . @ . @ . @ 
@ @ . @ @ @ . @ . . . @ . @ @ . @ . @ . @ @ . @ . @ . . . . . . . @ . @ . @ . @ . . . . . . @ @ . @ 
@ @ . . . . . . @ . @ @ @ . @ . @ @ . . . @ . . @ . . @ . @ . @ @ . . . @ @ @ @ @ @ . @ . @ @ . . @ 
@ . . @ . @ . @ . . . . . . . . . @ @ . @ . . @ @ @ . @ . . @ . . . @ @ @ @ @ @ @ . . . @ @ @ @ . @ 
@ . @ @ @ . . . @ . @ . @ . @ . @ @ . . . @ . @ . @ @ @ . @ . @ @ . @ @ @ @ . @ @ @ . @ @ @ @ @ . @ 
@ @ . . . . @ . . . @ @ . @ . . @ . . @ @ . . . . . . . @ @ . . @ . @ @ @ @ . . @ . . . . @ @ . . @ 
@ . @ @ @ @ . @ . @ . . . . . @ @ @ . @ . @ . @ . @ @ @ @ . . @ @ @ @ @ @ @ @ . @ @ . @ . @ @ @ . @ 
@ . . . . . . . . . @ . @ . @ . . . . . . . . @ . . . . . . @ @ @ @ @ @ @ @ . . . . . @ @ @ @ . . @ 
@ @ @ @ @ @ @ @ @ @ @ @ @ @ @ @ @ @ @ @ @ @ @ @ @ @ @ @ @ @ @ @ @ @ @ @ @ @ @ @ @ @ @ @ @ @ @ @ @ @ 
3
20 4 18 13
34 43 46 9
13 39 24 14
