10 10
@ @ @ @ @ @ @ @ @ @ 
@ @ . @ @ @ @ . . @ 
@ . . . @ @ . . @ @ 
@ @ . @ @ . @ . . @ 
@ . . @ . . . . @ @ 
@ @ . . @ @ @ . . @ 
@ . . @ . . . . @ @ 
@ . @ . @ @ . @ . @ 
@ . . . . . . . . @ 
@ @ @ @ @ @ @ @ @ @ 
3
6 2 4 2
8 5 8 3
4 4 1 2
