25 25
@ @ @ @ @ @ @ @ @ @ @ @ @ @ @ @ @ @ @ @ @ @ @ @ @ 
@ @ @ . . . @ . @ @ . @ . @ . @ . @ @ @ @ @ @ @ @ 
@ @ @ . @ @ . . . . . . . . . . . . @ @ @ @ @ @ @ 
@ . . . . . @ @ @ . @ . @ @ . @ . @ @ @ @ @ @ @ @ 
@ . @ . @ @ . . @ . . @ . . . . @ @ @ @ @ . @ @ @ 
@ @ @ . . @ . @ . . @ @ . @ . @ . @ @ @ . . . @ @ 
@ . . . @ . . . @ . @ . @ . @ . . . @ @ @ . @ . @ 
@ @ . @ . @ @ . . . . . . . @ @ . @ . @ @ . . . @ 
@ . . . . . . . @ . @ . @ . . . . . . . . . @ . @ 
@ @ . @ . @ . @ . . @ @ . @ . @ . @ . @ @ . @ @ @ 
@ @ @ . . @ @ . . @ . @ . @ . . @ @ . @ @ @ @ @ @ 
@ @ . @ @ . . @ . . . @ . . . @ . @ . @ @ @ @ @ @ 
@ . . . @ @ . @ @ . @ . . @ . . . . @ @ @ @ @ @ @ 
@ @ @ . . . . . . . @ . @ @ @ . @ . @ @ @ . . @ @ 
@ . . . @ @ . @ . @ . . @ @ . . @ @ @ @ @ @ . @ @ 
@ . @ . . . @ . . @ . @ @ . @ . . . . . . . . . @ 
@ . . @ . @ @ @ @ . . @ . . . . @ . @ . @ . @ . @ 
@ . @ . @ . @ . . @ . @ . @ . @ . . . @ . @ . . @ 
@ . . . . . @ @ . @ . @ . @ . . @ . @ . . @ @ . @ 
@ . @ . @ @ . . . . . @ . @ . @ . . . @ . @ . . @ 
@ . @ @ . . @ @ . @ . @ @ . . . @ . @ @ . . @ . @ 
@ . . . @ . @ . @ . . @ . @ . @ . . . . . @ . . @ 
@ . @ . . . . . . @ . @ . . . . @ @ . @ @ @ @ . @ 
@ @ . . @ @ . @ . @ . @ . @ . @ . . . @ @ @ @ @ @ 
@ @ @ @ @ @ @ @ @ @ @ @ @ @ @ @ @ @ @ @ @ @ @ @ @ 
3
7 12 21 3
7 13 2 14
13 4 7 8
