25 25
@ @ @ @ @ @ @ @ @ @ @ @ @ @ @ @ @ @ @ @ @ @ @ @ @ 
@ @ . . @ . @ @ . @ @ @ . @ . @ . . . @ @ . @ @ @ 
@ . @ . . . . . . . . . . . . . @ . @ . @ . . . @ 
@ . . . @ . @ . @ . @ . @ . @ . . . . . @ . @ . @ 
@ . @ . . @ @ @ . . . @ . . . @ @ . @ . . . @ . @ 
@ . @ . @ . @ @ @ . @ . @ . @ . . . . @ . @ @ @ @ 
@ @ . . . . . @ @ . . . . @ . @ @ @ . . @ @ @ @ @ 
@ @ . @ @ . @ . . @ @ @ . . . . . . @ . . . @ @ @ 
@ . . . . @ @ @ . . . . @ . @ . @ . . @ . @ @ @ @ 
@ . @ . @ . . . . @ . @ . . . @ @ @ . . @ @ @ @ @ 
@ . . @ . . @ . @ . . @ @ . @ . @ . . @ @ @ @ @ @ 
@ . @ . . @ . @ . . @ . @ . . . @ @ . . @ @ @ @ @ 
@ . . . @ . . . @ . . . @ . @ . . . @ . @ @ @ @ @ 
@ @ @ . @ @ @ . . . @ . . @ . . @ . . @ . @ @ @ @ 
@ . . . . @ . . @ . @ . @ @ @ . . @ . @ . @ @ @ @ 
@ . @ . @ . . @ . . . @ . @ . @ . . @ . . . . @ @ 
@ @ . @ . @ . . @ . @ @ . . . . . @ @ . @ @ @ . @ 
@ @ . . . . . @ @ . @ . . @ @ @ . @ . . @ @ . . @ 
@ @ . @ . @ . @ @ @ @ @ . . @ . . @ . @ @ . @ . @ 
@ @ @ . . @ @ . . . @ . . @ . @ . . . . . . . . @ 
@ @ @ @ . . . . @ @ @ @ @ . . . . @ . @ . @ . @ @ 
@ @ . . . @ . @ . @ @ . . . @ @ . . @ @ @ . . @ @ 
@ . @ . @ . . . . . . @ @ . @ @ . @ . @ . @ . @ @ 
@ . . . . @ . @ . @ . . . @ . . . . . . . @ @ @ @ 
@ @ @ @ @ @ @ @ @ @ @ @ @ @ @ @ @ @ @ @ @ @ @ @ @ 
3
17 12 14 9
17 5 23 10
19 8 21 12
