12 12
@ @ @ @ @ @ @ @ @ @ @ @ 
@ @ @ @ . @ . . @ . @ @ 
@ @ @ . . . @ . . . . @ 
@ @ . @ . @ . . @ . @ @ 
@ . . . . @ . @ . . . @ 
@ @ . @ . . @ . @ . @ @ 
@ @ @ . @ . . . . . . @ 
@ @ @ . . @ . @ @ . @ @ 
@ . . @ . . @ . . . . @ 
@ @ . @ @ . @ @ . @ . @ 
@ . . . . . . . . . @ @ 
@ @ @ @ @ @ @ @ @ @ @ @ 
3
8 2 8 1
4 10 2 10
4 2 5 5
