100 100
@ @ @ @ @ @ @ @ @ @ @ @ @ @ @ @ @ @ @ @ @ @ @ @ @ @ @ @ @ @ @ @ @ @ @ @ @ @ @ @ @ @ @ @ @ @ @ @ @ @ @ @ @ @ @ @ @ @ @ @ @ @ @ @ @ @ @ @ @ @ @ @ @ @ @ @ @ @ @ @ @ @ @ @ @ @ @ @ @ @ @ @ @ @ @ @ @ @ @ @ 
@ . . . @ @ @ @ @ @ @ @ . @ . . . . @ . . . @ @ . @ . @ @ @ @ @ . . . . . . . @ @ . . @ @ . . @ @ @ . @ . @ @ @ . . . . @ . . @ . . . . . . . . @ @ . . . . @ . . . . @ . @ . @ . . @ . . . @ . @ . @ @ 
@ @ @ . . . . @ @ @ @ @ . . . @ . @ . @ . @ . . . . . . . @ @ @ @ . @ @ . @ . . . @ . @ . @ . . @ . . . . @ @ . @ . @ @ . @ . . @ . @ @ . @ @ . . . . @ @ @ . @ . @ @ . . . . @ . @ . @ @ . . . . . . @ 
@ . . . @ @ @ . @ . @ . @ . @ @ . . . . . . . @ @ . @ . @ @ @ @ @ . @ @ . . @ @ . . . . . . @ . . @ @ @ . . @ . @ . @ . . . @ . . . @ . @ @ @ @ . @ . . . . . . . . . @ @ @ . @ . . . . . @ . @ . @ . @ 
@ . @ . . @ . . . . . . . . . . @ . @ . @ . @ . @ . @ . @ @ @ @ . @ . . . @ . . @ . @ . @ . @ . @ @ @ . @ . . . @ . @ @ . @ . @ @ . @ . @ . @ . @ @ @ @ @ . @ . @ . @ . . . . . . @ . @ . . @ . . . @ @ 
@ @ . @ . . @ @ . @ . @ . @ . @ @ @ . . @ . @ . @ @ @ @ @ @ @ @ . . @ @ @ @ . @ . . . @ @ . @ . . @ . . . . @ . @ . . . . . . . . . . . . . . . . . . . @ . . @ . . . . @ . @ . @ @ . . @ . . @ . @ . @ 
@ . . . . @ . . . . @ . . @ . @ @ @ @ @ . . . . . @ @ @ @ @ @ . @ . @ . . @ . @ @ . @ @ . . @ . @ . @ . @ . . @ . . @ . @ @ . @ . @ . @ . @ @ . @ @ . @ @ . @ . . @ . @ @ . . @ . @ . @ . . @ . . @ . @ 
@ . @ @ . . . @ . @ @ @ . . @ . @ @ @ . . @ . @ . . @ @ @ @ . . . . . @ . . . . . . . @ @ . . . . . . @ @ @ . . . @ @ . @ . @ . @ @ @ . . @ @ . . . @ @ @ @ @ @ . @ . @ . @ . @ . @ @ . @ . . @ . . . @ 
@ . . @ @ @ @ . . . @ . . @ . . . . . @ @ . . . @ . . . @ @ @ . @ . @ @ . @ @ . @ . @ @ @ @ . @ . @ . . @ . . @ . @ . . . . . . . @ @ @ . @ @ . @ . @ @ @ @ @ @ . @ . . . @ @ @ . . . . @ . @ . . @ . @ 
@ . @ . @ @ @ @ . @ @ @ . . . @ . @ . @ @ @ . @ @ @ . @ . @ . . . @ . . . @ @ @ . . @ . @ @ . . @ . @ @ @ @ . . @ . @ . @ @ . @ . . @ @ . . . @ @ @ @ @ @ @ @ @ @ @ . @ @ . . . @ @ . @ @ . @ . @ @ @ @ 
@ @ . . @ . @ . @ . . . . @ . @ . . @ . @ . @ . . @ . . . . @ . @ @ @ . @ . . . . @ . . @ . . @ . . . . @ . . @ . . . . @ @ . . @ . . . @ . @ @ @ . . . . @ . @ . . @ @ . . @ . @ . . . . . . . . . . @ 
@ @ . @ . . . . . @ . @ . . @ @ @ . . . @ . . @ . @ . @ . @ @ . . @ @ @ . . @ @ @ @ @ . @ @ . . @ . @ @ . . @ @ @ . @ . . . @ . . @ . @ @ . @ . . @ @ @ . . . @ . @ . @ . @ . @ @ . @ . @ . @ . @ . @ @ 
@ . . . @ @ . @ . . . @ . @ . @ . . @ . . @ . @ . . . . @ . @ . @ @ @ @ . @ . . . @ . . @ . . @ . . . . . @ . @ @ @ . . @ @ . . @ @ . . . @ . @ . . . . . @ @ . . . . . . . . . @ . . @ . . @ @ @ . @ @ 
@ @ . @ @ @ @ . @ . @ . . @ . @ @ . . @ . . . @ . @ . @ . . . . . @ @ @ @ . @ . @ . @ . . @ . . @ . @ @ . . . @ @ @ @ . @ @ @ . . . @ @ . . . . @ @ . @ . . @ . @ . @ @ @ @ . @ . . @ . @ . . @ . . . @ 
@ . . @ . @ . . @ @ . @ . . . . @ . @ @ . @ . . @ @ @ . @ . @ @ . . @ @ . . @ . @ . @ . @ . @ . . @ . . . @ @ . @ @ @ @ . . . . @ @ @ . . @ . @ . . . @ . @ . . . @ @ . . . @ . . @ . . . . @ @ @ . @ @ 
@ @ . . . @ . @ @ @ . @ . @ . @ @ . . . @ @ @ @ . . . . . @ @ @ . @ @ @ @ . . . . . @ . @ . . . @ . . @ . @ @ . @ @ @ . @ . @ . . @ . @ . @ . . @ @ . @ . . . @ @ . . . @ @ . @ . . @ . @ . @ . @ @ @ @ 
@ . @ @ . @ . . . . . . . . @ @ @ . @ @ . @ . @ @ . @ . @ . @ . . . @ @ @ @ . @ @ . @ . . @ @ . . @ @ @ . . . . . @ . . . . . @ . . . @ . . @ @ . @ @ . . @ @ . @ . @ . @ . . . @ @ . @ . . . . . @ @ @ 
@ . @ . . . @ @ . @ . @ . @ @ @ . . . . . . . . @ . @ . . . . @ @ . . @ @ @ . @ . @ . . @ @ . . @ . @ . . @ @ . @ . . @ @ . @ @ . @ . . @ . . @ . . . @ . @ @ . . . @ @ . @ . @ . @ . . . @ . @ @ @ @ @ 
@ . . @ @ . . @ @ @ @ . . . @ . @ . @ . @ . @ . . . @ . @ . @ @ . @ . . @ . . . . . @ . @ @ . @ . . . @ . . @ @ @ @ . @ . @ . . . @ . @ @ . @ . @ . @ . . . . . @ @ . @ . @ . @ . . @ @ . @ . @ . @ @ @ 
@ @ . @ . @ . . . @ @ @ . @ . . . @ . . . @ . . @ @ @ @ @ @ . . . . @ . . @ . @ . @ @ . . . . . . @ @ . . @ @ . @ @ @ . . . @ @ . @ . . . @ @ . . . . . @ @ @ @ . . . @ . . . @ . @ @ @ . @ . . . . @ @ 
@ . . . . . . @ @ . @ . @ . @ @ . . @ . @ . . @ @ @ @ . @ @ @ . @ . @ . @ . . . @ @ . @ @ @ . @ . @ @ . @ @ . . . . . @ . @ @ . . . @ . @ . . . @ . @ . . . . . . @ @ . . @ . . . . @ @ @ . . @ . @ @ @ 
@ @ . @ . @ . . . . . . @ . @ . @ . @ . @ @ . @ @ . . . . @ @ @ . . @ . . @ . @ . . . . @ . . . @ . . . . @ . @ . @ . . . . . @ . @ . @ . @ . @ . . @ . @ @ @ @ @ . @ @ @ . . @ @ . @ @ . @ . . @ @ @ @ 
@ @ @ . . . @ . @ . @ @ . . . . . . . . . . @ . @ @ . @ . @ @ . @ . . . @ . . . @ @ . @ . @ . @ . @ @ . @ . @ @ @ . . @ . @ . @ @ . . . . @ @ @ . @ @ . . . . @ . . . @ . . @ . @ . @ . . . . @ @ @ @ @ 
@ @ @ @ . @ @ @ @ . . . . @ . @ @ . @ . @ @ @ . @ @ @ @ . . . . @ . @ . . @ @ . @ . . . . . . . . . . . . . . @ @ @ . . @ @ @ @ @ @ . @ @ @ . @ . @ . @ . @ @ . . @ @ @ @ . @ . . @ @ @ . @ . @ @ @ @ @ 
@ @ @ . @ @ @ . @ @ @ . @ . . @ @ @ . . . . . . . @ @ . @ . @ @ @ @ . . @ @ . . . @ . @ . @ @ . @ . @ . @ . @ @ @ . . @ . @ @ @ . . . . . . . . . . . @ . @ . @ . . @ @ @ . @ . @ . @ . . @ @ @ @ @ @ @ 
@ @ @ . @ @ . . @ @ @ @ @ @ . . . @ @ . @ . @ @ @ @ @ . @ . . . @ . @ . . @ @ @ . . . . @ . . . @ . . @ . @ @ @ @ @ . . . . @ @ @ . @ . @ @ . @ . @ . . @ . . @ . @ . @ . . . . . . . @ @ @ @ @ @ @ @ @ 
@ @ . . . @ @ . . @ @ @ @ @ . @ . @ @ @ . . . . . @ . . . . @ @ . . @ . @ @ @ @ @ @ . @ . @ @ . @ . @ . . . @ @ @ @ . @ . @ @ @ @ @ @ @ . . . @ . . @ @ @ @ . @ . @ . . @ . @ . @ . @ . @ @ @ @ @ @ @ @ 
@ . @ . @ . @ . @ . @ @ . @ @ . . @ @ . @ . @ . @ . @ @ @ . @ . @ . @ . @ . @ @ @ . . . . . @ @ . @ . @ @ . . . . @ . . @ @ @ @ @ @ @ @ . @ @ . . @ . . . . . @ . . @ . . . . @ @ @ @ . @ @ @ @ . @ @ @ 
@ . . . . . . . . . . . . . . . @ . . . . . . @ @ . . @ @ . . . . . . . . . @ @ . . @ . @ @ . @ . . . . . . @ @ @ @ . @ . @ @ @ @ . . . . @ . @ . . . @ @ . @ @ . @ @ . @ . @ . @ . . . . @ @ @ . . @ @ 
@ @ . @ . @ . @ . @ . @ . @ @ . . @ . @ @ . @ @ . . @ @ . @ @ @ . @ . @ @ . . . @ . @ @ @ . . . @ @ . @ @ . . @ . . . @ . . @ @ . @ @ . @ . . . . @ @ . @ . . @ . @ @ . . @ . . @ @ @ . @ . @ . . @ . @ 
@ . . . @ @ @ @ @ . . . @ . . . @ @ @ . . . . @ @ . @ . . . . . . . @ . . . @ . . . . @ @ @ . @ @ @ @ @ . @ . @ @ @ . . . @ . @ . . @ . @ . @ . @ . @ . . @ @ . . . . . @ . @ . . @ . . . . . @ . . . @ 
@ @ . @ . . . @ @ @ . @ . @ . @ . . . . @ . @ . . . . @ @ . @ @ @ . . @ @ @ @ @ . @ . . @ . . . @ @ . @ . @ . @ . @ . @ @ . . . . @ @ . . @ . . . . . . @ . @ @ @ . @ @ . . . . @ . @ . @ . @ . . @ @ @ 
@ . . . . @ @ . @ . . @ . . @ . . @ . @ @ @ . . @ @ @ . @ @ @ . @ . @ @ @ @ @ @ @ @ . @ . @ . @ . @ . . . . . . . . . . . . @ @ . @ . . @ @ @ . @ @ . @ @ . @ . @ . @ @ . @ . @ . . . . . @ . . @ . @ @ 
@ @ . @ @ @ @ . . @ . @ . @ @ @ . @ . . . . @ . . . . . . . @ . . @ @ @ @ @ . @ @ . . . . . . . . . . @ @ @ @ . @ . @ @ @ @ . @ @ . @ @ . @ . . . . @ @ @ . . . @ . . . . . @ . . @ @ . @ . . @ @ . @ @ 
@ . . . . @ . . @ @ @ . . . . . . . @ @ . @ @ . @ . @ . @ . @ . @ . @ . . @ . . @ . @ @ @ . @ . @ @ @ . @ . @ @ . @ . . . . . . . . . @ . . @ . @ @ @ @ . @ @ . . . @ . @ . @ @ . . . @ @ . @ . . . @ @ 
@ @ @ @ @ . @ . @ @ . @ . @ . @ . @ . . . . . . . @ . . @ @ . . . . . @ . . . @ . . . @ . @ . @ . . . . . . . . . . . @ . @ . @ . @ . . @ . . . @ . . @ . @ . . @ @ @ . . @ @ @ . @ . @ . . . . @ @ . @ 
@ @ @ @ . . . . . . . . . @ @ . . . @ @ . @ @ . @ . @ @ . @ . @ @ . @ . . @ @ . . @ . . . . . . . @ @ . @ . @ . @ . @ . . . @ . . . @ @ @ . @ @ . . @ . . . @ . @ @ @ . @ @ @ . . . @ . @ . @ . . . . @ 
@ @ @ . @ . @ . @ . @ @ . @ . . @ @ . @ @ . . . . . . . . . . . @ @ . @ . @ . . @ . @ . @ @ . @ . . . @ . . . @ . @ . @ . @ . @ . @ . @ . . . . @ . @ . @ @ . . . @ . @ . @ . @ . @ . . . . . @ . @ . @ 
@ @ . . . . @ . . @ . . . @ @ . . . . . @ @ . @ . @ . @ . @ @ . @ @ . . . . @ . @ . . @ . . . . @ . @ @ @ . @ . . . . . . . . . @ . . . @ . @ . @ . . . . @ . @ @ . . . . . . . . . . @ . @ @ . @ @ @ @ 
@ . @ . @ . . @ @ . . @ . @ @ . @ . @ . @ @ @ @ @ @ @ . . . . @ @ . @ @ . @ . . . . @ . @ @ . @ . . . . @ . @ . @ . @ . @ . @ @ . @ . @ . @ . . . . @ . @ . . @ . . @ . @ . @ . @ . @ @ @ @ . . @ @ @ @ 
@ . @ @ . . @ @ . @ . @ . @ . @ . . . @ . . @ @ @ @ @ @ . @ . . . . . . . . . @ @ . . . . @ @ . . @ . @ @ . . @ . @ . . @ . . . . . . . . . @ . @ @ . @ @ . @ . @ . . @ . . @ @ @ @ . @ . @ . @ . @ @ @ 
@ . . @ . @ . . . . . . @ . . . . @ @ . @ . . @ @ @ @ . . . @ . @ . @ . @ . @ . . . @ . @ @ . @ @ . @ . . . @ @ . . . @ . . @ . @ @ . @ @ . . . . . . . . . . . . . @ @ @ @ . . . . . . . . . . . @ @ @ 
@ . @ . . @ @ . @ . @ . @ @ . @ . . . . @ . @ . @ . . @ . @ . . . @ . . . @ . @ . @ . @ . . . . . . . @ . @ . . @ @ . . @ @ @ @ . . . @ @ @ . @ . @ . @ . @ . @ . @ . @ @ @ . @ . @ @ @ . @ . @ @ @ @ @ 
@ . . . @ . . . . @ . . @ . . @ . @ @ . . . . . . @ . @ . @ @ . @ @ @ . @ . . . . . . . . @ @ @ . @ . . @ @ . @ @ . . @ @ @ . . @ . @ . @ . . . @ . . . @ @ . @ . . . . . . . . @ . @ . @ @ @ . . @ @ @ 
@ @ . @ . . @ . @ . @ . @ . @ . @ @ @ . @ @ . @ @ . . . . . . @ @ @ @ @ @ @ @ @ . @ . @ . . . . @ . @ . . . . . . @ @ . @ . @ . @ . . . @ . @ @ . @ @ . @ @ . @ @ @ . @ . @ . @ . . . . @ @ . . @ . @ @ 
@ . . @ @ @ . . . . . @ @ @ . . . @ . . . . @ @ . @ . @ @ . @ . @ @ . @ @ @ . @ . . @ . . @ . @ @ . . . @ . @ . @ @ . . . . . . @ . @ . . @ @ . . . . . . . @ @ @ . . . @ . @ @ . @ . @ . @ . @ . . . @ 
@ @ . . @ . . @ . @ @ . @ . . @ . . . @ . @ @ . . . @ . @ . . . . . . @ @ . . @ . @ . @ @ @ . . . @ . @ . . . @ @ @ . @ . @ @ @ . @ . . @ . . @ . @ . @ . @ @ @ @ @ @ . @ . @ . . . @ . . . . . . @ . @ 
@ . . @ . @ . @ . . . . . @ . . @ @ . @ . @ . @ @ . . . . . @ @ . @ . @ . @ . @ . . . . . . @ . @ . @ . @ . @ @ @ . . . @ . . . . . @ . @ @ . . @ . . @ . . @ @ @ @ @ . . . . @ . @ . @ . @ . @ @ . . @ 
@ . @ . . . . @ . @ @ @ . . @ . @ . . @ @ @ . @ . . @ . @ . . . @ . . . . . . . @ . @ . @ @ . . @ . @ . @ @ @ @ . @ . @ . . @ . @ . @ . . . @ . . @ . @ . @ . @ @ . @ . @ @ . . . . . . . . @ . . @ . @ 
@ . @ @ . @ . @ . . @ . . @ @ @ . @ . . . . . . @ . . @ . . @ @ @ @ . @ @ . @ @ . . . @ @ @ @ . . . . . . @ . . . . . . @ @ . . . @ @ @ . @ @ @ . @ . @ . . . . . . . @ @ @ . @ . @ . @ @ @ @ . @ @ @ @ 
@ @ . . . . @ @ . @ . @ . @ @ . . . . @ . @ . @ . . @ . @ . @ @ @ @ . . @ @ @ @ . @ @ . @ @ . . @ . @ . @ @ @ @ . @ . @ . @ @ . @ . @ . @ . @ . . . @ . . @ . @ . @ . . @ . . . @ . . . @ . . . . @ @ @ 
@ @ @ . @ . @ @ . . . . @ . . . @ @ . @ . . @ @ . @ . . . . @ @ @ . . @ @ . @ . . . . . . . @ @ . . . @ . @ @ . @ . . . . . . . . . . . . . . . @ . . @ @ . . @ . . @ @ . @ . @ @ @ . @ @ @ @ . @ . . @ 
@ @ @ . @ . . @ @ . @ @ @ @ . @ . . . . @ . . . @ . @ @ @ . @ @ . . @ . . . . @ . @ . @ . @ @ . . @ . . . . . . . . @ . @ @ . @ @ . @ . @ . @ . @ @ @ . . @ . . @ . . @ . @ @ @ @ @ @ . @ @ @ . . . @ @ 
@ . . . @ . @ . . . @ . @ . @ . @ . @ . . @ . @ @ . . . @ @ @ . . @ . @ @ . @ @ @ . . . @ . @ @ . . @ @ . @ . @ . @ . . @ . . . . @ @ @ @ @ . . . . . @ . . @ . . @ . . . . . . . @ . . . @ . . @ @ . @ 
@ . @ . @ . . @ . @ @ . . . . . . . @ . @ . . @ . @ . @ . @ . @ . . . . . . . . . @ . @ . . . @ . @ . @ . @ . @ . @ . @ @ @ . @ . @ @ @ @ @ @ . @ . @ @ @ . . . @ . @ . @ . @ @ @ @ @ . @ . @ . @ . . @ 
@ @ . . @ @ @ . . . . @ @ . @ . @ . @ . . @ . . . . . . . @ . . . @ @ . @ . @ @ . @ . . . @ @ @ . . . @ . @ . . @ @ . @ @ . . . @ @ @ @ @ @ . . @ . . @ @ . @ . . . @ . . @ . @ . @ . . . . @ . . @ . @ 
@ @ @ . . . . @ . @ . . @ @ . . @ . @ . @ @ . @ . @ . @ . . @ . @ . @ @ . . . . @ @ . @ . . . . @ . @ . . . @ . . @ . . . @ . @ . @ @ @ @ @ @ . @ . @ @ . @ . . @ . . @ . . . . . . @ . @ @ . @ . . . @ 
@ @ . @ @ . @ . @ . . @ @ . @ . @ . @ . . . @ @ @ . . . @ @ . . . . . . @ . @ @ . . @ . . @ . @ . . . @ @ @ @ @ @ . . @ @ @ . @ . . @ @ @ @ . . . @ . . . @ @ . @ . @ . . @ . @ . @ @ . . @ . . . @ . @ 
@ @ . @ . . @ . @ @ . @ . . . . . @ @ . @ @ @ . @ @ @ @ . . @ . @ . @ . @ . . . . @ . . @ @ . @ @ . @ . @ . @ @ @ @ . . . @ . @ . @ . @ @ . @ . @ @ . @ . . @ . . @ . . @ @ @ . @ . . . @ . . @ @ . @ @ 
@ . . . @ . . . @ . . @ . @ @ . @ . . . . . . . . @ @ @ @ . @ . . @ . . @ . @ @ @ . @ @ . . @ @ . . . . . . . @ @ @ @ . @ . . . . . . . . . . @ . @ @ . . @ . . @ . @ @ . @ . . . @ @ . . . @ @ @ . . @ 
@ . @ . . . @ . @ @ @ @ . @ @ @ . @ @ . @ . @ . @ . . . . . . . @ @ @ . @ . . . . . . . . @ . . @ . @ . @ . @ . @ @ . @ . @ . @ . @ . @ @ @ . @ . . @ @ . @ @ . . . . . . . . @ @ . . . @ @ . @ . . @ @ 
@ @ . . @ . @ . @ . . . . . @ . . . . @ @ @ . . @ . @ . @ . @ . @ @ . . @ . @ . @ . @ . @ . . @ . . . @ . . . . . . . . . @ . . @ @ . . . . @ @ @ . @ . . . @ . @ . @ . @ . @ @ . @ . @ @ @ . @ . @ . @ 
@ . . @ . . . @ . @ . @ . @ . @ @ . @ . @ . @ . @ . . @ . @ @ @ . . . @ . . . @ @ . . @ @ @ . @ @ . @ . @ . @ . @ @ . @ @ . @ . . . @ . @ . . @ . . . @ @ . @ . . @ . . . @ . . . . . . . . . . . . . @ 
@ @ . . @ . @ . . . . @ . @ . @ @ . . . . . . . @ . @ . . @ . . @ @ . . @ . @ . . . @ . @ @ . . @ . @ . @ . @ . . . @ . @ . @ . @ . @ . @ . @ . @ . @ . @ . @ . @ @ @ . @ @ @ . @ @ @ @ . @ @ @ @ @ @ @ 
@ . @ . . @ @ . @ . @ . . . . . . @ @ . @ @ . @ . . @ @ . @ . @ @ @ . @ . @ . . @ . . . . . . @ . . . . . @ @ . @ . . . . . . @ . @ @ . . @ @ . @ . . . . . . @ @ . . @ . . @ . . . . . @ . . . . . . @ 
@ . . . @ @ . . . @ . . @ . @ . @ . @ @ @ @ @ . @ . . . . . . . @ . . . . @ @ . @ @ . @ @ . @ . @ . @ @ . . . @ @ . @ . @ @ @ . . . . . @ . @ . . . @ @ . @ . . @ @ . @ @ . . . @ . @ . . . @ @ @ . @ @ 
@ . @ . . . @ . @ . @ . @ . @ . . . @ . @ @ . . . @ . @ . @ @ . . @ . @ . . . @ . . . @ @ . . . . @ . @ . @ . . . @ @ @ . . @ @ @ . @ . . . . . @ @ @ @ . . @ . . . . . @ . @ @ . @ . @ @ . . . . @ . @ 
@ . @ . @ @ . . . . @ . @ . @ . @ . . . @ @ @ . @ . . . @ . @ . @ . . . @ . @ @ . @ . . . @ @ . @ . . . . . @ . @ . @ . @ . . . @ @ @ . @ . @ . . . @ @ . @ . . @ . @ . . . . . . @ . . @ @ . @ . . . @ 
@ @ . . @ @ @ . @ @ . . @ . . @ . @ . @ @ @ . . . . @ . . . . @ @ @ . @ @ . . . @ . . @ . . . @ . @ @ @ . @ . . . . . . . . @ . . . @ . . @ @ @ . @ . . . @ @ . . @ @ . @ . @ . @ @ . @ . @ @ . . @ . @ 
@ @ @ . @ . @ . @ @ @ . @ . @ . . . @ . @ . @ . @ . @ . @ . @ . @ @ . @ . . @ . . @ . . @ . @ @ . . @ . . @ @ @ . @ . @ @ . . @ @ . . @ . . @ . . . @ @ . . . @ . . . @ . . . @ . @ . @ . @ @ @ . @ . @ 
@ @ . . . . . @ . . . . . @ @ . @ . @ . . . . . . @ . . . @ . . . @ . @ @ . . @ . . @ . @ . . @ . @ . @ @ . @ . @ . @ . . . @ @ @ @ . @ . @ . . @ . . @ . @ . . @ . @ . . @ . . . . . . . . . @ @ . . @ 
@ . @ . @ . @ @ @ . @ . @ @ @ @ . . . @ @ . @ . @ . @ . @ . @ . @ @ . . . @ . @ . @ @ . . @ . . . . . . . . . . @ . . . @ . . @ @ @ . . @ . @ . . @ @ . . . @ . . @ . @ . @ . @ @ . @ . @ . @ @ @ @ . @ 
@ . . . @ @ @ . . . @ . . @ @ @ @ . @ . . @ @ @ @ . . . . . . . . . @ @ @ . . . @ @ @ @ . . @ . @ . @ . @ . @ . . @ @ . @ . @ . @ . @ @ @ . @ . @ @ @ @ . @ . @ . @ . . . @ . @ @ . @ . @ @ . @ . . . @ 
@ @ . @ . @ . @ . @ . . @ @ . @ @ . @ . @ . @ . . . @ . @ . @ . @ . . @ @ @ . @ . @ @ . . @ . @ @ @ . . . @ . . @ @ @ @ . . @ . @ . . . . . . . . @ @ @ . . . @ @ @ @ @ . . @ . . . . @ . . . . . @ . @ 
@ @ @ @ . . . . . . @ . . . . . . . . . . . @ @ . @ . . . @ . . . @ . @ @ @ @ @ . @ . @ @ . . @ @ . @ . @ . @ . . @ @ @ @ . @ . . @ @ . @ . @ . @ . @ . @ . @ @ @ @ @ @ . @ . . @ . @ @ . @ . @ . @ @ @ 
@ @ . . @ . @ @ . @ . @ . @ . @ @ . @ @ . @ @ . . @ @ . @ @ . @ @ . . . . . . . . . . . . @ . . . . . . . . . @ . . @ @ . @ @ . @ . @ @ @ @ . . . . . . . @ @ @ @ @ . . @ . . @ @ @ @ @ @ @ @ @ @ @ @ @ 
@ . @ . @ @ . . . @ . . . @ . . . @ . @ . . @ @ @ . . . @ . @ . . @ . @ . @ . @ @ . @ . @ @ . @ . @ @ . @ . @ @ @ . . . . . . . . . . . . @ @ . @ . @ . @ . @ @ @ . @ . @ @ @ @ @ @ @ @ @ @ @ @ @ @ @ @ 
@ . . . . . . @ . . @ . @ . @ @ . . . @ . @ . . . . @ . . . @ @ . . . . @ . . . . @ . . . . @ . . . . @ . . . @ . . @ . @ . @ . @ . @ . @ @ . . . @ @ . . . . . . . . . . @ . @ @ @ @ @ @ @ @ @ @ @ @ @ 
@ @ . @ . @ @ . . @ . @ @ . . . . @ . . @ . . @ . @ . . @ @ . @ . @ . @ . @ @ . @ . @ @ . @ . @ . @ @ . . @ . @ @ . @ @ . . @ . . @ @ . . . @ . @ . . . @ . @ . @ . @ . @ @ . @ @ @ @ @ @ @ @ @ @ . @ @ 
@ . @ @ . . . @ . . . . @ @ @ . @ . @ @ . @ @ . . . @ . . @ . @ @ . . . . . @ . . . . . @ @ . @ . . . @ . . @ @ . @ . @ @ . @ . @ . @ . @ @ @ @ @ @ @ . . @ @ . . @ @ . . @ . . @ @ @ @ @ @ @ @ @ . @ @ 
@ . @ . @ @ @ . . @ . @ . @ . . . . . . . . . @ @ @ @ . @ . . . @ @ . @ . @ @ . @ . @ @ . . . . . @ @ . . @ . . . . . . . . @ . . . . @ . @ @ @ @ @ . @ . @ . . @ . . . @ . . @ . @ @ @ @ @ @ @ @ . . @ 
@ . . . @ . . . @ @ . @ . . @ . @ @ @ . @ . @ . . . . . . . @ @ . . . . @ . @ . . @ @ @ . @ . @ . . . @ @ @ @ @ . @ . @ . @ @ @ @ . @ . . @ @ @ . @ . . @ . . @ @ . @ . . @ . . . . @ @ @ @ @ . . . @ @ 
@ . @ . . . @ . . @ . . . @ . . . . . @ . . . @ @ . @ . @ . . . @ . @ . . . @ @ . @ @ @ @ . . @ . @ . . . @ . . @ . @ . . @ @ @ @ . @ . @ @ @ . . . @ . . @ @ . @ @ . . @ . . @ . @ @ @ @ @ . @ . @ @ @ 
@ . . @ . @ . . @ . . @ . @ . @ . @ . @ @ . @ . . . @ @ . . @ . @ @ @ @ @ @ . @ . . @ . . @ @ . . . @ . @ . @ . @ . @ @ . . . . @ . . . . @ . @ . @ . . @ @ @ . . @ @ . @ . @ . @ . @ @ . . . . . . @ @ 
@ . @ @ @ @ @ . . @ @ @ @ . . @ . @ . . . @ . . @ . . . @ . . @ . @ @ . @ . . . . @ @ @ . @ @ @ . @ . . . . . . . . . @ . @ . @ @ . @ . @ . . . . @ . @ . . @ . @ . @ . . . . . . . . @ . @ . @ . @ . @ 
@ @ . @ . @ . . @ . @ @ @ @ . @ . @ . @ . . @ @ . . @ @ . . @ @ . @ . . . . @ . @ @ @ . . . @ . . . @ . @ . @ @ @ @ @ . . . @ . . . . @ @ . @ @ @ @ . @ @ . . . . . . @ . @ . @ . @ . . . @ @ . @ . . @ 
@ @ . . . . . @ . . . @ @ . @ . . @ . @ . @ @ . @ . . . @ . . . . @ @ @ . @ . @ . @ . @ . @ . @ . @ @ . @ . . @ @ @ @ @ . @ @ . @ . @ . . . . . . . . . . . @ @ @ @ @ . @ . . @ . @ . @ . . . . . . @ @ 
@ . . @ . @ . . @ . @ . . . . @ . . @ @ @ . . . . . @ @ . . @ . @ @ @ @ @ . . @ . . . . . . . . . . . @ @ . @ @ @ @ . . @ @ @ @ . . . . @ @ . @ . @ . @ @ . . . . . . . @ @ . . @ . . @ @ @ . @ . @ @ @ 
@ . @ @ . . @ . @ . . . @ @ @ . . @ . . . @ . @ @ @ @ @ @ . @ @ . . . @ @ @ . . . @ @ @ . @ . @ . @ . . . @ . . . . . @ @ @ @ @ @ . @ @ . @ . . @ @ @ . . @ . @ . @ . @ . @ @ @ . @ . . . . @ @ . . @ @ 
@ . . @ . @ @ . . . @ @ . . . . @ . @ . @ . @ . . . . . @ . . @ . @ @ . @ . @ @ . . . @ @ . . . @ . . @ @ . @ . @ . @ . . @ @ @ @ . . . . . @ @ . @ . . @ @ @ . @ . . @ . . . . . @ @ . @ . . . @ . . @ 
@ . @ @ @ . . . @ . . @ @ . @ . . . . . . . @ . @ @ @ . . @ @ . . . @ . . . . . @ @ . . @ @ . @ . @ . . @ . . . . @ . . @ . @ @ . . @ . @ . . . . . . @ . . . . . @ . @ . @ . @ . . @ . @ . @ @ @ . @ @ 
@ . . . @ . @ . . @ . @ . . @ @ . @ @ . @ . . . . . @ . @ @ . @ . @ . . @ . @ . . @ @ . . . @ . . . . @ . . @ . @ . @ . . . . . @ . . @ . . @ . @ . @ . @ @ . @ . @ . . . . @ . . @ . . . @ @ . . . . @ 
@ . @ . @ @ . @ . . @ @ . @ . . @ . . . @ . @ @ . @ @ @ . . . @ . . . @ @ @ @ @ @ . @ . @ . . @ . @ . @ . @ . . . . . . @ . @ @ . . @ . @ . @ . @ . . . . . . . @ . . @ . @ @ . @ @ @ . @ . . . @ . @ @ 
@ . . @ @ . . . . @ . . . . @ . @ @ @ . . @ @ . . @ @ @ . @ @ . . @ @ . @ . . @ @ . @ @ . . @ @ @ @ . . . . @ . @ @ . @ . . @ . @ . . . . @ @ . . @ . @ . @ . @ @ @ . . @ @ @ @ . @ . . @ . @ . @ . . @ 
@ . @ @ @ @ . @ . @ @ . @ . . . @ @ @ . @ @ @ @ . . @ . . . @ . @ . @ . . . @ . @ . . @ @ . . @ . @ . @ . @ . . . . @ . . @ . . . . @ . @ @ . @ @ @ @ @ . @ . . @ . . @ . @ . . . . . @ . @ . @ . . @ @ 
@ @ @ @ @ @ . . @ @ . . @ . @ . @ @ . . @ . @ @ @ . @ @ . @ . . . . . . @ . . . . . @ . . @ @ . . @ . . @ . @ @ @ . . @ . . @ . @ . . @ @ . . . @ @ @ @ @ . @ @ . @ . . . . @ @ . @ . . . . . . @ . . @ 
@ @ @ @ @ @ @ . @ @ @ . @ . . @ . @ @ . . . . @ . . . . . . . @ . @ . @ @ . @ . @ @ @ . @ . . . @ @ . @ . . . . . @ . @ . @ @ @ . . @ @ . @ . @ . @ . . . . . @ . @ . @ . @ @ . . @ @ . @ . @ . @ . @ @ 
@ @ @ @ @ @ @ . . . @ . @ . @ . . . . . @ @ . @ @ . @ . @ . @ @ . . @ . . . . @ @ . . . . @ . @ . . . @ . @ . @ @ @ @ . @ . @ @ @ . . . . . . . . . . @ . @ . . . . @ . . . @ @ . . @ . . @ . . @ . . @ 
@ @ @ @ @ @ @ @ @ . @ . @ @ @ @ . @ . @ . . . . @ @ . . . @ @ @ @ @ . . @ . @ @ . . @ @ . . . . . @ . . . . @ @ @ @ @ . . . . . . . @ . @ . @ @ @ . @ . . . @ . @ @ @ @ . @ @ @ @ @ @ . @ @ . @ . . @ @ 
@ @ @ @ @ @ @ @ @ @ @ @ @ @ @ @ @ @ @ @ @ @ @ @ @ @ @ @ @ @ @ @ @ @ @ @ @ @ @ @ @ @ @ @ @ @ @ @ @ @ @ @ @ @ @ @ @ @ @ @ @ @ @ @ @ @ @ @ @ @ @ @ @ @ @ @ @ @ @ @ @ @ @ @ @ @ @ @ @ @ @ @ @ @ @ @ @ @ @ @ 
3
29 6 72 32
24 3 90 91
97 44 59 12
