25 25
@ @ @ @ @ @ @ @ @ @ @ @ @ @ @ @ @ @ @ @ @ @ @ @ @ 
@ @ @ @ . @ @ . @ . . . . . @ @ . @ . . @ . @ . @ 
@ @ @ . . . @ . . @ @ @ . @ @ . . . . @ . . . . @ 
@ . . @ . @ . @ . . . . . @ . . @ . @ . @ . @ . @ 
@ @ . . . . . . @ @ @ @ . . @ . . @ @ . . . . @ @ 
@ . . @ . @ @ . . @ . @ . @ @ . @ . . @ . @ . @ @ 
@ @ . . @ . . . @ . . . . . @ . . @ . @ . . @ @ @ 
@ @ @ @ . @ @ . . @ . @ . @ @ @ . @ . @ . @ . @ @ 
@ @ . @ . @ . @ . @ @ . . . @ . . . . . . . . . @ 
@ . . . . . . . . . . @ . @ @ @ . @ . @ . @ . @ @ 
@ . @ . @ @ . @ . @ . . . . . . . @ @ @ @ . . . @ 
@ . . @ . . . @ . . @ . @ @ . @ . @ @ @ @ @ . @ @ 
@ . @ @ @ . @ . . @ @ . @ @ . @ . . @ @ @ @ . @ @ 
@ @ . . . . @ @ . @ . @ . . . @ . @ . @ @ . @ @ @ 
@ . . @ . @ . . . . . . @ @ @ . . @ . . . . . @ @ 
@ @ @ @ . @ . @ . @ @ @ . @ . @ . . . @ . @ . . @ 
@ . @ . @ . . @ . @ . . . . . . . @ @ . . . @ . @ 
@ . . . . . @ @ . . @ . @ . @ @ . @ . @ . @ . . @ 
@ @ . @ . @ . . . @ . . . @ . . . @ . . . . @ @ @ 
@ . @ . . @ @ . @ . @ . @ @ @ . @ @ . @ @ @ @ @ @ 
@ . . . @ . . . . . . @ @ @ . . @ @ . @ @ @ @ @ @ 
@ . @ . @ @ . @ . @ @ . . . . @ @ . @ @ @ @ @ @ @ 
@ . . @ @ . @ . @ @ . @ . @ . . . . . @ @ @ @ @ @ 
@ . @ . . . . . . . . . . . @ . @ . @ @ @ @ @ @ @ 
@ @ @ @ @ @ @ @ @ @ @ @ @ @ @ @ @ @ @ @ @ @ @ @ @ 
3
14 2 18 21
21 1 20 5
17 16 10 11
