10 10
@ @ @ @ @ @ @ @ @ @ 
@ @ . . @ @ . @ . @ 
@ @ . @ . . . @ . @ 
@ . . . @ @ . . . @ 
@ @ @ . . . . @ @ @ 
@ @ @ @ . @ . . @ @ 
@ @ @ @ @ . . @ @ @ 
@ @ . . . @ . @ @ @ 
@ @ . @ . . . . @ @ 
@ @ @ @ @ @ @ @ @ @ 
3
7 6 1 8
3 7 1 6
8 4 7 2
