12 12
@ @ @ @ @ @ @ @ @ @ @ @ 
@ @ @ @ @ @ @ @ @ . . @ 
@ @ @ @ . @ @ @ . @ . @ 
@ @ @ . . . @ . . . . @ 
@ @ . @ . @ . @ . @ . @ 
@ . . . . . . . . . @ @ 
@ @ . @ . @ . @ . @ . @ 
@ . . . @ @ @ . . . . @ 
@ @ @ . . @ . @ . @ . @ 
@ . . . @ . . @ . @ . @ 
@ @ . @ @ @ . . . . @ @ 
@ @ @ @ @ @ @ @ @ @ @ @ 
3
9 5 4 4
7 1 2 8
3 5 4 10
