100 100
@ @ @ @ @ @ @ @ @ @ @ @ @ @ @ @ @ @ @ @ @ @ @ @ @ @ @ @ @ @ @ @ @ @ @ @ @ @ @ @ @ @ @ @ @ @ @ @ @ @ @ @ @ @ @ @ @ @ @ @ @ @ @ @ @ @ @ @ @ @ @ @ @ @ @ @ @ @ @ @ @ @ @ @ @ @ @ @ @ @ @ @ @ @ @ @ @ @ @ @ 
@ . @ @ . . @ . @ @ @ . . . . . . . . . @ @ @ . . @ . . @ . . @ . . @ @ @ . . . . @ . @ . . . . @ @ @ @ @ @ @ @ @ @ @ @ . @ @ . . @ . @ . . . . . . @ . @ @ @ @ . . . . . @ @ . . . . . . . . . . @ @ @ 
@ . @ @ @ . . . . . . . @ . @ . @ . @ . . @ . . @ . . @ @ . @ . . @ . @ . @ @ . @ . . . @ @ @ . . @ @ @ @ @ @ @ @ @ @ . . . . . @ . . . . @ @ . @ @ . . . @ @ @ @ . @ . @ . . @ . @ . @ . @ . @ . . . @ 
@ . . @ . . @ @ @ . @ @ . . @ @ . . @ . @ . @ . @ @ . . . . . @ . . . @ . . . . . @ . @ . @ @ . @ . @ @ @ @ @ @ @ @ . @ @ @ @ . @ . @ . @ @ . . . @ @ . @ . @ . . . @ . . @ . . @ . . . @ @ . @ . @ . @ 
@ . @ . @ . . @ . . @ @ @ . @ . @ @ . . @ . @ . . @ . @ . @ . @ @ . @ @ @ . @ . @ . . . . . . . . . . @ @ @ @ @ @ . . . . @ . . . @ . . . . @ @ . . . . . . . @ . @ . @ . @ . @ . @ @ . @ @ . . @ @ . @ 
@ . . . . . @ . @ @ . @ @ @ . . @ . @ . . . . @ . . @ . . @ . . @ . . @ @ @ . . . . @ @ . @ . @ . @ @ @ . . @ @ . . @ . @ . @ . @ . @ . @ . @ . . @ . @ . @ @ . @ . . . . . . . . . @ . . @ @ @ @ @ . @ 
@ @ . @ . @ . . . . . . @ @ @ . . . @ . @ @ . . @ . @ @ . . @ . . . @ . @ . @ . @ @ . @ . @ @ @ @ . . . @ . @ . @ . @ . . . . . . . . . . @ @ @ . @ . . @ . . . . @ . @ . @ @ . @ @ . . @ @ @ . @ @ @ @ 
@ . . @ @ @ @ . @ @ . @ . @ @ @ . @ @ . @ . . @ @ . . @ @ @ @ . @ . @ . @ . @ . . . . . @ @ @ @ @ @ @ . . . . . . . @ . @ @ . @ @ @ . @ @ . . . . . @ @ . . @ . @ @ @ . . @ . . @ @ . @ . @ @ . . @ @ @ 
@ . @ @ . @ . @ . @ . . . . . . . . @ . @ @ . . @ . @ . . . . @ . . @ . @ . . . @ @ . @ @ @ @ @ @ @ @ @ . @ @ . @ . @ . . . @ . @ . @ . . . @ . @ @ . @ @ @ . . . @ . @ . @ . @ . . . . . . @ . @ . @ @ 
@ . @ . . . . . . . . @ . @ . @ . @ . @ @ . @ . . . . . @ . @ @ @ . @ . @ . @ @ @ @ . @ @ @ @ @ @ @ @ @ @ . . . @ . . @ @ @ . . . . . @ . @ . @ @ @ . . @ @ @ . @ . . @ . . @ @ @ @ . @ . @ . . . . . @ 
@ @ . @ @ . @ @ @ . @ . . . @ @ @ . . . @ . . . @ . @ @ . . . @ . . @ . . . . . @ . . @ @ @ @ @ @ @ @ @ @ @ . @ @ @ @ . @ @ . @ . @ . @ . . . . . . . @ @ @ . . . @ . . . @ @ @ . @ . . @ . . @ . @ . @ 
@ @ . . . . . . @ . . @ . @ . @ . @ . @ . @ @ @ . @ @ . @ . @ . @ . . @ . @ . @ @ @ @ @ @ @ @ @ @ @ @ @ . . . . @ . . . . . @ . . @ . . . @ . @ . @ @ . @ . . @ @ . . @ . . @ @ . @ . @ . @ . . @ @ . @ 
@ . @ . @ . @ @ . . @ . . . . . . . . . . . @ . . . . . . . . . . . @ @ . . @ @ @ . . @ @ . @ . @ @ @ @ @ . @ @ . @ @ . @ . @ . @ @ @ @ . @ @ . @ @ @ . . @ . . @ . @ . . @ . @ . . . . . . . @ . . . @ 
@ . . . @ . . . @ @ @ @ . @ . @ . @ @ . @ @ . @ . @ @ . @ . @ . @ . . . @ . . @ @ . @ @ . . . . @ @ @ @ @ @ @ @ . @ . . . @ @ @ @ @ . . . . @ . . . . . @ . @ . . @ . @ . . . . . @ @ @ @ . @ @ @ @ . @ 
@ @ . @ . . @ . . @ @ @ . . @ . @ . . . . @ . . @ . . @ @ @ . @ . @ . @ . . @ @ . . . @ @ . @ . @ @ @ @ @ @ @ @ . . @ . @ @ @ @ . . . @ . @ . @ @ . @ . . . . @ . . . . . @ . @ . . . . . @ @ @ . . @ @ 
@ . . @ @ . @ . @ @ @ . . @ . . . . @ . @ . @ . @ . @ . . . . . . . . @ . @ @ . @ . @ @ @ @ . . . @ @ . . @ @ @ @ . @ . . @ . . @ @ @ . . . . . @ @ . . @ @ @ . @ . @ . @ @ @ @ . @ . @ . . @ . @ . . @ 
@ . @ . . . . @ @ @ @ @ . . @ @ . @ . . . . . . . . . . @ . @ @ . @ . . . . . . . . . @ @ . @ . @ . . @ . . @ @ @ . @ . @ . @ . @ . . @ . @ . @ . . . @ . @ . . . . . @ . @ . @ @ . . . @ . @ . . . @ @ 
@ . @ @ @ . @ @ @ @ @ @ @ @ . . @ . . @ . @ . @ . @ . @ . . . . @ . @ . @ . @ @ . @ . . . . . . . @ . . . @ @ @ . . . . . . @ . . @ . . . . @ @ . @ @ @ . . @ . @ @ @ . . . . . . . @ @ . @ @ . @ . . @ 
@ . . @ @ @ @ @ . @ . . . . . @ @ @ . . @ . . . @ . . . @ . @ @ . . . . . @ . . . @ @ . @ . @ . @ . @ @ . . . . @ @ @ @ . @ @ @ . . @ @ . @ @ . . . . . . @ . . . . @ . @ . @ . @ . @ @ . . @ @ @ . @ @ 
@ . @ @ @ . . . . . @ . @ . @ . @ . . @ . @ . @ @ @ . @ @ @ @ . @ . @ . @ . @ . @ @ @ . @ @ @ . . . @ . @ . @ @ @ @ @ . . . @ . . @ @ @ . @ . @ . @ @ @ @ . . @ . @ @ @ @ @ @ @ . . @ . @ . . @ . . . @ 
@ . @ @ @ @ . @ . @ @ @ . . . . . @ . . . @ . @ @ @ . @ . . . . . . . @ . . . . . . . @ . @ . @ @ . . . @ . . @ @ @ . . @ . @ . @ . @ . . . . . . . @ . . . @ . @ @ @ @ @ @ @ @ @ @ @ . . . @ . @ . @ @ 
@ @ @ @ @ @ @ . . @ . . . @ . @ . . . @ . . @ . . . . . @ @ . @ . @ @ @ . @ @ . @ @ . @ . . . @ . @ @ . . @ . . . . @ @ . . @ . . . . @ . @ . @ . @ . @ @ . . . . @ @ @ @ @ . @ . @ . @ @ . @ . . . . @ 
@ . @ @ @ . . @ . @ @ . @ . @ . @ . @ . @ @ . @ @ . @ @ . @ . . @ . . . . . @ . . . @ @ @ @ . @ . @ . @ . @ . @ . @ . . . @ @ @ . @ . @ . . @ @ @ . . . . . @ . @ @ @ @ @ . . . . . . . . . @ . @ . @ @ 
@ . @ @ @ . @ . . . . @ @ . . . . . @ . @ . . . . @ . . . . . @ @ @ . @ . @ @ . @ @ . @ . . . . . . . . . . . . @ . @ . @ @ @ @ @ . . . . @ . @ @ @ . @ . @ . @ @ @ @ @ . @ @ @ . @ @ . @ . . . @ . . @ 
@ . . @ @ . . @ @ @ . @ @ @ . @ . @ . . . @ . @ @ . . @ @ @ . . @ @ @ @ . . . @ . . . . . @ @ . @ @ . @ . @ @ . . . . . . @ @ . @ @ . @ . . . . . . . @ @ @ . . . . @ . . . @ . . . . @ @ @ . @ @ . @ @ 
@ . @ @ . . @ . . . . . . @ . . @ . @ @ . . . . . . @ . . . . @ . @ . . . @ @ . @ . @ . @ . . . . @ @ . . . . @ . @ . @ . . . . @ . @ . . @ . @ . @ . . @ . . @ . @ . @ . @ . @ @ . @ @ @ . . . @ . . @ 
@ . @ @ . @ . @ . @ . @ @ @ @ . @ . . . . @ @ @ @ . @ @ . @ . @ . . @ @ . . @ . @ @ . @ . . @ . @ @ . @ . @ . @ . @ @ . . @ @ . . . . . @ . @ @ . . @ @ . @ . . @ . . . . . . @ . @ @ @ . @ . @ . @ . @ 
@ . . . . @ . . @ . . @ . . @ . . @ . @ . . . . @ @ . . . . @ @ . @ . . . @ . . @ @ . @ @ . @ @ . . . . . . @ @ @ . @ @ @ . . . @ . @ @ @ . @ . @ @ . . . . . @ @ @ . @ @ @ @ . . . @ @ . . . @ . . @ @ 
@ @ . @ . . . @ . . @ . . @ . @ @ @ @ . . @ . @ @ @ @ @ . @ @ . . . . @ . . . @ . . . . . @ . . . @ @ . @ @ @ . . . . . . . @ @ . . . @ . . . . . . @ @ @ . @ . @ . . . @ @ @ @ . @ . @ @ @ . @ . @ . @ 
@ . . . @ . @ @ @ . . . @ . . @ . @ . @ . @ . @ @ @ @ @ . . @ @ . @ . @ @ @ @ . @ . @ . @ @ @ @ . @ . . @ . . . @ . @ @ . @ @ . . @ @ . @ . @ . @ . . . @ . . . . . @ . . @ @ . . . . @ @ . . . . . . @ 
@ @ . @ . . . @ . @ . @ . . @ . . @ . @ . . @ . @ @ @ . @ . @ @ . @ . . @ . . . . @ . . . @ . @ . @ @ @ @ @ . @ @ @ . . . @ . @ . . . . . . . @ . . @ @ @ . @ . @ . @ . @ . @ @ . @ . @ . . @ @ . @ . @ 
@ @ @ . . @ . @ . . . . . @ . @ . . . @ . @ . . @ @ . . . @ @ . @ . @ @ . @ @ @ . . . @ @ . . @ @ . . . @ @ @ . @ . @ . @ . . . . @ . @ @ @ @ . @ @ @ . . . . @ . @ . . . . @ . . . @ . . @ . . @ @ . @ 
@ . . @ . . @ . . @ . @ . @ . . @ . @ @ @ @ @ . . . . @ @ @ . . . . . @ . . . . @ @ . . . @ . . @ . @ @ . @ . . . . @ @ . @ . @ @ . @ . @ . @ . @ @ @ @ @ . @ . . . @ @ . @ @ @ . @ . @ . . . @ . . . @ 
@ @ . . . @ . @ . . @ . . . @ . . . @ @ . @ . @ @ . @ . @ . @ . @ . @ . @ . @ @ @ @ @ @ . . . @ . . . @ . . . @ . @ . . . . . . . . . . . . . . . . . . . . . @ . @ . @ . . . . . . . . . @ @ @ @ . @ @ 
@ . @ @ . . . @ . @ @ @ . @ @ . @ . . . . . . @ @ . . . . . . . . @ @ . @ . . @ @ @ @ . . @ @ @ @ . @ . @ . @ @ @ . . @ . @ . @ @ @ . @ . @ . @ . @ @ @ . @ . . . . . @ . @ . @ . @ . @ . @ . @ . . . @ 
@ . @ . . @ . @ . @ @ @ . @ . @ . . @ . @ . @ @ @ @ @ @ @ @ @ @ . . . . . . @ . @ @ . @ . @ . @ . . . . . . . @ . . @ @ . . @ . . . @ @ @ . @ @ @ . . . @ @ @ @ @ . @ @ . . @ . . . @ . . . . . @ @ . @ 
@ . @ @ @ @ . @ . . @ . @ . . @ . @ . @ . . @ @ @ . . . . . . . . @ . @ @ . @ . @ @ . . . . . . . @ . @ @ @ . . @ . @ . @ . @ . @ . . @ . . . @ @ . @ @ . @ . @ . . @ . . @ . @ @ @ @ @ . @ @ . . . @ @ 
@ . . . . @ . @ @ . @ . . @ . . . . . . @ . @ @ @ . @ . @ . @ @ . . @ @ @ . @ . . @ @ . @ . @ . @ . . . . @ . @ @ @ . . . . . @ . . @ . @ . @ . @ . . . . . . . @ . @ @ @ . . . . . . @ . . @ . @ @ @ @ 
@ . @ @ . . . . @ . . . @ @ . @ . @ . @ @ @ . @ @ . . @ @ . @ @ . @ @ @ . . @ . @ . . @ @ @ . . @ . @ @ . . @ @ @ . @ . @ . @ . @ . . . . . . . . . @ . @ . @ @ . . @ . . . @ . @ . @ . @ @ @ @ . @ @ @ 
@ . @ @ . @ . @ . @ . @ . @ . . @ . . . @ . . . @ @ . @ . @ . . . @ @ @ @ . . . . @ . . . @ @ . @ @ @ . . @ . @ @ . . @ @ . . . . . @ @ @ @ @ @ @ @ . . . @ . . @ . @ . @ . . @ . . . . . . . . . . @ @ 
@ @ . . @ . . . . @ . . . . . @ . @ . @ . @ . @ @ @ @ . . . @ . @ @ @ @ . @ . @ @ . @ @ . . @ . @ @ . . @ . . . @ @ . . . . @ . @ . . . . . . . . @ @ @ . . @ . . @ @ @ . . @ . . @ . @ @ @ . @ . @ . @ 
@ . @ . . @ @ @ . @ @ . @ . @ . . . @ . . @ . . . . . @ . @ . @ @ . @ . . . . . . . . . . @ . @ @ . @ . @ . @ @ @ . @ @ . @ . . . @ . @ . @ . @ . . . @ . @ . . @ @ @ . @ . @ @ . @ . . . @ @ . @ . . @ 
@ . . @ . . @ . . @ . . . @ . @ . @ @ @ . . . @ . @ . . . . . . . . . . @ . @ @ @ @ @ @ . . . . . . . . . . . . . . . . . . @ . @ @ . @ . @ . @ . @ . @ . @ . @ . @ @ . . . . @ . @ . @ @ . @ . . @ . @ 
@ @ . @ . @ . @ . @ . @ @ . . . . . @ . @ . @ . @ . . @ . @ . @ @ . @ . . @ . . . . . . . @ . @ . @ @ @ @ . @ . @ . @ @ . @ @ . . . @ . . . @ . . . @ . . . . . . @ . @ @ . @ . @ @ @ . . . . . @ . . @ 
@ . . . . . . . . . . . . . @ @ @ @ . . . . . . . @ @ . . @ @ . . @ . . @ . . @ . @ @ @ . @ . @ @ . . . . . @ @ . . @ . . . @ . @ . . @ @ . . @ . @ @ @ @ . @ @ . . . . . . . . . @ @ @ @ @ . @ @ . @ @ 
@ . @ @ . @ . @ @ . @ . @ . . . @ @ @ . @ . @ . @ @ @ @ . . . . @ . @ @ @ @ . @ @ . . . @ @ @ . . . @ . @ . . . @ . . @ . @ . . @ @ . . . @ . . @ @ @ . @ @ . @ . @ . @ @ . @ . @ @ @ . . . . . . . . @ 
@ . @ . @ . . . . @ @ @ . @ . @ . @ . @ . @ @ @ @ @ . . . @ . @ . . . . . . . @ @ @ @ . @ @ @ . @ . . @ . . @ . . @ . @ . . @ @ . . . @ @ . . @ . @ . . . . . . @ @ . . . @ @ . . @ . @ @ . @ @ . @ @ @ 
@ . . . . @ . @ . . @ . . . . . . . . . . . . . . . . @ . . @ @ @ @ . @ . @ . . @ . . . . @ . @ @ @ . @ @ . @ @ @ . @ . . @ @ @ . @ . . @ @ . . . . . @ . @ @ . @ . @ @ @ @ . @ . . . . . . . . @ . . @ 
@ . @ @ @ @ . . @ . . @ . @ . @ . @ @ . @ . @ @ . @ @ . . @ . @ @ @ @ @ @ @ @ . . @ . @ . . . @ @ . @ . . . @ . . . . @ . @ @ @ @ . . @ . . . @ @ . @ . @ . . . . . . . . . . @ @ @ @ @ @ @ @ @ . @ . @ 
@ . . @ @ . . @ @ . @ . @ . . . @ . . . . @ . . . @ @ . @ . . . @ @ . @ . . @ . @ @ @ @ @ @ . . . . @ . @ . . @ . @ . . . @ @ . . @ . @ . @ . . . @ . . . . @ . @ . @ @ . @ . . . . . . . . . . . . . @ 
@ @ . @ @ @ . . . @ . . . @ . @ . @ @ . @ @ . @ @ . . . . . @ . @ . . . @ . . . @ @ . @ . . @ . @ . @ @ . . @ . @ . @ . @ . . . @ . . @ @ . . @ @ . @ . @ . @ . . @ . . . . @ @ . @ . @ . @ @ . @ @ . @ 
@ . @ @ @ . . @ . @ . @ @ . . . . @ . @ . . . . . @ . @ . @ . @ . @ @ . . @ . @ . . . . . @ . @ . . . . . @ . . . . . . . . @ @ @ @ . . @ @ . @ . . . @ @ @ . . @ @ . @ . @ @ . . . @ @ @ . . . . . @ @ 
@ . . . . . @ @ @ @ . . . @ . @ . @ . . @ @ . @ . . @ . . @ . . . @ . @ . @ @ . . @ @ @ . . . . . @ . @ . . @ . @ . @ . @ . . . @ . . @ . @ . . @ . @ @ @ @ @ @ . . @ . @ . @ @ . @ @ @ @ . @ . @ . . @ 
@ . @ . @ . . @ @ @ . @ @ . @ @ @ @ @ . . . . . @ @ . . @ . . @ . . . . . . . . @ . . . . @ . @ . @ . @ @ @ . . @ @ @ . . @ . @ . @ . . . . @ @ . . . @ @ @ . . @ . @ . @ . . @ . . . @ . . @ . . @ . @ 
@ @ . @ . @ . . . . . . . . . @ @ @ @ @ @ @ . @ . . . @ . @ . . @ . @ . @ @ @ @ . @ . @ . . @ . . . @ . . . . @ . . . . @ @ . . . . @ . @ . . . @ . @ . @ @ . @ . . . . . . @ @ @ . @ . . @ . . @ @ . @ 
@ . . . . . . @ . @ . @ . @ @ @ @ @ @ @ @ . . . @ . @ . . . . @ @ @ . @ . . . . . . . @ @ @ . @ . @ @ . @ @ . . @ . @ . . @ . @ @ @ . . . @ @ . . . . . . . . . . @ . @ . @ @ . @ . @ . @ . @ . . . @ @ 
@ @ . @ . @ . @ . . @ . . @ @ . @ @ @ @ . . @ @ . . . @ . @ . @ . . . . @ . @ . @ . @ . . . . . . @ @ @ . . . @ . @ . . @ @ @ @ @ . . @ @ . @ @ . @ . @ . @ @ . @ . . @ . . @ . @ . @ . @ . @ . @ . . @ 
@ @ . . @ . . . @ . @ . @ @ . . . @ @ @ @ . @ . . @ @ @ @ @ . @ @ . @ @ @ . @ @ . . @ . @ . @ . @ . . . . @ . . . @ @ @ @ @ . @ @ @ . @ . . . . . . @ . . . . @ . @ . . @ . . . . @ . . @ . . . . @ . @ 
@ . . @ @ @ . @ . @ @ . @ . @ . @ @ @ @ @ @ @ @ . . . . . . @ . . . . @ . . . . @ . . @ @ @ . . . @ . @ . @ @ . @ @ @ . @ . . . @ . @ @ . @ . @ . @ . @ . @ . . . @ . @ @ . @ . @ . . @ @ @ @ . @ @ . @ 
@ @ . @ @ . @ . . . . @ . . . . . @ @ @ @ @ @ . . @ . @ @ . @ @ . @ . . @ . @ . @ . @ @ @ @ @ . @ @ @ . . @ . . @ . . . . @ . @ . . . . . . @ . . . . . @ . . @ . . @ . @ . . @ @ @ . @ . @ @ . . . @ @ 
@ . . @ . . @ . @ @ . @ @ . @ @ . . @ @ @ @ . @ . . @ @ . @ . . @ . @ . . . @ . @ . . . @ . . @ . . . @ . . @ . . @ @ @ . . . . . @ . @ . @ @ @ . @ . @ . @ . . @ . @ . @ @ @ . @ @ @ . . . @ . @ . . @ 
@ @ . . @ . @ . @ @ @ . . @ . @ @ . . @ . . . . . @ . . . . @ . @ . @ @ . @ . . @ . @ @ . @ . @ @ @ . @ . @ . @ . @ . . . @ . @ . . @ @ @ @ @ . . @ . @ . . . @ . . . . . . . . . . . @ . @ . @ . @ @ @ 
@ . @ . @ . . . . @ . @ . @ . @ . @ . . . @ . @ . . @ @ . @ @ . @ . . @ @ . . @ @ @ . . . . . . . . . . . . . . @ . @ . @ . . . @ . @ . @ . @ @ . @ . . @ @ . @ @ . @ . @ . @ . @ @ . . . . . . . . . @ 
@ . @ @ . @ @ . @ . . . . . . . . . . @ . . @ . . @ . . . . . . @ . @ @ @ @ . . . @ . @ . @ . @ . @ . @ . @ @ . . . . @ @ @ . @ @ . . . . . . @ @ . @ . @ . @ @ @ . . @ @ . @ @ . @ . @ . @ . @ . @ . @ 
@ . . . . . . . . . @ . @ . @ . @ . @ . @ @ . @ . . @ @ . @ @ . . . . @ . . . @ . @ @ . @ . . . @ @ @ . . @ . . @ @ . @ @ . @ . @ . @ @ . @ @ . . . . . @ . @ @ @ . @ @ @ . . . . . @ @ @ @ . . @ @ . @ 
@ . @ @ . @ . @ . @ @ @ . . . @ @ . @ . @ . . . . @ @ @ . @ @ @ . @ . . . @ . . @ @ . . @ @ . @ @ @ @ @ @ . . @ @ . . . . . @ . . . . . @ . @ . @ . @ @ . . . . . . @ @ @ . @ . @ . . @ . . . @ . @ . @ 
@ @ @ @ @ . . . @ @ @ . . @ . . . @ . . . . @ . @ . @ . @ . @ @ . . @ . @ . . @ @ . . @ . . . @ @ @ @ @ @ @ . . . @ . @ . @ . @ . @ . @ . . . . . @ . @ @ . @ . @ . . . . @ @ . . @ . @ . @ . . . . @ @ 
@ @ @ @ . @ . @ . @ @ @ . @ . @ @ @ @ . @ . @ . @ . . . . . . . . @ @ @ @ @ . @ . . @ . @ @ . @ @ . @ . @ @ @ . @ @ . . @ @ . . . . @ @ @ . @ . @ . . . @ @ . . @ . @ . @ @ . . @ @ @ . @ @ @ @ @ . . @ 
@ @ @ . . . . . . . @ @ @ . . @ . @ . @ . @ . . @ . @ . @ @ . @ . @ @ . @ . @ . @ . . . . . . . . . . . . . @ . @ @ @ . . @ . @ . @ . @ @ . . @ . @ . @ . . . @ . . . @ @ . @ . . @ @ . @ @ @ @ @ . @ @ 
@ @ . @ . @ @ . @ . . . . @ @ . . . . . . . @ . @ . @ @ . . . . @ . @ . . . . . . . @ . @ @ . @ @ . @ @ . @ @ @ @ . . . @ @ @ . . . . . . @ . . . @ . . @ . @ @ @ . @ . . . . . @ . @ . . @ @ @ . . . @ 
@ . . . . @ . . . @ @ @ . . @ @ . @ . @ @ . . . . @ . . . @ . @ @ . . @ @ . @ . @ . @ @ . . . @ . . . . @ @ @ @ . @ @ . @ @ . @ . @ @ . @ @ @ . @ . @ . . . . @ @ . @ . @ . @ . @ . @ . @ . @ @ @ . @ @ 
@ . @ . @ @ @ . @ @ @ . @ @ . . . @ . @ . . @ . @ . . @ . @ . . @ . @ . @ . @ @ @ @ . . . @ . @ @ @ @ . . @ @ . . @ @ . . . . . @ . . @ @ @ @ . . . . @ . @ . . . @ @ . . @ . . . . . . . . @ @ . . . @ 
@ . @ . . @ . @ . . . . . . . @ . @ . . @ . @ . @ . @ . @ . . @ . . . . . . @ @ . . . @ @ . . . . . . @ @ @ . @ . @ . . @ . @ . . . @ . @ @ @ @ . @ . @ . @ . @ @ @ @ @ . @ @ @ . @ . @ . @ @ . @ @ . @ 
@ @ @ . @ . . . . @ @ . @ . @ . . . @ . @ @ . . @ . . . @ @ @ @ . @ . @ . @ . . . @ . . . @ . @ @ . @ . @ . . . . . . @ . . . @ @ . . . . @ . . . . @ @ . @ . . . . @ . . @ @ . . @ . . @ . . . @ . . @ 
@ @ . . @ . @ @ @ @ @ @ . . . @ . @ . . . . @ . @ . @ . . . @ @ @ . . . @ @ @ @ @ . . @ . . @ @ . . . . @ @ @ . @ . @ @ @ . @ . . . @ @ @ @ @ @ . @ . @ . @ . @ @ @ . @ . @ . @ . . @ @ . @ @ . @ @ @ @ 
@ . . @ . . . . @ @ @ @ @ . @ @ . @ . @ . @ . @ . . . @ @ @ @ @ @ @ @ @ . . @ . @ @ . . @ @ . . . @ . @ @ . @ @ @ . . @ . @ . @ @ . . . . @ . . . @ . . . . @ . . . . @ . @ . . . @ . . . @ . . . @ . @ 
@ @ . . @ . @ . . @ @ @ @ @ @ @ @ @ . . @ . . . @ . @ . @ @ @ @ @ @ @ @ @ . . . . . . @ @ . . @ . . @ @ . . . . . . @ @ . @ . @ . . @ @ . . @ @ . . @ @ . @ @ @ . @ . . . . @ . @ . @ . @ . @ . @ . . @ 
@ @ @ @ . . . @ . . @ @ @ @ @ @ @ @ . @ . @ . @ . . . . . @ @ @ @ @ @ @ @ @ . @ . @ . . . @ . @ . @ . . @ . @ . @ @ . . . @ . @ @ . @ @ . @ @ @ @ . . @ . . @ . . . @ . @ @ @ @ @ . @ . . . . . . . @ @ 
@ @ @ @ @ . @ @ . @ @ @ @ @ @ @ @ @ @ . . . . . @ . @ @ . @ @ @ @ @ @ @ @ @ . . @ . @ . @ @ . . @ . @ . . @ . . . . . @ @ . . . . . . @ . . @ @ . @ . @ . @ @ @ . @ . @ . @ @ @ . . . @ @ . @ . @ . . @ 
@ @ @ @ @ . . . @ @ @ @ @ @ @ @ @ @ @ @ . @ @ . @ . @ @ @ @ @ @ @ @ @ @ @ @ @ @ . . . . . . @ . . . @ @ . @ . @ @ @ @ @ @ @ . @ . @ . . @ . @ . . . . @ . . @ @ @ . . . . . @ . @ . @ . @ @ . . @ @ . @ 
@ @ . @ @ . @ . . @ @ @ @ @ @ @ @ @ @ @ @ @ @ . . @ . @ . @ @ @ @ @ @ @ @ @ @ . . @ . @ @ . @ . @ . @ . . . . . . . . @ @ @ @ . . @ . @ @ . . @ @ @ . @ . @ . @ . @ @ . @ . . . @ . . . . @ @ . . @ . @ 
@ . . . . . . @ . . @ @ @ @ @ @ @ @ @ @ . @ @ @ . @ . @ . @ . @ @ @ @ @ @ @ . . @ . . . @ . @ . @ @ . @ . @ . @ @ . @ . @ @ . @ . @ . . . @ . . @ @ . . @ @ . . . . @ . @ . @ @ . . @ . @ @ . . @ @ @ @ 
@ . @ . @ . @ . . @ @ @ @ @ @ @ @ @ @ . . . @ . . . . . . @ . . @ @ @ @ @ @ @ . . @ . @ . . @ . . . . . @ . . . @ . . . . @ . @ . @ . @ . . @ @ . . . @ . . . @ . @ . . . @ @ @ @ . . @ @ . . @ . @ . @ 
@ @ . @ . . . @ . . @ @ @ @ @ @ @ . . @ @ . @ @ . @ . @ @ . . @ . . @ @ @ @ . . @ @ . . @ . @ . @ . @ @ . @ . @ @ . @ . @ . . . . @ . . @ . . @ . @ . @ . @ @ . @ @ @ . @ . @ @ @ . @ . @ . @ . . . . @ 
@ . . . . @ . @ . @ . @ @ @ @ @ . @ . @ . . . @ . . @ @ @ . @ . . @ . @ . @ @ . . @ . @ . . @ . . @ . . . . . . . @ . . . @ . @ . @ . @ . . @ @ @ . . . . . . . . . . . . . . . . . . . . . . . @ . @ @ 
@ . @ @ . @ . . @ @ . . @ . @ . . . . . @ . @ . . @ @ @ . . @ @ . . . . . . . @ . @ . . @ . @ . @ @ @ . @ @ . @ . @ @ . @ . @ . . @ . . @ @ @ @ @ @ . @ . @ . @ . @ . @ . @ . @ . @ @ . @ . @ . @ @ . @ 
@ . . @ @ @ . @ @ @ @ . . . . . @ . @ . . . . . @ . @ . @ . . . . @ @ . @ @ . . @ . . @ . . @ . @ @ @ @ . . . @ . @ @ @ @ . @ @ . @ . @ @ @ @ @ @ . . . @ @ . @ . . @ @ . . @ @ . @ . . . @ . . . . . @ 
@ @ @ . . . . . . @ . . @ . @ . . @ . @ @ . @ @ . . . . . . @ @ . . @ . . @ @ . . @ @ @ @ . @ @ @ @ @ @ @ . @ . . @ @ . . . @ . @ . . @ @ @ @ @ . @ . @ . . . . @ . . . @ . . . @ @ @ . @ . @ . @ @ @ @ 
@ . @ . @ @ . @ @ . . @ . . @ . @ . . . . . @ . @ . @ @ . @ @ . @ . . @ . . . @ @ @ @ @ . . . @ @ . @ . . . . @ @ . . . @ . . . . . @ . @ . @ . . . . @ @ . @ . @ . @ . . @ . @ . . . . . . @ . . @ @ @ 
@ . . @ @ . . . @ @ @ . . @ . @ @ @ . @ . @ . . . . . @ . . . . @ @ @ . @ . @ . @ . @ @ @ . @ . . . . . @ . @ @ . @ . @ @ @ @ . @ . @ . . . . . @ . @ @ . . @ . . @ . @ @ @ @ . @ . @ . @ . . @ . . . @ 
@ @ . @ @ . @ . . @ . . @ . . @ @ . . @ @ . . @ . @ . . @ . @ . . . . . @ . . . . . . @ . . . @ @ @ . @ . . . . . @ . . . . . @ . . . @ . @ . @ . . @ . @ . @ . @ . . . . @ @ . . @ . . . @ . @ . @ . @ 
@ . . . . . @ @ . @ . @ . @ . . @ . @ . @ @ . . @ . . @ . . @ . @ @ . @ . . @ . @ . @ . @ . @ . @ . @ . @ . @ . @ . @ . @ . @ . @ . @ . @ @ . . @ . . . . @ . . . . @ . @ . . . @ . @ . @ . . @ . . @ @ 
@ . @ . @ . @ . . . @ @ . . . @ . . @ . . . . @ . @ @ @ @ . . @ @ @ @ . . @ . . . @ @ . . . . . . . . . @ @ . . . . . @ @ @ . . . . . . . . @ @ @ @ . @ . . @ . @ @ . . . @ @ . @ . . . . @ . @ . @ @ @ 
@ . @ @ @ . . @ . @ @ . @ @ . @ . @ @ . @ . @ @ . . . @ . . @ @ @ @ . @ . @ @ . @ . @ . @ . @ @ . @ @ . @ . @ . @ . @ @ @ . @ . @ . @ . @ . . . @ . . @ . @ . . @ @ @ . @ . @ . . @ . @ @ . . @ . . @ @ 
@ @ . . . . @ @ . . . . . . . . . . . . . @ . @ . @ @ . @ . @ @ @ . . . @ @ @ @ @ . @ . . @ . . . . . @ . . . . . @ @ @ . . . . @ . @ . . @ . @ . @ . . @ . @ . @ @ @ . . . . . @ @ . @ . @ . @ . @ @ @ 
@ . @ . @ . @ . @ . @ . @ . @ . @ @ . @ @ . . . . @ . . . @ . @ . @ . @ . @ @ . . . . . @ . @ . @ . @ @ @ . @ . @ @ @ @ @ . @ @ @ @ . @ . @ . . . @ . @ @ . @ . . @ . . @ . @ . . . @ @ . @ . . @ @ @ @ 
@ . . . . @ @ . @ @ @ . @ @ . @ @ . . @ @ . @ @ . . . @ . . . . . . . . . . @ . @ . @ . . . @ . @ . . . . @ . . . . @ @ @ @ . . . @ . . . . @ . @ . @ . . . . . @ . . @ . @ . . @ . . . . @ . @ @ @ @ @ 
@ @ . @ @ @ @ . @ . @ . . . . . . @ . . . . . . @ . @ . . @ . @ . @ . @ . @ @ @ . . @ @ . @ . . @ . @ . @ @ @ . @ @ @ @ @ @ @ . @ . . @ . @ @ . . . @ . @ . @ . @ @ . . . . @ . @ . @ . @ . @ @ @ @ @ @ 
@ @ . . . @ . . . . . . @ . @ . @ . . @ . @ . @ . . @ . @ @ . . @ . . . @ @ @ @ @ . @ . . . @ . @ . . @ @ @ @ @ @ @ @ @ @ @ . . . . @ @ . @ . . @ @ . . @ . . @ @ . . @ . @ . . . @ @ . . . @ @ @ @ @ @ 
@ @ @ @ @ @ @ @ @ @ @ @ @ @ @ @ @ @ @ @ @ @ @ @ @ @ @ @ @ @ @ @ @ @ @ @ @ @ @ @ @ @ @ @ @ @ @ @ @ @ @ @ @ @ @ @ @ @ @ @ @ @ @ @ @ @ @ @ @ @ @ @ @ @ @ @ @ @ @ @ @ @ @ @ @ @ @ @ @ @ @ @ @ @ @ @ @ @ @ @ 
3
1 29 27 32
70 97 44 51
15 28 68 53
