100 100
@ @ @ @ @ @ @ @ @ @ @ @ @ @ @ @ @ @ @ @ @ @ @ @ @ @ @ @ @ @ @ @ @ @ @ @ @ @ @ @ @ @ @ @ @ @ @ @ @ @ @ @ @ @ @ @ @ @ @ @ @ @ @ @ @ @ @ @ @ @ @ @ @ @ @ @ @ @ @ @ @ @ @ @ @ @ @ @ @ @ @ @ @ @ @ @ @ @ @ @ 
@ @ @ @ @ @ @ . . @ . . . . . @ . . . . . . @ @ @ @ @ . @ @ @ @ . . . @ @ @ . . @ @ . @ @ . @ @ @ @ . @ . @ @ @ . @ . . @ @ @ @ @ @ @ @ @ @ @ @ @ @ . . @ . @ @ @ @ @ @ @ @ @ @ @ @ @ @ @ @ @ @ @ @ @ @ 
@ @ @ . @ @ @ . @ . . @ . @ @ @ @ @ . @ . @ @ @ @ @ . . @ @ @ @ @ . @ @ @ . @ . . . . . . . . . @ . . . . . . . . . @ . . @ @ @ @ @ @ @ @ @ @ @ @ @ @ . . . . @ . @ @ @ @ @ @ @ @ @ @ @ @ @ @ @ @ @ @ @ 
@ . . . . @ . . . . @ . @ @ @ @ @ @ . . @ @ @ @ @ @ . @ . . @ @ . . . @ @ . @ . @ . @ . @ . @ @ @ @ . @ @ @ . @ @ @ . . @ . @ @ @ @ @ @ @ @ . @ @ @ . . @ . @ . . . @ . . @ @ @ @ @ @ @ @ @ @ @ @ @ @ @ 
@ . @ . @ . @ . @ @ @ . @ . @ @ @ @ . @ . @ @ @ @ . . @ @ . . @ @ @ . . . . . . . @ . . . @ @ @ @ . . @ @ . . @ @ . . @ . . . @ . @ @ @ . . . . @ @ @ . . @ . . @ @ . @ . @ @ @ @ @ @ @ @ @ @ @ @ @ @ @ 
@ @ . . @ . . . @ @ . . . . @ @ @ . . . . . @ @ @ @ . @ . @ . . @ . . @ . @ @ @ @ . @ . @ @ @ @ . @ . . . @ . @ . @ . . . @ @ . . @ @ @ @ . @ . . @ . . @ . @ . . . . . . . @ @ @ @ @ @ @ @ @ @ @ @ @ @ 
@ . . @ . . @ . @ . . @ @ @ . @ . @ . @ . @ . @ @ . . . . . . @ . @ . . @ @ @ . @ . . @ @ . @ . . . . @ . @ @ . . @ . @ @ . @ . @ . @ @ @ @ . . @ . @ . . . . . @ @ . @ . @ . @ @ . @ @ @ @ . @ @ @ @ @ 
@ @ . . @ @ . . . @ . @ . @ . . . . . . @ @ . . @ . @ . @ . @ . . . . @ . @ . . . . @ . . . @ . @ . @ @ @ . . @ . . . . . . . . . . . @ @ @ @ . . . . . @ . @ @ @ . . @ @ . . . . . . . . . . . @ @ @ @ 
@ . . @ . . @ . @ . . @ . . . @ . @ . @ . . . @ @ @ @ @ . . . @ . @ . . . . @ . @ . @ . @ . . @ . . . @ . . @ . . @ . @ . @ . @ . @ . @ @ . @ . @ . @ @ . . . . . @ @ . . @ . @ . @ . @ @ @ . @ @ @ @ @ 
@ @ . . . @ @ . . . @ . . @ @ . @ @ @ . @ . @ . @ . @ . @ . @ @ @ . . @ . @ . . . @ . @ . . @ . @ . @ . @ . . @ . . @ . @ @ @ . . . @ . . . . . . @ @ @ . @ @ . @ . . . @ . . . @ @ @ . . @ @ @ @ @ @ @ 
@ @ @ @ . . @ . @ @ . . @ . @ . @ @ . . . . . . . . . . . . . . . @ . . @ @ @ @ . . . . @ . . . . . . . . @ . . . @ @ . @ @ @ @ . @ . @ @ . @ @ @ . @ . . . @ @ @ . @ . . . @ @ . @ @ @ . . . @ @ @ @ @ 
@ . . . @ . @ . . @ . @ . . . . . . @ . @ . @ @ . @ @ @ . @ . @ . @ . @ . @ @ . . @ . @ . . @ @ . @ . @ . @ . @ . . @ . . @ @ . . . . . @ . @ . @ . @ . @ @ . . . @ . @ @ . . @ . . . . . @ @ @ @ @ @ @ 
@ . @ @ . . @ . @ . . . . @ @ . @ @ . . . @ . . . @ @ @ @ @ @ . . @ . @ . @ . @ . @ . . . @ . . @ . . . @ . . . @ @ . . @ . @ @ . @ . @ . . . . . . . @ @ @ @ . @ . . . @ . @ . . @ . @ . @ @ @ @ @ @ @ 
@ . . . @ . . . . . @ . @ @ @ @ . . @ . @ . @ . @ @ @ @ @ @ @ @ . @ . . . . . . . . @ @ @ . . @ @ @ . @ @ @ . @ . @ . @ . . @ . . @ . . @ . @ . @ . @ . @ @ . . . @ . @ . . . . @ . . . @ @ @ @ @ @ @ @ 
@ @ @ . . @ . @ @ . . @ @ @ @ . . @ . . . . . @ . @ @ @ @ @ @ @ . @ . @ @ @ @ @ . @ . . @ . @ . @ . @ @ . @ . . . @ . . . @ . @ . . @ @ @ . . @ . . . . . . @ @ . @ . . @ . @ @ @ @ . @ . @ @ @ . @ @ @ 
@ @ @ . @ . . . . @ . @ . @ . @ . @ . @ @ @ . . . @ @ @ @ @ @ @ . . . . @ . @ . @ @ @ . . . . . . . . . . . . @ . . @ @ . @ . . . @ @ . . . @ . @ . @ . @ . . . . @ . @ . . . @ @ @ . @ . . @ . . . @ @ 
@ . @ . . @ . @ @ . @ @ . . . . . . @ @ . . . @ @ @ @ @ @ @ . . @ . @ . . . @ . @ @ @ @ . @ @ . @ . @ . @ @ . @ . @ @ . . @ @ @ @ @ . . @ . . . . @ @ @ . . @ @ @ . . . @ . @ . @ . @ @ @ . . @ . @ @ @ 
@ . . . @ . . . . . . @ . @ . @ . @ @ @ @ . @ @ @ @ @ @ @ . @ . @ . . @ . @ @ . @ @ @ @ @ @ @ @ . . . @ . . . . @ . . @ . . . . . @ . @ @ . @ @ @ . . . . @ . . . . @ @ . . . . . . . @ . . @ . . . . @ 
@ . @ . . @ . @ . @ . . . . @ . @ @ @ @ @ @ @ @ @ @ @ @ . . . . . . @ . @ . . . . . @ . . @ @ @ @ @ . @ . @ . @ @ @ . . . @ @ @ @ . @ . . . . . @ @ @ . @ . @ . @ . @ @ @ . @ . @ . @ . @ . . @ . @ . @ 
@ @ . @ . . . @ . . @ . @ . . . . @ @ @ @ @ @ @ @ @ @ . @ @ @ . @ . @ . . @ . @ . @ . @ . @ . @ . @ @ . . @ . . @ @ . @ . . @ . . . . . @ . @ @ . . . @ @ . . @ @ . . @ @ . . @ . . @ . . @ . . . . @ @ 
@ . . . @ @ . . @ . . @ @ . @ . @ @ @ @ @ @ @ . @ . . . . . . . @ . . . @ . @ . . . . . . . . . . . . @ . . @ . . . @ . . @ . @ @ . @ @ . @ . . . @ . @ . @ . . . . @ . . . @ . @ @ . . @ . . @ . @ @ @ 
@ @ . @ @ @ . @ . @ . . . @ @ . . @ @ @ @ @ . . . . @ . @ @ . @ . . @ @ . . . @ . @ . @ . @ @ @ @ . @ @ @ . @ @ . @ @ @ . . . . . . . . . . @ . @ . . . . @ @ . @ . . @ @ . . . . . @ . @ . @ . @ @ @ @ 
@ . . . @ . . . . . @ @ . @ @ . @ @ @ . @ @ @ . @ . . @ . @ @ @ @ . . @ . @ @ . . . @ . . @ . . . @ . @ . . . . @ @ @ . @ . @ @ . @ @ . @ @ . @ @ @ . @ . @ . . @ . @ . . . @ . @ . . . . . . . . @ . @ 
@ @ . @ . . @ . @ . @ . @ @ @ @ @ . . . . . @ @ . . @ . . . @ . @ . @ . . @ . . @ . . @ @ @ . @ @ . . @ @ . @ @ . @ @ . @ . @ . @ . . @ . @ . . @ @ @ . . . @ @ . . . @ @ . . @ . . @ . @ @ @ . @ . . @ 
@ . . . @ . @ . . @ . . . . @ @ . @ @ . @ @ . @ @ . @ @ . @ . . @ . . . @ . @ . @ . @ . . . . @ @ . @ . . . . . . . @ . . . @ . . @ . . . @ . @ . . . @ @ . @ . @ . @ . . . @ @ @ . . @ . . . . . @ . @ 
@ @ @ . . . . @ @ . @ . @ @ . . . . . . . . . . @ @ @ . . . . @ @ . @ @ . . . . . @ @ @ @ @ . . . . . . @ . @ . @ @ @ . @ @ . @ . . @ @ . . . @ . @ @ . . . . . . . @ . @ . . @ . . @ . @ . @ . @ @ . @ 
@ @ @ @ @ @ . . @ . . . . @ . @ . @ . @ . @ . @ . . @ @ . @ . @ . . . . . @ . @ . . . . @ . . @ . @ . @ . . . @ . . @ . . . . . . @ . @ @ . @ . . . @ . @ . @ . @ . . @ . . @ . @ . @ . . . . @ . . . @ 
@ @ @ . @ . . @ . @ @ . @ . . . @ @ @ @ @ @ @ . @ . . . . . @ . @ . @ @ @ . @ @ @ . @ @ . . @ . @ . . . @ . @ . @ . . . @ @ . @ @ @ . . . . . . @ @ @ @ . . @ @ . . @ . @ . @ . . . @ @ . @ . . . @ . @ 
@ @ @ . . @ . . . . . . . @ . @ . @ . @ . . @ . . . @ . @ . . . . . . . . . . @ . @ . @ . @ . . @ . @ . . @ @ . . . @ . @ . @ @ @ . . @ @ . @ @ . @ @ @ @ @ . @ @ . . . . . . @ @ . @ @ @ @ @ . @ . . @ 
@ @ . @ . . @ @ . @ . @ @ . . . . @ . . @ . . @ . @ . @ . @ . @ . @ . @ . @ . . . . . . . . . @ . @ . . @ @ @ @ . @ . @ @ . @ @ @ @ . . @ . @ . . . . @ . @ . @ . @ @ . @ . @ @ @ @ @ @ . . . @ @ @ . @ 
@ @ . . @ . @ @ . @ . @ . . @ @ . @ . @ . . @ . . . . . . @ . . @ @ @ . . . @ . @ @ @ . @ @ . . . . @ . @ @ @ @ . . . . . . . . . . . @ . @ @ @ . @ @ . . . . . . . . . @ @ @ @ @ . @ . @ . @ @ @ @ @ @ 
@ . @ . . . @ . . . @ @ @ . @ . . @ . @ . @ @ . @ . @ . @ . . @ . @ @ @ @ @ @ @ . @ @ . @ . @ @ . @ . . @ @ @ @ . @ . @ @ . @ @ . @ . @ . @ @ . . . @ . @ . @ . @ . @ @ . @ @ @ @ . @ . @ . . @ @ @ @ @ 
@ . . @ @ . . @ . @ . @ . . . @ . @ . @ . . . . . @ @ @ . @ @ . . . @ . . . . . . . @ @ . . @ . @ @ @ . @ @ . @ . @ . @ . . . . @ @ @ . . @ . @ . @ . . . @ @ . @ . . . . . . . . . . . . . @ . . . . @ 
@ @ . . . @ . . . . . . @ . @ . @ . . @ . @ @ . @ . . . . @ @ . @ @ . @ . @ . @ @ . @ . . @ . . . @ @ @ . @ . . . . @ . @ @ . @ @ @ @ @ . . . . . . . @ . . @ @ @ @ . @ . @ . @ @ @ . @ @ @ . . @ @ . @ 
@ . @ . @ . . @ . @ . @ . . . . . @ . @ . . @ @ @ . @ . @ @ . . . . . . . . @ @ . @ . @ . @ . @ @ @ @ @ . . . @ @ @ . . . @ . @ @ @ . . . @ . @ . @ . @ . @ @ @ @ . . . @ . . @ . @ . . . @ @ . . @ . @ 
@ . . . @ . @ @ . @ . @ . @ . @ . . . @ . @ @ . . . . @ . . @ . @ @ . @ @ @ . @ . . . @ . . . @ @ @ @ @ . @ @ . @ . . @ . @ @ . @ . @ @ . . @ . . . @ @ . . @ @ @ @ . @ @ @ . . . . @ . @ @ . . @ . @ @ 
@ @ @ . @ @ . . . . @ . . @ . . @ @ . @ . . . @ @ . @ . . @ . . . @ @ . . . . . . @ . @ . @ @ . . . @ . . . . . . . @ . @ . . . . . . @ . @ @ @ . @ . . @ @ . @ @ . . . @ @ @ . @ . . @ . @ . @ . . @ @ 
@ . . . @ @ . @ . @ . @ . . @ . . . @ @ . @ @ . . . . . @ @ @ . @ @ . . @ . @ @ . . @ @ . . . . @ @ . @ . @ @ . @ @ . . @ @ . @ . @ @ . . @ @ @ . . . @ . . . @ . @ . @ @ @ @ @ @ @ . @ . . . . . @ @ @ 
@ @ @ . . . @ . . @ . @ . @ . @ @ @ @ . . . . @ @ . @ . . . . . @ . @ @ . . . . @ @ . . . @ . @ . . . . . . @ @ @ . . @ @ . . . @ . . . @ . @ . . @ . . . @ . . . . @ @ @ . @ . @ . @ @ @ . @ @ . @ @ @ 
@ . . . @ @ . @ . @ . . . . . . . @ @ @ . @ @ . @ @ . . @ . @ . . . . @ @ . @ @ @ . @ . @ @ @ @ @ . @ . @ @ . @ . @ . @ . @ . @ . @ @ . . . @ . @ @ . @ . . @ . @ . @ . @ . . . . . . @ @ . . @ . . . @ 
@ @ @ . . . . . . . . @ @ @ . @ . @ @ @ . . @ . @ . @ . @ @ @ @ . @ @ . @ . . . @ . . . . @ . . . . . @ . . . . . . . . . . . . . . . . @ @ . @ . . @ @ @ @ . @ . . @ . . . @ . @ . @ . @ . @ . . @ . @ 
@ . . . @ . @ @ . @ @ . . . @ @ @ . @ @ . @ . . . . . @ @ @ @ . . . . . . @ . @ . @ @ . @ . @ @ @ . @ . @ . @ . @ . @ @ . @ @ . @ . @ . . . . . @ . @ @ @ . . @ @ @ . . @ @ . @ @ @ . . . . . @ . @ . @ 
@ @ @ . . @ . @ . . @ . @ . . @ . . . @ . . . @ @ @ @ @ @ @ . . @ @ . @ . . . . . . . . . . . @ . . . . . . . @ @ . @ @ . . @ @ @ . . @ . @ . @ . . . @ . . @ . @ @ @ . . @ . . @ . . @ . @ . . @ @ @ @ 
@ . . . @ . . . . @ . @ . . @ . @ . @ . . @ . . . . . @ @ . . @ . . @ . @ . @ . @ @ @ @ @ @ @ . @ . @ . @ . @ . . . @ . @ . @ . . . @ @ . . @ @ . @ @ . @ . . . @ @ . . @ . . @ . @ . @ @ . . @ @ @ @ @ 
@ @ . @ @ @ . @ . @ . @ @ . . . . . . . @ . . @ @ . @ . @ . @ @ . @ . . @ @ . @ . . . . . . . . . . . @ . @ @ @ @ . @ . . @ @ @ @ . . . @ . @ . . . @ . . . @ @ . @ . @ @ . @ . . . . @ @ @ . @ @ @ @ @ 
@ @ @ . @ . . . @ . . . . . @ . @ . @ @ . . @ @ . . . . . . . . . . @ . . @ . . . @ . @ @ . @ @ . @ @ . . @ @ @ @ @ @ . @ . @ . @ . @ . . @ @ @ . @ @ @ . @ . @ . . . . . . . . @ @ @ . . @ @ . @ @ @ @ 
@ @ @ . @ @ . @ . @ . @ . @ @ @ . . @ . . @ . . @ . @ @ . @ . @ . @ @ . @ @ . @ @ . @ @ @ @ @ . @ . @ . @ . @ @ @ @ . . . . . . @ @ . . @ @ @ @ . . @ . . . . . . @ . @ . @ . @ . @ . @ . . @ . . @ @ @ 
@ @ . . . . . . . . . @ . . . . @ . @ @ @ @ . @ @ . @ . @ @ . @ . . . . . . . . . . . @ @ . @ . @ . . . . . . @ @ . @ . @ @ . @ @ @ @ @ . @ @ . . @ . @ . @ . @ . @ @ . @ . . . . . . . . @ . @ . @ @ @ 
@ @ . @ . @ . @ . @ . . @ . @ . . @ @ . . . . . @ . . . . . @ @ . @ . @ @ @ . @ . @ . . @ . . . . . @ @ . @ . . . . . . . @ . @ . @ . . . . @ @ . . . . . . @ @ @ . . . @ @ . @ . @ @ . @ @ . . . . @ @ 
@ . . . @ @ @ @ @ @ @ @ . @ . . @ . . . @ @ . @ . . @ . @ . . . @ @ @ . . . . @ . @ @ . . . @ . @ @ . . @ @ @ . @ . @ . @ @ @ . . . . @ @ @ . . @ . @ . @ @ . @ @ @ . @ . @ . . @ @ @ . @ . . @ . @ @ @ 
@ @ . @ @ @ . @ @ @ . . . . @ . . @ @ . . . @ . . @ . @ @ . @ . . . . @ @ @ . . @ . . . @ . . @ . . . @ @ @ . @ @ @ . @ @ @ @ @ . @ . . @ @ . @ . . . @ @ @ . . @ . . . . . @ @ @ @ . . . . @ . . . @ @ 
@ . . . @ . . . @ @ . @ . @ . @ . . @ . @ @ @ @ . . . . @ . . @ @ . @ @ . . @ @ . @ @ . . @ @ . . @ @ . . . . . . . . . @ . @ . @ @ . @ . @ . @ . @ @ . @ @ . @ . @ @ . @ . . . @ @ @ . @ @ @ @ . @ @ @ 
@ . @ @ . @ . @ . @ @ . . . . @ @ . . . . . . @ @ . @ . @ . @ . @ . @ @ . @ @ . . @ . @ @ . @ @ . @ @ . @ . @ . @ @ . @ . . @ . . . . . . . . . . . . . . . . . . . @ . @ . @ @ . @ @ @ @ @ @ @ . . @ @ 
@ . . . . . . . . . . . @ . @ . . @ . @ . @ . . @ . . @ . . . . @ . @ . . . @ . @ . . . . . . . . . . . . @ . @ . @ @ . . @ . . @ @ . @ . @ . @ @ @ . @ . @ @ . @ . . . . @ . . . . @ @ @ @ @ . . @ @ @ 
@ @ @ @ . @ . @ . @ . @ @ @ @ . @ @ @ . . . @ . . @ . . @ . @ @ @ @ @ @ . @ . . . . @ @ . @ . @ . @ . @ . . . . . . @ @ . . . @ . @ . . @ @ @ . . @ . . @ @ @ @ @ @ @ . @ . @ . @ @ . @ @ @ @ @ . @ @ @ 
@ . . . @ @ . . @ . . . . . . . @ . . @ . @ . . @ @ @ . . @ . . @ . @ . . . . @ . @ . @ . . @ @ @ . . . @ @ @ @ . @ . . . @ . . . . @ . @ @ @ @ . . @ . @ @ @ @ @ @ @ . . . . . . . . . @ @ @ @ @ @ @ @ 
@ . @ @ . @ . @ . . @ . @ @ . @ . @ . . . . @ @ . @ @ . @ @ @ . . . . . @ @ . . @ . . @ . @ . @ @ @ . @ @ . . . @ . . @ @ @ . @ @ @ . @ . . @ . . @ . @ . @ . @ @ @ . @ . @ . @ . @ . @ . @ @ @ @ @ @ @ 
@ . . . . . . . @ . @ . . @ . . . . @ @ @ . . @ . . @ @ @ . @ @ . @ @ . . @ . @ . . @ . . . . . @ @ @ . @ . @ . . @ @ @ @ . . . @ @ . . @ . . @ . . . @ . . . . @ @ . . @ . . . @ @ . . . . . @ . @ @ @ 
@ @ . @ . @ . @ . . @ . @ . . @ @ @ . . @ @ @ . . @ . . @ . . @ . @ . . @ . @ . . @ @ @ . @ . @ @ @ @ . . . . @ @ @ @ @ @ @ . @ . . @ . @ . @ @ . @ @ . . @ @ @ @ . @ . @ @ . @ @ . . @ . @ . . . . @ @ 
@ . . . @ . . . @ . . @ @ @ . . . @ . @ . @ @ . @ . . @ @ . @ . @ . . @ . . . @ . . @ @ . . @ @ @ @ . . @ @ @ . @ @ @ @ @ . . . . @ . . . . . . . . . . @ . . . . . . . . . . @ . @ @ . @ @ . @ @ . . @ 
@ . @ @ . @ . @ . @ @ @ @ @ @ @ . . . . . . . . . @ . . . . . . . @ . . . @ . @ @ . @ . . @ @ @ @ . @ . @ @ @ . . . @ @ @ @ . @ . @ . @ @ . @ @ . @ . @ . @ @ @ . @ . @ . @ . . . . . . . . @ @ @ . @ @ 
@ @ . . . . . . . . . @ @ @ @ @ @ . @ @ . @ . @ . . . @ @ @ @ @ @ @ . @ . @ . @ . . . @ @ @ @ @ . . . . . @ . . @ @ . @ @ @ . . @ @ @ . . . . @ . @ . . . . @ . . . @ . @ @ . @ . @ . @ @ . . @ @ @ @ @ 
@ . . @ . @ . @ . @ . . @ @ @ @ @ . . @ @ @ . . @ @ . . . . . . . . . . @ . @ . @ . @ . @ . @ . @ . @ . @ . @ . @ @ . @ . @ . @ . @ . @ @ . @ . @ . . @ . @ @ @ . @ . . . . @ . . . @ . @ . @ @ @ . @ @ 
@ . @ @ @ . . . @ . . @ . @ @ @ . . @ . . @ . @ . @ . @ . @ . @ @ . @ . . . . . . . . . . . . . . @ . . . . . . . . . . . . . . . . . . . . . . . @ . @ @ . @ . . . . @ . @ @ @ . @ @ . @ @ @ @ . . . @ 
@ . @ @ . @ . @ . @ . . . . . . @ . . . @ . . . . . @ . . @ . . . @ @ @ @ . @ . @ . @ . @ . @ . @ @ . @ . @ @ . @ . @ @ . @ . @ . @ . @ . @ . @ . @ . . . . @ @ . @ @ . @ . . . . . . . . . @ . @ . @ @ 
@ @ . . . . . . . @ . @ . @ . @ @ . @ . @ . @ . @ . @ @ . . @ @ . . @ . @ . . @ @ @ . . @ . @ . . . . . @ @ @ . @ . @ . . . @ . . @ . @ . . @ @ @ . . @ . @ . @ . @ . . . @ . @ . @ . @ . @ . . . . . @ 
@ @ @ . @ . @ . @ @ @ . . . @ . @ @ @ . @ @ . . @ . @ . . @ . . . @ @ . @ . @ @ @ @ @ . . @ . . @ . @ . . @ . @ . @ . @ . @ . @ . . @ @ @ . @ @ @ @ . . @ @ . @ . . @ . @ . @ . . @ . . @ @ . @ . @ . @ 
@ @ . @ . @ . @ . . . @ . @ . . . @ @ @ @ @ @ . . @ . . @ . . @ . . . . . @ @ @ @ @ @ . @ . @ . . @ . @ . . . . . . . . @ . . @ @ @ . @ @ @ . @ @ @ @ . @ @ . @ @ @ . . . . . @ . . @ . . . . . @ @ . @ 
@ . . . . @ . @ @ @ . . . . @ . @ . @ . @ @ . . @ @ @ . @ . @ . . @ @ @ . . . @ @ @ . . . . . @ . . . . @ @ . @ . @ @ . @ . @ . . . . . . . . . . . @ . @ @ . . . . @ . @ . @ . @ @ @ . @ @ . @ @ . . @ 
@ @ . @ . . . . . . . @ @ . @ . . . . . . . @ @ . @ @ @ . . . @ . . @ . . @ . @ @ . . @ . @ @ . . @ . @ . . . . @ . . . . . . . @ @ @ . @ . @ . @ . . @ . . . @ . @ . . . @ @ . . @ . @ @ . . @ . @ . @ 
@ . @ @ . @ . @ . @ . @ . . . . @ @ . @ @ . . . . . . . @ . @ @ . @ . @ . . @ . . @ @ @ . . @ @ . . @ @ . @ @ @ . @ . @ . @ @ @ @ . . . . @ . . . @ . @ . @ @ . @ @ . @ @ . @ . @ @ . @ @ @ . @ . . @ @ 
@ . @ . @ . . @ @ . . . @ . @ . . . @ @ . @ . @ . @ . @ . @ . . . . . @ . @ . @ . @ . . . @ @ @ . @ . . @ . . @ . . . @ @ . @ @ @ @ @ . @ . . @ . . @ . . . . . . . . . . . . . . @ . @ @ . . @ . @ @ @ 
@ . . . . @ . @ @ @ . @ . . . @ @ . . . . @ . . @ . @ @ . . . @ . @ . @ . . . . . . @ @ . . . . @ @ . @ . . @ @ @ . @ . . . . @ @ @ @ @ . @ . @ @ . . . @ . @ . @ . @ . @ . @ @ . @ . . . . @ . . . @ @ 
@ @ @ @ . @ . @ @ . . . @ . @ . . . @ . @ @ @ . . . @ @ @ . @ . . . @ . @ . @ . @ . . . @ . @ . . . . . . @ @ @ @ . . @ @ . @ . @ . @ @ . . . @ @ . @ . @ . . @ . . . @ @ . . . @ . @ @ . @ @ @ . @ @ @ 
@ @ @ . . . . @ . @ . @ @ @ . . @ . . @ @ @ @ @ . @ . . . . @ @ . @ @ . . . . @ . . @ @ @ @ @ . @ . @ . @ . @ @ . @ @ @ . . . . . . . . @ @ . @ @ . @ @ . . @ @ . @ . . . @ . @ @ . . @ @ . @ . . . @ @ 
@ @ @ . @ . @ . . . . . @ @ @ @ . . @ @ @ @ @ @ @ @ @ @ . @ . . . . . @ . @ @ @ @ . . . @ @ . . . @ . . . . @ . . . . . @ . @ @ . @ . @ . @ . . . @ @ @ @ . @ . . @ . @ @ . . . @ . @ @ @ . . . @ @ . @ 
@ @ . @ . . @ @ . @ . @ . @ . @ @ . @ @ @ @ @ @ @ @ @ . @ @ @ . @ . @ @ @ @ @ @ . . @ @ . . @ . @ . @ . @ . . . @ . @ . . . @ . . @ . . . @ . @ . @ @ @ . . @ @ . . @ . . @ . @ @ . . @ . . @ @ . @ . @ 
@ . . @ @ . . . @ . . . . . . . @ . @ @ @ @ @ @ @ @ . . . @ @ . . @ @ @ @ . @ . @ . @ @ @ . . . @ . @ . . @ @ @ @ . . @ . @ @ @ . . @ . @ . . . @ . . . . @ . . . @ @ . @ . . . . . @ @ . @ . @ . . . @ 
@ @ . . @ . @ @ . @ . @ @ . @ @ . . @ . @ @ @ . @ . @ . @ . . . @ . . @ @ . . . . . . @ @ @ @ . . . . @ @ . . . . . @ . . . @ . . @ @ . . @ . @ . . @ . @ @ @ . @ @ @ . . . @ . @ . . . . . . . . @ @ @ 
@ . . @ . @ . . . . . . . @ @ @ @ . . . . @ . . . . . . . @ @ . @ . @ . . . @ . @ . @ . @ @ . . @ @ . @ @ @ . @ . @ @ @ @ @ @ @ @ @ . . @ . . @ . @ . . . @ . . @ @ . @ . @ . . . @ @ . @ . @ @ . . . @ 
@ @ . . . . . @ . @ . @ . . @ . . @ . @ . . . @ . @ . @ . . . @ . . . @ . @ @ @ . . . . @ . . @ @ . . @ @ @ @ . . @ @ . @ . @ . @ . @ @ . @ . . @ . @ . @ . @ . . . . . @ . @ . @ @ @ . @ . . @ @ . @ @ 
@ . . @ . @ . @ @ . . . @ . @ @ . . . . @ . @ . @ . . . @ . @ @ . @ . . @ . . . . @ . @ @ @ @ . . @ . . @ @ @ @ . . . . . . . . . . . . . @ . @ . . . . . . . @ . @ . @ . . . . . . . @ @ @ . @ . @ @ @ 
@ @ . . @ . . @ @ @ . @ @ @ . @ . @ . @ . . . . @ @ . @ @ . @ @ . . @ @ . @ @ . @ . . . . . . . @ . . @ @ . @ . . @ . @ . @ . @ . @ . @ . @ . . @ . @ . @ @ @ @ . @ . @ . @ @ . @ . @ . . . . . . . . @ 
@ . @ . @ . @ . @ @ . . @ . . . . . @ @ @ . @ . . @ . . . @ . @ . @ . @ . @ @ . . @ . @ . @ . @ . @ @ . @ . @ @ . . @ . . . @ . . . @ @ . @ . @ @ @ . . . . . . @ . . @ @ . . . . @ . @ . @ . @ . @ . @ 
@ . . . @ . . . @ . . @ @ @ . @ @ . @ @ . @ @ . @ . @ . @ @ . . . . . . . . @ . @ . . . @ . . . . . . . . . . @ . @ . @ . @ @ @ . @ . . . . @ @ @ . @ . @ . @ . @ @ . . . @ @ . @ . . . . . @ @ . . @ @ 
@ @ @ @ @ . @ . . @ . @ @ @ @ . . . @ . . . @ . . . @ . . . . @ . @ . @ @ @ . . . @ . @ @ @ . @ . @ . @ @ . @ . . . . . @ . @ @ . @ @ @ . @ @ @ . . . . . @ . . @ . . @ . . . @ . . @ . @ @ @ . . @ . @ 
@ . . . . . @ . @ @ . . . @ @ @ . @ @ @ . @ . . @ @ . . @ . @ @ . . @ @ @ @ @ . @ . . . @ @ . . @ @ . . . @ @ @ @ . @ . . . . . @ . @ . @ @ @ . @ . @ . @ . @ . . @ . . @ @ . @ @ . @ . @ @ . @ . . . @ 
@ @ @ . @ . @ . . . @ @ . @ @ @ @ . . . . . . @ . . @ . @ . @ . @ @ @ @ @ @ @ . . @ @ . . . @ . . . @ . @ . . . . @ @ . @ . @ . . . . . . @ . . . @ @ . . . . @ . @ . @ @ @ @ . @ @ @ . @ . . . . @ . @ 
@ @ @ @ . . @ . @ . . @ . @ @ @ @ @ . @ . @ . @ @ . @ @ @ . . . . @ . @ @ . . . @ . . . @ . . @ @ . . @ @ . @ @ @ . . @ . @ . @ @ @ . @ . @ . @ . . . @ . @ . @ . . @ . @ @ . . . . . @ @ @ . @ . . @ @ 
@ @ @ . @ . . @ . . @ . @ @ @ @ @ . . @ . @ . . . . . . @ . @ . @ . . . @ . @ @ @ . @ . . @ . . . @ . . . . . . @ . @ . . . . . . . @ @ . . . @ . @ @ . . . @ @ @ . . . . . . @ @ @ @ . . @ . @ . @ . @ 
@ @ . . . . @ . @ . . . . . . . @ . @ @ @ . . @ @ . @ . . @ @ . . . @ @ . @ . . @ . . @ @ . . @ . . @ @ @ . @ . . . . . @ @ @ . @ . @ . . @ @ @ @ @ . @ . @ @ @ . @ . @ . @ . . . . . @ . . @ . . . . @ 
@ @ . @ @ . . . . @ . @ . @ . @ . @ @ @ . . @ . @ . . @ . . . @ . @ @ @ . @ . @ @ @ @ . @ @ @ . . @ . @ @ . . @ . @ . @ . . @ . . @ . @ @ . @ @ . . . . @ @ @ . . @ . @ . . @ . @ . @ @ @ . . @ . @ @ @ 
@ @ @ . . . @ . @ . . . @ @ @ . . . @ . @ @ @ . . . @ @ @ . @ @ . . . . . . . . . . . . . . @ @ . . . . . @ . . @ . @ . . @ @ @ . . . . . . . . @ @ . @ . @ . @ . . @ . . @ @ @ . @ . @ . @ . @ . . . @ 
@ @ @ @ @ . . @ @ @ . @ . @ @ @ . @ . . . . . @ . @ @ . . . . . @ . @ @ . @ . @ . @ . @ . @ . @ @ @ . @ @ @ @ . . . . . @ @ @ @ . @ @ . @ . @ . . . . . . . . . . @ @ @ . . @ @ . . . . . . . . . @ . @ 
@ . @ . @ . @ @ @ @ . . . . @ . . . @ . @ @ . . . @ . @ @ . @ . . @ . . . . @ . . @ . . @ . . . . . . @ @ @ @ . @ @ . @ . @ @ @ @ @ @ @ . . . @ . @ . @ . @ . @ @ . @ . @ @ @ @ @ @ @ . @ . @ . @ . . @ 
@ . . . . . . . @ @ . @ . @ . @ . @ . @ . @ . @ . . . . @ . . @ . . @ @ . @ @ @ . @ . @ . . @ . @ @ . . @ @ @ . @ @ . . . . . . . @ @ . @ . @ @ . . @ @ @ @ . . @ . @ . . @ @ @ @ @ @ @ . . . @ @ @ . @ 
@ . @ . @ . @ . . . @ . . . . . . . . . . @ @ . . @ . @ . . @ @ . @ . @ @ @ . . . . @ . @ . . @ . . . @ @ @ . . . . @ . @ . @ . @ @ @ . @ . . . @ . . @ . @ . @ . . . @ . . . @ @ @ . @ @ . @ @ @ @ @ @ 
@ @ @ @ . . . @ . @ . @ . @ . @ . @ . @ @ . @ @ . @ . . @ . . . @ . . . . . . @ . @ . . . . @ . @ . @ @ @ . @ . @ @ . . @ . . @ . @ . . @ . @ . . @ . . . . @ . @ . @ . . @ . @ @ . . . . . @ @ @ @ @ @ 
@ @ @ @ @ . @ @ . . . . @ . . @ . . @ @ @ . . . . . @ @ . . @ . . @ @ . @ . @ . . @ . @ . @ . . . . . @ . . . . . . @ . . @ . . . . . @ @ @ . . @ @ . @ @ . . . . . . . @ . . . . @ @ . @ . @ @ @ @ @ @ 
@ @ @ @ @ @ @ @ @ @ @ @ @ @ @ @ @ @ @ @ @ @ @ @ @ @ @ @ @ @ @ @ @ @ @ @ @ @ @ @ @ @ @ @ @ @ @ @ @ @ @ @ @ @ @ @ @ @ @ @ @ @ @ @ @ @ @ @ @ @ @ @ @ @ @ @ @ @ @ @ @ @ @ @ @ @ @ @ @ @ @ @ @ @ @ @ @ @ @ @ 
3
61 90 37 2
15 43 68 13
65 19 81 76
