50 50
@ @ @ @ @ @ @ @ @ @ @ @ @ @ @ @ @ @ @ @ @ @ @ @ @ @ @ @ @ @ @ @ @ @ @ @ @ @ @ @ @ @ @ @ @ @ @ @ @ @ 
@ @ @ @ @ @ @ @ . @ . . . . @ @ . . . @ . @ . . @ @ @ @ . @ @ @ @ @ @ @ @ @ @ @ @ @ @ @ @ @ @ @ @ @ 
@ @ @ @ @ @ @ . . @ @ . @ . . @ . @ . @ . . . @ . @ . . . . @ @ @ . @ . @ @ @ @ @ @ @ @ @ @ @ @ @ @ 
@ @ @ @ @ @ . @ . . @ @ . @ . @ @ . . . @ @ . . . . . @ . @ @ @ . . . . . @ . @ @ @ @ @ @ @ @ @ @ @ 
@ @ @ @ @ . . . . @ . . . . . . . @ @ . @ @ . @ . @ . . @ @ @ . . @ . @ . @ . . @ @ @ @ @ @ @ @ @ @ 
@ @ @ @ @ @ . @ . . @ @ . @ . @ . . @ . @ . . . @ . . @ @ . . @ . @ . @ . . . @ . @ @ @ @ @ @ @ @ @ 
@ @ @ @ @ @ @ . . @ @ . @ . @ . @ . . . . . @ @ @ . @ . . @ . . @ . @ @ @ @ . . . . @ @ @ @ @ @ @ @ 
@ @ @ @ @ @ . . @ . . . . . @ . @ . @ @ . @ . . . @ . . @ . @ . . . . @ . . @ . @ @ . @ @ @ @ @ @ @ 
@ @ @ @ @ @ @ . . @ @ @ @ . . . . @ . @ . . . @ . . . @ . . @ . @ . @ . @ . . . . . . . @ @ @ @ @ @ 
@ @ @ @ @ @ . @ . . . @ . . @ . @ . . @ . @ @ . . @ @ @ @ . . . @ @ @ . @ . @ . @ @ . @ . @ @ @ @ @ 
@ @ @ @ @ @ . . @ @ . . @ . . @ . . @ . . . @ @ . @ . @ . @ . @ . . . . @ @ . . . @ . . . . @ @ @ @ 
@ @ @ @ @ . @ . . @ @ . @ @ . @ . @ @ @ . @ . @ @ . . . . . . . @ @ @ . @ . @ . @ . . @ . @ @ @ @ @ 
@ @ @ @ . . . . @ @ . . . @ . @ . . @ . . @ . . @ @ @ . @ . @ . . . . . . . . . @ @ . . @ @ @ @ @ @ 
@ @ . . @ . @ . . . @ @ . . . . @ . . @ . . . @ @ @ @ @ . @ . @ . @ . @ . @ @ . . @ . @ . . @ @ @ @ 
@ @ . @ @ . . @ @ . . . @ . @ . @ @ . . . @ @ . @ @ @ . . @ . . . . @ @ @ @ . @ . . @ @ . @ . @ @ @ 
@ . . . . . @ @ @ @ @ . . @ . . . @ . @ @ . @ . . @ . . @ . . @ . @ . . @ . . . . @ @ . . . . . @ @ 
@ @ @ . @ . @ @ @ . . . @ . @ . @ @ . . . . . . @ . @ . @ . @ . . @ . @ @ @ @ @ . . . . @ . @ . @ @ 
@ @ @ @ @ @ . @ . . @ . . . . . @ @ . @ . @ @ . . . . . . @ @ . @ @ . . @ . @ @ . @ @ @ . @ . @ @ @ 
@ @ @ @ @ . . . @ . . @ . @ @ . @ . . . @ @ @ . @ @ @ @ @ . . @ . @ . @ . . . . . . . . . . . @ @ @ 
@ @ @ @ @ @ @ . @ @ @ @ @ . @ . . . @ . @ @ @ . @ . . @ . . @ . . . . . . @ . @ . @ . @ . @ . . @ @ 
@ @ @ @ @ @ . . @ @ . @ . . . @ @ . . @ . @ @ @ . @ . . @ . . . @ @ . @ . . @ @ @ @ . . @ @ @ @ . @ 
@ @ @ @ @ @ @ . . . . . . @ . . . @ . . . . @ . . . . @ . . @ @ . @ @ . @ . @ . . @ . @ @ @ @ . . @ 
@ @ @ @ @ @ @ @ . @ @ . @ . @ . @ . @ @ . @ . @ @ @ . . . @ . . . . @ . . . @ . @ . @ @ @ @ @ . @ @ 
@ @ @ @ @ @ @ @ @ . . . @ . . . . . . . . . . . . . . @ . . . @ . @ . @ . @ @ . . . . @ . @ @ . . @ 
@ @ @ @ @ @ @ @ @ @ @ . . @ . @ . @ . @ @ @ . @ . @ . @ . @ @ . @ . . @ @ . . . @ . @ @ . . @ . @ @ 
@ @ @ @ @ @ @ @ @ @ @ @ . . @ . . . @ . . . . . @ @ @ . . . . . . @ . @ @ . @ . . @ . . . @ . . @ @ 
@ @ @ @ @ @ @ @ @ @ @ @ @ @ . @ . @ @ . @ . @ . . @ @ @ . @ . @ . . . . . @ @ @ . . @ @ . . . @ @ @ 
@ @ @ @ @ @ @ @ @ @ @ . @ . . . . . @ . @ . . @ . . @ . . . @ . @ . @ . @ @ @ . . @ . @ . @ @ . @ @ 
@ @ @ @ @ @ @ @ @ @ . . . @ . @ . @ @ @ . . @ . . @ . @ . @ . . . @ . . . @ . @ . @ . . . . . . . @ 
@ @ @ @ @ . . @ . @ . @ @ . @ @ @ @ @ @ @ . . @ @ . . . . . . @ @ . @ . @ . . @ . . . @ @ . @ . @ @ 
@ @ @ @ @ @ . . . . . . . . . . . @ @ @ @ @ @ @ @ @ . @ . @ . @ . . . @ . @ . . . @ . . @ @ . @ @ @ 
@ @ @ @ @ @ . @ . @ . @ . @ . @ . . @ @ @ @ @ @ @ . @ . . . @ @ @ . @ . . . @ . @ @ @ @ @ . . . @ @ 
@ @ @ @ @ @ @ @ . @ @ . . @ @ . . @ @ @ @ @ @ @ . . . @ . @ @ @ . . . @ @ . . . @ @ . . . @ @ . . @ 
@ @ @ @ @ @ @ @ @ @ @ @ . @ . @ . . @ @ @ @ . . @ . @ . . @ . . @ . @ . @ @ . @ . . @ . @ . @ @ . @ 
@ @ @ @ @ @ @ @ @ @ @ @ . @ . . . @ . @ . . . @ . . @ . @ . @ . . . . . . . . @ . @ @ . . . . . . @ 
@ @ @ @ @ @ @ @ @ @ @ @ @ @ @ @ . @ . . @ . @ @ @ . @ . . . . . @ . @ . @ . @ @ . @ @ . @ . @ . @ @ 
@ @ @ @ @ @ @ @ @ @ @ @ @ @ . . . . @ . . . . @ . . @ . @ @ . @ . @ . @ . . @ . . @ . . @ . . @ @ @ 
@ @ @ @ @ @ @ @ @ @ @ @ @ @ @ . @ . . @ . @ . . @ . . . @ . . @ . @ . @ @ @ . @ . . . @ @ @ @ . . @ 
@ @ @ @ @ @ @ @ @ @ @ @ @ @ @ @ . @ . . @ . . @ . @ . @ . @ @ . . . . . . . . . . @ @ . . . . . @ @ 
@ @ @ @ @ @ @ @ @ @ @ @ @ @ @ . . . . @ . @ . . . . . . . . @ . @ . @ @ @ @ . @ @ . . @ @ . @ @ . @ 
@ @ @ @ @ @ @ @ @ @ @ @ @ @ @ @ . @ . . . @ . @ . @ @ @ . @ . . . @ @ . . @ . . @ . @ @ @ . . . . @ 
@ @ @ @ @ @ @ @ @ . @ . @ @ @ . @ . . @ . . @ . . . @ . . . . @ . @ . . @ @ @ . @ . . @ . . @ . @ @ 
@ . . @ @ @ @ @ . . . . @ . . . . @ . @ . @ . @ . @ . @ @ . @ @ @ . @ . @ @ . @ . . @ . @ . . @ @ @ 
@ @ . @ @ . @ . @ @ . @ . @ @ . @ . @ . . . . . . . . . @ . @ @ @ . . . . @ . @ @ . @ . @ . @ . @ @ 
@ . . . . . . . . . . . . . . . . . . @ . @ @ . @ . @ . . @ @ @ . . @ . @ . . . . . . . . . . . . @ 
@ @ . @ . @ . @ . @ @ @ . @ . @ . @ . . . @ . . @ . @ @ . . @ . @ . @ . . . @ @ . @ . @ . @ @ . @ @ 
@ . . @ . . @ @ . @ . @ . @ @ . . . @ . @ . @ . @ . . . @ . . . . . @ . @ @ @ @ @ @ @ . . @ @ @ @ @ 
@ @ . . @ . . @ @ . . . . . . @ @ @ . @ . . . . @ . @ . @ . @ @ . @ . . @ @ @ @ @ @ @ @ . . @ @ @ @ 
@ . . @ . . @ @ @ @ . @ @ . @ . . . . . . @ . @ . . . @ . . . . @ @ @ . . @ @ @ @ @ @ @ @ @ @ @ @ @ 
@ @ @ @ @ @ @ @ @ @ @ @ @ @ @ @ @ @ @ @ @ @ @ @ @ @ @ @ @ @ @ @ @ @ @ @ @ @ @ @ @ @ @ @ @ @ @ @ @ @ 
3
40 20 46 1
24 34 23 28
42 29 35 30
