100 100
@ @ @ @ @ @ @ @ @ @ @ @ @ @ @ @ @ @ @ @ @ @ @ @ @ @ @ @ @ @ @ @ @ @ @ @ @ @ @ @ @ @ @ @ @ @ @ @ @ @ @ @ @ @ @ @ @ @ @ @ @ @ @ @ @ @ @ @ @ @ @ @ @ @ @ @ @ @ @ @ @ @ @ @ @ @ @ @ @ @ @ @ @ @ @ @ @ @ @ @ 
@ @ . @ @ . @ @ @ @ @ @ @ @ . . . @ . . . @ @ @ . @ . @ @ @ @ . . @ @ @ @ . @ . @ . @ @ @ . @ @ . @ . @ . . @ . . . . . . . . . . @ . @ . @ @ @ @ . . @ . @ . . . . . . @ @ @ . . . . . @ . . . . . . @ 
@ . . . @ . . @ @ . @ @ @ . @ . @ . @ . @ . @ . . . . . @ @ @ @ . . @ @ @ . . . . . . @ . . . @ . @ . @ . @ . @ . @ . @ . @ @ @ . . . . . . . @ . @ . . . . @ . @ . @ @ @ @ @ @ . @ . @ . @ . @ . @ @ @ 
@ @ . @ . . @ @ @ . . @ . . . . . . . . . . . @ @ . @ @ . @ @ @ . @ . @ @ . @ @ . @ . @ @ . @ . . . . . . . . . . . @ . @ . @ . . @ . @ . @ . . . . @ @ @ . . . . @ . . . @ @ . . . @ . . . @ . . . . @ 
@ . . @ . @ . @ . . @ . @ . @ . @ . @ . @ . @ . . . . . . . @ . . . . . . . . . @ . . @ . . . @ . @ . @ @ . @ . @ @ . . . . . @ . @ . @ . . @ @ . @ @ . @ . @ . @ . @ . @ @ . @ . @ . @ . @ @ . @ . @ @ 
@ . @ . . . . @ @ . . . . . . @ @ @ @ . . @ @ . @ . @ . @ @ . @ . @ . @ . @ . @ . @ @ @ @ . @ @ . @ @ @ . . @ . . . . @ . @ . @ . . @ @ @ @ @ @ . @ @ . @ . @ @ . . . . . . . . . . . . . . @ @ . . . @ 
@ . . . @ . @ @ @ . @ . @ . @ . @ . . @ . @ . . . @ @ @ @ . . . . @ . . @ . . @ . . . @ . . . . . . . @ @ . @ . @ . @ . . . @ @ @ @ @ @ @ @ @ . @ @ . . . . @ @ . @ . @ . @ . @ . @ . @ . @ @ . @ . @ @ 
@ . @ @ @ @ @ @ . . . @ . . . . . . @ . @ . @ . @ . @ . @ . @ . @ @ @ @ @ @ . . @ . @ . @ @ . @ @ . @ @ @ @ @ . . @ @ @ . @ @ @ . . @ @ @ @ @ . @ @ @ @ . @ . . . . @ . @ @ @ . . @ @ . . . @ . . . . @ 
@ . . . . . @ . . @ @ . @ @ @ @ @ @ . . @ . . . . . @ . . . @ @ @ @ . . @ @ @ . @ . @ . @ . . . @ @ @ @ @ @ @ . @ . @ . @ . @ . . @ . @ @ @ . . . @ @ @ . . @ @ . @ . . . @ . . @ . @ @ . @ @ . @ . @ @ 
@ @ . @ . @ @ . @ . @ . @ . @ . @ . @ . @ . @ @ @ @ . . @ @ . . @ . . @ . @ . . @ . . . . @ . @ . . @ @ @ . . . . . . . . . . @ . . . . @ . @ . @ @ @ @ . @ . . . @ . @ @ @ @ . . . . . @ . . @ . . . @ 
@ . . @ . . . . . . . . . . . . . . @ . . . . @ . . . @ . @ . @ . . @ . . . @ @ . @ . @ . . . . . @ @ @ . . @ . @ . @ . @ . @ . . @ @ @ . . . . . @ @ @ . @ . @ . . . . @ @ @ . @ . @ @ @ . @ . @ . @ @ 
@ . @ . @ . @ . @ @ . @ . @ . @ . @ . @ @ . @ . @ @ . . . . . . @ . . @ . @ . @ . @ @ . @ @ . @ @ . @ @ @ . @ . . @ @ @ @ @ . @ . . . @ . @ @ @ @ . @ . . . @ . . @ . @ . @ . . . @ . @ . . . . . . . @ 
@ . @ . . @ . @ @ . . . @ . @ . . @ . . . . . . . . . @ . @ . @ @ . @ . . . . . . . . . . . . . . . . . @ @ @ . @ @ @ . @ . . . . @ @ . . . . . . . . @ . @ . @ . . @ . . . @ . @ @ . . @ . @ . @ @ . @ 
@ . . . @ . . . @ . @ . . . @ @ . . . @ . @ . @ . @ @ @ @ . . @ . . @ . @ @ @ . @ . @ @ . @ . @ . @ . @ . @ . @ @ @ . . . @ . @ . @ @ . @ @ . @ @ @ . . . . . @ . @ . @ . @ . @ @ @ . @ . @ . @ @ @ . @ 
@ . @ @ . . @ @ . @ . @ . @ . @ . @ @ . @ . @ . . @ . . . . @ . @ . . . . . . @ . . . . @ . . . @ @ . . . . . . . . @ . @ . @ . . . @ . @ . . @ @ . . @ . @ . . . . . . . . . . @ . . . . @ . . @ . . @ 
@ @ @ @ . @ . . . . . . . . . @ . . . . . . @ @ . . @ . @ . . . . . @ . @ . @ @ @ @ . @ @ @ @ . . . @ . @ . @ . @ . . . . . . @ . @ . . @ @ @ . . . @ @ . . @ . @ . @ . @ . @ . @ . @ @ @ . . @ . @ . @ 
@ @ @ . . . . @ . @ . @ . @ . . @ . @ . @ @ . @ . @ @ @ @ @ @ @ @ . @ . . @ @ @ . @ @ . @ . @ @ @ @ . @ @ @ . @ . @ @ @ @ @ @ . . . . @ @ @ @ @ . @ @ @ @ . . @ . @ . @ . . @ . . . . . @ @ . . . . . @ 
@ @ . . @ . @ . . @ @ . . @ @ @ . @ . . @ @ . @ @ . @ . @ . . . . @ . . @ . @ . . . . . . . . . . . . . . . . . . . . . . . @ . @ . @ @ @ @ @ @ @ . . @ . @ . . . . . . @ . . @ . @ . @ . . . @ @ @ @ @ 
@ @ . @ @ @ . . @ . . . @ . @ @ . @ @ . . . . . . . . . @ . @ . @ @ @ . . . . . @ . @ @ . @ @ @ @ @ . @ . @ . @ @ . @ . @ . . . . @ . @ @ . . @ @ @ . @ . . . @ . @ . @ @ . @ . . . @ . @ @ . . . . @ @ 
@ . . @ @ . @ @ . . @ . . . . . . . @ . @ . @ . @ . @ . . . . @ @ @ . . @ . @ . . @ . . . . @ @ @ . . @ . . @ . @ . . @ @ @ @ . @ . . @ . @ . . @ . . . . @ . . @ @ @ @ @ @ @ . @ . @ . . . @ @ . @ . @ 
@ . @ @ . . @ . @ . . @ . @ . @ . @ . . @ . @ . @ . @ @ . @ . . . @ @ . . @ . . @ . . @ . @ @ @ . @ . . @ . . . . @ . @ @ . . . . . @ @ . . . @ @ @ @ . @ . . @ . @ . @ @ @ . @ . @ @ . @ @ . . . . . @ 
@ . . . @ . . . . . @ . . . @ @ . @ @ . . @ . . . @ . @ . @ . @ @ @ . . @ . @ . . @ @ . . . . . . . @ . . @ . @ . . @ . . @ @ @ . @ @ . . @ @ . @ @ @ @ . . @ @ . . . . . . . . . . . . . . . @ . @ . @ 
@ . @ . . @ @ . @ . . @ . @ @ . . . @ . @ . @ @ . . . @ . @ . . . @ @ . @ . . . @ @ @ @ . @ @ . @ @ . . @ @ . . @ @ . @ . @ . @ . . @ . @ . @ . @ @ @ . . @ @ . . @ . @ @ . @ . @ . @ . @ . @ . . . @ @ 
@ @ . . @ . @ @ . . @ @ @ @ . @ . @ @ . @ . @ . . @ . . @ @ . @ @ @ @ @ . . @ . . @ . . . . . @ @ . @ . . . @ . . . . . . . . . @ . . . . . . . . . . @ @ . @ . @ . @ . @ . @ . . @ . . . @ . @ . @ @ @ 
@ @ @ . . . . @ @ . . @ . . . . . . @ . @ . . . @ @ @ . . . @ @ @ . . @ . @ . . @ . @ @ @ . @ . @ . . . @ . . @ . @ . @ . @ . @ @ . @ . @ . @ . @ . @ @ @ . . . . . . . . @ @ . @ . @ . @ . . . . @ @ @ 
@ @ . . @ . @ . . . @ . @ @ @ @ . @ . @ . . @ . . . @ . @ . . @ @ @ . @ . . @ . . . @ @ @ @ . . @ @ @ . @ . @ @ @ @ . . @ . . . . @ @ . @ . . @ @ . . @ . @ . @ . @ . @ . . . @ @ . . . . @ . @ . . @ @ 
@ . . @ . . . @ @ . . . . . @ . . @ . . @ @ @ @ . @ . @ . @ . @ @ . . @ @ @ . . @ . . . @ . @ . . @ . . . @ . . . . @ . . @ . @ . . . @ . . @ @ @ @ . . . . . . @ . . . @ @ . . @ @ @ . @ . @ @ @ . . @ 
@ . @ @ @ . @ @ . . @ . @ . . @ . . @ . @ @ @ . . . . . . . @ . @ @ . @ @ . . @ . @ . @ @ . . . @ @ @ . @ . @ . @ . . . @ . . . @ . @ . @ . . . . @ . @ . @ . @ . @ . @ @ @ . @ @ @ @ . . . . @ . . @ @ 
@ . . @ . . @ @ @ . @ . . @ @ . . @ . . . . . @ . @ . @ . @ @ . @ . . . . @ . . . @ . . . . @ @ @ @ @ . . . . @ @ @ @ . @ @ . @ . . . . . @ . @ . @ . . @ . @ . . @ . . @ . . . @ @ @ . @ . @ @ @ . @ @ 
@ . @ @ . @ . @ . @ . @ . . . @ . . . @ @ . @ . . . @ . . . . . . . @ @ @ . @ . @ . . @ @ @ @ @ @ @ @ @ . @ @ @ . . . . . . @ . @ . @ @ . @ . @ . . @ @ @ . . @ . @ @ @ . @ @ @ @ @ . @ . . . @ @ @ @ @ 
@ . . @ @ . . . . . . . . @ . @ . @ . . . @ @ @ . @ @ @ . @ @ . @ . . . . . . @ . . @ @ . @ @ @ @ @ @ . . @ . . @ . @ . @ @ . . @ . . . @ . . . @ . . @ @ . @ . . . . . . . . . @ @ . . @ . @ @ @ @ @ @ 
@ . @ @ . @ . @ . @ . @ . . @ . . . @ . @ . @ . . . . . @ . @ . . @ . @ . @ . @ @ . . . . . @ @ @ @ . . @ @ . @ @ . . @ @ @ @ . . . @ . @ @ @ . . @ . . . . . . @ @ @ @ @ . @ @ @ . . @ . . @ @ @ @ @ @ 
@ . . @ . @ @ . . @ @ . . @ @ @ . @ . @ . . @ . @ . @ . . . @ . @ @ @ . . . @ @ . . @ . @ . . @ . @ @ . . . . . . @ @ . @ @ . @ @ @ . @ . @ . . @ @ . @ . @ @ . . . . . . @ . @ . . @ . @ @ @ @ @ @ @ @ 
@ @ @ . . . . @ . @ @ @ . @ . . . . . . . @ . @ . . @ . @ . @ . @ . . @ . @ @ . @ . . @ @ . @ @ . . . @ . @ . @ . . . . . . . . . . . . . @ @ @ @ @ @ . . . . @ . @ . @ . . . . @ . . . . @ @ @ @ @ @ @ 
@ @ . @ . @ @ . @ . . . . . @ @ . @ . @ . . . @ . @ @ . . @ . . . . @ . . . . . . @ . . @ . . . . @ @ . . . @ . . @ @ @ . @ . @ @ . @ @ . . . @ . . @ . @ . @ . @ @ . . @ . @ . . . @ . @ @ @ . @ @ @ @ 
@ @ . . . . . . @ @ . @ . @ . . . . @ . . @ @ . @ @ @ . @ @ @ . @ . @ @ . @ . @ @ . . @ . . @ . @ @ @ @ . @ . @ . @ . @ . . @ . @ @ . . . @ . . . @ . . @ . @ . @ @ . @ . . . @ . @ @ . . @ @ . . @ @ @ 
@ @ @ . @ @ @ . . . @ . . . @ @ . @ . @ . . . . . . . @ . . . . . @ . . @ . . . @ @ . @ @ . . @ . @ . . . @ . . . . . . @ . . . . @ . @ . . @ . @ @ @ . @ . . . . . @ @ @ . @ . . @ . @ @ @ @ . @ . @ @ 
@ @ @ . @ . . @ . @ . @ . @ @ @ @ @ . . . @ . @ . @ . @ @ . @ . @ @ . @ . @ . @ @ @ . . . @ . . . . @ . @ . @ @ . @ . @ @ @ . @ . @ @ @ @ . . @ @ @ @ @ @ @ . @ . @ @ @ . . @ @ . . . . . @ . . . . . @ 
@ . . @ @ @ . . . . . . . . . . . . @ @ . @ . @ @ @ . @ @ . . @ @ . . . . . . . @ . . @ . . @ @ . @ . @ @ . . . @ @ . . @ @ . . @ . @ . @ . @ @ @ @ @ @ @ @ @ . . @ @ @ @ . . . @ @ @ @ . . . @ . @ . @ 
@ @ . @ @ . @ . @ @ . @ . @ @ . @ . . @ @ . . . . . @ . . @ @ @ . . @ . @ @ @ @ . . @ @ . @ @ . . . . . . . @ . . . @ . . . @ . . . . . . @ . @ @ @ @ @ @ @ @ @ . @ @ @ @ @ . @ . @ . @ . @ . @ @ @ @ @ 
@ . . . . . . . . . @ . . @ . . . @ @ . . . @ . @ @ . @ . @ . . @ @ . . . . @ . . @ @ . . . @ @ . @ . @ @ @ . @ @ @ . . @ . . @ . @ @ . @ @ . . @ @ @ @ @ @ @ @ @ @ @ @ @ . . . . . . . @ . . . . . . @ 
@ . @ . @ @ . @ . @ . @ . @ @ . @ . . . @ . @ . . . . . . . @ . . @ @ . @ . @ @ . @ . @ . @ . @ . @ . . . . . . . . @ . . @ . @ . . . @ @ @ . @ . @ @ @ @ @ @ @ @ . @ @ . @ . @ @ . @ . @ @ . @ . @ @ @ 
@ @ . . @ . . @ . . . @ @ @ @ . . @ . @ . . @ . @ . @ . @ . . . @ @ @ . . @ . @ @ . . . . . . . @ @ @ . @ @ . @ . @ . . @ . @ @ . @ . @ . @ . @ . . @ @ . @ @ @ @ . @ . . . . . . @ @ . . . @ . . . . @ 
@ @ @ . @ @ . @ . @ . @ @ @ @ . @ @ . . @ . . @ @ @ @ @ @ . @ @ . @ . @ . . . . @ @ @ @ . @ . @ . @ . . @ @ . . @ . . @ @ . @ . @ @ . . . . . . . @ @ . . . @ @ . . . @ @ . @ @ . . . @ . @ @ @ . @ . @ 
@ @ . @ @ . . @ . . @ . @ @ @ @ . . . @ @ . @ @ @ . @ . . . @ @ . . . . . @ @ @ . @ . @ @ @ @ . . @ @ . @ @ . @ @ @ . @ . . @ . . . . @ . @ . @ . . . . @ @ . @ @ . @ . @ . . @ . @ . . @ @ @ @ . @ . @ 
@ . . . @ @ . @ . @ . . @ @ @ . . @ . @ . . . . @ . @ . @ @ @ @ . @ . @ . . . . . . . . . . @ . @ @ . @ @ . @ . @ . . . @ . . @ . @ . . @ @ . . @ . @ . . . . . . . . . @ . @ . . . @ . @ @ . . . . @ @ 
@ @ . @ . @ . @ . @ . @ . . @ . @ @ @ @ @ . @ . . . @ @ @ @ @ @ @ . . . @ @ . @ . @ . @ . @ . . . . . . . . . . @ @ . @ . @ . @ . @ . @ @ @ . @ . . @ . @ . @ @ . @ . @ . . . @ @ . . @ @ . . @ . @ @ @ 
@ @ . . . . . @ . . . . . @ . . . @ @ @ . @ . . @ . @ @ @ @ @ @ @ @ . @ . @ . @ . @ . . @ @ . @ . @ @ . @ . @ . . @ . . . . . . @ @ . @ . @ @ . @ @ @ @ @ @ . . . . @ . @ . @ @ @ @ @ . . @ . . @ . @ @ 
@ . . @ . @ . @ . @ . @ . . @ . @ . @ @ . @ @ . . @ @ . . @ @ @ @ @ @ . . @ . . @ . . @ @ . . . @ @ @ . @ @ @ @ . . . @ @ . @ . . @ . . . . . . @ . @ @ @ . . @ . @ @ . @ @ . . @ @ @ . @ . @ . . . . @ 
@ @ . @ @ . . @ . @ . . @ @ @ . . . . . . . @ @ @ @ . @ . . @ @ @ @ @ @ . . . @ . @ . . . @ @ @ . @ @ @ . @ @ . @ . @ . @ @ . . @ . . @ . @ . @ @ . . @ . @ @ . . @ . . @ . @ . @ @ @ . . . . . @ . @ @ 
@ . @ @ . @ @ . . . @ . @ @ @ . @ @ . @ @ . @ @ @ @ . @ . @ . @ @ @ @ . . @ . . . @ @ @ . @ . . . @ @ . . . @ . . @ @ . . . @ . . @ @ . . . @ @ . @ . . . . @ @ @ @ @ . . . . . @ @ @ @ @ . @ . @ . . @ 
@ . . . . . . . @ . . @ @ @ . . @ @ . . . @ @ @ . . . . . . . . @ @ . @ @ . . @ . . . . @ @ @ @ . . @ . @ . . . @ @ . . @ @ . . @ . . @ . @ . @ . @ @ @ . @ . @ . @ . @ @ . @ @ . @ @ @ . @ . . . @ . @ 
@ @ . @ @ . @ . @ . @ . @ . @ . . . @ . @ . @ @ @ @ . @ @ . @ . @ . . . . @ . @ @ . @ . @ @ . . @ . . @ @ . @ @ . @ @ . . @ . @ @ @ . . . . . . . . . . . . . . . . . . . . . . . . @ @ . @ @ . @ . . @ 
@ @ @ . . . . @ . . . . . . . @ . @ . . . . @ @ @ @ @ @ . @ . . . @ . @ @ . @ @ . . . @ . @ . @ . @ . . . . . . . . @ . @ . . . . . @ @ . @ . @ . @ . @ @ . @ . @ . @ @ . @ @ @ . @ . @ . @ @ @ @ @ . @ 
@ @ . @ @ . @ @ @ . @ . @ @ . . @ @ @ . @ @ @ @ @ @ . . . . . @ . . . . . . @ @ @ @ . . . . . . . . . @ @ @ . @ . @ @ . . @ @ . @ . @ . . . @ . . . @ @ @ . . @ . @ . @ . @ . . . . . . . . . . @ . . @ 
@ . . . . . . @ . . . @ @ @ . @ @ @ @ @ @ @ @ @ @ . @ . @ . @ @ . @ . @ @ . . . . . . @ . @ . @ . @ @ . . . . @ . @ @ @ . . @ @ @ . @ @ . @ . @ @ . . . . @ . . . . . @ @ . @ . @ . @ . @ . @ @ . @ . @ 
@ @ @ . @ . @ . @ . @ @ @ . . . @ @ @ . @ @ . @ . . . . @ @ . . @ . . @ @ @ . @ . @ . . @ . . . @ . . @ @ @ . . @ @ @ . . @ . @ . @ . . . . . @ . . @ @ @ @ . @ @ @ . . @ . @ . @ . . @ @ @ . . . @ . @ 
@ @ . @ . . . . @ @ @ @ . @ @ @ @ @ . . . . . . . @ . @ . @ . @ . @ @ . @ @ . @ @ . @ . @ . @ @ @ . @ . . @ . @ . @ . @ . . . @ . @ . @ . @ @ . @ . . . . . @ . . . @ . . . @ . @ . @ . @ @ . @ @ . . @ 
@ . . . @ . @ . @ @ @ . . . . @ . @ @ . @ . @ @ @ . @ . . . . . . . . . . . . . @ . @ @ . . . . . . . . @ @ . . . . . . . @ . . . . @ . . . @ . @ . @ . @ . . @ @ . . . @ @ . . @ . . . . . . . @ @ . @ 
@ @ @ . . . . @ @ @ . @ @ . @ . . . @ @ . . . @ . . . . @ @ @ . @ . @ . @ . @ . . . . . @ @ . @ . @ @ . . . @ . @ . @ . @ @ @ @ @ @ . @ @ @ @ . @ . . @ @ @ . @ @ @ @ @ @ . @ . @ . @ @ @ . @ . @ @ @ @ 
@ . . . @ . @ . @ . . . . . . . @ . . @ @ . @ . @ . @ . @ @ @ @ . @ @ @ . . . @ . @ . @ . . . . @ . @ . @ . . @ . . @ . . . . . . . . . . . . . . @ @ @ @ @ @ @ @ @ @ . @ . . . . @ @ . . . . @ @ @ @ @ 
@ . @ . . @ . . . @ @ @ @ . @ . . @ . . @ . . . . @ . . . @ @ @ . . @ . . @ . @ . @ . @ @ . @ . . . . @ . . @ @ @ . @ . @ . @ . @ . @ @ @ @ @ . @ @ @ @ @ @ @ @ @ @ . . . . @ . @ . @ @ @ @ @ @ @ @ @ @ 
@ @ @ @ @ . . @ . . @ . . @ . . @ . @ . . . @ @ @ . @ . @ . @ @ . @ @ @ . @ . @ . . @ . . . @ . @ @ . . @ . . . . @ . . . @ @ . . @ . . . . . . . . @ @ @ @ @ @ @ . . @ . @ . . . . . . . . @ @ @ @ @ @ 
@ . @ . . @ . @ @ . @ . @ . @ . . . @ @ . @ . @ . . . . @ . . . . . @ . . @ . @ . @ . . @ . @ . . . @ . . @ @ . @ . @ . @ . . . @ @ @ @ @ . @ . @ . . @ @ @ @ @ . @ . . @ . @ . @ . @ . @ @ @ @ @ @ @ @ 
@ . @ @ . . @ . . . . . . . . . @ . @ . . @ . @ @ @ . @ @ . @ @ . @ @ @ . @ @ . @ @ @ . @ . @ . @ . . @ . @ @ . . . . @ . . @ . . . @ . @ . . @ . . @ . @ @ @ . . . @ . @ . . . . @ @ @ @ @ @ @ @ @ @ @ 
@ . . . . @ . @ @ . @ . @ . @ . . @ @ @ . . . . . @ @ . . . . @ . @ . . . . @ . @ @ . . . @ . . . @ @ . . . . @ @ . @ . @ . @ . @ @ . . . . @ @ @ @ @ . . . . @ . @ . @ . . @ . @ @ @ @ @ @ @ @ @ @ @ @ 
@ . @ . @ @ . . @ @ . . @ @ . . @ @ @ . . @ . @ @ @ @ . @ . @ . @ @ @ . @ . . . . . @ @ . @ @ . @ . . @ . @ . . . @ . . . @ @ . . @ @ . @ . . @ @ . @ . @ @ . . . . . . @ . @ . @ @ @ @ @ @ @ @ @ @ @ @ 
@ . . @ @ . . @ @ @ @ @ . . @ . @ @ . @ . . @ . . @ . @ . . . . . @ . . @ . @ @ . @ . @ @ . . . @ . @ @ . @ @ . @ . . @ . @ . . @ @ @ @ . . @ @ @ . . @ . @ . @ . @ . @ @ . . @ @ . @ . . @ @ @ @ @ @ @ 
@ . @ . @ @ . . @ . . . @ . . @ @ . . . . @ . @ . . . . . @ . @ @ . @ . . @ @ @ . @ . . . . @ . . . . . @ @ @ . . . @ @ @ . @ . @ @ @ @ @ . @ @ @ . @ . . . . @ . . @ @ @ . @ @ . . . . @ . @ @ @ @ @ @ 
@ . . . @ . . @ . @ . @ . @ . @ . @ . @ @ . . . . @ . @ @ . . @ . . @ . @ . @ . . . @ @ @ @ . . @ @ . @ @ @ @ @ . @ @ @ @ . @ @ @ @ @ @ . . . . . . . . @ . @ . @ @ . @ . @ @ . @ @ @ . . . @ @ @ @ @ @ 
@ . @ @ . @ . @ . . . . . . . . . . . @ . @ . @ @ . @ . @ @ . @ @ . @ . . . @ @ . @ . . . @ @ . @ . . . . @ @ . . . @ @ . . . . @ . @ . @ . @ . @ . @ . @ . . . . . . . . . . . . @ @ . @ @ . @ @ @ @ @ 
@ . . @ . . . . @ . @ @ @ . @ . @ . @ @ . . . . . . . . . @ @ . . . @ . @ @ @ @ @ . . @ . . . . @ @ . @ @ @ . @ . @ . . . @ @ . . . . . . @ @ . . @ . @ . . @ @ . @ . @ . @ . @ . . . . . . . . @ @ @ @ 
@ . @ . . @ @ . . @ . . . . . @ . @ . @ . @ . @ @ @ . @ . . @ @ . @ @ @ . . @ @ @ @ . . @ . @ . . @ @ @ @ . . @ . . . @ . . . @ . @ . @ . @ . . @ @ . . @ . @ . . @ . . @ . . @ . @ . @ . @ . @ . . @ @ 
@ . . @ @ . @ . @ . . @ . @ . @ . @ . @ . . @ @ @ @ @ . @ @ . . . . @ @ . @ @ @ @ @ . @ . @ . . @ @ @ @ @ . @ . @ . @ . . @ @ . @ . . . @ . @ . . . @ . @ @ . @ @ . @ . . @ . . @ . . . @ @ . @ . @ . @ 
@ @ . . @ . . . . . @ . @ @ . . . . . . . @ . @ @ . . . . @ . @ . @ @ . . . @ @ @ @ . . . . @ @ @ @ @ @ @ . . . . . . @ @ @ @ . @ @ . @ . . . . @ . . . . . . . . . @ . @ @ . @ . @ . @ @ . . . . . . @ 
@ @ . @ @ @ . @ @ @ @ . @ @ . @ . @ . @ . . . . . . @ . @ . . @ . @ . @ . @ . . @ @ . @ . @ @ @ @ @ . @ . . @ . @ . @ @ @ @ . . . . . . @ @ @ . . @ . @ . @ . @ . @ . . . @ . . . . @ @ . @ . @ . @ . @ 
@ . . . . . . . . @ . . . . . . @ @ @ . . @ @ . @ @ @ . . @ @ . . . . . . . @ . . . . . @ @ @ @ @ @ . . @ . @ @ . . . @ . @ . @ . @ . @ @ @ @ . @ . @ @ @ . . @ . . @ . @ @ @ . @ . . . . . @ @ . . @ @ 
@ @ . @ @ . @ @ @ . @ @ . @ . @ . @ @ @ . . . @ @ @ @ @ @ @ . @ . @ @ @ @ . . @ @ . @ . @ @ @ @ @ . @ . . . @ @ . @ . @ . . @ @ @ . @ @ @ @ @ . . . . . . @ . . @ @ . @ . @ . @ . . @ . @ . @ . . @ @ @ 
@ . @ . . . . . . . @ . . . @ . . . @ . . @ . @ . @ . . @ . . @ @ . @ @ @ . @ @ @ @ @ @ @ @ @ @ . . . @ . @ . . . @ . @ . @ . @ @ . @ @ @ @ @ . @ . @ @ @ . . @ @ @ . @ . . . @ @ . . @ @ @ @ @ . . @ @ 
@ . . . @ . @ . @ . @ @ @ . @ . @ @ . . @ . . . . . @ . . @ . @ . . @ @ . . . @ @ @ @ . @ @ @ . @ . @ . @ . . @ . @ . . . . . . . . . . . @ @ . . @ . . . @ . @ @ . . @ . @ @ @ . @ . . @ . @ @ . @ @ @ 
@ @ . @ . . . @ . . . @ . . . . . . @ . . @ . @ . @ . @ . . . . @ . @ . @ . @ @ @ @ @ . . . . . . . . . . . @ . . @ . @ . @ . @ . @ @ @ @ . . . @ . . @ @ . @ . . @ . . . . @ . . . . @ . . . . . . . @ 
@ . . @ @ . @ . @ . @ . @ . @ . @ . @ . @ @ @ @ . . . . @ . @ . . . . . . . . . . . . . @ . @ . @ . @ . @ . . @ @ @ . . @ . . . @ @ @ @ . @ @ . @ . @ @ @ . @ . @ . @ . @ @ . . @ . @ @ @ . @ @ . @ . @ 
@ . @ . . . . . . @ @ . @ @ @ @ @ . . @ @ @ . . @ . @ . . @ . @ . @ . @ . @ . @ . @ . @ . . . @ . . . @ . . @ . . . . @ . @ . @ @ @ @ . . @ @ @ . . . . . . . . . . . . . . @ . . @ @ @ @ @ . . . @ . @ 
@ @ . . @ . @ . @ . . . . . . . . . @ @ . @ . @ @ @ . . @ @ . @ @ . . . @ . @ . @ . . . @ . @ @ @ . @ @ @ . . @ . @ . @ . . @ @ @ @ @ @ . @ . @ . @ @ @ @ @ . @ @ . @ . @ . @ . @ @ . @ @ . . @ @ @ . @ 
@ . @ . @ . . @ @ @ @ . @ @ . @ . @ @ . . . . . . . @ . . @ . . . @ . @ . . . . . @ . @ @ @ @ @ @ @ . . . . @ . . . @ . . @ @ @ @ @ @ . . . . . . . @ . . . @ . @ . . @ @ @ @ . . . . . . @ . . . . @ @ 
@ . . @ . . @ . . @ @ @ . . . @ . . @ . @ . @ . @ @ . . @ @ @ . @ . . . . @ @ @ @ @ @ @ @ @ @ @ @ @ @ . @ . . @ . @ . @ . @ . @ @ @ . . @ . @ @ . @ @ @ . @ . . . @ @ @ . . . . @ . @ . @ @ . @ @ . . @ 
@ @ . @ . @ . @ . . @ . . @ @ . @ . @ . @ @ . . . @ @ . @ @ . . . @ . @ . . . . . @ @ @ @ @ @ @ @ @ @ @ . . @ . . . . . . . . . . . @ . @ @ . . @ . . @ . . . @ @ . @ @ . @ @ . . @ . . . @ . . . @ . @ 
@ @ . . . . . @ . @ @ @ . @ . . . . @ . @ . @ . @ . @ . . . @ @ . @ . . @ . @ . @ @ @ @ @ @ @ @ . @ @ . @ . . @ . @ . @ . @ @ . @ . . . @ @ . @ . @ . . @ @ . . . . . @ @ . . @ @ @ @ . @ @ . @ . . @ @ 
@ @ @ @ . @ . . . . @ . . @ . @ . @ @ @ . . . . . . . . @ . @ . . . . @ @ . . @ . @ @ @ @ @ @ . . . . . . @ @ @ . @ . . @ . @ @ . . @ . . . . . . . . @ . @ . @ . @ . . . @ . @ . @ . @ . @ @ @ @ @ @ @ 
@ @ @ @ @ . . @ . @ @ @ . . @ . . . @ . @ @ . @ @ . @ . . @ . @ . @ . . . @ . . . . @ @ @ @ @ @ . @ @ @ @ @ . @ . . @ . . . . . @ . . @ . @ . @ . @ . . . . . . @ @ @ . @ . . . . . . . . . . . . . . @ 
@ @ @ . @ @ . . @ @ . @ . @ @ @ . @ @ . @ . @ @ . @ . . @ . . . @ . . @ . @ . @ @ @ @ @ @ @ . . . . @ @ . . . . . @ . @ @ . @ . . @ @ . . . @ @ . . @ . @ . @ . . @ . @ @ @ . @ . @ . @ @ @ . @ . @ . @ 
@ . . . . . . @ . . . . . @ . . . @ @ . . . . . . . @ . . @ @ . @ . @ . . @ . . . . @ @ @ @ . @ . @ @ . . @ . @ . . . @ . @ . @ . @ . @ @ . . . @ . . @ . . . @ . . . . . . . @ . @ . @ . @ . . @ @ @ @ 
@ @ . @ @ @ @ . . @ . @ . . @ @ . . @ . @ @ . @ @ . . . @ . . . . . . @ . . @ . @ @ . @ @ . @ . . . . @ . @ @ @ @ . @ . . . . . . @ . @ @ . @ . . @ @ @ @ . @ . . @ . @ . @ @ . @ . @ . . . @ . @ @ . @ 
@ . . . . @ @ @ @ @ @ . . @ . . . @ . @ . . . @ @ @ @ . . @ . @ . @ @ . . @ @ @ @ . . . . . . . @ . @ . . @ . @ . @ @ @ . @ . @ . . . . . @ . . @ . . . . . . @ . . @ . . . . . . . . @ . @ . @ . @ . @ 
@ @ . @ . . . . @ @ . . @ . @ @ . . . . @ @ . . . @ @ @ . @ @ . . . . @ . @ @ @ @ @ @ @ @ . @ @ . @ @ . @ . . . . @ . . @ . . . @ @ . @ @ @ @ . @ . @ . @ . @ @ . @ @ @ . @ . @ . @ . . . . . . . . . @ 
@ @ @ . @ @ . @ @ @ @ . @ . . . . @ . @ @ @ @ . @ . @ . @ . . @ . @ . . @ @ @ @ @ . . . . . . . . @ . . . @ @ . @ . @ . @ @ . @ @ @ . . . @ . . . @ @ @ . . . . @ . @ @ . . @ @ @ . @ . @ @ . @ @ . @ @ 
@ . @ . @ @ . @ @ @ . @ . @ . @ . . @ @ @ @ @ @ . . . . . @ . . . . @ . @ @ @ @ @ @ . @ . @ . @ . . . @ . . @ . . . . . . . . . @ . @ . @ . @ . @ @ @ . @ . @ . . . . . @ . . . . . . @ @ @ . . . @ @ @ 
@ . . . . . . . @ . . . . . . . @ . . . . @ @ @ @ . @ . @ . @ . @ . . @ @ @ @ @ @ @ @ @ @ . . @ @ . @ . . @ . . @ . @ @ . @ . @ @ . . . . . @ @ . @ @ . @ . . @ @ . @ . . @ . @ . @ . . . . @ . @ @ @ @ 
@ @ . @ . @ . @ . . @ . @ @ . @ @ @ . @ . @ @ @ @ @ . . . . . . @ . @ @ @ @ @ @ @ @ @ @ . . @ @ . . @ . @ @ @ @ . . . @ . @ @ . . . @ . @ . . . . . . . . @ . . . @ . . @ . . . @ @ @ . @ . . @ @ @ @ @ 
@ @ @ @ @ @ @ @ @ @ @ @ @ @ @ @ @ @ @ @ @ @ @ @ @ @ @ @ @ @ @ @ @ @ @ @ @ @ @ @ @ @ @ @ @ @ @ @ @ @ @ @ @ @ @ @ @ @ @ @ @ @ @ @ @ @ @ @ @ @ @ @ @ @ @ @ @ @ @ @ @ @ @ @ @ @ @ @ @ @ @ @ @ @ @ @ @ @ @ @ 
3
14 19 11 98
36 48 55 78
13 70 81 58
