100 100
@ @ @ @ @ @ @ @ @ @ @ @ @ @ @ @ @ @ @ @ @ @ @ @ @ @ @ @ @ @ @ @ @ @ @ @ @ @ @ @ @ @ @ @ @ @ @ @ @ @ @ @ @ @ @ @ @ @ @ @ @ @ @ @ @ @ @ @ @ @ @ @ @ @ @ @ @ @ @ @ @ @ @ @ @ @ @ @ @ @ @ @ @ @ @ @ @ @ @ @ 
@ @ @ @ . . @ @ . . . . @ . @ @ @ @ . . @ @ @ @ @ @ @ @ @ . @ . @ . . . @ . . @ . . @ . @ . @ . . @ @ @ @ @ . . . . . . @ @ @ @ @ @ . @ . . . @ @ @ @ . @ . @ @ @ @ @ @ . . . . @ @ @ @ @ @ @ @ @ @ @ @ 
@ @ . . @ . . . @ . @ . @ . . @ @ @ . @ @ @ . @ @ @ @ . . . @ . . @ @ . . . @ @ @ . @ . . . . @ . . @ @ @ @ @ . @ . @ . @ . @ @ @ . . . @ @ . . . @ . . . . . . @ @ @ . @ @ @ . . @ @ @ @ @ @ @ @ @ @ @ 
@ . @ . . . @ . @ . @ @ @ . @ @ @ . . @ @ . . . . @ . @ @ . . @ . @ . @ . @ . . . . . @ @ @ . . . @ @ @ @ . . . @ @ . . . . . @ @ @ . @ . . . @ . . @ . @ . @ . . @ . . . @ . . @ @ @ @ @ @ @ @ @ @ @ @ 
@ . . . @ . @ @ . . . @ . . @ @ . @ . . @ . @ . @ . . @ . . @ . . . . . . . @ . @ . @ . @ . . @ . . @ @ @ @ . @ @ @ . @ . @ . . . . . . . @ . @ . @ . . @ . . @ @ . @ . @ @ @ . @ @ @ @ @ @ @ @ @ @ @ @ 
@ @ @ . . @ @ . @ . @ . . @ . . . . . @ . @ . . . @ . . @ . . @ . @ @ @ . @ . @ . . . . . @ . @ . @ @ @ . . . @ . . . @ . @ . @ . @ . @ . . @ @ . . @ . . @ @ @ . . . . @ @ . . @ @ @ @ @ @ @ @ @ @ . @ 
@ . . . @ @ . . . . @ . @ @ @ . @ @ . . . . . @ . @ @ . @ @ . @ @ @ @ @ . . . . . @ . @ @ @ @ . . @ @ @ @ . @ . @ @ . . @ . . @ @ @ . . @ @ . . @ @ . @ . . . . . @ . @ . . @ . @ @ @ @ @ @ @ @ @ @ . @ 
@ @ @ . @ . @ @ @ . . . . @ . @ . . . @ . @ . @ . . . . . . . . @ . @ . @ . @ . @ @ . @ . @ @ @ . . @ . . @ . . @ @ @ . @ @ . @ @ @ @ . @ . . @ @ @ . . @ @ . @ @ . . . @ . . . . @ @ @ @ @ @ @ . . . @ 
@ . . . . . . @ . . @ @ @ . . . @ . @ . . . @ @ . @ . @ . @ . @ . . @ . . @ . . . @ @ . . . @ @ @ . @ @ . . . @ . @ . . . @ @ . . @ . @ @ @ . . @ . . @ . . @ . . @ . @ @ @ @ . @ . @ @ @ @ . @ . @ . @ 
@ @ @ . @ . @ . @ . . @ . @ . @ . . @ @ . @ @ @ . @ @ . @ . . . @ . @ . @ . @ @ . @ . @ @ . . @ @ . . @ @ @ . . . . . @ @ . . @ . . . . . @ . @ . @ . @ . @ . @ . . . . @ . . . . . . @ @ @ . @ . @ . @ 
@ @ . . @ . . . . . @ @ . @ . . . @ . . . @ . . @ @ @ . @ . @ . . . . . . . . . . @ . @ . . @ @ @ @ . @ @ . @ . @ @ . . @ @ . . . @ . @ . @ . . . . . . . @ . @ . @ @ . @ . @ . @ @ . @ . . . . @ . . @ 
@ @ @ . . @ @ . @ . . . . . @ @ . @ . @ . . . @ . @ . . . . . @ . @ . @ @ . @ @ . @ . . @ . . @ . . . @ . . . . @ . . @ . @ . @ . @ @ @ @ @ . @ @ . @ @ @ . . . @ @ @ . . . . @ @ . @ . @ @ . @ . @ . @ 
@ @ . . @ . . @ . . @ . @ . . . . @ @ . . @ @ . . . @ @ @ @ . . @ . . @ @ @ . . . @ @ . . . @ @ @ . @ . @ . @ @ . . @ . . . @ . . . @ . . . . . @ . @ . . . @ @ . @ . @ . @ . . . . . . . . . . . . . @ 
@ @ @ . . @ . @ @ . @ . @ . @ . @ . . . @ @ . @ . @ . . . @ @ . . @ @ @ . . @ @ . . . @ @ . . @ . . . . . @ . . @ . @ . @ . @ @ . @ . @ @ @ . @ . @ @ @ . @ . @ . . . . . @ @ @ . @ @ . @ . @ . @ . @ @ 
@ @ . . @ . . @ . @ . . @ @ . . @ . @ . @ . . . . . . @ . . @ @ @ . @ . @ . @ . @ . @ @ @ . @ . . @ @ @ . . . @ . . . . . @ . . . . . . @ . . @ . . @ . . . . . . @ @ @ @ . . @ @ . . @ @ @ . . . @ @ @ 
@ . @ @ . @ . @ . . @ . @ . @ @ . . . @ @ @ . @ . @ @ @ @ . @ . . . @ . . . . . . . . @ @ . @ . @ . . . @ . @ . . @ . @ @ . . @ . @ . @ . @ . @ . @ . @ . @ . @ . . . @ @ . @ . @ . @ . @ . @ . @ . @ @ 
@ . . . . . . . . @ @ @ . . @ . . @ . @ @ @ @ . . . @ . @ @ . @ @ . . @ . @ @ . @ @ . . @ . . . . . @ @ . @ @ @ . @ . . @ . @ . . . @ @ . . . . . . . . . . @ . . @ . . . . . . . . @ . . . . . . . . @ 
@ @ . @ . @ . @ . . @ . @ . . . @ @ . @ @ @ . @ . @ . . . @ . @ . @ . @ @ . @ @ . @ . @ @ @ @ . @ . . . . . @ . . @ @ . @ @ . @ . @ . @ . @ . @ . @ . @ . @ @ @ . . @ @ . @ . @ . @ . . @ . @ . @ @ . @ 
@ . @ @ @ . @ . . @ . . . . @ . @ . . @ @ . . . . . @ @ . . . . . . . . . . @ @ . . . . @ @ @ . . @ @ @ . @ @ @ . . . @ . . . . . . . . . @ . . @ . . @ @ @ @ @ @ @ @ @ . . @ @ @ @ @ . @ @ . . . . @ @ 
@ . . @ . . . @ . . . @ . @ @ @ @ @ . @ . @ . @ . @ @ @ @ . @ . @ @ . @ . @ . . @ @ . @ . @ . @ . @ . . @ @ @ . . @ . @ . @ . @ . @ . @ . @ @ @ . . @ . @ @ @ @ . . @ @ @ @ . . . . . . @ . @ . @ @ @ @ 
@ @ . @ @ . @ . @ @ . . @ @ @ @ @ @ . @ . . @ @ . @ @ @ @ @ . @ @ . . . @ . @ . @ . . @ . . . . . . . @ . @ . @ . . @ . @ . . . @ @ @ . @ . . @ . @ . . @ @ @ . . @ . . @ . . @ . @ @ @ . . . . @ . @ @ 
@ . . . . . . . . . . @ @ @ @ @ @ @ @ . . @ @ . . . @ . @ . . @ @ @ . @ . . . . . @ . @ . @ . @ . @ . . . . . . . @ @ . . @ . @ @ @ . . @ . @ . @ . @ . . . . . @ @ . @ . @ . . @ @ @ @ @ . @ . . . . @ 
@ . @ @ @ @ . @ . @ . . @ @ @ @ @ @ @ @ . @ . @ . @ @ . . . @ . . . . . @ @ . @ . . . . @ . . @ @ @ @ . @ @ . @ . . @ . @ . . @ . . @ . . . . . . . . . @ @ @ @ . . . . . . . @ . @ . . @ . @ @ @ @ @ @ 
@ . @ . . @ . . @ . @ . . @ @ @ @ @ @ . . . . . . @ . @ . @ . @ @ @ @ . . @ @ . @ @ @ . . @ @ . . . . . . . @ . . @ @ . . . @ . . @ @ @ @ . @ . @ . @ . . . . . @ @ . @ . @ . @ . @ . @ @ . . . . . . @ 
@ . @ @ . . . @ . . . . @ @ @ @ @ @ . @ . @ . @ . . . . . @ . @ . . . . @ . . . . . . @ . . @ . @ . @ . @ @ @ @ . . . @ @ . @ . @ . @ . . @ @ @ . . . @ . @ @ . @ @ . . @ @ @ . . . . . . . @ . @ . @ @ 
@ . @ @ @ @ . @ . @ @ . . @ @ @ @ . . @ @ @ @ @ @ @ . @ . @ . . . @ . @ . @ @ . @ @ . @ . @ . @ @ @ @ @ @ @ @ . . @ @ . . . @ . . . . . @ . @ . . @ @ . @ @ . @ . . @ @ @ @ @ @ @ . @ . @ . . @ @ . . @ 
@ @ . . . . . @ . . . @ . @ . @ @ @ . @ . . @ @ @ @ @ . . . @ @ @ . . @ . . @ . . @ . . . @ . . . . @ @ @ @ . . @ . . @ @ . @ . @ . @ @ . . . @ . . . . . . . . . @ @ @ @ @ @ @ @ @ @ @ . @ . . . @ @ @ 
@ . @ . @ . @ @ @ @ @ @ @ . . . @ . . . . @ @ @ @ @ . @ . @ . . . @ . . . @ @ . @ . @ @ . @ @ . @ . @ @ @ @ @ . . . @ . . . @ . . @ @ @ . @ @ @ . @ @ @ @ . @ . @ @ @ @ @ @ @ @ @ @ @ @ . . @ . @ @ @ @ 
@ . . @ . . . . . @ . @ . @ . @ . @ . @ . . @ @ @ . . . . . @ . @ . @ . @ . @ @ @ . @ . . . . . . @ . @ @ @ . . @ . @ . @ . . . @ . @ . . . . . . . . @ @ . . @ . @ @ @ @ @ @ @ @ @ @ @ @ . @ . @ @ @ @ 
@ @ . @ @ . @ @ @ . . . . . . . . . @ . @ . @ @ @ @ @ . @ . @ . . . . . . . @ . . . . @ @ . @ . @ . . . @ . @ . . @ @ @ . @ . @ . . . @ . @ . @ . @ @ @ . . @ . . @ @ @ @ @ @ @ @ @ @ @ @ . @ . . @ . @ 
@ @ . . @ . . . . @ . @ . @ @ . @ . . . . . . @ . . @ . @ . . @ . @ . @ @ . @ @ @ . @ . . @ . . . @ . @ . . @ . @ @ @ . . . . . . @ . @ . @ @ . . . @ . . @ . . @ . @ . @ @ @ @ @ @ @ @ @ . @ @ . . . @ 
@ . @ . . . @ . @ @ . @ . @ @ @ . @ @ . @ . @ @ @ . . @ . @ . @ . . @ . . . . @ . . . @ . @ . @ . . . . @ . . . . @ . @ @ . @ . @ . @ . . @ @ @ . @ @ @ . @ @ . . . . . . . @ @ @ . . @ . . . . . @ . @ 
@ . . . @ . . @ @ @ @ . . . @ . . . . @ . . . @ . @ . . . . . . @ @ @ @ . @ . . @ . @ . . . @ @ @ . @ . . @ @ . @ @ . . . . . @ . . . @ . . @ @ @ @ @ @ . . . . @ @ @ @ . @ @ . . @ . . @ . @ . @ . . @ 
@ @ . @ . . @ @ @ @ @ . @ @ . @ . @ @ . @ . @ . . . . @ @ . @ . @ . @ . @ . . @ . . @ . @ . . . . @ . @ . @ @ . . . @ . @ . @ . @ . @ @ . @ . . @ @ @ . @ . @ . . . . . @ @ . . @ . @ . . @ . . . @ . @ 
@ . . @ . @ @ @ @ @ @ @ . . . . . . . . . . . . @ . @ @ . @ . . . . . . . @ . . @ . . @ . @ @ . @ @ . . . . . . @ . . @ . . . . . . . . . . . @ . @ . . @ . @ . @ . @ @ . . @ . @ . @ . @ . @ . @ . . @ 
@ . @ . . . . @ @ @ @ . @ . @ @ @ . @ . @ . @ . . @ . . . . . @ @ . @ @ . . . @ . @ . . . @ @ . @ . @ @ @ . @ . @ @ @ . @ . @ . @ . @ . @ @ @ . . . @ . . @ . . . @ @ . . @ . . . . . . . . . @ @ @ . @ 
@ @ @ @ . @ . @ @ @ . . . . @ @ . @ . . @ @ . . @ @ @ . @ . @ . . . @ . @ @ . @ . . @ . @ @ . . . . . . @ @ . . . . . . . . . @ . @ @ . . @ . @ . @ . . @ @ @ . @ . . @ . . . @ . @ . @ . @ . @ @ @ . @ 
@ @ @ . . . @ @ @ . @ @ . @ @ @ . . @ . @ @ @ . . . . @ . . . @ . @ . . . . . @ @ . . . . @ . @ @ @ @ . . . . @ @ @ @ . @ . @ . . . @ . @ . . . . . . @ @ @ @ @ . . @ . . @ . . @ . . . @ @ @ @ @ @ . @ 
@ @ @ @ . @ @ @ @ . @ . @ . @ @ . @ . @ . . @ . @ . @ @ @ . @ . @ . @ . @ @ . . @ . @ . @ . @ . . @ . @ . @ . . @ . . . . @ . @ . @ . @ @ . @ @ . @ . @ @ @ @ . @ . . @ . @ . @ @ @ . @ @ @ . . @ . @ @ 
@ @ @ @ . @ @ @ . . . . . . . . . . . . . @ @ . . @ @ @ @ @ . . . . . @ @ . . @ @ @ . . . . . . @ @ . . @ . . @ . @ @ . @ . . . . . . . @ @ @ . . . @ . @ @ . . @ . @ . . . @ @ @ @ . . @ . @ . . . . @ 
@ @ @ . . . @ . @ . @ . @ . @ . @ . @ . @ . . . @ @ @ @ . . @ . @ . @ . . @ . . @ . . @ @ @ . @ @ @ @ . . . @ . . @ @ . . @ @ @ . @ . @ . @ . @ . @ . . . . @ . @ . @ . @ @ . @ @ @ @ @ . . . . @ . @ @ 
@ @ . . @ @ . . . . @ @ . . @ @ . . @ . . @ . @ @ @ @ @ @ . @ @ . . @ @ . . . @ @ @ . . @ . @ @ @ @ . @ @ @ . @ . . . @ . @ . . @ @ . . . @ . . . @ @ . @ . @ . @ . @ . . . . @ @ . . . @ . @ . @ . . @ 
@ @ @ . @ @ @ . @ . . . @ . . @ @ @ . . @ . @ @ . @ . . . . @ . @ . . @ . @ . . @ . @ . . . . @ @ @ . . . . . . @ @ . . . . . @ @ . . @ @ @ . @ . . . @ @ . @ . @ . . . @ . @ . . . @ . . @ . . . @ . @ 
@ @ @ @ @ @ @ . . @ @ . . @ . . @ . @ . @ . @ . . . . @ . @ . . @ . @ . @ . . @ . . @ . @ . @ . @ @ @ . @ . @ . @ @ . @ . @ . @ . @ . @ . . . @ . @ @ . @ . @ . . . @ @ . @ @ @ @ @ . @ . @ . @ . @ @ @ 
@ @ @ @ @ @ . . @ . . . @ @ . @ . . . . . . . @ . @ . . @ @ @ . . . . . . @ . . @ . . @ . . . . . @ @ @ @ @ . . . . @ @ @ . . . . . . . . @ . . @ @ . . . . . @ . @ . @ . @ @ @ @ . . . . . . . @ . . @ 
@ @ @ @ @ . @ . . @ @ . . @ . @ . @ . @ . @ @ . . . @ . @ @ . @ . @ . @ . . @ . . . @ . @ . @ @ @ . @ . @ @ @ . @ . . @ . @ . @ . @ @ . @ . . @ . @ . @ . @ . @ . . . . . . . . @ @ @ @ . @ @ . @ . @ @ 
@ @ . @ . . @ . @ . . @ @ . @ . @ . . . @ @ @ . @ . @ . . @ . @ @ . . . @ . . . @ . . . . . . @ . . . . . @ . @ @ . @ @ . . . @ @ . . . @ @ . . . @ @ @ @ . . @ . @ . @ . @ @ @ @ . . @ @ @ . . . . . @ 
@ . . . @ . @ @ . . @ . . . . . . @ . @ . . . . @ . @ . @ . . . . @ . @ . . @ . @ @ . @ @ . @ . @ . @ . @ . . . . . . . @ @ @ . . @ @ . @ . @ @ . @ . @ @ . @ . . @ @ . @ @ . @ . . @ @ . @ @ . @ . @ @ 
@ . @ . . . . . . @ @ @ . @ . @ . . . @ . @ . @ . @ . @ @ @ . @ @ . @ . . @ . . . . @ . . . . . . @ . . @ . @ @ @ . @ @ @ @ @ @ . @ . . @ . . . . . . @ . . . . @ @ . . . . . . . @ . . . . @ @ . . . @ 
@ . @ . @ . @ . @ @ @ @ @ . . . @ @ . . . . @ @ . . . . @ . . . . . @ @ @ . . @ . @ @ @ @ . @ . @ @ @ . . . @ . . . . @ @ @ . . . . @ @ . @ . @ . @ . . . @ . @ . @ . @ . @ . @ . @ . @ . @ @ . . @ @ @ 
@ @ . . . @ @ @ @ @ @ @ @ @ . @ . . . @ @ @ @ @ . @ . @ . . @ . @ . . @ . @ . @ . . @ . . . . @ @ @ . @ @ . . @ . @ . . . . @ . @ . @ . . @ . @ @ @ @ . @ @ . . . . @ . @ . . . @ . . @ . . . @ . . . @ 
@ . @ . @ @ @ @ @ @ @ @ @ . @ . . @ @ @ . @ . . . @ @ . @ . . @ @ . @ . . @ . @ . @ . @ . @ . @ @ . . @ . . @ @ . @ @ @ @ . @ @ . . . @ . . @ @ . . . . @ @ . @ . @ . . @ @ . @ . @ . . @ . @ . . @ . @ 
@ . . . . @ @ @ @ @ @ @ @ . @ . @ . @ @ . @ . @ . . . . . . @ @ . @ @ @ . . . . @ @ . . . . @ @ . . @ @ @ . @ . . @ . . . @ @ @ @ @ . . . @ . . @ . @ . . @ @ . . @ @ . @ . . . . @ . @ . @ . . @ . @ @ 
@ . @ . @ . @ @ @ . @ @ . . . . . . . . . . @ . @ . @ . @ @ @ . . . . . @ @ . @ @ . @ @ . @ . @ @ . . @ @ @ . @ . @ @ @ . . @ @ . . @ @ . @ . @ . @ . . @ @ . @ . . @ . . @ . @ @ . . @ . . @ . . . . @ 
@ @ . . . . . @ @ . . . . @ . @ . @ @ . @ . . . @ @ . . . . @ @ . @ . @ . @ . @ . . . . . . . . . . @ . @ . . . . . @ . @ . @ . @ . . . . @ . . . . . @ @ @ . . . @ . . @ @ . @ @ @ . . . @ . . @ . @ @ 
@ @ . @ . @ . . @ @ . @ @ . . @ . @ @ @ @ @ @ . @ . @ . @ @ . @ @ @ . . . . @ . . @ . @ @ @ @ . @ . @ . @ . @ @ . @ . . . . . . @ . @ @ @ . @ @ @ @ . @ . . @ @ . . . @ . . . . @ . . @ @ . . @ . @ @ @ 
@ @ @ . @ . . @ . @ @ . . . @ . . . @ @ @ @ . . . . . . . . . . . @ . @ @ @ . . @ . @ @ . . @ . @ . . . . @ . . . . @ @ . @ @ . . . @ . @ . @ @ . @ . . @ . @ . @ @ . . @ . @ @ . @ . . . . @ . . . @ @ 
@ @ @ . @ @ . . . . . @ . @ . @ . @ . @ @ . . @ . @ @ . @ . @ @ @ @ . . @ @ @ . @ . @ . @ . . @ . . @ . @ . @ . @ . @ @ @ . @ . @ . . . . . . . . . @ @ @ . . . . . . @ @ . @ . . @ . @ @ @ . . @ . @ @ 
@ @ @ . . . . @ . @ . . @ . . . . . . . @ @ @ . . . @ . @ @ . @ @ @ . @ . @ . @ . . . . . . @ . @ . . @ @ . @ . . @ @ @ . . @ @ . . @ @ . @ . @ . @ . . . @ . @ . @ . @ . . . @ . @ . @ . @ . @ . @ @ @ 
@ @ . @ @ @ . . @ @ @ . @ @ . @ . @ . @ . @ @ @ @ @ . . . . . . . . . . . . . . . @ @ . @ . @ . . . @ @ . . . . @ . @ @ @ . @ . @ . . . @ . @ @ @ . @ @ . . @ . @ . . . @ . @ . . . . . . . . . . @ @ @ 
@ . . . . @ . @ . @ @ @ . @ . @ . . @ . . . @ . . . @ . @ . @ . @ @ . @ @ . @ @ . . . @ . . . . @ . . @ @ . @ . . . @ @ . . . . . . @ @ . . . . . . @ . @ . . . . . @ . @ . . @ @ . @ @ . @ @ . @ . @ @ 
@ @ @ @ . . . . . . . . . . . @ @ @ . @ . @ . @ . @ . . @ @ . . @ @ @ . @ . . @ . @ . . @ . @ . @ @ . . . @ . @ @ . . @ @ @ . @ @ . . @ @ . @ . @ . @ . . @ . @ . @ @ . . . @ . . . @ . @ @ @ @ @ . . @ 
@ . @ . @ . @ . @ . @ @ . @ . @ @ . . . . . . . . . . @ . . . @ . . . . . . @ . . . @ . @ @ . . @ . @ . @ @ . @ . . @ . @ @ @ . @ @ . . . . . @ . . . @ . @ @ . @ @ . . @ @ @ . @ @ . . . . @ . . . @ @ 
@ . . . . . . @ . . . . @ . . @ @ @ @ . @ @ @ @ . @ . . @ . @ . @ . @ . @ . . @ @ @ . . . @ . @ @ . @ . . @ . . @ . . . . @ . . . @ @ . @ @ @ . @ . @ . . . @ . . . @ . @ @ . . @ . . @ . @ . @ @ . . @ 
@ . @ . @ . @ @ @ @ . @ . . @ @ @ . . . . . @ @ @ . . @ . @ . . . . . @ . . @ . . @ @ @ . . @ . . . . . @ . @ . . . @ . @ . @ . @ . @ @ . . . . . . . . @ @ . @ . @ . . . @ @ . . @ . . @ . . . . . @ @ 
@ @ . . @ . @ . @ . . . @ . . @ @ @ . @ @ @ . @ . @ . @ . @ @ . @ . @ @ @ . . @ . . . . . @ . . @ @ @ . . . . @ @ . @ @ . . @ . . . . . @ . @ . @ . @ . @ . . . . . . @ . @ . . @ . . @ . . @ . @ . . @ 
@ . @ @ . @ @ . . @ . @ @ . @ @ @ @ @ . . . . . . . . @ . . . @ . . . @ @ . @ . @ @ . @ . . @ . . @ @ @ . @ . . @ . . @ @ . . . @ . @ . @ @ . @ @ @ . . . @ . @ @ . @ . . . . @ . . @ . . @ . @ . . @ @ 
@ . . . . . . @ . @ @ @ . @ @ @ . @ @ @ @ . @ . @ . @ @ . @ @ . @ . @ . @ . . . @ . @ . . @ . . @ @ @ @ @ . . @ @ . @ @ @ . @ @ @ . . @ @ . . . @ . @ . @ @ @ @ @ @ @ @ . @ @ . @ . . . @ . . . @ @ @ @ 
@ @ @ @ . @ . @ . @ @ . . . @ . . . @ @ @ @ @ @ @ @ @ @ . . . . . @ . . . . @ . @ . . . @ . . @ @ @ @ @ . @ . . . . . . . . . . . @ . @ . . @ @ @ . . . . @ . . @ @ @ @ . . . . . . @ @ . . @ @ . . @ @ 
@ . . . @ . . . . @ . @ . @ . @ . @ @ . @ . @ @ @ . . . @ @ @ . @ @ . @ . @ . . . @ @ . . @ . . @ . @ . . @ . @ . @ . @ . @ . @ @ . @ . @ . @ . @ @ @ . @ . @ . . @ . . . @ @ @ @ . . @ . @ . @ . @ . @ 
@ @ . @ . @ @ @ . . . . . . . . . . . . . . . @ @ . @ @ . . . . . . . @ . @ @ . @ @ @ @ @ . @ . . . . @ . . @ . @ . @ . @ . . . . . . . . . . . . . . . . . @ . @ . @ @ . @ . . . @ @ . . . . . . . . @ 
@ . . . . . . . . @ . @ . @ . @ @ @ @ @ . @ @ @ . . . . . @ . @ @ . @ . . . @ . @ @ . . . . . . @ @ @ . . @ @ . . . . . . . @ @ . @ @ . @ . @ . @ . @ . @ . . . . . . . . . . @ . . @ @ . @ . @ @ . @ @ 
@ . @ @ . @ . @ @ . . . @ . . @ . @ . @ . . . . . @ . @ . . @ @ @ @ . @ . @ . . . @ . @ . @ @ . @ . @ . @ @ @ @ @ . @ @ . @ @ . . @ . @ . @ . . . @ . . @ @ @ @ . @ @ . @ @ . @ @ @ . @ . . @ . . . . @ 
@ . . @ @ @ @ . . . @ @ @ . @ . . . . . . @ . @ . . @ . . @ . . @ . . @ @ @ @ . @ @ . @ @ . . . @ . . . . @ @ . . . @ . @ . . . @ . . . . . . @ @ . . @ . . @ . . . . @ . . . . . . . . . @ @ @ @ . @ @ 
@ @ @ @ @ @ @ @ @ . . @ @ @ . @ @ . @ . @ @ @ . . @ @ @ . . @ . @ @ . . @ @ @ @ @ . . @ . . @ . @ @ @ @ . . . @ . @ . . . . @ . . @ . @ @ . @ . . @ @ @ @ . . . @ . @ @ . @ . @ @ . @ . @ @ . @ . . . @ 
@ . @ . @ . @ @ @ . @ . @ @ . @ @ @ . . . @ . @ . @ @ . . @ . . . @ . @ . @ @ . . @ @ . @ . . @ . . @ . @ @ . @ . . @ @ . @ . . @ . @ . . @ @ . @ . . . . . @ @ @ . . . @ . . . . @ . @ . . . . @ @ @ @ 
@ . . . . . . @ @ @ @ . . @ . . @ @ @ . @ . . @ @ . . . @ . @ . @ . . . . . . @ . @ @ . . . @ @ @ . . . . . . . @ . @ . . @ @ . . . . @ . . . . . . @ . @ @ . . . . @ @ @ @ . @ . . . . . @ . @ . . . @ 
@ @ . @ @ . @ . @ . @ . @ . @ . @ . @ . @ . @ . @ @ . @ . . . . . . @ @ . @ . . . . . . @ . @ @ @ @ . @ . @ . @ . . . @ @ . . . @ . @ . . @ . @ . @ . . @ . . @ @ . @ . @ . . . @ @ . @ . . @ . @ . @ @ 
@ @ @ @ . . . . . . . . . . . . . . . . @ . . . . @ @ @ @ . @ . @ . . @ @ . @ @ @ . @ @ . . @ @ @ @ . @ @ . . . @ . @ . @ @ . @ . @ . @ . . @ . . @ @ . @ . @ @ @ @ . . @ . @ . . @ . . @ . . . . . . @ 
@ @ @ @ . @ . @ @ @ @ . @ . @ @ . @ . @ @ . @ . @ @ @ @ @ . . @ . . @ @ @ . . . . . . @ @ @ @ @ @ . @ @ . . @ . @ . . . @ . . @ . . . . . @ @ @ @ . . . . @ @ @ @ @ @ . . . @ @ . . @ @ @ . @ . @ . @ @ 
@ @ @ @ . @ . @ . @ @ @ . . . @ . @ . . . . . @ @ @ @ @ @ @ @ @ @ @ . @ @ @ @ . @ . @ . . . @ . . . . @ @ . @ . . . @ @ @ @ @ . @ . @ . @ @ . @ . . @ . @ @ @ @ @ @ @ @ @ @ @ . . @ . @ @ . @ . . @ @ @ 
@ @ . @ . . @ @ . . @ . @ . @ . @ . . @ . @ . . @ @ @ @ . @ . @ @ @ . . . @ @ @ . . @ . @ . @ @ . @ . @ . @ . . @ . @ . @ . . . . . @ . @ @ . @ . @ . . @ @ @ @ @ @ @ . @ @ . . @ . . . . . @ . @ . @ @ 
@ . . . @ . . . . @ . . . . . . . @ . . @ . . @ @ @ @ . . @ . . @ . @ @ . . @ @ @ . . . . @ @ @ @ . . . . . . @ @ @ . . . . @ . @ . . @ . . . . . @ @ . . @ . @ @ @ . . @ . @ @ @ @ . @ . @ . . . . . @ 
@ . @ . . . @ @ . @ @ . @ . @ . @ . . @ @ @ . @ @ @ . @ . @ . @ . . . @ . @ . @ . . @ @ . @ @ @ @ @ @ @ . @ . . @ . . @ @ @ @ @ . . @ @ @ @ . @ @ . . . @ . . . @ . @ . . . . . . . . . @ @ @ . @ . @ @ 
@ . @ @ @ . @ . @ . . . @ . . @ . @ . . . . @ . @ . . . . . . . . @ @ . . . . @ . @ @ . @ . @ @ @ . @ . @ . . @ @ @ . @ @ . @ . @ . . . . . @ @ @ @ . @ @ . @ @ . . . . @ . @ . @ . @ . @ . . . @ . . @ 
@ . @ @ @ @ . . . @ @ @ . @ @ . . @ . @ . @ . . . @ @ @ @ @ @ @ . . . . @ . @ @ @ @ . . . . . . . . . . . . @ @ @ @ @ . . . . . . . @ @ . @ @ @ . . . . @ . . . @ . @ . . @ . . . @ . . @ . @ . @ . @ @ 
@ @ . @ . @ @ @ . @ . . . @ @ . @ . . @ @ . @ . @ . . @ . . . . . @ @ . . @ @ @ @ @ @ @ @ @ . @ . @ . @ . @ @ @ @ . . . @ . @ @ @ . . @ @ . @ @ @ . @ . . . @ @ . @ . . @ . @ . @ @ @ . @ . @ . . @ . @ 
@ @ . . . . . . . . @ @ . @ . . . @ @ . @ . @ . . @ . . @ @ . @ . . @ . @ . @ @ @ @ @ @ @ @ @ . . . @ . . @ @ @ @ @ . @ . . @ . @ . @ . . . . . . @ . . @ . . . . @ . @ @ . . . . @ . . . @ . . @ @ . @ 
@ . @ @ @ @ @ @ @ . . . . . @ . @ . @ . @ . @ @ . . @ . . @ . @ @ @ . . . . @ . @ @ @ @ . @ . @ . @ @ . @ @ . @ @ . . . @ . @ . . . . . @ @ . @ @ @ @ . . @ @ . @ @ @ . . . @ . @ @ @ . @ . @ . . . . @ 
@ . . . . . . . . . @ . @ . . . . . . . @ . @ . @ . @ . @ @ @ @ @ . @ . @ @ . . . @ . @ . . . . @ . . . . . . . @ @ . @ @ @ . . @ . @ @ @ @ @ @ . @ . . @ . @ . . . . @ . @ . . . @ @ @ . . . . @ . @ @ 
@ . @ . @ . @ . @ @ . . . @ . @ . @ . @ @ . . . . . . . . @ @ . . . . . . . @ . @ . . . . @ . @ @ . @ . @ @ . @ . . @ @ @ @ @ @ . . . @ @ @ @ @ . . @ . . . @ . @ . @ @ . @ @ . @ @ @ . @ . @ . . @ @ @ 
@ . . @ . . @ @ . . @ @ . @ . . @ . . . @ @ . @ . @ @ @ . . . . @ . @ . @ . . . . @ . @ . . @ @ . . @ . . @ . @ . @ . @ @ @ . . @ . @ . @ . @ . @ . @ . @ . . @ @ @ . . . . @ . @ @ @ . @ . @ . @ @ @ @ 
@ @ . @ @ . @ @ @ . . . . . @ . @ @ @ . @ . @ . @ . . . . @ . @ . . . @ . @ @ @ . @ @ . @ . @ . @ . @ . @ @ @ . . . . . @ . . @ @ @ . . . . . . . . . . @ @ @ @ @ @ @ . @ @ . . . @ . . . . @ . . @ @ @ 
@ . @ . . . @ @ @ . @ @ . @ @ @ . . @ . . . . . . . @ . @ . . @ @ . @ @ . . . . . . . . . . . . . . @ . . @ @ @ @ @ . @ @ . @ . @ . . @ . @ @ @ . @ @ . . . @ @ @ @ @ @ . @ . @ . . @ @ . @ . . @ @ @ @ 
@ . @ @ . @ . @ . @ . . @ . @ @ . @ . @ . @ . @ . @ . . @ . @ . . . . . @ . @ . @ . @ . @ . @ @ . @ . . @ . . . @ . . . . . @ . @ . @ . . @ @ . @ . . . @ . @ @ @ @ @ . . @ . @ @ @ . @ @ . . @ @ @ @ @ 
@ . @ . @ @ . . . . . @ . . @ . . . . @ . . @ . . @ @ . . @ @ . @ . @ . . @ . . . @ . . @ . @ @ . . @ @ . . @ . . . @ . @ . . . . . @ @ . . @ . . . @ . . @ @ @ . @ . @ . @ . . @ . . . . @ . . . @ @ @ 
@ . . . . . . @ . @ . . @ . . @ . @ @ . @ . @ @ . . @ @ . . . @ . . . @ @ @ @ . @ . @ . . @ . . . @ @ . @ . . @ . @ . . @ @ . @ . @ . . . @ . @ . @ . . @ @ @ . . . . . . . . @ @ . @ @ @ . . @ . . . @ 
@ @ @ . @ . @ . . . @ . @ . @ . . . . . . @ . @ . @ @ . . @ @ . @ . @ . . @ . . . . . @ . . @ @ . @ . . . . @ @ @ @ @ . @ . @ . . @ @ @ . @ . @ @ @ . @ . @ . @ . @ . @ . @ . . . . . @ @ @ . . @ @ . @ 
@ @ @ @ . . . @ . @ . . . . . . @ . @ @ . . . . . . . @ . . . . @ . . . @ . . @ @ . @ @ @ . . . @ . . @ . @ @ @ @ @ @ @ . . . . @ . . . . . . @ @ @ . . . . . @ @ . . . @ @ . @ . @ @ @ @ @ @ . @ @ @ @ 
@ @ @ @ @ @ @ @ @ @ @ @ @ @ @ @ @ @ @ @ @ @ @ @ @ @ @ @ @ @ @ @ @ @ @ @ @ @ @ @ @ @ @ @ @ @ @ @ @ @ @ @ @ @ @ @ @ @ @ @ @ @ @ @ @ @ @ @ @ @ @ @ @ @ @ @ @ @ @ @ @ @ @ @ @ @ @ @ @ @ @ @ @ @ @ @ @ @ @ @ 
3
54 80 6 38
21 30 55 25
65 13 5 23
