100 100
@ @ @ @ @ @ @ @ @ @ @ @ @ @ @ @ @ @ @ @ @ @ @ @ @ @ @ @ @ @ @ @ @ @ @ @ @ @ @ @ @ @ @ @ @ @ @ @ @ @ @ @ @ @ @ @ @ @ @ @ @ @ @ @ @ @ @ @ @ @ @ @ @ @ @ @ @ @ @ @ @ @ @ @ @ @ @ @ @ @ @ @ @ @ @ @ @ @ @ @ 
@ @ @ @ @ . . . @ . . @ . . @ . @ . @ . @ . @ . . . @ @ @ @ . @ . @ . . @ . . @ . . . @ @ . @ @ @ @ @ . . @ @ @ @ @ @ @ @ @ @ @ @ . @ . @ . @ @ @ @ @ @ @ @ @ @ @ @ @ @ @ @ @ @ . . . . . . . @ @ @ @ @ 
@ @ . @ . @ . @ . @ . . @ . . . . . . . @ . @ . @ . @ @ @ . . . . . @ . . . @ @ @ @ . . . . @ @ @ @ . . @ @ @ @ @ @ @ @ @ @ @ @ . . . . . . . . @ @ @ @ @ @ @ @ @ @ @ @ @ @ . . . @ . @ . @ . . @ @ @ @ 
@ . . . . . . . . @ . @ . @ . @ @ @ . @ . . . @ . . . @ @ @ . @ . @ . . @ @ . @ @ . . @ . @ @ @ @ . @ . @ . @ . @ @ @ @ @ @ @ . . @ @ . @ @ . @ @ @ @ @ @ @ @ @ @ @ @ @ @ @ @ . @ @ @ @ @ . . @ @ @ @ @ 
@ @ . @ . @ @ @ . @ . @ . @ @ . @ . . . @ . @ . @ . @ . @ . . @ . . . @ . @ . . . . @ @ @ @ @ @ . . . . . . . . . @ @ @ @ @ @ @ . . . @ . . . @ . @ @ @ @ @ @ @ @ @ @ @ @ @ @ @ @ @ @ @ . @ . . @ @ @ @ 
@ . . . @ @ @ . . @ . @ . @ . . . . @ . . . . . @ . . . . @ @ . . @ @ @ . . @ . @ . . @ @ @ . . @ . @ @ @ @ @ . @ . @ @ @ @ @ . . @ @ @ @ . @ . . . @ @ @ @ @ @ @ @ @ @ @ @ @ @ @ @ @ . . . . @ @ @ @ @ 
@ @ . @ @ @ @ @ . . . @ . . @ @ . @ . @ @ . @ . . . @ . @ @ . @ . . . @ . @ . @ . . @ @ @ . . @ @ @ . . . @ . . . . . . . @ . @ . @ . @ . . . @ . @ @ @ @ @ @ @ @ @ @ @ @ @ @ @ @ @ @ @ @ @ . @ @ @ @ @ 
@ @ @ @ @ @ @ . @ @ . . . @ . . @ . . @ . @ . @ @ . . @ . . . @ @ . @ @ . . . . @ . . @ . @ . . @ @ @ @ . . @ . @ @ . @ . @ . . . @ . . @ . @ @ . @ @ @ @ @ @ @ @ @ @ @ @ @ @ @ @ . @ . . . . . @ @ @ @ 
@ @ @ @ . @ . . . @ @ . @ . . @ . . @ . . . . . . . @ . @ . @ . @ . . . @ . @ @ . . @ . . . . @ @ @ @ . @ . @ . . @ . @ @ . @ @ . @ . @ . @ @ . . . @ @ @ @ @ @ @ @ @ @ @ @ @ @ . . . . @ @ @ . . @ @ @ 
@ . . . . . @ . @ . @ . . . @ @ @ . @ . @ . @ @ @ . . . . . . . @ . @ @ . . . @ . @ . . @ . @ @ @ @ . . . . @ . @ . @ . @ . @ . . . . . . . . @ . @ . @ . . @ @ @ @ @ @ @ @ @ @ @ . @ . . @ @ . @ . @ @ 
@ @ @ @ @ . . . . . @ . @ . . @ . . . @ . . @ . . @ . @ . @ @ . @ . . . @ . @ @ . . @ . . @ @ @ @ @ @ . @ . . . . . @ . . . . @ . @ @ . @ @ . . . . . . . @ . . @ @ @ @ @ @ @ @ @ @ . . @ @ . . @ . @ @ 
@ . . . . . @ . @ . @ . @ @ @ . @ . @ . @ . @ . @ . @ . @ @ . . @ . @ @ . . . . @ . . . @ @ @ @ @ @ @ @ . @ @ . @ @ . . @ @ @ @ . . @ . . . @ @ . @ . @ . @ @ . @ . . @ @ @ @ @ . @ . @ . . @ . . . . @ 
@ . @ @ @ . @ @ . . . . . . . . . . . . . @ . . . . . . . . @ . @ . . . @ . @ @ @ @ . @ @ @ @ @ . . @ . . . . . . . @ . . @ . . . @ . . @ . . . @ . . . @ @ . . @ . @ @ . . @ . . . @ . . @ . . @ . @ @ 
@ @ @ . @ . @ . . @ . @ . @ . @ @ . @ @ @ . @ . @ . @ . @ @ . . . . @ @ . . . . . @ . @ @ @ . . . @ . . @ . @ @ @ . . @ . @ . @ . . @ . . @ . @ . @ . @ @ . @ . . . @ @ @ . . @ . @ . @ . @ . @ . @ @ @ 
@ . . . . @ . @ @ . @ . @ . @ . . . . @ . . . @ . . @ . @ . @ @ . @ . . . @ . @ . @ . . @ . @ @ . @ . @ @ @ . . . . @ . . @ @ . . @ . @ @ @ . . . @ @ @ @ . . . @ @ @ @ @ @ . . . . . . . . . . . @ . @ 
@ @ . @ . @ . . . . . . @ . . @ . @ . . @ . @ . @ . . @ . . . @ . @ . @ @ . . . @ . . @ . . . . . @ @ . @ @ . @ @ . @ . @ @ . @ . @ . . @ . @ @ @ . . @ . . @ @ . @ @ @ @ . . @ . @ @ . @ @ . @ . . . @ 
@ . @ @ . @ @ . @ . @ . @ . @ . @ @ @ . . . . . @ . @ . @ . @ . . . . @ . @ . @ . @ . . . @ @ @ @ . . . . . @ @ . . @ . . @ . . . . . @ . . @ @ @ @ . . @ . . . . . . @ . @ . @ . . @ . . . @ . @ . @ @ 
@ . @ . . . . . @ @ . . . . . . . . . . @ @ @ . . . . . . . @ @ . @ . . . . @ . . @ . @ . . . . . @ @ @ . @ . . . @ . . @ . . @ @ @ @ . @ . @ @ . . @ . @ . @ @ . @ @ . . . @ . . @ . @ . @ . . . . @ @ 
@ . . . @ . @ . @ . @ . @ . @ @ . @ @ @ . . . . @ . @ . @ . . . @ @ @ . @ @ . @ . @ . . @ @ @ @ @ . . @ . . . @ @ . . @ . . @ . @ . @ . . . @ . @ . . . @ . . @ . . . @ . @ . @ . @ . . @ @ @ . @ @ . @ 
@ @ @ . @ @ . . . . . @ . . . . @ . . . . @ . @ . . . @ . @ . @ @ @ . . . . . . . @ . @ . . . . . . @ . @ . @ . @ . @ @ . @ . . . . . . @ @ . . . @ . @ . @ . . @ . @ . . . . . . . . @ @ @ @ @ @ @ . @ 
@ @ . @ . . . @ . @ @ @ @ . @ @ @ @ @ . @ . . @ @ . @ . . . . . @ @ @ . @ @ @ @ @ @ . . @ . @ @ @ . . . . . . . . . . . . . . @ . @ . @ . . @ @ . . . . . . . @ @ . @ . @ . @ . @ . @ @ @ @ @ @ . . . @ 
@ . . . . @ . @ . @ . @ . @ . . @ . @ @ . @ . . @ @ @ . @ . @ . @ @ @ . . . . @ @ . . @ . @ . . . . @ . @ . @ @ . @ . @ . @ . . @ . . . @ . . . @ @ @ @ . @ . @ . @ . . . @ @ @ . . . @ @ @ @ @ . @ . @ 
@ @ @ . @ . . @ . . . @ . @ @ . . . . . . . . @ . @ . @ . . . @ . @ . . @ . @ @ @ @ . . . . @ . @ @ . . . @ @ @ @ . . . @ . . @ @ @ . @ . @ . @ . @ . . . . @ @ . . @ . @ . @ . @ . @ @ @ @ @ @ @ @ . @ 
@ @ . @ @ @ . @ . @ @ . . . . @ . @ . @ . @ . . . . . . @ . @ . . . . @ @ @ . @ @ @ . @ . @ @ . @ . @ . @ . @ @ . @ . @ @ @ . @ @ @ @ @ . @ . @ . . . @ @ . . @ . @ . . . . . . . @ @ @ @ @ @ @ . . . @ 
@ @ . @ . @ @ @ @ . @ . @ . @ @ @ @ . . @ . . @ . @ @ . @ . @ @ @ @ . . @ @ . . @ . . . @ . . . @ . . . . . . . . . @ . @ @ . @ @ @ @ . . . . . . @ @ . @ @ . @ . . . @ @ . @ @ . . @ @ @ @ @ @ . @ . @ 
@ . . . . @ @ @ . . . . . @ @ @ @ . . @ . @ . . @ . . . @ . . . @ . . @ . @ @ . . @ . @ @ @ . @ . . @ . @ . @ . @ @ . . . . @ @ @ @ . @ . @ . @ . . . . @ . @ @ . @ @ . @ . @ @ @ @ @ @ @ . @ . . . @ @ 
@ @ @ @ . @ . . . @ @ . @ . @ @ @ @ . @ . . . @ @ @ . @ . @ . @ . @ . . . . . @ . . . @ @ @ @ . @ . @ . @ @ . . . @ . @ . @ @ @ @ . . . @ . . . @ @ . @ @ . @ . . . @ . @ @ . @ @ @ @ @ @ . @ @ . @ @ @ 
@ . @ . . . . @ . @ . . . . . @ . . @ . . @ . @ . @ @ . . . . @ . @ . @ @ @ @ . @ @ . @ @ @ . . . . . @ @ . @ . @ . . . @ @ @ @ . @ @ . . @ . @ . . @ @ . . . . @ @ . . . @ . @ @ @ @ @ . . . @ . @ @ @ 
@ . @ @ @ . @ @ @ @ @ . @ . @ @ . @ . @ . . @ . . . @ @ . @ . @ . . . . . @ . . @ . . @ @ . . @ @ . @ @ . . . . . @ . @ . @ @ . . @ . . @ @ . @ . @ @ . @ . @ @ . @ . @ . . . . @ @ @ @ @ . @ . . . @ @ 
@ . . @ . @ . . . @ . @ @ . . . . . . . . @ . @ . @ . @ @ . . . @ @ . @ @ . @ . . @ . . @ @ . @ @ . . . @ @ . @ . . . . . . . . @ . @ . @ . . . . . . . . . . . . . . . @ @ . @ @ @ @ @ @ . @ . @ . . @ 
@ @ . . . . @ @ . . . @ . . @ @ . @ @ @ @ . . @ . . . @ . . @ @ . . . @ . . . . @ . @ . . . . @ . . @ @ . . . @ . @ . @ @ . @ @ . . . . . @ . @ @ @ @ . @ . @ @ . @ . @ @ . . . . . . . . . . . . @ . @ 
@ @ @ . @ . @ . @ . @ . @ . . @ @ @ @ . . . @ . . @ @ . @ . . @ . @ @ . @ . @ . . . . @ . @ . @ . @ . . . @ . @ . . @ . . . . @ . @ @ . @ . . . @ @ @ . . @ . . . . @ @ @ @ . @ . @ @ . @ . @ . @ . . @ 
@ @ @ @ @ . . . . . . . . . @ @ @ @ . @ . @ . @ . . . . . . @ . . . @ . . . @ . @ @ @ @ @ . . . @ . @ . @ . . @ . @ @ @ . @ @ . @ . . . . @ . @ @ @ @ . @ . . @ . @ @ @ @ . @ . . . . @ @ . @ . . @ @ @ 
@ @ @ . @ @ . @ . @ @ @ . @ @ @ @ . . . . . . . @ . @ . @ . @ @ . @ . @ . @ @ . . @ . @ . . @ . @ . . @ . @ . @ @ . @ @ @ . . . . @ @ . @ @ . @ @ @ . @ @ @ . . @ @ @ @ @ . . @ . @ . . . @ . . @ @ @ @ 
@ . @ . . @ @ @ @ . . . . . @ @ @ @ . @ . @ @ . @ . @ @ @ . @ . . . . . @ . . . @ . . . @ . . @ . . @ @ . @ . . . . . @ . @ @ . @ . . . @ . . . @ . . @ . @ @ @ . @ @ @ @ . @ . . @ . @ . @ @ . @ @ @ @ 
@ . . . @ @ @ @ @ @ @ @ . @ @ @ . . @ @ @ . @ . . @ @ @ . . . @ . @ @ @ . @ @ . . @ . @ . . @ @ . @ . . . . . @ . @ @ . . . . . . @ @ . @ . @ . . @ . @ . . @ @ . . @ . @ . @ @ @ . . @ @ . . . . @ @ @ 
@ @ . @ . . @ @ @ @ @ @ . @ @ @ @ . . @ @ . @ . @ . @ . @ . @ @ . @ . @ . . . . @ @ . . . @ . . . . @ @ . @ . . @ @ . @ . @ @ . @ . . . @ . . @ @ . . . . @ . . . @ @ . . . . @ @ @ @ . . . @ . @ @ @ @ 
@ . . . @ . . . @ @ @ @ . . @ @ . . @ . . . . . . . . . . . . . . . . . @ . @ . @ . . @ @ . @ . @ @ . @ . @ . @ @ @ . . @ . . . . . @ @ @ . @ . @ @ . @ @ . @ @ . @ . . @ . @ @ @ @ @ @ @ . @ . @ @ @ @ 
@ . @ . . . @ @ @ @ @ @ @ . @ . @ . . . @ @ @ . @ . @ . @ . @ . @ . @ . . @ . . . @ . . @ . @ . . @ . . @ . @ @ @ . @ . @ . @ . @ . . . @ . . . . . . . . . . . . . . @ . . @ @ @ @ @ @ @ @ . @ . @ @ @ 
@ @ . @ @ . @ . . @ @ . . @ . . . . @ . . @ . @ . . . @ . . . @ . . @ . @ . . @ . . . @ @ . @ . @ . . @ @ . @ @ . . . . . @ @ @ . . @ @ . . @ . @ @ . @ . @ @ . @ . @ @ @ . @ @ @ @ @ @ @ @ . . . . . @ 
@ . . . . . . @ . @ . @ . @ . @ . @ . . @ . . . . @ . . @ . @ @ . @ @ . . @ . @ . @ @ . @ . @ . @ . @ @ . . @ @ @ . @ . @ . @ . . @ . @ @ . . @ . . . . @ . . @ . @ . @ . @ @ @ @ @ @ @ @ . . @ @ . @ @ 
@ . @ . @ @ . . . . . . . . . @ . . @ . @ @ @ . @ . . @ . . . @ @ . . . @ . . . @ . . . . . @ . . . . @ . @ . @ . @ . . . . . @ . . . @ @ . @ . . @ . @ @ . @ . . . . . . @ @ @ @ @ @ @ . @ . . . @ @ @ 
@ @ . . @ . . @ . @ . @ . @ @ . . @ . @ . . . . @ . @ @ @ . @ @ . @ @ . . @ . @ . @ @ . @ . @ . @ . @ . . . . . . . . @ @ @ @ . @ @ . @ . . @ @ . @ . @ . . . . @ . @ @ . @ @ @ @ . @ . . . . @ @ . @ @ 
@ @ . @ . @ @ @ @ . . @ @ . . . @ . . . . @ @ . . @ @ @ @ @ @ @ . . . @ . . . . . . . @ . . . . . @ . . @ . @ @ . @ . . . . . . . . . . @ . . . @ . @ . @ . @ . . @ . . @ . @ @ . . . . @ . @ . . . . @ 
@ . . . . @ @ @ @ @ . @ @ @ . @ . @ . @ . @ . . @ @ @ @ @ @ @ @ @ . @ . . @ . @ . @ @ . @ @ . @ . . @ . . @ . . @ . @ . @ . @ . @ . @ . . . @ . . . . . . . @ @ @ . @ . . . . . @ @ . @ . @ @ @ . @ . @ 
@ @ . @ @ @ @ @ @ @ . @ . . . . . . @ @ @ . @ . . @ @ @ @ @ @ @ . . . . @ . . . @ @ @ . @ . . . @ @ . . @ . @ . . . @ @ . . . @ . @ @ @ . @ . . @ . @ . @ . . . . . . . @ @ . @ . . . . . . . . . . @ @ 
@ . . . @ . . . . @ @ . . @ . @ @ . @ . . . . . @ @ @ @ @ @ @ @ @ @ . @ . @ . @ . @ . . . . @ @ . @ . @ . . . . @ @ . @ @ . @ @ . @ . . @ @ @ . . @ . . . @ . @ . @ . @ . . @ @ . @ @ @ @ @ @ . @ . @ @ 
@ @ @ . . @ @ @ . . . . @ . . . . @ @ @ @ . @ . @ @ @ @ @ @ @ @ @ @ @ . . . . . . . @ . @ . @ . . . . . . @ . @ . . . . @ . @ . . . @ . @ @ @ . @ . . @ . . @ . . @ . . . @ . . . . . . . @ @ . . @ @ @ 
@ @ . . @ . @ . @ . @ . @ @ . @ . . @ @ . . . @ @ @ @ @ @ @ @ @ @ @ @ @ @ @ . @ . @ @ . . @ . . @ . @ . @ . @ @ . @ @ . . @ @ @ @ . . . @ @ @ . @ @ . @ . @ @ @ . @ . @ . . . @ . @ @ . @ . . . @ @ @ @ 
@ @ . @ . . . . . . @ @ . . . . @ @ @ @ @ . @ @ @ @ @ @ @ @ @ @ @ @ @ @ @ . . @ . @ . . @ . . @ . @ @ @ . . @ . . . @ . @ . . . . . @ . . @ @ @ . . . @ @ . @ . . . @ @ @ . @ . . . . @ @ @ @ . . @ @ @ 
@ @ @ . . @ . @ @ @ . . . @ . @ @ . @ . @ @ . @ @ @ @ @ @ @ @ @ @ @ @ @ @ @ . @ @ . @ . . . @ . . @ @ . @ . . . @ @ . @ @ @ . @ @ . @ . @ . @ @ . @ . . . . . @ @ @ . @ . . . @ . @ . @ @ @ . . @ . @ @ 
@ @ . @ . . @ @ . @ @ @ . @ . . . . @ . . @ . . @ @ @ @ @ @ @ @ @ @ @ @ . . . @ . . . . @ @ . . @ . . . . . @ @ . @ . . . . @ @ . @ . . . . . @ . . @ @ . @ . . . . . . @ . @ . @ . @ . @ . @ . . . . @ 
@ . . . @ . @ . . @ @ @ . . @ . @ @ . . @ . @ . . @ @ @ @ @ @ @ @ @ @ . @ . @ . @ @ @ . @ @ . @ . @ @ . @ . @ . . . . @ . @ @ @ . . @ . @ . @ . @ . @ @ @ . . @ . @ . @ @ . . . @ . @ . . . . . @ . @ @ 
@ . @ . . @ . @ . @ @ @ @ @ . . . . @ . . . @ . @ @ @ @ @ @ @ @ @ @ @ . . . . . . @ . . . . . . . . . @ . . . @ . @ @ . @ @ @ . . @ . . . @ . . . @ @ @ @ @ . . @ @ . . @ . @ . . . . @ . @ . @ . . . @ 
@ @ . . @ . . . . . @ @ @ @ @ . @ @ @ @ . @ . . . . @ @ @ @ @ @ @ @ @ . @ . @ @ @ . @ . @ @ @ . @ . @ . @ . @ . . . . . . @ . @ . . . @ . @ @ . @ . . @ . . @ . . . @ . @ . @ @ @ . @ @ @ . . . @ @ . @ 
@ . @ . . @ @ @ . @ . @ @ @ @ . . @ @ . . . . @ @ . @ @ @ @ @ @ @ @ @ @ . . . . . . . . . . . @ . . @ . . . . . @ . @ . @ @ . . . @ . @ @ . . . . @ . @ . @ . @ . @ . . @ . . . . @ @ @ . @ . @ . . . @ 
@ . . @ . . @ @ . @ . @ @ . . @ @ . . . @ @ . . @ @ @ @ @ @ . @ @ . @ . @ . @ @ . @ . @ . @ . . @ . @ . @ @ @ @ . @ . @ @ . . @ @ @ . . @ @ @ @ . @ . . . . . . @ . @ . @ . @ @ . @ . . . . . . @ @ . @ 
@ @ . . . @ . . . . . @ . . @ . @ @ @ . @ . . @ @ . @ . @ . . @ @ . . . . . . @ @ . . . @ . @ . @ . @ . . . @ . . . . . @ @ . . @ @ @ . @ . . @ . . . @ . @ . @ . . . . @ . . . @ @ @ . @ . @ . . @ . @ 
@ . @ @ . . . @ @ @ . @ . @ . . . . @ @ . @ . @ . . . . . @ . . @ . @ @ @ . @ @ @ @ . @ @ . . @ @ @ . . @ @ . @ . @ . @ . . . @ . @ . . . @ . @ . @ @ . . . @ @ @ . @ . @ . @ @ @ @ @ @ . . @ . @ @ . @ 
@ . @ . @ @ . @ . @ . . . . @ . @ @ @ . . . . @ @ @ . @ . @ . @ . @ @ . @ . . @ . . @ @ @ @ . . @ . @ . . . . . . . @ @ . @ . . . . @ . @ @ . @ . @ . @ . @ . . . @ . . @ @ . @ @ @ @ @ . @ @ . @ . @ @ 
@ . . . . . . . . @ . @ . @ @ . . @ . @ . @ . . @ @ @ . . @ . . . @ . . . . @ . @ . . @ @ @ @ . @ . . . @ . @ @ . @ . . @ @ . @ . @ @ @ @ . . . . . . . @ @ @ . @ . @ . . @ . @ . @ @ . @ . @ . . . . @ 
@ @ . @ . @ . @ . . @ @ @ . @ . @ @ . . . @ . @ @ . . @ . @ . @ @ @ @ . @ . @ . . . @ @ @ @ . . . @ . @ . @ . . @ @ . @ . @ . . @ @ @ @ @ @ @ . @ @ . @ . @ . . . . . @ . . . . . @ . . . . . @ @ @ @ @ 
@ . . @ @ @ . @ . @ . . @ . . . . @ . @ . . @ @ @ . @ @ . . . @ @ @ @ @ . . . @ @ . @ @ @ . @ @ . . . . . . @ . . @ . . . . . @ . @ @ @ @ . . . @ @ @ @ . . @ . @ . @ . . @ . @ . . @ . @ @ . . . . . @ 
@ . @ . . . . @ . . @ . @ . @ . @ @ @ . . @ . @ . . . @ @ . @ @ . @ @ . @ . @ @ . . . @ . . . @ . @ @ @ @ . . . @ @ . @ . @ @ . . . . @ @ @ . @ @ @ . @ . @ . @ . . . . @ . . . @ . . . . . @ . @ . @ @ 
@ . . @ . @ @ . @ . . . . . . @ @ @ @ @ . . . . . @ @ @ @ . . . . . . . @ . @ . @ . @ @ @ . @ . . @ . . @ . @ @ . . . . @ . . . @ . @ @ @ . . . . . . . . . . . @ @ . @ . . @ . . @ @ @ . @ @ @ . @ @ @ 
@ @ . . @ . @ . @ @ @ . @ . @ . @ @ @ . . @ @ . @ . @ . @ @ . @ @ . @ . . . . . . . . @ . . @ . @ . @ . . @ @ @ @ . @ @ . @ . @ . @ @ @ . . @ @ . @ . @ . @ . @ . @ . @ . @ . . @ @ @ @ . . . . . . . @ 
@ . @ . . . @ . . . @ . @ . . . . @ @ @ . @ @ @ . . . . . . . @ @ @ . . @ . @ . @ @ @ . @ . . . . . . . @ . @ . . . . . . . . . . . @ . @ . @ @ . . @ . @ . . . . . @ . @ @ @ @ @ . @ . . @ . @ @ . @ @ 
@ . . . @ @ . . @ . . @ . . @ . @ . @ . . . @ . @ @ . @ . @ . @ @ @ @ . @ . @ @ @ . . . . . @ . @ . @ . @ . @ . @ . @ . @ . @ . @ @ @ . . . @ @ @ . . . . @ . @ . @ @ . @ @ @ . @ . . @ . @ . @ @ @ @ @ 
@ . @ . @ . . @ . . @ . @ . . @ . . . . @ . @ . @ . @ . . @ . @ @ @ . . . @ @ @ @ @ . @ . @ . @ . . . @ . . . . . @ @ . . @ . . . . . @ . @ . @ @ @ . @ . . @ @ . @ @ . @ @ @ . . . @ . @ . . @ @ @ @ @ 
@ @ . . @ @ . . @ . . . @ . @ . @ . @ @ @ . . . . . @ @ @ @ @ @ @ . . @ . . @ @ @ . . . @ @ . . @ @ @ . . @ @ . @ . . . @ @ @ . @ . @ . . . . . @ @ @ @ . @ . . @ @ . . . @ . . @ . @ . . @ . . @ @ @ @ 
@ @ @ . @ . . @ . @ @ . . . . . . . . @ . @ @ . @ . . . @ @ @ @ @ @ . . @ . @ . . @ . @ . @ @ . . @ . @ . . @ . @ @ @ . . @ @ @ @ @ . . @ . @ @ @ @ . . @ @ . @ @ . . @ . . @ @ @ . @ . @ . @ @ @ @ @ @ 
@ @ @ @ . @ . . . . . @ . @ . @ @ @ . . . . @ @ . . @ . @ @ @ @ @ . . @ . @ @ @ . . . . . . @ . @ @ . @ . @ @ @ . @ @ @ @ @ @ . @ . @ . . @ @ @ @ @ @ . @ @ . @ @ @ @ . @ . @ . @ . . . . . . @ @ . @ @ 
@ @ . @ . . . @ . @ @ . . . @ @ @ @ @ . @ . . . @ @ @ . @ @ @ @ . . @ . . . @ @ . @ . @ . @ @ . . . . . . @ . . . . . . @ @ . . @ . . . @ . @ @ @ @ . . . @ . . @ @ . . . . . . . . @ . @ . @ @ . . @ @ 
@ @ . @ . @ . . @ @ @ @ . @ @ @ @ @ . . . @ @ . . @ . @ . @ @ @ @ . . . @ @ . @ @ . . . @ @ . . @ . @ @ @ . . @ . @ @ @ . @ @ . . . @ @ . . . @ @ @ @ . @ @ . @ . @ . @ . @ @ . @ . . @ . . . @ @ . . @ 
@ @ . . @ . @ . @ . . @ . @ @ . @ . @ . @ . . . @ @ . @ . . @ @ @ . @ @ . . . . . @ . @ @ . @ . . @ . . . . @ . @ @ . @ . @ . @ . @ . @ . @ @ @ @ @ . . @ . . . . . @ @ @ . . . @ . @ @ @ . @ . @ . @ @ 
@ . . @ @ . . . @ . @ . . . . . . . . @ @ @ @ . . . . . . @ . @ . . . @ . @ @ @ @ . . . @ . @ . @ . @ @ . @ . . . . . . . . . . . . . . . . @ @ @ @ @ . @ . @ . @ @ . @ @ @ . @ . . @ . . . . . . . . @ 
@ @ . @ . @ . @ . . . @ @ . @ . @ . @ . @ . @ . @ . @ . @ . . . . @ . @ . . @ @ . @ . @ . . . . . . . . . . . @ . @ @ . @ . @ . @ @ @ @ . @ . @ @ @ . . . . . @ @ @ . . @ @ @ . . @ . . @ . @ @ . @ . @ 
@ . . @ . . . . . @ @ @ @ @ @ @ @ . . . . . . @ . @ . . . @ . @ . . @ . . @ @ . . . . . . @ . @ . @ . @ . @ . @ . . . @ @ . . @ . @ . . @ @ . . . @ @ . @ @ @ @ @ . . @ . @ @ @ @ . @ . . @ @ @ . @ @ @ 
@ @ . . @ . @ . @ @ @ @ @ @ @ . @ @ @ @ . @ @ . . @ . @ . . @ . . @ @ @ . . . . @ . @ . @ . . . @ @ @ @ @ . . . @ @ @ . . @ . . . . . @ . . . @ @ . @ . . @ @ @ . . @ . . . @ @ . . . . @ @ @ @ . @ . @ 
@ . @ . @ . @ . . @ @ @ @ @ . . . @ @ . @ @ @ @ . @ . @ . @ . . @ @ @ . . @ . @ @ . . @ @ @ . @ . @ . @ . @ @ . . . . . @ . . @ @ . @ . @ . @ . @ . @ . @ . @ . @ . . . @ @ . @ @ . @ . . @ @ @ . @ . @ 
@ . . . . @ . . @ . . @ @ . @ . @ @ . . . @ @ @ . . @ @ @ . . @ . @ . @ . . @ . @ @ @ @ . @ . . . . . . . . @ . @ . @ @ @ @ . @ . . . . . . . . . . . . . . . . . . @ . @ . . @ . . . @ @ . @ . . @ . @ 
@ @ @ . @ . @ . @ . @ . . . . . . . @ . @ . @ @ . @ @ . @ @ . . . . . . . @ . . . @ . . . . . @ . @ @ @ . @ @ . . @ @ . @ @ @ @ @ . @ . @ . @ . @ . @ . @ . @ @ . @ . @ @ . @ . @ . @ . @ . . @ . @ . @ 
@ . . . . . . . . . @ . @ . @ . @ . . . . . . . . . . . . . . @ . @ . @ @ @ @ . @ . . @ . @ . . @ @ @ @ @ . . . @ . . . . @ @ @ @ @ . . . @ @ . @ @ @ . @ . . . @ . . . . . . . . . . . . . @ . @ . . @ 
@ . @ . @ . @ . @ . . . @ . @ . . @ . @ . @ @ . @ . @ . @ . @ @ . @ . . @ @ . . . @ . @ @ . . @ . @ @ @ @ . @ . @ . @ @ . @ @ @ @ . @ . @ . @ . . . . @ . . @ . . . @ . @ . @ . @ . @ . @ . . . . @ . @ 
@ @ @ . @ @ @ @ @ @ . @ @ . @ . @ . . . @ . . . . @ @ @ . @ @ . . . @ . . @ . @ . . . @ . @ . . . @ @ @ @ @ . . . @ . . . @ @ @ . . . . . . . @ @ . @ . @ . . @ . @ @ . . @ . . . @ . . . @ . @ . . . @ 
@ . . . @ @ @ . . @ @ . . . @ @ . @ . @ @ . @ @ . . . . . . @ @ . @ @ @ @ . @ @ @ @ @ . . . . @ . @ @ @ @ @ @ . @ @ @ . @ @ @ @ @ . @ . @ . @ @ @ @ @ . . . @ @ @ . @ @ @ @ @ . @ . @ . @ . . . @ . @ @ 
@ . @ . . . . @ . @ . . @ . . . . @ . . . @ . @ . @ @ . @ . @ . @ . @ . @ . . @ . . @ @ . @ . . @ . @ . @ @ . @ @ @ . . . @ . @ @ @ . . @ @ @ @ . @ . @ @ . . . . . . . . . @ . . . . @ @ @ . @ . . . @ 
@ @ . . @ . @ . . . @ . @ . @ . @ . . @ . . . @ . . @ . . @ . . . . . . . . @ @ . @ @ @ . . @ . . . . . . . . . . . @ . @ . . @ @ . @ . . @ . . . . . @ . . @ . @ . @ . @ . @ . @ . @ . . . . . @ @ . @ 
@ . . @ @ . @ @ . @ @ . . @ . . . @ @ . @ . @ @ . @ @ . @ . . @ @ . @ . @ . . @ . . @ . . @ . . @ . @ . @ . @ . @ @ . . . . @ . . . . . @ . @ @ @ . @ . @ . . @ @ @ . . . @ . . @ . @ . @ . @ . . . @ @ 
@ @ . . . @ . . . . . . @ . @ . @ @ . . . . . . @ @ . @ @ @ . . @ . . @ @ . @ . . @ . @ . @ @ @ . . . @ @ . . @ . . . @ . @ . . @ . @ . . . . . . . . . . @ @ @ @ . @ . @ @ @ . . @ @ @ . . @ . @ . . @ 
@ . . @ @ @ @ . @ . @ . . . @ . @ @ @ @ . @ . @ . . . @ . . . @ . . @ @ . . @ . @ . . @ @ . @ . . @ @ . @ . @ @ . @ . . @ . . @ @ @ . . @ . @ . @ . @ . @ @ . @ @ . . . . @ . . @ @ @ . . @ . . . @ . @ 
@ @ . . @ @ . @ . . @ . @ @ . . . . . @ . @ . @ . @ @ . @ @ . . @ . @ @ @ . @ . . . @ . @ . . @ . . @ . @ @ @ . . @ @ . . @ . @ @ . @ @ @ @ . . . @ @ . . . . @ . . @ . @ @ @ . . . . @ . @ @ . @ . @ @ 
@ . . @ @ . . @ @ . @ . . @ @ . @ @ . @ . @ . . . . . . . . . @ @ @ @ @ . . @ . @ . @ . . . @ . @ @ . . @ . @ @ @ . @ . @ . @ . . . . . @ @ . @ . . . @ @ . @ . . @ . . @ @ @ @ . @ @ . . @ . . @ . . @ 
@ @ . @ @ @ . @ @ @ . . @ @ . . @ . . @ . @ @ . @ . @ . @ . @ . @ @ @ . @ @ @ @ @ . . . @ @ . . . @ @ . . . . @ . . . . . . . . @ . @ @ @ @ @ @ . @ . . . @ @ @ . . @ . . . @ . . . @ @ . @ @ . . @ . @ 
@ . . . @ . . . @ @ @ . . @ . @ @ . @ . . . @ . . @ . . . @ . . . @ @ . @ . @ . . @ . @ @ . @ . @ . @ . @ @ @ . @ . @ @ . @ . @ @ . . . . . . . @ @ . @ @ @ @ @ @ . . @ . @ @ @ . @ @ @ @ . . . @ . . @ 
@ . @ . . . @ . @ . . . @ . . . . @ @ @ . @ . . @ . @ . @ . @ . @ . . . . . . @ . . . . . . . . . . . . . . . . @ . @ . . . @ . . . @ . @ . @ . . . @ @ @ @ @ @ . @ . . @ @ @ @ @ . . . . . @ . @ . @ @ 
@ . . @ . @ . @ @ @ @ . . @ . @ . . @ . . . @ . @ . . . . . . . . . @ @ . @ . . . @ @ @ . @ . @ @ @ . @ . @ . @ . . . @ @ @ . . @ . @ . . @ @ @ @ @ @ @ @ @ . . . . . @ @ @ @ . @ . @ . @ . @ . . . . @ 
@ . @ . . . . . @ @ @ . @ . . . @ @ @ @ . @ . . @ . @ @ . @ @ @ @ . . @ . . @ @ . . . . @ . . . @ . . . @ . . . . @ . . . @ . @ . @ @ . @ @ @ @ @ @ @ @ @ @ . @ . @ . @ . @ . . . @ @ . . @ . . @ . @ @ 
@ @ @ . @ . @ . @ @ @ . . @ . @ @ @ @ @ . . @ . @ @ . . . @ @ @ @ . @ . . @ . . . @ . @ @ @ . @ @ @ . @ @ @ . @ . @ . @ @ . . . . . . @ @ @ @ @ @ @ @ @ @ @ @ . . @ . . . . . @ . . . @ . . @ . . @ @ @ 
@ @ @ @ @ @ @ @ @ @ @ @ @ @ @ @ @ @ @ @ @ @ @ @ @ @ @ @ @ @ @ @ @ @ @ @ @ @ @ @ @ @ @ @ @ @ @ @ @ @ @ @ @ @ @ @ @ @ @ @ @ @ @ @ @ @ @ @ @ @ @ @ @ @ @ @ @ @ @ @ @ @ @ @ @ @ @ @ @ @ @ @ @ @ @ @ @ @ @ @ 
3
80 7 45 10
60 96 94 2
27 55 16 81
