50 50
@ @ @ @ @ @ @ @ @ @ @ @ @ @ @ @ @ @ @ @ @ @ @ @ @ @ @ @ @ @ @ @ @ @ @ @ @ @ @ @ @ @ @ @ @ @ @ @ @ @ 
@ @ . . @ . . . @ . @ @ @ @ @ . . @ @ . . @ @ @ @ . . @ @ @ . . . . . . . . . @ . . @ @ @ @ @ @ @ @ 
@ . . @ . @ @ . . . . @ @ . . @ . . . @ . . @ @ @ . @ . @ . @ . @ . @ . @ . @ @ . @ . @ @ @ @ @ @ @ 
@ @ . . . . . . @ . @ . . . @ . @ . @ . . @ . @ . . . . . . . . @ . . @ . . . @ . . . . @ @ @ @ @ @ 
@ @ @ . @ . @ . . @ . @ @ . . . . . @ . @ . . . @ . @ @ . @ . @ . . @ @ @ . @ . . @ . @ @ @ @ @ @ @ 
@ . . . . @ . . @ . . . @ . @ @ . @ . . . . @ @ . . . @ . . @ @ . @ . @ . @ . @ . @ @ @ @ @ @ @ @ @ 
@ . @ . @ . @ . @ @ . @ @ . @ . @ . @ . @ @ . @ . @ @ . @ @ @ . @ . . @ . . . . . . . @ @ @ @ @ @ @ 
@ . @ @ . . . . . @ . . . . . . . . . . . . . . . . @ . @ @ @ . . . @ @ . @ . @ @ @ @ @ @ @ @ @ @ @ 
@ @ . . @ . @ . @ . . @ @ . @ . @ . @ @ @ . @ . @ @ . . . @ . . @ @ . . . . @ . . . . @ @ @ . @ @ @ 
@ @ @ . . @ . . @ @ . . @ @ . @ @ . . @ . . . @ . @ @ . @ . @ . . @ @ . @ . . . @ . @ . @ . . @ @ @ 
@ @ . . @ . . @ . @ . @ @ @ . . . . @ @ @ @ . . . . . . . . . @ . . . . . @ . @ @ . . . . @ . @ @ @ 
@ @ . @ . @ . . . @ . . @ @ @ @ @ . . . . . @ @ . @ . @ . @ . . . @ @ @ @ . @ . . . @ . @ @ . @ @ @ 
@ . . . . . . @ @ . . @ . @ @ @ . . @ . @ . . . @ . . . @ . . @ . . . . . . . @ . @ @ . @ . . @ @ @ 
@ @ . @ . @ . @ . @ . . . . @ @ @ . . @ . . @ . @ @ . @ . @ @ . @ . @ @ . @ . @ @ @ . . . . @ @ @ @ 
@ . @ . @ . . . . . . @ . @ . @ . @ . @ . @ . @ . @ . . . . @ . . . @ . . @ . . . . @ . @ @ @ @ @ @ 
@ . @ . . . @ . @ @ . @ . . . @ . . @ . . @ . . . . @ . @ @ . . @ . @ @ . . @ . @ . . @ @ @ @ @ @ @ 
@ . . @ @ . @ @ . . . . @ . @ . . @ . @ @ . . @ . @ @ . . . @ @ . . @ @ . @ . @ . . @ @ @ @ @ @ @ @ 
@ @ . . @ @ . . . @ . @ . . @ @ . . . . . @ . . @ @ . @ @ . . @ @ . @ @ . . . . @ . @ @ @ @ @ @ @ @ 
@ @ @ . . . @ @ . . @ @ @ @ . . . @ . @ @ . . @ . . . @ . @ @ . @ @ . . @ . @ . . @ @ @ @ @ @ @ @ @ 
@ @ @ . @ . @ . @ . @ @ . @ . @ . @ @ . . @ . @ . @ . @ . . @ . @ @ . @ . @ @ . @ @ @ @ @ @ @ @ @ @ 
@ @ . . . @ . . . . @ @ . . . . @ . @ . @ @ . . @ . . @ @ . . . . @ . . . . @ . @ @ @ @ @ @ @ @ @ @ 
@ . @ . @ @ @ @ @ . . . . @ @ . . . . . . . . @ . @ . . . . @ @ @ . . @ . @ . @ @ @ @ @ @ @ @ @ . @ 
@ . . . . . . . . . @ . @ . . . @ . @ @ @ @ @ . . . . @ . @ . . @ . @ . @ @ . . @ @ @ @ @ . @ @ . @ 
@ @ . @ . @ @ . @ . . @ . @ . @ . . . @ . @ . @ @ . @ . @ @ @ . . . . . . . . @ . @ @ . @ . . . . @ 
@ @ @ . . . @ @ . . @ . . @ . @ @ @ . . . . . . @ . @ . . . . . @ . @ @ . @ . . . . . . . . @ . @ @ 
@ @ @ @ . @ . . @ . @ . @ . @ . . . @ . @ . @ . . . . . @ . @ @ @ . . @ . . @ . @ . @ @ . @ @ . @ @ 
@ @ @ @ . @ @ . . . . . . . . . @ @ @ @ @ @ . . @ . @ . @ @ . @ . . @ @ . @ . . . @ . @ . . . @ @ @ 
@ @ @ @ @ . . . @ . @ . @ @ . @ @ @ @ @ @ . @ . . @ . . . . . . @ . . . @ . @ . @ @ . . . @ @ @ @ @ 
@ @ @ @ @ @ . @ . . . @ @ . . . @ @ @ @ @ . @ . @ . @ @ @ . @ @ . . @ . . . . @ . . @ @ @ . @ @ @ @ 
@ @ @ @ @ . . . @ . @ @ . @ . @ . @ . . @ . . . . . . @ . . . @ @ . @ . @ . @ @ . @ @ @ . . . @ . @ 
@ . . . . . @ @ . . . . . . @ . . . @ . . @ @ . @ . @ @ @ . @ @ @ @ . @ . . . . . . . . . @ . . . @ 
@ @ . @ @ . . . @ . @ . @ . . . @ . @ @ . @ . @ . @ . @ @ . @ @ @ . . @ @ . @ . @ . @ . @ . @ @ @ @ 
@ @ . . @ . @ @ @ . . @ . . @ . @ . . . . . . . . . . . . @ . @ . . @ . @ @ . @ . @ . . . . . . . @ 
@ @ @ . . @ . . . . @ . @ . . @ . . @ . @ @ . @ @ . @ @ . . . . @ . . . . . . @ . . . @ . @ @ @ . @ 
@ @ @ @ . @ @ . @ . . . . @ @ @ @ . . @ . . . . . @ . . @ . @ . . . @ . @ @ . . @ . @ @ . @ . @ . @ 
@ @ @ @ @ @ @ @ . . @ @ . . . @ @ @ . . @ @ . @ . @ @ . . . . @ . @ . . . @ . @ . . @ . . . . @ . @ 
@ @ @ @ . @ @ @ @ . @ @ . @ . @ . @ . @ . @ . . @ @ . @ @ . @ @ . . @ . @ . @ . . @ @ @ . @ . @ . @ 
@ . . . . . . . . . . . @ @ . @ . @ @ . . @ . @ . . . @ @ @ . . . @ . . @ . @ @ @ . . @ @ @ . . @ @ 
@ . @ . @ @ @ . @ @ . @ . . . . . . . . @ . @ @ . @ @ @ @ @ . @ . @ @ . . . . . . @ . . . . . @ . @ 
@ @ . . . . . @ . . @ . . @ . @ . @ @ . . . . . . . . @ @ . @ @ . @ . @ . @ . @ @ . @ . @ @ . @ . @ 
@ @ @ . @ @ . . . @ . . @ @ . . @ @ . . @ . @ . @ . @ . @ . . @ . . . . @ @ . @ @ . . @ @ . . . . @ 
@ @ @ . @ @ . @ . . @ @ . . . @ . . @ . . @ . . . @ @ . . . @ . . @ . @ . @ . . @ @ . @ . @ . @ @ @ 
@ @ . . . . @ @ @ @ @ @ @ . @ . . @ . . @ . @ @ . . . . @ @ @ @ @ @ . . . @ . @ @ @ . . . . @ . @ @ 
@ @ @ . @ . @ @ @ @ @ @ @ @ . . @ . @ . . . @ . . @ . @ . @ @ . . . @ . @ . . . . . . @ @ . . . . @ 
@ . . . . @ @ @ @ @ @ @ @ @ @ . . . . . @ . @ . @ . . . . . . . @ . . @ @ @ . @ . @ . @ . . @ . @ @ 
@ @ @ . @ @ @ @ @ @ @ @ @ @ @ @ . @ . @ . @ @ . . @ . @ . @ . @ . @ @ @ @ @ @ . . @ @ . @ . . @ . @ 
@ @ @ @ @ @ @ @ @ @ @ @ @ @ @ @ @ . . . . . . @ . @ . . @ . . . . . @ @ @ @ @ @ . @ . . . @ . . . @ 
@ @ @ @ @ @ @ @ @ @ @ @ @ @ @ @ @ @ . @ @ @ . . @ . . @ @ @ . @ . @ @ @ @ @ @ . . . . @ @ . . @ . @ 
@ @ @ @ @ @ @ @ @ @ @ @ @ @ @ @ @ @ @ @ @ @ . @ @ @ . @ . . . . @ @ @ @ @ @ @ . @ @ . . . @ @ @ @ @ 
@ @ @ @ @ @ @ @ @ @ @ @ @ @ @ @ @ @ @ @ @ @ @ @ @ @ @ @ @ @ @ @ @ @ @ @ @ @ @ @ @ @ @ @ @ @ @ @ @ @ 
3
25 41 23 2
39 43 43 28
16 29 28 21
