50 50
@ @ @ @ @ @ @ @ @ @ @ @ @ @ @ @ @ @ @ @ @ @ @ @ @ @ @ @ @ @ @ @ @ @ @ @ @ @ @ @ @ @ @ @ @ @ @ @ @ @ 
@ @ @ . @ @ @ . @ . @ . @ @ @ @ @ @ . . . . . . . @ . @ . . . @ . @ . . @ @ @ @ @ @ @ . . . . . @ @ 
@ . @ . . @ . . . . . . . . . . . . @ . @ @ . @ @ . . @ . @ . . . @ @ . . . @ @ . @ . . @ . @ @ . @ 
@ . @ . @ . @ . @ . @ . @ . @ @ @ @ . . . . @ . . @ . . . . @ . @ . . . @ @ @ @ . . @ . . @ . . . @ 
@ . . . . . . . . @ . . . @ @ . @ . . @ . @ . . @ @ @ . @ @ . @ @ . @ . @ . . . . @ . . @ @ @ . @ @ 
@ @ . @ . @ @ . @ . @ . @ @ . . @ . @ . . . @ . . @ . . . . . . @ @ @ . . @ . @ . . @ . . . @ . @ @ 
@ @ @ @ @ . . . . . . @ @ . @ . . @ . @ . @ . . @ . @ . @ @ . @ @ @ . @ . . @ . @ . @ . @ . @ . . @ 
@ @ . @ @ @ . @ @ @ @ @ . . . . @ @ . @ . . . @ . . . . @ @ . . @ . . . @ . . . . . . . . @ . . @ @ 
@ . . @ . . . . @ . . @ . @ @ . . . . . @ @ . . @ . @ . @ . . @ @ @ . @ . @ @ . @ . @ @ . . @ . @ @ 
@ @ . . @ . @ @ @ . @ . @ . . . @ @ . @ . @ . @ @ @ . . @ . @ @ @ @ . . . @ . @ . . . @ . @ @ . . @ 
@ @ @ . . . @ . . . . . . . @ . . @ . . . . . . @ . @ . . @ . @ @ @ . @ . . . . @ . @ . @ . @ . @ @ 
@ @ . @ @ . @ @ . @ . @ . @ . . @ . @ . @ @ @ . @ . . . @ . . . @ . @ . @ @ @ . . . . . . . . . @ @ 
@ . . @ . . @ @ @ . @ . . . @ . . . . @ @ @ . @ @ @ @ . . . @ @ @ . . . . . . . @ . @ . @ . @ . @ @ 
@ @ . . @ . . . . . . @ @ @ . . @ @ . . @ @ . @ @ . . . @ . . @ . @ @ @ @ @ @ . @ . @ . . @ . . . @ 
@ . @ . . . @ . @ . @ @ . . @ . . . @ . @ . . @ . @ @ . . @ . . . . . . . . . @ @ . . @ @ @ @ @ . @ 
@ . . @ @ . @ @ . @ . . @ . . . @ @ . . . @ . . . . @ . @ . @ . @ . @ @ . @ @ . . @ . . @ @ @ @ @ @ 
@ @ . . @ . . @ . . . @ @ . @ . @ @ @ . @ @ . @ . @ . . . . . @ @ @ @ . . @ . @ . . . @ . @ @ @ @ @ 
@ @ @ . . . @ . . @ . @ . . @ @ @ @ @ . @ . . . @ . @ . @ @ @ @ @ @ @ . @ . . @ . @ @ . . . . @ @ @ 
@ @ @ @ @ . @ @ . @ . @ @ . @ @ @ @ . @ . @ . @ . . . . . . . @ @ @ @ @ . @ . . . @ @ . @ @ @ . @ @ 
@ @ @ @ @ . . @ . . @ . @ . . @ @ . . . . . . . @ @ @ . @ @ . . @ . @ . . . @ @ . . @ . . . @ . . @ 
@ @ @ . . . @ @ . @ . . @ . @ . . @ . @ @ . @ . . . @ @ . . . @ . . . @ @ . . @ . @ @ . @ @ . . @ @ 
@ . . @ . @ @ . . . @ . . . . . @ @ @ . @ . . @ @ . . @ @ . @ . @ . @ @ . @ . . . . @ . @ @ . @ . @ 
@ @ . @ . @ . @ . @ . @ . @ @ @ @ . @ . @ @ @ @ . @ . @ . . . . . . . . . . @ @ . @ . . . . . . . @ 
@ @ . . . . . . . . . . . . . . . . . . @ @ @ @ . . . . @ . @ . @ . @ . @ @ . @ . . . @ . @ @ . @ @ 
@ @ @ . @ . @ . @ @ . @ . @ . @ . @ . @ . @ . . @ @ . @ . @ @ . @ . . @ . . . . . @ @ @ @ . . @ @ @ 
@ @ . . . @ @ @ . @ @ . . . @ @ @ . . . . . @ . @ . . @ . @ . . . @ @ . . @ @ . @ . . @ @ @ . . @ @ 
@ @ @ @ @ . @ @ . . . @ . @ @ @ @ . @ . @ . . . . @ . @ . @ @ . @ @ @ @ @ . . . . . @ . @ . . @ . @ 
@ . . . . . . . . @ . @ . @ @ @ . @ . . . @ . @ . . . @ . @ . . @ . @ @ @ @ @ . @ @ . . @ @ . . . @ 
@ @ @ @ . @ @ @ . @ . . @ . @ . . . . @ . . @ . @ @ . @ . @ @ . . . @ . @ @ @ . . @ . @ . . . @ @ @ 
@ . @ . @ . @ . . . @ . @ . . @ . @ . @ . @ @ . @ . . . . @ . @ . @ . . . @ . . @ . . . . @ @ @ @ @ 
@ . . . . . . . @ . . @ @ . @ @ @ . . @ . @ . . . @ . @ . @ . . . . . @ @ . @ . . . @ @ @ . @ @ @ @ 
@ @ . @ . @ @ @ . . @ @ @ . . . . @ . @ . @ @ @ . . @ . . . @ @ . @ . . . . . . @ . . . . . . @ @ @ 
@ . . @ . . . . @ . . @ . . @ . @ . . . @ . . . . @ . @ . @ . . @ . . @ . @ @ . @ @ . @ @ . @ @ @ @ 
@ . @ . @ @ . @ @ . @ . @ . . @ @ @ . @ @ @ . @ . . . . . . . @ . . @ . @ @ @ . . @ . . . @ @ @ @ @ 
@ . @ . . @ @ @ . . . . . . @ . @ . . . @ @ @ . @ @ . @ . @ . @ @ . . . . @ @ @ @ . . @ @ @ @ . @ @ 
@ @ . . @ . @ . @ . @ . @ . . . . @ . @ @ @ @ . . . @ . . . @ . . . @ . @ @ @ @ @ @ . @ . @ . . @ @ 
@ . @ . . . @ . @ @ @ @ . . @ . @ @ @ @ @ @ . . @ . @ @ . @ @ . @ . . @ @ @ @ @ @ @ @ . . . @ . . @ 
@ . . . @ @ . . . @ . . @ . . @ . . @ @ @ @ @ . . @ . . . . . @ . . @ . @ @ @ @ . . . @ @ . . . @ @ 
@ . @ . . . @ . @ . @ . . . @ . @ . . @ @ @ . . @ @ @ . @ . @ @ @ . . . @ @ @ @ @ @ . . . @ @ . @ @ 
@ @ @ . @ @ . . . . . @ @ . @ . @ . @ @ @ . @ . . . . @ . . . . . . @ @ . . @ . . @ @ . @ @ . . . @ 
@ @ . . . @ @ @ . @ . . . . . . . . . . . . . . @ . @ . . @ . @ @ . @ . @ . @ @ . . . . . . @ . @ @ 
@ . @ . @ @ . @ . . @ . @ @ . @ . @ . @ . @ @ . . @ . @ @ @ @ . . . . . . . . . . @ . @ . @ . . @ @ 
@ . . . . . . . . @ . @ @ . . @ . . @ . . @ . . @ . . @ . @ . @ @ . @ . @ . @ @ @ @ @ . . . @ . . @ 
@ @ . @ . @ . @ . . . @ . @ . . @ @ @ @ . @ @ . @ @ . . . . . @ . @ . @ @ @ . . . . . @ . @ . . @ @ 
@ @ . . @ @ @ . . @ . . . @ . @ @ @ @ @ @ . . . . . . @ @ @ . . . @ . @ @ . @ . @ @ . . . . . @ . @ 
@ @ @ @ . @ . @ . @ . @ . @ . @ @ @ @ @ @ @ . @ . @ . @ . . . @ . . . . . . . . . @ . @ . @ . . . @ 
@ @ @ . . . . . . . @ @ @ . . @ @ @ @ @ @ @ @ @ @ . @ . @ @ @ . @ @ @ @ . @ . @ @ . @ @ @ . . @ . @ 
@ @ @ @ . @ . @ . @ . . @ @ @ @ @ @ @ @ @ @ @ . . . . . . . . . . . . . . @ . . @ . . @ . @ . . @ @ 
@ @ @ @ . . @ . . . . @ @ @ @ @ @ @ @ @ @ @ @ @ . @ . @ @ @ . @ . @ . @ . . @ . . @ . . . . . @ @ @ 
@ @ @ @ @ @ @ @ @ @ @ @ @ @ @ @ @ @ @ @ @ @ @ @ @ @ @ @ @ @ @ @ @ @ @ @ @ @ @ @ @ @ @ @ @ @ @ @ @ @ 
3
34 12 42 28
2 9 10 7
35 42 8 5
