20 20
@ @ @ @ @ @ @ @ @ @ @ @ @ @ @ @ @ @ @ @ 
@ @ . @ @ . . . @ @ @ @ . . @ @ @ @ @ @ 
@ . . @ . . @ @ . @ @ . . @ . @ @ . @ @ 
@ . @ . @ . . . . . . @ . . . . . . . @ 
@ . . . . . @ . @ . @ . . @ . @ . @ @ @ 
@ . @ . @ . @ . . @ . @ . . @ . @ . @ @ 
@ @ @ @ . . . @ @ . . . . @ . . . . . @ 
@ . @ . @ . @ . @ . @ . @ . @ @ . @ @ @ 
@ . . . . . . . . . @ . . . . . . . . @ 
@ @ . @ . @ @ . @ @ . . @ @ . @ . @ . @ 
@ @ @ . . . @ . @ . @ . . . @ @ @ . . @ 
@ @ @ @ . @ . @ . . . . @ . @ @ @ @ . @ 
@ @ @ . . . . @ @ . @ . . @ @ @ @ @ . @ 
@ . . @ . @ . @ @ @ . @ @ @ @ @ @ @ @ @ 
@ @ . @ . @ @ . @ . . . @ @ @ @ @ @ @ @ 
@ . . . . . . . . @ @ . @ @ @ @ @ @ @ @ 
@ . @ @ . @ . @ . . . . . @ @ @ @ @ @ @ 
@ . . . @ . . @ . @ . @ . . @ @ @ @ @ @ 
@ . @ . . @ . . @ . . . @ . . @ @ @ @ @ 
@ @ @ @ @ @ @ @ @ @ @ @ @ @ @ @ @ @ @ @ 
3
12 9 17 3
7 9 17 12
11 13 12 3
