25 25
@ @ @ @ @ @ @ @ @ @ @ @ @ @ @ @ @ @ @ @ @ @ @ @ @ 
@ @ @ @ @ @ @ . @ . @ . . @ @ @ @ @ @ @ @ @ @ @ @ 
@ @ @ @ @ @ @ . . . @ . @ . . @ @ @ @ @ @ . @ @ @ 
@ @ @ @ @ @ @ . @ . @ . . . @ @ @ @ @ @ . . @ @ @ 
@ @ @ . @ @ . @ . . @ . @ . @ @ @ @ @ @ @ . . @ @ 
@ @ . . . . . @ @ . . @ . . . @ @ @ . . . . @ . @ 
@ @ @ . @ . @ . @ . @ . @ . @ . @ . @ @ @ . @ . @ 
@ . . . . @ @ . . . @ . . . . . . . . . . . . . @ 
@ @ @ . @ . @ . @ . @ . @ . @ . @ @ @ . @ . @ . @ 
@ . . . . . . . . @ . @ @ @ . . @ @ @ @ . . . @ @ 
@ @ . @ . @ @ . @ @ . . @ @ @ . . @ @ @ @ . @ @ @ 
@ . . . @ @ . @ . . . @ @ . . @ @ @ @ @ @ . . @ @ 
@ @ . @ . @ . . @ @ . @ . . @ @ . @ @ . @ . @ @ @ 
@ . . . . . . @ . . . . @ . . . . . . . . . . @ @ 
@ . @ @ . @ . . . @ . @ @ . @ @ . @ @ . @ . @ @ @ 
@ . @ @ @ @ . @ . @ . . @ . @ . . @ . . . @ @ @ @ 
@ . . . @ @ . . @ . @ @ @ . @ @ @ . @ . @ . @ @ @ 
@ @ . @ @ . . @ @ . @ . @ @ . . . . . . . . . . @ 
@ . . @ . @ . . @ . . . . . . @ . @ . @ @ @ @ @ @ 
@ @ @ . . . . @ . . @ . @ @ . . @ . @ @ . . . . @ 
@ . . @ @ @ . . @ @ @ @ . . . @ . . . @ . @ @ @ @ 
@ . @ . . @ @ . @ . @ . @ . @ . . @ . . . @ . . @ 
@ . @ . @ . . . . . . . . . . . @ . . @ . . . @ @ 
@ . . . . . @ . @ . @ . @ . @ @ @ @ . . @ @ . . @ 
@ @ @ @ @ @ @ @ @ @ @ @ @ @ @ @ @ @ @ @ @ @ @ @ @ 
3
23 4 2 11
6 11 18 9
9 15 15 8
