20 20
@ @ @ @ @ @ @ @ @ @ @ @ @ @ @ @ @ @ @ @ 
@ . @ @ @ @ . . . . . @ . @ @ @ @ @ @ @ 
@ . @ @ @ . . @ . @ . . . . @ @ @ @ @ @ 
@ . . @ . . @ . . . @ . @ @ . @ @ @ @ @ 
@ . @ . @ . . @ @ . @ @ @ @ . . @ . @ @ 
@ . . . . . @ . . @ . . . . . @ . . . @ 
@ @ @ . @ . . @ . . @ . @ . @ . @ . @ @ 
@ @ @ @ . @ . . @ . @ . . @ . . . . . @ 
@ @ @ . . . . @ . . . . @ @ . @ @ . @ @ 
@ @ . @ @ . @ . @ . @ . . . @ . . . . @ 
@ . . . . . . . . @ @ . @ @ . @ @ . @ @ 
@ . @ . @ . @ . @ . . . . @ . . . . . @ 
@ . @ @ . . . @ @ @ @ . @ . . @ @ @ @ @ 
@ @ @ . @ . @ . @ . @ . @ . @ . @ @ . @ 
@ . . . . . . . . . . . . . . . . . . @ 
@ . @ . @ . @ . @ . @ @ . @ . @ @ . @ @ 
@ . . @ . . . @ . . . @ . . @ @ @ . . @ 
@ . @ @ @ . @ @ @ . @ @ @ . . . . @ . @ 
@ @ . . . . . @ @ @ @ @ @ @ . @ . . @ @ 
@ @ @ @ @ @ @ @ @ @ @ @ @ @ @ @ @ @ @ @ 
3
13 15 2 10
5 16 12 14
4 3 8 11
