25 25
@ @ @ @ @ @ @ @ @ @ @ @ @ @ @ @ @ @ @ @ @ @ @ @ @ 
@ @ @ . @ . . @ . @ . @ . . . @ . @ @ @ @ @ @ @ @ 
@ . . . . . @ . . . . . . @ @ @ . . @ @ @ @ @ @ @ 
@ . @ . @ . @ @ @ @ @ @ . @ @ @ . @ . @ @ @ @ @ @ 
@ @ @ @ . . . . . . . . . . . . . . . . @ . . @ @ 
@ @ @ . . @ . @ . @ . @ . @ . @ @ . @ @ . . @ . @ 
@ . . . @ . @ @ @ . . . @ . . . @ . @ . @ . . . @ 
@ @ @ . . . . @ . . @ . @ @ . @ . . @ . @ . @ @ @ 
@ . . . @ @ @ . @ . @ . @ . . @ @ . . . . . . . @ 
@ . @ . . @ . . @ . @ . . @ . @ @ . @ . @ @ . @ @ 
@ . . @ . @ . @ @ @ . . @ . . . . @ . . . . @ @ @ 
@ . @ . . . . @ @ @ @ . . @ . @ . @ @ . @ . . . @ 
@ . . @ . @ . @ @ @ . @ @ . . . @ @ @ @ @ @ . @ @ 
@ . @ . @ @ @ @ . . . . . . @ . @ @ @ . @ @ @ @ @ 
@ . . . . @ . . . @ @ . @ . @ . . . . . . @ @ @ @ 
@ . @ . @ . @ @ . @ . @ . . @ . @ . @ . @ @ @ @ @ 
@ . . @ . . . . . @ . @ @ . @ . . @ . . @ @ . . @ 
@ . @ @ @ @ @ . @ . . . . . @ . @ . . @ @ @ . @ @ 
@ . . @ @ . @ @ . . @ . @ . @ . . @ @ @ @ . . . @ 
@ @ . . @ . @ . @ . @ . @ @ . . @ . . @ . . @ @ @ 
@ @ @ @ . . . . . . @ . . @ @ . . . @ @ @ . . . @ 
@ @ . @ @ . @ . @ . @ @ @ . . . @ @ @ . . . @ @ @ 
@ . . . . . @ @ @ @ . . . . @ . . . . @ . @ @ @ @ 
@ . @ . @ . . @ @ @ @ @ @ . . @ . @ . . . . @ @ @ 
@ @ @ @ @ @ @ @ @ @ @ @ @ @ @ @ @ @ @ @ @ @ @ @ @ 
3
11 23 11 16
18 21 5 14
1 6 2 9
