100 100
@ @ @ @ @ @ @ @ @ @ @ @ @ @ @ @ @ @ @ @ @ @ @ @ @ @ @ @ @ @ @ @ @ @ @ @ @ @ @ @ @ @ @ @ @ @ @ @ @ @ @ @ @ @ @ @ @ @ @ @ @ @ @ @ @ @ @ @ @ @ @ @ @ @ @ @ @ @ @ @ @ @ @ @ @ @ @ @ @ @ @ @ @ @ @ @ @ @ @ @ 
@ . . @ . @ . @ . . @ . . @ . . . . . . . @ . . . . @ @ @ . @ . @ . . . . @ @ . . . . @ . @ . @ . . . . . . @ @ @ @ . . . @ @ @ . @ @ @ . @ @ @ @ . @ @ . @ @ @ @ . . . @ @ . . @ . . . @ . . . . . @ @ 
@ . @ . . @ . . . @ . @ . @ . @ . @ @ @ @ @ @ . @ . . @ . . @ . . . @ . @ . . @ . @ @ . . . . . @ . @ . @ @ . . @ . @ @ . . @ . . . @ . . . @ @ . . . . . . @ @ @ @ . @ @ . . @ @ @ . @ . . @ . @ @ . @ 
@ . @ . @ . @ @ . . . . . . . . @ @ . @ @ @ . . @ @ @ . @ . @ . @ @ . . . . @ . . @ . @ @ . @ . . @ . . . . @ . . . @ @ . @ @ @ . @ @ @ . @ . . @ . @ . @ . . . @ . . . . . @ . . . . @ @ . . @ . @ . @ 
@ . @ . @ . . . @ @ . @ @ . @ @ . @ . . @ . @ . . @ . . @ . . @ . . @ . @ @ @ @ . @ . . . @ . . @ @ . @ @ . @ . @ . @ . . . @ . . . @ . . @ @ . . . . @ . . @ . . @ . @ . @ @ @ . @ . @ . . @ . . . . @ 
@ . . . . . @ @ . . . . @ . . . . . @ . . . . . @ . @ . @ . @ . @ . @ . . . @ @ . @ . @ . @ @ . . @ @ @ @ . . . . @ . @ . @ . @ . @ @ . @ . . @ @ . @ @ @ . . @ . . . @ @ @ @ @ @ . . @ @ . @ . @ . @ @ 
@ @ @ . @ @ @ . @ @ . @ . . @ @ . @ . . @ @ . @ . . . . . . . . . . . . @ @ @ . . @ . . @ . @ . @ . . @ . @ . @ . . . . . . . . . . . . . . @ . . . . @ . . @ . @ @ . @ . @ @ @ . @ . @ . . . . . @ @ @ 
@ . . . . @ . . . @ . . @ . . . @ @ @ . . . @ @ @ . @ . @ . @ . @ . @ . . @ @ @ . . . @ . . . . . @ . . . @ . . @ . @ . @ @ . @ . @ @ . @ . @ . @ @ . . @ @ . . . @ . . . . @ @ . . . @ @ . @ @ @ @ @ @ 
@ . @ . @ . @ @ . . @ @ . . @ . . @ . . @ @ . . . @ . . . @ . . . @ . @ . . @ @ @ . @ . @ . @ @ . . @ @ . @ . @ . . . @ . . @ . @ @ @ . . @ . . @ . . @ . @ . @ . . @ @ @ @ . . @ @ . @ . . @ @ @ @ @ @ 
@ @ . . . . @ . . @ . . . @ . . @ . @ . @ @ . @ . . @ . @ . @ . @ . . . . @ . . . . . . @ @ . . . @ @ @ . @ . @ @ . @ @ @ . . . . @ . @ . @ @ . . @ . . . @ . . @ . . @ @ @ . @ . @ . . @ . @ @ @ @ @ @ 
@ @ @ . @ . . @ . . . @ . . @ . . . . . . . . @ . @ @ @ . . . . . @ . @ . . . @ @ @ . @ . . @ @ . @ . . . @ . . . @ @ . . . @ . @ . . @ @ . @ @ @ . . @ @ . @ . @ @ . . @ @ . . . @ . @ . . . @ @ @ @ @ 
@ . . . @ @ . @ @ . @ . @ @ . . @ . @ @ . @ @ @ @ @ @ @ @ . @ . @ @ @ . @ @ . . @ . @ . @ . . @ . @ @ . @ . . @ . . . @ . @ . @ . . @ . . . . @ @ @ . @ . . . . . . @ . . . . @ @ @ . @ . @ . @ @ @ @ @ 
@ . @ . @ . . . . . . . . @ @ . . @ @ . @ . . . . @ . @ @ @ . . @ @ @ . @ . . @ . . . . . @ . . . @ . . @ @ . . @ @ . . . @ . . @ . @ . @ . @ @ @ . . . @ @ . @ . @ . . @ @ . . . @ . . @ . . . @ @ @ @ 
@ @ . @ @ . @ . @ @ @ @ . . @ . @ . . . . @ @ . @ . . . @ . @ . @ @ . . . @ . . @ @ . @ . . @ @ . . . @ @ @ . @ @ . @ @ @ . . @ . . . @ . . . @ . @ @ . . . @ . . . @ . . @ @ . @ @ . @ . @ @ . . @ . @ 
@ @ . . @ . . @ . . . . @ . @ @ . . @ . @ @ @ . . . @ @ @ . . . @ . @ . @ . @ . @ . @ . @ . @ . @ @ . @ @ . . @ @ . . . @ @ . . @ . @ . @ . @ . . @ . @ . @ . @ . @ @ @ @ @ @ @ . . . . . . @ . @ . . @ 
@ . . @ . @ @ . . @ . @ . . . . @ . @ . . @ . @ . @ @ . . @ @ @ @ . . . . . . . . . . . . . . . . . . . . @ . @ @ . @ @ . @ . @ . . . . . . . @ . . . . . . . @ . . . . . @ @ @ @ . @ . @ . . . @ @ . @ 
@ @ . . . . . . @ . . . . @ @ . @ @ . . @ . . . . . @ @ . . @ @ @ . @ . @ . @ . @ . @ . @ . @ . @ . @ . @ @ . . . . . . . @ . . . @ . @ @ @ . @ . @ . @ . @ . @ . @ @ . @ @ @ . . @ @ @ . @ . @ . . . @ 
@ @ . @ . @ . @ @ @ . @ @ @ @ . . . @ . . @ . @ . @ . . . @ . . @ . . @ . @ . @ . . . @ . . @ @ . @ . . . @ . @ . @ . @ @ . @ . @ @ @ @ @ . @ @ @ . . . @ . . @ . . @ @ @ @ . . @ . @ . . . . . . @ . @ 
@ @ @ . @ @ @ . @ . @ @ . @ . @ . @ . . @ . @ . . . @ . @ . . @ . @ @ . . . . . @ . @ @ @ @ . . . . @ . @ . . . @ . @ @ @ . @ . . @ @ @ . . . @ @ . @ @ @ @ . . . @ . . @ . @ . . . . @ . @ . @ . @ . @ 
@ @ . . . @ . . . . . . . . . . . . @ . @ . . @ . @ . . . . @ . . @ . . @ . @ . @ . . @ @ . @ @ @ . @ . . @ @ . . . . . @ . @ . @ . @ @ @ . @ . @ . @ @ @ . @ . @ @ @ . . . @ . @ @ @ . @ @ @ . . . @ @ 
@ . @ . @ @ @ . @ . @ . @ @ . @ @ . . . . @ . . . @ . @ . @ @ @ . @ @ @ . @ . . @ . @ @ . . . @ . . . . @ . . . @ @ @ . . . . . . . . @ . . . . . @ @ @ @ . . . . @ . . @ @ . . . . . . . @ . @ . @ . @ 
@ . @ . . @ @ @ . . @ @ . @ @ . . @ @ @ . @ . @ . . . . @ @ @ . . . . @ . . @ . @ . @ . @ . @ . @ . @ . @ . @ . . @ . @ . @ . @ @ @ @ . @ . @ . @ @ . @ . . @ . @ @ @ . . @ . @ . @ @ . @ . . . . . . @ 
@ . . @ . . @ @ @ . @ . . . . @ . . @ . . . @ . . @ @ @ @ . . @ . @ @ . . @ . . @ @ . . . . . . @ . @ . . @ . . @ @ . @ @ . . @ . @ . . . . . @ @ . . . @ . @ . . . . . @ @ . . @ . . . . . @ . @ . @ @ 
@ @ . . . @ . @ @ @ . . @ @ @ . @ . . @ . @ @ . @ @ . . . @ . . . . . . @ . @ . @ . @ . @ . @ . . @ . . @ . . @ @ . . . @ @ . . . @ @ . @ . @ @ @ @ . @ . . . @ . @ . @ . . . @ . . @ . @ . . @ . . . @ 
@ @ @ @ . . . . @ . . @ . . . . . . @ . . @ . . . . . @ . . @ @ @ . @ . . . . . . . . . . @ . . @ @ @ . . . @ . . @ . @ @ . @ . @ . . @ . . . @ . . . . @ . @ . . @ @ . @ . @ @ @ @ . . . @ . . @ . @ @ 
@ @ @ @ @ . @ . . . @ @ @ @ @ . @ . @ . @ . @ . @ . @ . @ . @ . @ @ @ @ . @ @ . @ . @ . @ @ @ . @ @ . @ @ . @ @ . . . . . . . @ . . @ . @ . @ . . @ . @ . . . @ @ @ . . @ . . @ @ @ . @ @ . . @ . @ . @ 
@ @ @ @ @ @ @ @ @ . @ @ @ . . @ . . . . . . . @ @ @ . . . . @ . @ . . . . @ @ . @ . . @ . @ . . . . . . . . . . . @ . @ . @ . . @ . . . . . . @ @ . . . @ . @ @ @ @ @ . . . @ @ @ . . . @ @ . . . . . @ 
@ @ @ @ @ @ . . . . @ @ @ @ . . . @ . @ . @ . . @ . @ . @ . @ . @ @ @ @ . . . @ . . @ . . . @ . @ @ . @ . @ . @ . . @ . . . @ @ . . @ . @ . @ . . @ . @ @ . . . . . @ @ . @ . @ . @ . @ . . . @ . @ @ @ 
@ @ @ @ @ @ @ @ @ . . @ . . @ @ . . @ . @ . . @ . . . @ @ . @ . . @ @ . . @ . . @ @ . @ . @ @ @ . @ @ . . . @ . @ . . @ . @ @ @ . @ @ . @ . . @ . @ . @ . . @ . @ . @ . . . . . . @ . @ @ @ . . @ . @ @ 
@ @ @ @ @ @ @ . . @ . . @ . @ @ . @ . . . @ . . @ . @ @ . . @ . @ @ @ @ . @ . @ . . . . . . @ @ . . . @ . @ . . . . @ . @ @ @ . @ @ . @ . . @ @ . . . . @ . @ . . @ @ @ . @ @ . @ @ . . . @ . @ . . @ @ 
@ @ @ @ @ @ . . @ . @ . @ . @ . @ @ . @ . . @ . . . @ . @ . @ . . @ @ @ @ . @ . @ . @ @ @ @ . @ @ . @ @ @ . @ . @ . . . . . . . . @ . . . @ . @ . @ . @ . . @ @ . . @ @ @ . . . . . @ . @ . . @ @ . @ @ 
@ @ @ @ @ . @ . @ . . . . . . . . @ @ @ @ . . @ @ . . . . . @ . @ @ @ @ @ . . . . . @ . . . . . . . @ @ . . @ @ . . @ @ . @ . @ @ . . @ . @ . . @ . . . @ . . @ . @ @ @ . @ @ @ . @ . @ @ @ . . . . . @ 
@ @ @ @ @ . . . . . @ . @ . @ . @ . @ . . @ . @ @ . @ @ @ . . . @ @ @ @ . . @ . @ @ . @ . @ . @ . @ @ . . @ . . @ . . @ . . @ @ @ @ @ . . @ . @ . @ . @ @ . @ @ @ @ @ . . @ . . . @ . . @ @ @ . @ . @ @ 
@ @ @ @ @ @ @ . @ . @ @ . . @ . . . . . @ . . . . @ . . . @ . @ @ @ @ @ @ . . @ @ @ . . . . @ . @ @ . @ . @ . @ . . @ . @ @ @ @ @ @ . @ . @ . . . . . . @ . . @ . @ . @ . . @ @ . . . @ . . @ . . @ . @ 
@ @ @ @ @ . . . @ @ . . . @ . @ @ @ @ . . @ @ @ . . . @ @ . . . @ . @ @ @ . @ . @ . . @ @ . . . @ @ . . . . . . @ . . . . . . . @ . . . . @ . @ @ @ . @ . . @ . . . . . @ . @ . @ . @ . @ . . @ @ @ . @ 
@ @ @ @ @ @ . @ @ @ @ . @ . . . @ . . @ . . . @ @ . @ @ . @ . @ . . . @ . . . . . . @ . . . @ . . @ @ @ @ @ @ . . . @ @ . @ @ @ . @ @ @ . @ . . @ @ @ . @ . . @ @ . @ . . . . . . . . . . . @ @ @ @ . @ 
@ @ @ @ @ @ @ @ @ @ @ @ . @ . @ @ . @ . @ @ . @ . . . . . . . . . @ . . . @ . @ . @ @ . @ . . @ . @ . . . . . . @ . @ . @ . . @ . . @ . . . @ . . @ . . . . @ @ @ @ . @ @ . @ @ @ . @ @ @ . @ @ @ . . @ 
@ @ @ @ @ @ @ @ @ @ @ . . . . . . . . . . . . . . @ . @ . @ @ . @ . @ @ . . @ @ . . . @ . . @ @ @ @ @ . @ . @ @ . . . . . @ . . @ . @ @ . @ . . @ @ @ @ @ . . @ @ @ . . . @ . @ . . @ @ @ . . @ . . @ @ 
@ @ @ @ @ @ @ @ @ @ @ @ . @ . @ . @ @ . @ @ . @ . @ @ @ . . . @ @ . @ . . @ . . @ . @ . . @ . @ . @ . @ . . . @ . @ @ . @ @ @ . @ . @ . . . . @ @ @ . . . . @ @ @ . . @ . @ . . @ @ @ @ @ . @ @ @ . . @ 
@ @ @ @ @ @ @ @ @ @ @ @ @ . . @ . @ . @ . . . . @ . @ . @ . @ @ . . . @ . . . @ @ @ @ @ . @ . . . . . @ . @ . @ @ . @ . . @ . . @ . . @ @ @ . . @ . @ . @ @ . @ @ @ . . @ . . @ @ @ @ @ . . @ @ . @ . @ 
@ @ @ @ @ @ @ @ @ @ @ @ . @ . @ @ . . . . @ . @ @ . . . @ . . @ . @ . @ . @ @ @ @ . @ . @ . @ @ . @ . @ . @ . @ . . . . @ . @ . . . @ . . @ . @ . . . . . . . . @ . . @ . @ . . @ . @ . @ . . @ . . . @ 
@ @ @ @ @ @ @ @ @ . @ . . . @ . . . @ @ @ . . @ . . @ . @ . @ @ . @ . @ . @ @ @ . . . . . . . . . . @ . . @ @ . @ . @ . . . . @ . @ @ @ . . . . . @ @ . @ @ @ . @ . @ . . @ . @ . . . . . . @ . @ @ . @ 
@ @ @ @ @ @ @ @ . . . . @ . @ . @ . @ @ @ . @ . @ . . @ . @ . . @ . . . . @ @ @ @ . @ . @ . @ . @ @ . @ @ . . . @ @ . . @ @ . . . . @ . . @ @ . @ . . . @ . . @ . . . @ . . . . . @ . @ . @ . . . . . @ 
@ @ @ @ @ @ @ @ @ @ @ . @ . @ @ . . . . . @ . . . . @ . . . @ . . @ . @ . @ @ . . @ @ @ @ @ . . @ . . . . @ @ . @ @ @ . . @ . @ . @ . @ . . @ @ . @ . @ . @ . . @ . @ . . @ . @ @ @ . . @ . . @ . @ . @ 
@ @ @ @ @ @ @ @ @ @ @ @ . . . . @ . @ @ @ @ . @ @ . @ . @ . . @ . @ . @ . . . @ . @ @ @ @ @ @ . . . @ . @ . . . . @ . . @ . @ @ @ @ . . . @ @ . . @ . @ . . . @ @ . . @ . . @ @ @ . . @ @ @ . . @ @ @ @ 
@ @ @ @ @ @ @ @ @ @ @ @ . @ @ @ . . @ @ @ @ @ . . . . @ . @ . . . . @ . @ . @ . . . @ @ . @ . @ . @ . @ . @ @ . @ . @ . . . @ . @ . @ @ . @ @ . @ . @ . . @ @ . @ . @ . . @ . @ . . @ @ @ @ . @ . @ @ @ 
@ @ @ @ @ @ @ @ @ @ @ @ . . @ . @ . @ @ @ @ . @ . @ . . . . . @ @ . . . . . . @ . @ . . . . . . . . . . . . @ . . . . . @ @ . . . . . @ . @ . . . . . @ . @ @ . @ . . @ . . . . @ @ @ @ @ @ . @ . . @ @ 
@ @ @ @ @ @ @ @ @ @ @ . . @ . . @ . @ @ @ . . . . . @ @ @ @ . @ @ @ . @ . @ . . . . . @ @ . @ . @ @ . @ . @ . @ @ . @ . . @ . @ . @ . @ . . . @ . @ . . . @ . . @ @ . @ @ . @ @ . . @ @ @ . . . . @ @ @ 
@ @ @ @ @ @ @ @ @ @ . . @ @ @ . . @ @ @ . . @ @ . @ . . @ . @ . . . . . @ . . @ . @ . . . @ . . @ . @ . . . . . @ @ @ . @ . . . @ @ @ . . @ . @ @ @ . @ . . @ . @ . . . @ . . @ . @ . @ . @ . @ @ . . @ 
@ @ @ @ @ @ @ @ @ . @ . @ @ @ . @ . @ . @ @ . @ @ . . @ . . . @ @ @ @ @ . . @ . . @ . @ . . @ . . . @ @ @ . @ . . . @ . . @ . @ @ . . . @ . . . @ . @ . . @ . . . @ . @ @ . @ . . . . . . . . . . . @ @ 
@ @ @ @ @ @ @ @ . . . . . . . . . . @ . @ . . . . . @ . @ . @ . . . . . . @ . . @ @ . . @ @ . . @ @ . @ @ . @ . @ @ . . @ . . . @ @ @ . . @ . @ . . @ @ . . @ @ . . . @ . . . . @ . @ . @ . @ . @ @ @ @ 
@ @ @ @ @ @ @ . @ . @ . @ . @ . @ . . . @ @ @ . @ . . . . . . . @ @ . @ @ . . @ . . . @ @ . @ . . . . . @ @ . . . . @ . . . @ . @ . @ . @ @ @ . @ . @ . . @ . . @ . @ . . @ . @ . . . @ @ @ . . . . @ @ 
@ @ @ @ @ @ . . @ . @ @ . . . @ . @ @ . . @ . . . @ . @ @ @ . @ . . . @ . @ . . @ . @ . . . . . @ . @ @ . @ @ . @ . @ . @ @ @ @ . . . @ @ @ . . . . . @ . . . @ . . @ . @ . . @ @ . @ @ @ @ @ . @ . . @ 
@ @ @ @ @ . @ . @ . @ @ @ . @ . . . . @ . . @ . @ . @ . . . . . @ . @ . . . . @ @ @ . @ @ . @ . . @ . . . . . . . @ . . @ @ @ . @ @ . @ . @ @ . @ . @ . . @ @ @ @ . @ . . @ . . . @ @ . @ @ @ . @ . @ @ 
@ @ @ @ . . . . . @ . @ . @ . @ . @ . @ . @ @ @ . . . @ . @ @ . . @ . . @ @ . . @ . . . @ @ . . @ . @ . @ . @ . @ . @ . @ @ . . @ . . . . . @ @ . . . . @ . . @ . . @ . @ @ @ @ @ . . . . . . . @ @ . @ 
@ @ @ . @ @ @ . @ . . . . . . . . . @ . . @ @ . @ . @ . . @ . . @ @ . @ . . . @ . @ . @ . @ @ . . . @ . . @ . . . . . . @ . @ . . @ . @ . @ . . . @ . @ @ @ . . @ . @ . . @ . @ . @ . @ . @ @ . @ @ . @ 
@ . . . @ . @ . @ . @ . @ . @ @ . @ . @ . @ . . . . . . @ . @ . @ . @ @ @ . @ . . . . . . . . . @ @ . . @ @ @ . @ @ @ . . . . @ . @ . @ . . . @ . . @ @ . @ @ . . . . . @ . . . . . @ . . @ . @ @ . . @ 
@ . @ . . . . . . @ . @ . @ . @ . . . . . . . @ . @ . @ . . . . . . . @ . . . @ . @ . @ . @ @ . . . @ . . @ . . . . . @ . @ . . . . @ . @ . @ . @ . @ . . . . @ @ @ . @ . . @ . @ @ . @ @ . . @ . @ . @ 
@ . . @ @ @ . @ . . . . . . . . . @ @ . @ @ . . @ . . . @ . @ . @ . @ @ @ . @ @ @ . . . @ . . . @ . . @ @ . @ . @ @ . . @ . @ @ . @ . . . . . . . @ . @ . @ @ . @ . . . . @ . @ . . . . . @ . . . . . @ 
@ . @ . . . @ . @ . @ @ . @ . @ . @ . . . @ @ . . @ . @ . @ . . . @ @ @ @ @ . @ . @ . @ @ @ @ . . @ @ . @ . @ @ @ . @ @ . . . @ . . @ @ @ . @ . @ . . . . . @ . . . @ @ @ . . . . @ @ . @ @ . @ . @ . @ 
@ @ @ @ @ . @ . @ @ . . . @ @ . . . @ . @ . . . @ . . . . . @ . @ @ @ @ @ . . . . @ @ . @ . @ . @ . . . . . . @ . . . . @ . @ . @ . . . . . . @ . @ . @ . @ . . @ @ . . @ . @ @ . @ . . @ . . . @ @ @ @ 
@ . @ . . . . . . . . @ . @ . @ . @ @ @ . . @ . @ @ . @ . @ @ @ @ @ @ @ @ @ @ @ . . @ . . . . . @ . @ . @ . @ @ @ . @ . . . @ . . @ . @ @ . @ @ . . . @ . @ . @ . @ . @ . . @ . . @ @ . . @ . @ @ @ @ @ 
@ . . . @ . @ . @ . @ . . @ . . . . @ . @ @ . . @ . . . @ . @ . @ @ @ @ @ . . . @ . . . @ . @ . . @ . . @ . @ @ . @ . @ @ . . @ . @ @ @ @ . . . @ @ . . @ @ . . . . . @ @ . @ . @ . . . @ . . . @ @ @ @ 
@ @ @ @ . . @ @ @ @ . . @ @ . @ . @ @ . @ . @ . . @ . @ @ . . . @ @ @ @ . . @ . . . @ . @ @ . . @ @ @ @ . . . @ . @ . . . @ . . . @ . . . . @ . @ . . @ @ . . @ . @ @ . @ . @ @ . @ @ . @ . @ @ @ @ @ @ 
@ @ . . . @ . . @ . @ . . . @ . . . @ . . . . . @ @ @ @ @ . @ @ @ @ @ @ @ . . @ . @ . . @ . . @ @ @ . @ @ @ . . . . @ @ . . @ @ . . @ @ @ . . @ . @ . . @ @ . . @ . . . . . . . . . @ . @ . . . . . . @ 
@ @ . @ . . @ . . . . . @ . . @ . @ @ . @ @ . @ . @ @ @ . . . . @ @ @ @ @ @ @ @ . @ @ . . @ @ @ @ . . . @ . . @ @ . @ . @ . @ . @ . @ . @ . @ . . @ . @ . @ . @ . @ @ . @ @ . @ . @ . . . . @ @ @ . @ @ 
@ @ @ . . @ . @ @ . @ . @ @ @ . . . @ @ @ @ @ . . . @ . . @ . @ . @ @ @ @ . . . . @ @ . @ . @ @ . @ . @ @ @ @ . @ . . . . . . . . . . . . . . @ . . . . . . . . . . . . . @ @ @ . . @ . @ . . . . @ . @ 
@ @ . @ @ @ . @ . @ . . @ . @ @ . @ @ . @ . @ . @ @ @ @ . . @ . . . @ @ @ . @ . @ . . . . . . . . . . . @ . . . . . @ . @ @ . @ . @ . @ . @ . . . @ @ . @ . @ . @ @ @ @ @ @ @ @ . @ . @ . . @ . @ @ . @ 
@ . . . . . . . . . . @ . . . . . . . . . . . . . . @ . . @ @ @ . @ . @ @ @ . . @ @ . @ @ @ @ . @ . @ @ @ @ . @ . @ . . . . @ . @ @ . . @ . @ @ . . @ . . @ @ @ . . . . . . @ . @ . . . @ . @ . . . . @ 
@ @ @ . @ . @ @ . @ . @ . @ @ . @ . @ @ @ . @ . @ . . @ . . @ . . . . . . . @ @ . . . . @ @ @ . @ @ @ @ @ @ . . @ @ @ . @ . @ . . . @ @ . . . . . @ . @ @ @ @ . . @ . @ . @ @ . . @ . @ . @ @ @ . @ . @ 
@ @ @ @ @ @ . . . . @ @ @ @ @ . @ . . . @ . . @ . . @ . . @ . @ . @ @ @ @ . @ @ @ . @ . @ . @ . @ . @ @ @ @ . @ @ . @ @ . @ . @ @ . @ . @ . @ @ . . . . @ . . @ . @ @ @ @ . . . @ . . @ . . @ . . . @ @ 
@ @ @ @ @ @ @ @ . @ @ @ . . . . @ . @ . . @ @ . @ . . @ . . . . . . . @ . @ . @ @ @ @ @ . . . . . . . . . @ . @ . . . . . . . . . . . . . . @ @ @ . @ . . @ . @ . . @ . . . @ @ . @ . . . @ . @ . @ @ @ 
@ @ @ @ @ . . . . . @ @ @ . @ . @ . . @ . . . . . @ . . . @ . @ . @ . . . . . @ @ . @ @ @ . @ @ . @ . @ . @ @ . . @ @ . @ . @ . @ . @ . @ . . @ . . . @ . . . . . @ . @ . @ . @ . @ . @ @ . . . @ @ @ @ 
@ @ @ @ @ @ . @ . @ @ @ @ @ . . @ . @ . . @ @ . @ . . @ . @ @ . @ . . @ . @ . . . . @ @ @ . @ . . . @ @ . @ . @ . @ . @ . . . @ . . @ . @ @ . . @ . @ @ . @ . @ . . . . . . . . . . . . . . @ @ . @ @ @ 
@ @ . . @ . @ . . . . @ @ . @ . . @ @ @ . . . @ . . @ @ . . . . @ @ . . @ @ . @ . @ . @ @ . @ . @ @ @ . . @ . @ @ . . . . @ @ . @ . @ . @ . . @ @ @ . . . . @ . . @ . @ . @ @ . @ . @ . @ . . . . . . @ 
@ @ @ . @ . . @ . @ @ . . . . @ . @ @ . @ . @ . @ @ . @ . @ . @ . @ @ . @ . @ @ . . . . . @ @ . . . . @ . . . . @ @ . @ . . . . . @ @ @ @ @ . @ @ . . @ . @ . @ @ . . @ . @ @ . . @ . @ @ . @ . @ . @ @ 
@ @ . . . . @ . . . . @ . @ . . . @ . . @ . . . . . . . @ @ @ . . . @ . . . @ @ @ . @ . @ @ . @ @ @ @ @ . @ . @ . . @ . . @ . @ . @ @ . @ . . @ @ @ . @ . @ . . @ @ . @ . . . @ . . . . . @ . . @ . . @ 
@ @ @ . @ . @ @ . @ . . @ @ @ @ . . @ . . @ . @ . @ . @ . @ . @ . @ . @ @ @ @ . . . . @ @ . . . . . @ @ @ @ . . . @ @ @ . . @ @ @ . . . . @ . . @ . @ . . @ . @ . @ @ . @ . @ . . @ @ . @ . @ . . @ . @ 
@ @ . @ . . . @ . . @ . . @ . . . @ . . @ . . . @ . . . . . . . . . . . . . . @ . @ @ @ . @ . @ . @ . @ . @ . @ . . @ . . @ @ @ @ @ @ . @ . @ . . . @ @ . . . . . . . . . @ . @ . . . @ . . @ . @ @ . @ 
@ @ . @ . @ . . . @ . . @ . . @ . . @ . . @ . @ @ @ . @ . @ @ . @ . @ . @ @ . @ @ . . . . . . . @ . . . . . . . @ . . @ . . @ . @ . . . . . . . @ @ . @ . @ . @ . @ . @ . . . . @ . @ . @ . @ . . . @ @ 
@ . . . @ @ . @ . @ @ @ . . @ . . @ @ . @ . @ . @ . . @ . . @ . @ . @ . . . @ @ . @ . @ . @ . @ . @ @ . @ @ . @ @ . @ . . @ . . @ @ @ . @ @ @ . @ @ . @ . . @ . @ . . @ . @ . @ @ . . . . . . @ . @ @ @ 
@ @ . @ . . . @ . . . . @ . @ @ . . . . . . . . . @ . . @ . . @ . . . @ . @ @ . . @ . @ @ @ @ . . . @ . @ . . . . @ @ @ . . . @ . . @ . . @ . @ . . . . . @ . . . @ . . @ @ @ @ . . @ . @ . @ @ . @ . @ 
@ . . . . @ @ . . @ . @ . @ . . . @ @ . @ . @ . @ . . @ . . @ @ @ . @ . . @ . @ . @ . @ @ @ @ @ . @ . . . @ . @ . . @ . . @ . . @ . . . @ @ . . . @ . @ . . @ . @ . . @ @ . @ . @ . . @ @ . . . @ @ . @ 
@ @ . @ . @ . @ . . @ . . . @ @ . . @ @ . . . @ @ @ . @ @ . . . . @ . . @ . . . . . . @ @ . . . . . @ . @ @ @ . . @ @ @ . . @ . @ . @ . @ @ @ @ . . @ @ @ . @ . @ @ . . . . . . . @ . . . @ . @ . . . @ 
@ @ @ . . @ . @ . @ . . @ . . . . @ . @ @ . @ . @ @ . . . @ @ . @ . @ @ @ @ @ . @ . @ . @ @ . @ . @ . @ @ @ . @ . . @ @ . @ . @ . @ @ @ . . . . . @ . @ . . . . . . @ . @ . @ . @ . @ . @ . @ . . @ @ @ 
@ @ @ @ @ . . . . @ @ . . @ . @ . . . @ @ . . . . . @ . @ . @ . . . . . @ . @ @ . . . . @ @ @ . . . . . @ . . . @ @ . . @ . . . . . . . . @ . @ . . . @ @ . @ . @ . . @ . . . @ . . @ . @ . . @ . . @ @ 
@ @ @ @ . @ . @ . . @ . @ @ @ . . @ . @ @ @ @ @ @ @ . . . . . @ @ @ @ . @ . @ . @ . @ . . . . @ . @ . @ @ @ . @ . . . @ @ . @ . @ . @ . @ . . . @ . @ . . @ @ . . @ . . @ . @ @ @ . @ @ . @ . . . @ . @ 
@ . . . . . . @ . @ @ . @ @ @ @ . . @ @ @ @ @ @ @ . @ @ . @ . . . @ @ . @ . @ . . @ . . @ . @ . . @ . @ . . . . . @ . @ . @ . . @ @ . . @ @ . @ . . . @ . . . . @ @ . @ . . . @ . . . @ . . . @ . . . @ 
@ @ @ . @ . @ @ @ @ @ @ . @ . . . @ . @ . @ @ @ @ . @ @ @ . . @ . . . @ . . . . @ . . @ . @ @ @ . @ @ . @ . @ @ . @ . . . . . @ . . . @ . . . . @ . @ . @ . @ . . . @ . @ . @ . @ . @ . @ @ . @ . @ . @ 
@ . . @ . . @ @ @ @ @ @ . . . @ . . . . . . . @ . . @ . . @ . @ . @ . . . @ @ . @ @ . @ . . @ . . . . . . @ . . @ . . @ . @ . . @ @ . @ @ @ . @ . . . . . @ . . @ . . . . @ . . . . . . . @ . @ @ . . @ 
@ . @ . @ . @ . @ @ @ @ @ . @ . . @ @ . @ . @ . @ . @ . @ @ @ @ @ @ @ @ @ @ . @ @ . . . . @ @ @ @ @ @ @ . . @ . @ @ . . @ @ . @ . @ @ . . . . . @ . @ @ @ . @ . . @ . @ @ . @ . @ . @ @ . . . . . @ . @ 
@ . @ . . . . . . @ @ @ @ . @ @ . . . @ @ . . . . . . . @ @ . . . . . @ @ @ . . . @ . @ @ . @ . . . . @ @ . . . . @ . @ @ @ . . . . @ @ . @ . @ . . . @ @ . @ . @ @ . . . . . . . @ . @ @ . @ . @ @ @ @ 
@ . . . @ . @ . @ @ @ @ . @ . . . @ . @ . . @ @ . @ . @ @ . . @ . @ @ @ @ @ @ . @ . . @ . . @ . @ @ . . @ @ . @ @ . @ . . . . @ . @ @ . . . @ . . @ . @ . . . . . . @ . @ @ . @ . . . @ . . . @ @ @ @ @ 
@ @ . @ . . . @ @ . @ @ . . @ @ @ . @ @ @ . . @ @ . . . . @ . . @ @ @ @ @ @ @ . . . @ . @ . @ @ @ . @ . @ . . . . . . . @ @ . . @ . @ @ . @ @ @ . @ . @ . @ . @ @ @ . . . . @ @ . @ . . @ . @ @ @ @ @ @ 
@ @ @ . . @ . . . . . . @ . . . . . . . . . @ . . . @ @ . . . @ @ @ @ @ @ @ @ @ @ . . . . . . . . . . . . . @ . @ . @ . . @ . @ . . @ . . . @ . @ . . @ . . @ . @ @ @ @ . @ . @ . @ @ . @ . . @ @ @ @ @ 
@ @ . @ . . @ @ . @ @ . . @ @ . @ . @ . @ . . @ @ . @ @ @ @ . . . @ @ @ @ @ @ @ . . @ . @ . @ . @ . @ . @ . . @ . . . @ . @ . @ @ . . @ . @ . . . . @ @ @ @ . . @ . . . . . . . @ . . . @ . @ @ @ @ @ @ 
@ . . . . @ @ . . . @ . @ @ . @ . . @ @ . . @ . @ @ . @ @ @ @ . @ @ @ @ @ @ @ @ @ . @ @ . . @ . . @ . . . @ @ . @ . @ @ @ . . @ . @ . @ . @ @ . @ . @ @ . @ @ . . @ . @ . @ . @ . . @ . . @ @ @ @ @ @ @ 
@ . @ @ . . . @ . @ @ @ . . . . . @ . @ @ . . . . . . . @ . . . @ @ @ @ @ @ @ @ . . @ . @ . @ . @ . @ . @ . . . . . @ @ @ @ . @ . . . . . @ @ @ @ @ . @ . @ . @ . . . . @ @ @ @ . @ . . @ . @ @ @ @ @ @ 
@ @ . . . @ @ @ @ @ @ @ . @ . @ . . . . @ @ . @ . @ . @ @ @ . @ @ @ @ @ @ @ @ @ @ . . . . @ . . . . . @ . . @ . @ . . . @ @ . @ . @ . @ . @ @ @ @ . . . . . . . . @ . @ @ @ @ . . . @ . . . @ @ @ @ @ @ 
@ @ @ @ @ @ @ @ @ @ @ @ @ @ @ @ @ @ @ @ @ @ @ @ @ @ @ @ @ @ @ @ @ @ @ @ @ @ @ @ @ @ @ @ @ @ @ @ @ @ @ @ @ @ @ @ @ @ @ @ @ @ @ @ @ @ @ @ @ @ @ @ @ @ @ @ @ @ @ @ @ @ @ @ @ @ @ @ @ @ @ @ @ @ @ @ @ @ @ @ 
3
86 39 28 36
40 75 71 69
69 84 12 40
