50 50
@ @ @ @ @ @ @ @ @ @ @ @ @ @ @ @ @ @ @ @ @ @ @ @ @ @ @ @ @ @ @ @ @ @ @ @ @ @ @ @ @ @ @ @ @ @ @ @ @ @ 
@ @ @ @ @ @ @ @ @ @ @ @ @ @ @ @ @ @ @ @ @ @ . @ @ . . @ . @ . . @ . @ . @ . . . . . . @ @ @ @ . @ @ 
@ @ @ @ @ @ @ @ @ @ @ @ @ @ @ @ @ @ @ @ @ . . . @ @ . . . . @ . . . . . . . @ @ @ . @ @ @ @ . . . @ 
@ @ @ @ @ @ @ @ @ @ @ . @ @ @ @ @ @ @ @ . @ . @ . . . @ . @ . @ @ . @ . @ . . . . @ . @ . . . @ . @ 
@ @ @ @ @ @ @ @ @ @ @ . . @ @ @ @ @ @ . . . . . . @ @ . . @ . @ . . @ @ @ @ . @ @ @ . . @ . @ . @ @ 
@ @ @ @ @ @ @ @ @ . @ . @ @ @ @ @ @ . . @ @ @ @ @ @ . . @ . . . @ . @ . . . . . . @ . @ . . . . . @ 
@ @ @ @ @ @ @ @ @ . . . @ @ @ @ @ @ @ . @ @ . . @ . @ . . . @ . . . . @ . @ . @ @ . . . @ . @ @ . @ 
@ @ @ @ @ @ @ @ . . @ @ @ @ @ @ @ . . . . . . @ @ . . . @ @ . . @ . @ . @ . . . . @ . @ . . . @ @ @ 
@ @ @ @ @ @ @ @ @ . . @ @ @ @ . . . @ . @ . @ . . @ @ . . @ @ . @ @ . . . . @ . @ @ . . . @ @ . . @ 
@ @ @ @ . . @ . @ . @ . @ @ . @ @ . . @ @ @ @ @ . . @ . @ . @ @ @ @ @ . @ . @ @ . @ @ . @ . @ . @ @ 
@ @ @ . . @ . . . . . . . . . . @ . @ @ @ @ @ @ . @ . . . . . . @ @ . @ . . . . . . . . . . . . . @ 
@ @ @ . @ . @ @ . @ . @ @ @ . @ . @ @ @ @ @ @ . . . @ . @ @ @ @ . . . . @ . @ . @ . @ . @ . @ . @ @ 
@ @ . . @ . . . @ . . . @ . . . . . @ @ @ @ . @ @ . @ . . . @ . @ @ . @ . @ @ @ @ @ . . . @ @ @ @ @ 
@ . @ . @ @ . @ . @ @ @ . @ . @ . @ @ @ @ @ . . @ . . . @ . . . . . . . . . @ @ @ @ @ . @ . @ @ @ @ 
@ . . . . . . . . @ . . . . @ . . @ @ @ . . . @ . @ @ . . @ @ . @ . @ . @ @ . @ @ @ . . . . . . . @ 
@ @ . @ @ . @ @ . . @ @ . @ . @ . . @ . @ @ . . . . @ . @ . . @ . . @ . @ . . . @ @ @ . @ . @ . @ @ 
@ @ @ . @ @ . . @ . . . . . . . . @ . . @ @ . @ . @ . . . . @ @ @ . . @ @ @ . @ . @ . . . @ @ @ @ @ 
@ . @ . . . @ . . . @ . @ @ . @ . . . @ . . @ . . . @ @ @ . @ @ @ . @ @ @ . . . . @ @ . @ @ @ @ @ @ 
@ . . . @ @ @ @ @ . @ . . @ . @ . @ . @ . @ . @ @ . . . @ . @ @ . @ @ @ . . @ . @ . @ @ @ . @ @ @ @ 
@ . @ . @ @ @ . @ @ @ @ @ . @ . . @ @ . . . . @ . @ . @ . . @ @ . . . . @ . @ . @ . @ . . . . @ @ @ 
@ @ . . @ @ . . . @ @ @ . . . @ . . @ @ . @ . . . . . . @ . . @ @ . @ . . . . @ @ . . @ . @ . . @ @ 
@ @ @ . @ . @ . @ . @ . @ . @ . @ . . @ @ . @ @ @ @ @ . . . @ . @ @ . @ @ . @ . @ . @ . @ . . @ @ @ 
@ . . . . . . . . . . . . . . . . . @ . @ . . @ . @ . @ @ . . . . @ . . . . . . . . @ . . . @ . @ @ 
@ . @ @ . @ @ . @ . @ . @ @ . @ @ @ . . . . @ . . . . . . . @ @ . @ . @ @ . @ @ . @ . . @ @ . . . @ 
@ . @ . . . @ . @ . . @ @ . @ . . . @ . @ . . . @ . @ @ @ . . . @ . . @ . . . @ @ @ . @ @ . . @ @ @ 
@ . . @ . @ . . . @ . @ . . . @ @ . . @ . . @ . @ . . . @ . @ . . . @ . @ @ . . @ . . . @ @ . . @ @ 
@ @ @ @ . @ @ @ . . @ . . @ . . . @ . . . @ . . @ @ . @ . @ . @ . @ . . . @ . @ . @ . @ . @ . @ . @ 
@ . . . . @ @ . . @ . . @ . @ @ @ . . @ @ . . @ . @ . @ . . . @ . . @ . @ . . . . . . . . . . . . @ 
@ @ . @ . . . @ . . @ . . . . . @ @ . . . @ . . . . @ . @ @ . @ . @ . . . . @ @ @ @ @ @ @ @ @ @ @ @ 
@ . @ . . @ @ @ @ . . . @ @ @ . @ . . @ @ . . @ @ @ . . @ . . . @ . @ . @ . . . . . . . . . . . . @ 
@ . . . @ . @ @ . . @ . . . . @ @ @ @ . . . @ @ @ . @ . . @ . @ . . @ . . @ @ . @ . @ @ . @ . @ . @ 
@ @ . @ . . . . @ . . @ . @ . . @ . @ . @ @ . @ . . . @ . . . @ . @ @ . @ . @ . @ . . @ . . @ . . @ 
@ . . . . @ @ @ . . @ . @ . . @ . . . @ @ . . @ @ @ . @ @ @ . . . . . . @ . . . @ . @ @ @ @ . @ . @ 
@ @ . @ . . . . @ . . . . @ @ @ @ . @ @ @ @ . . @ . . . . . . @ . @ . @ . . @ @ . . . @ . @ . @ . @ 
@ @ . . @ @ . @ @ . @ . @ @ @ @ . . . @ @ . . @ @ . @ . @ @ . @ . @ @ @ @ @ . . @ . @ . . . . . . @ 
@ . . @ . @ @ . . . . @ @ @ . . @ . @ @ @ @ . . . @ @ @ @ . . . @ @ @ @ . @ . @ . @ @ @ . @ . @ . @ 
@ @ . . . . . @ . @ . . . . @ . @ . . @ @ . . @ @ . @ . . @ . @ @ @ @ . . . . . . . . @ . . @ . . @ 
@ . . @ . @ @ @ . . @ @ @ . . . . . @ . . @ . . @ . . @ . . . . @ . . @ @ . @ . @ . @ . @ . . @ . @ 
@ @ . @ @ @ @ @ @ @ . . . . @ . @ . . . @ @ . @ . . @ @ @ @ @ . @ . @ @ @ @ . . @ . @ . @ @ @ . @ @ 
@ . . . . @ @ @ . . @ . @ . . @ . . @ @ . . . . . @ @ @ . . . . . . . @ @ @ @ @ . . . . . . . . . @ 
@ @ . @ @ . @ @ @ . . @ @ . @ . @ . . @ . @ . @ . @ . . . @ . @ @ . @ @ @ @ @ @ . @ . @ . @ . @ . @ 
@ . . @ . . . @ . @ . @ . @ . . . . @ @ . @ . @ @ @ @ @ . @ . @ . @ @ @ @ @ @ @ @ . . . @ . . . @ @ 
@ . @ . @ . @ @ . @ . . . . @ . @ . . @ . . @ . @ @ . @ . . @ . . @ @ @ @ @ @ @ @ @ . @ . @ . @ . @ 
@ @ . . . . . . . . @ . @ . . @ @ . @ . . @ . . . . . . . @ . @ . . @ @ @ @ @ @ @ . @ . . . . . . @ 
@ @ @ . @ . @ . @ . . @ @ @ . @ . . . . @ . @ . @ @ . @ . . . . . @ @ @ @ . @ @ @ . @ @ . @ . @ . @ 
@ @ @ @ . . . @ @ @ . . @ . . . . @ . @ . . @ . @ @ . @ @ . @ @ . @ @ . . . . @ . . @ . . @ . . @ @ 
@ @ @ @ @ . @ @ @ . . @ . @ @ @ @ . . . @ . . @ @ @ @ . . @ . @ . @ . @ @ . @ . @ . @ . @ . . @ @ @ 
@ @ @ @ @ . @ @ . @ . @ . @ . @ . @ @ . . . @ . @ @ @ . @ . . . . . . . . . . . . . . . . @ . . @ @ 
@ @ @ @ . . @ . . . . . . . . . . . . . @ . . . . . . . . . @ . @ @ . @ . @ . @ @ . @ . @ @ @ . . @ 
@ @ @ @ @ @ @ @ @ @ @ @ @ @ @ @ @ @ @ @ @ @ @ @ @ @ @ @ @ @ @ @ @ @ @ @ @ @ @ @ @ @ @ @ @ @ @ @ @ @ 
3
23 25 25 43
24 5 27 3
25 25 46 39
