12 12
@ @ @ @ @ @ @ @ @ @ @ @ 
@ . . @ @ @ @ @ @ @ @ @ 
@ @ . @ . @ @ @ @ @ @ @ 
@ . . . . @ @ @ @ @ @ @ 
@ . @ . @ . @ @ @ @ @ @ 
@ @ . . @ . . @ @ @ @ @ 
@ @ @ . @ . @ . @ . @ @ 
@ . . . . . . . . . . @ 
@ @ . @ . @ @ . @ . @ @ 
@ @ @ . . . . @ . . @ @ 
@ @ @ @ . @ . @ @ . . @ 
@ @ @ @ @ @ @ @ @ @ @ @ 
3
5 5 6 9
9 8 8 7
3 4 7 7
