100 100
@ @ @ @ @ @ @ @ @ @ @ @ @ @ @ @ @ @ @ @ @ @ @ @ @ @ @ @ @ @ @ @ @ @ @ @ @ @ @ @ @ @ @ @ @ @ @ @ @ @ @ @ @ @ @ @ @ @ @ @ @ @ @ @ @ @ @ @ @ @ @ @ @ @ @ @ @ @ @ @ @ @ @ @ @ @ @ @ @ @ @ @ @ @ @ @ @ @ @ @ 
@ @ @ @ . . . . . . . . @ @ @ @ @ . @ . @ @ @ @ @ . @ . @ . @ . @ @ @ . . . @ @ @ @ . . @ @ . @ . @ @ . . . . . @ @ @ . @ . @ . . @ @ @ @ @ @ @ @ @ @ @ @ @ @ @ @ @ . @ . @ . @ . @ . @ . @ . @ . @ . @ 
@ @ @ . @ . @ @ . @ @ . . @ . . . . . . . @ @ . . . @ . @ . @ . @ @ . . @ . @ . . . . @ . . . @ . . . @ . @ . @ @ @ . . . . @ . @ . @ @ @ @ @ @ @ @ @ @ @ @ @ @ @ . . . . @ . @ . . . . . . . . . . . @ 
@ @ @ . . . . @ @ @ @ @ . . @ @ @ . @ . @ . . . @ . . . . . . . @ . @ @ . . . @ . @ . . @ @ . . . @ @ . . . @ @ @ @ @ . @ . . . . . . . @ @ @ @ @ @ @ @ @ @ @ @ @ @ . @ . . . @ . @ . @ . @ @ . @ @ . @ 
@ . @ . @ . @ @ @ @ @ . @ . @ @ . . . @ . @ @ . . @ . @ . @ . @ . . . @ @ . @ . @ . @ . @ . @ @ . @ . @ . @ . @ . . @ . . @ . @ . @ . @ @ @ @ @ @ @ @ @ @ @ @ @ @ @ @ . @ . @ @ . @ . @ . . . @ . . . @ 
@ . . @ @ @ @ @ @ @ @ . . . @ @ @ . @ . . . @ . @ @ @ @ @ . . . . @ . @ . . . . . . . . . . . . . . . . . @ . . . @ @ @ . @ . . @ . . @ @ @ @ @ @ @ @ @ @ @ @ @ @ @ . . . . . @ . @ @ @ @ . @ @ @ . @ @ 
@ . @ . @ . @ . . @ . @ @ . @ . . . . @ . @ @ @ @ . . . . @ . @ @ . @ @ . @ @ . @ . @ @ . @ . @ @ @ . @ @ . . @ @ . @ . . @ . @ @ @ . @ @ @ @ @ @ @ @ @ @ @ @ @ . @ @ . @ @ @ . . . . . @ . . @ . . . @ 
@ . . . . . . . @ . . . @ . . @ @ . @ . . . @ . @ . @ @ . . . . @ . @ . @ . @ . . @ @ @ @ . . . @ . . . @ @ . . @ . . @ . . @ @ . . . @ @ @ @ @ @ @ @ @ @ @ @ . . @ . . . @ @ @ . @ . @ . @ . @ . @ . @ 
@ . @ @ . @ . @ @ . @ @ . @ . . . . . @ . @ . . @ @ . . . @ . @ . . . . . . . @ @ @ @ @ @ @ . @ . @ . @ . . . @ . . @ . . @ . . . @ . @ . @ @ @ @ @ @ @ . @ . @ . . @ @ . . @ . . . @ . . @ . @ . @ . @ 
@ . @ . @ . @ @ . . @ @ . . @ @ @ @ . . . . @ . . . . @ @ . . . @ . @ . @ . @ @ @ @ @ @ @ @ @ . . . . . @ . @ . . @ . . @ . @ @ . . @ . . . @ @ . @ . . . @ . . . @ . @ . @ . @ . @ . . @ . @ . . @ . @ 
@ . . . . . . @ @ . . @ @ . . . @ @ @ @ . @ @ @ . @ @ . . @ . @ . . . @ @ @ @ @ . @ @ @ @ @ . @ @ . @ . . . . . @ @ @ . . . . @ . @ . @ . @ . @ . @ @ @ . . . @ . . . . . . . . . . @ . . . . @ . @ . @ 
@ . @ . @ @ @ . @ . @ @ @ @ . @ @ @ @ . . . . @ . @ . @ . @ . . . @ @ . @ . @ . . @ @ @ @ . . . @ @ . . @ . @ @ . @ . . @ . @ . @ . . . . . . . . @ @ @ @ @ @ . . @ @ @ . @ @ @ @ . @ . @ . @ . . @ . @ 
@ @ . . . @ . . . . . . @ . . . @ @ @ . @ . @ . . . . @ . @ . @ . @ . . @ . . @ . @ @ @ . @ . @ . . @ . . @ @ . . . . @ @ @ . . @ @ . @ . @ . @ @ . @ @ . @ . @ . . @ . . @ . . @ . . . . @ . @ @ . @ @ 
@ . @ @ . . @ . @ . @ @ . @ . @ . @ . . . @ @ @ . @ @ . . . . . @ @ @ . . @ . . . . @ . . . . . @ . . . @ . . @ @ @ . . . @ @ . . @ . @ . @ @ . @ . @ . . . . . . @ . @ @ . . @ @ @ . @ . . . . . . . @ 
@ . @ . . @ @ @ @ . . @ . @ . . . . . @ . . @ . . . @ . @ . @ @ . @ . @ . @ . @ @ . . @ @ @ @ . . @ @ . . . @ . @ . . @ @ . . . @ . @ . . @ @ . . . . @ @ . @ @ . . . . @ @ . . . @ . . @ . @ . @ . @ @ 
@ . . @ . . @ . . @ . . . . @ @ . @ @ . . @ . @ . @ @ . @ . . . . . . @ . . @ . . @ . @ @ @ . @ . @ . . @ @ @ . . @ . @ . . @ . @ . . @ . . @ . @ . @ . @ . @ . . @ @ @ . . . @ @ . @ . . @ @ @ @ @ @ @ 
@ @ . . . @ . @ . . . @ . @ @ @ . @ . @ . @ . @ @ @ . @ . . @ . @ . @ @ . @ . @ . @ . @ @ @ . . . . @ . . @ . . @ . . . @ . . @ . . @ . . @ . . . @ . . . @ . . @ . . @ @ @ . . @ . @ @ . . @ . @ . @ @ 
@ . @ @ . @ . . @ @ @ . . @ @ . @ . . . . . . . @ . . . @ . . @ @ @ @ . . @ . . . . . . @ @ @ @ @ . . . @ . @ . . @ . @ @ . @ . @ . @ . @ . . @ . . @ . @ . @ . . . @ . . @ . @ . . @ . . @ @ . . . . @ 
@ . . . . @ @ . @ @ @ @ . . @ . . @ @ . @ @ . @ . . @ @ . . @ @ @ . @ @ . @ @ @ . @ . @ . @ @ . . . @ . . . . . @ . . . @ . . . @ . . . . . @ . @ @ @ . @ . . . @ @ . . @ . . . . @ @ @ @ . . . @ . @ @ 
@ @ . @ . . . . @ @ @ . . @ @ @ . @ @ @ . . . . @ . . . @ . . . @ . . . . @ . . @ . . . . . . @ . @ @ . @ @ @ @ @ @ . @ . . @ @ @ . @ . @ @ . . . @ . . . @ . @ . @ . @ . @ . @ @ . @ . . @ @ . . @ @ @ 
@ @ @ . @ @ . @ . @ . @ . . @ . . . @ . . @ @ . . . @ . @ . @ . . @ @ @ . @ . @ . @ . @ @ @ . @ . @ . . . @ . . @ . . . . @ . . . . . @ . . . @ @ . @ @ . . . . . . . @ . . . . . . . @ . @ . . @ . @ @ 
@ @ @ . @ . . . . . . @ . @ @ . @ @ @ @ @ . . . @ . . @ . . . @ . . . @ . @ . . . . . . . . @ . @ . @ . @ . @ . . @ . @ @ . @ @ @ . @ . . @ . . . . . @ . @ . @ . @ . . . @ . @ @ . @ @ . . @ . . . . @ 
@ @ . . . @ . @ . @ @ . . . @ . @ @ @ . . @ . @ . . @ . @ . @ . @ . @ . . . @ @ . @ . @ @ . . . . . . . . . . . @ . . . @ . @ . @ . . @ @ . . @ . @ . . . . @ . @ . . @ @ @ @ @ . @ @ @ @ . . . @ . @ @ 
@ @ . @ . . . @ @ @ . @ . @ . . . . . . @ @ . @ . @ . . . . . . . @ . @ . @ . @ @ @ @ @ @ @ . @ . @ @ . @ @ . @ . @ . @ . . . . . . @ @ @ @ . @ . . @ . @ @ @ . @ @ . . . . . . . . . @ @ @ @ . . @ @ @ 
@ @ @ @ @ @ . . . . . . . . . @ . @ . @ @ @ @ . . . @ . @ . @ . @ @ . . . . . . @ . . @ @ @ . @ . . @ . . @ @ @ . . . @ @ . @ . @ . @ @ . . . . @ . @ @ . . @ . . @ . @ . @ . @ . @ @ . @ . @ . @ @ @ @ 
@ @ @ . . . . @ @ . @ . @ . @ @ @ @ . . . @ . @ @ . . @ . . @ . @ . . @ @ @ @ . . @ . . @ . @ . . @ @ . @ . . . @ @ . . @ . @ . . @ @ . . @ . @ . . . @ . @ . . @ . . . @ . . . @ . . . . . . . @ . @ @ 
@ @ @ @ . @ . . @ @ @ . @ . . @ . . @ @ . @ . @ . . @ . @ . . @ . . @ . @ . . @ . @ . @ . . @ @ . . @ . @ . @ . . . . @ . . @ @ @ @ @ . @ . @ @ @ . @ . . . @ . . @ . @ . @ @ @ . . @ . @ . @ . . . . @ 
@ @ @ @ @ . @ @ @ @ . @ @ @ @ . . @ . . . . . . @ . . . . . @ . @ . @ . @ @ . . . @ . . . @ . @ @ @ . . . @ @ @ @ @ . . @ . . . . @ . . . . . . @ @ . . @ . @ . @ @ . . . @ . @ @ . @ . @ @ . . @ . @ @ 
@ @ @ @ . . @ @ @ . . . . . . . @ . . @ @ @ @ . . @ @ . @ . . . . . . . . @ . @ . . @ . @ . . @ . @ @ . @ @ @ @ . . . @ . . @ @ @ . @ . @ . @ . . @ @ . . @ @ . . @ . @ @ . . . @ . . @ . . @ @ @ @ @ @ 
@ @ @ @ . @ . @ . @ @ @ . @ @ @ . . @ . . . . @ . @ @ @ . @ . @ . @ @ . @ @ @ . @ . . . . . @ . . @ . . . @ @ . @ @ . @ @ . . . . . . . . @ . . @ @ @ @ . @ . . @ . @ @ . . @ @ . @ . @ . @ . @ @ @ @ @ 
@ @ @ . . . . . . . . @ . . . . . @ @ . @ . @ . . . . . . . . . @ @ . @ @ @ . . . @ . @ . @ . . @ . @ . @ . @ . . @ . @ . . @ . @ @ @ . @ . . @ @ @ @ . . . @ . . . . . @ . . . . . . . . . . @ @ @ @ @ 
@ . . . @ @ @ @ @ @ . . . @ . @ . . @ . @ . @ @ @ @ @ . @ . @ . . . . . . @ @ . @ . @ @ @ @ @ . . . . . @ . @ . @ . . . @ . . @ . @ . @ . @ . @ @ @ . . @ @ . . @ . @ @ . @ @ @ . @ @ @ . @ @ @ @ @ @ @ 
@ @ @ @ . . . . . . . @ . . @ . . @ @ @ . . . @ . . . @ . . @ . @ . @ . @ . . . . . . @ . @ @ . @ @ @ . . . . . . . @ @ . . @ . . . . @ . . . . @ . . @ . @ @ . @ . @ @ . . @ . . . . . @ . @ @ @ @ @ @ 
@ . . . . @ . @ . @ @ . . @ . @ . @ @ . @ . @ . . @ @ . @ . . @ @ @ @ . . @ . @ . @ @ @ . . . @ . . @ @ @ . @ . @ . @ @ @ . . @ . @ . . @ . @ @ . @ . . . @ . . @ @ . . . @ @ @ . @ @ . . . . @ @ @ @ @ 
@ . @ . @ . . . @ . . @ . @ . . . @ . . . . . @ . @ @ . . . @ @ @ @ . @ . @ . @ . @ . . . @ @ @ @ . . @ . . . @ @ @ . @ @ . @ . @ . . @ . @ . . . . . @ @ @ . @ . @ . @ . @ @ @ @ . . . @ . @ . . . @ @ 
@ @ . @ . . @ . @ @ . @ @ . . @ @ . @ @ @ . @ . . . . @ @ . @ @ . . . . . . . . @ . . @ . . . @ . @ . @ . @ . @ @ @ . @ @ . . . . @ . . . . @ . @ @ . . @ . . . . . @ . . . @ @ @ @ @ . . @ @ @ . @ . @ 
@ . . . . @ . . @ . . . . @ @ @ @ . . @ . . . . @ @ @ . . @ . . . @ . @ @ . @ . . @ . @ . @ @ . . . . . @ . . . @ . . . . . @ . @ . . @ @ . . @ @ . . @ . @ . @ . @ . @ . @ . @ . @ @ . @ . @ . . . . @ 
@ @ @ . @ @ @ . . @ . @ @ @ @ @ @ . @ . @ . @ . . . . . @ . @ . @ . . @ . . @ @ . . @ . . @ @ . @ . @ . . @ . @ @ @ . @ . @ . @ @ @ . . . @ . @ . @ . . . @ . . @ . . . . . . . . . . . . . . . @ . @ @ 
@ . . @ @ @ @ @ . . . @ . @ @ @ @ . . . . @ . . @ @ . @ @ . . @ . . @ . . @ @ @ @ . . @ . . @ . @ @ . . @ . . . @ @ @ . . . . . @ . . @ . @ @ @ . @ . @ @ . . @ . @ . @ @ @ . @ . @ . @ . @ @ @ . @ @ @ 
@ @ . . . . . . . @ . . . . @ @ . @ @ . @ @ @ . @ . @ . @ . @ . @ @ . . @ @ @ . . . @ . @ . . @ @ . . @ . @ . @ @ . . @ . @ @ @ . @ . . @ . . @ . . . @ @ @ . . . . . . @ @ @ . @ . @ . @ . @ . . @ @ @ 
@ . . @ . @ @ @ . @ . @ . @ . . . . . . . . . . . . . . . . . . . @ @ @ . @ . @ @ . . . . @ . . @ @ . @ . @ . @ . @ . @ . @ . . . @ . @ @ @ . . @ @ . . @ @ . @ @ . @ . @ . . . . . @ . @ . . . @ . @ @ 
@ . @ . . @ . @ @ . @ @ @ . @ @ @ . @ . @ . @ . @ . @ . @ @ @ . @ . @ @ . . . . . . @ @ @ . . @ . . . . . . . @ . @ . . . . @ . @ . . . @ . @ . . @ @ . . . . . . @ . @ . @ @ . @ . . . . @ @ . . . . @ 
@ . @ @ . . . . @ . . @ . . . @ . . @ @ . . @ @ @ @ . . @ @ @ . . . . @ @ . @ . @ . . . @ . @ @ @ @ . @ . @ . . . . . @ . @ @ . . @ . @ . . . @ . . @ . @ . @ . @ . . . . . @ @ @ . @ @ . . @ . @ . @ @ 
@ @ . . . @ @ @ @ . @ . @ @ . . . @ . . . @ . . @ @ @ . . @ . . @ @ . . @ . . @ . . @ @ . . @ . @ @ @ @ @ . . @ @ @ . @ @ . . @ . . . . . @ @ . @ . . . . @ . . @ . @ . @ @ . @ . . . @ @ @ . . @ @ @ @ 
@ @ @ @ . . @ @ . . . . . @ @ . @ @ @ . @ . @ . . @ @ . @ . @ . . @ . @ @ @ @ . @ . . . . @ . . @ @ . @ @ @ . . @ @ @ @ . . @ . . @ . @ @ . @ . @ . @ . @ . @ @ . . . @ . . . . @ . @ . . @ . @ . @ @ @ 
@ @ @ @ @ . @ . @ . @ . @ . . . @ @ @ @ . . . . @ @ . @ . . . . @ . @ @ . @ . . . . @ . @ . @ . . . . . @ . . @ . @ . . @ . @ . @ . @ @ @ . . . @ . @ @ @ . @ . @ . @ . @ . @ @ . . . @ . @ . @ . . . @ 
@ @ @ @ @ @ . . . . . @ . . @ . . . @ . @ . @ . . . . . . @ @ . . . . . . . @ . @ . . @ . . . @ @ @ . @ . @ . @ . . @ . . . . . . . . . . . @ . @ . @ . @ . . . . . . . . . . . @ . @ . . @ . . . @ . @ 
@ @ @ @ @ @ @ . @ . @ . @ @ @ . @ @ . . . . @ . @ . @ . @ . @ @ . @ . @ . @ @ @ @ @ . . @ @ . . @ . . @ . . . . . @ . @ @ . @ @ @ @ . @ . @ . . @ . @ . . . @ . @ @ @ @ @ @ @ @ . . . @ . . . @ @ @ @ @ 
@ @ @ @ @ @ @ @ . . . . @ . . @ @ @ @ . @ . @ . @ . . @ @ . . . @ . . @ . . @ . @ @ . @ . @ . @ @ @ . @ @ @ . @ . . . @ @ . . . . @ @ . . . @ . . . . . @ @ . @ . @ . . . . . . . @ @ . @ . @ @ . @ . @ 
@ @ @ @ @ @ @ . @ . @ . . . @ @ @ @ @ @ . . @ @ . @ @ @ @ . @ . @ @ @ . . @ . . @ . . . . . . @ @ . . . @ . . . @ . @ . . . @ . @ @ . @ . @ . @ . @ @ . . . . . . . . @ . @ . @ . . . . . . . . . . . @ 
@ @ @ @ @ @ . . @ . . @ . @ @ @ @ @ @ @ @ . @ @ . . . . . . . @ . @ . @ . . @ . . . @ . @ . @ @ . @ . @ @ . @ . @ . @ . @ . . @ . . . . @ . . . @ . . . @ @ @ . @ . @ . @ @ @ . . @ . @ . @ . @ . @ . @ 
@ @ @ @ @ . . @ . . @ @ @ @ @ @ @ @ @ @ @ . @ . . @ @ @ . @ . . . . . . . @ . . @ . @ . @ . . @ . . . . . . @ . . @ @ @ . . @ . @ . @ . @ @ @ . . . @ . . . @ @ . . . . . @ @ @ . . @ @ . . @ @ . . @ @ 
@ @ @ @ @ . @ @ @ . @ @ @ @ @ @ @ @ @ @ . @ . @ . @ . . . @ @ . @ @ @ @ . . . @ . . @ . @ . @ @ @ @ . @ @ . . @ @ @ . . @ . . . . @ . . . . . . @ . . @ . @ . . @ . @ . @ . @ . . @ . . . @ . @ . @ . @ 
@ @ @ @ . . . @ . . @ . @ @ @ @ . @ @ . . @ . . @ . . @ . . . @ . . . . . @ . . @ . . @ @ @ . . @ . @ @ @ @ . @ @ . . @ . . @ . @ @ @ . @ @ . @ . @ @ @ . @ . @ . . . @ . . @ @ . . @ @ . . . @ . . . @ 
@ @ @ @ @ . @ @ @ . . . . @ @ . . @ . @ . . . @ @ @ . . @ @ . @ . @ . @ . @ . @ @ @ . . @ . . @ . . . @ . @ . @ . @ . @ . @ @ @ . . @ @ . . . . . @ . @ . @ . @ @ @ . @ . @ . @ @ . . @ @ . @ @ . @ . @ 
@ @ @ @ @ . . @ . . @ . @ . . @ . . . @ . @ @ . @ . . @ . . @ @ @ @ @ . . @ . @ @ . . @ . @ . @ @ . @ @ . . . . . . . . . @ @ @ @ . . @ @ @ . @ . @ . . . @ . @ . . . . . . . . . @ . @ . . . . @ @ . @ 
@ @ @ @ . . @ . @ . . @ . @ . . @ @ . . . . @ . . @ . @ @ . @ @ @ @ @ . @ . . @ . @ . . . . . . @ . . . @ @ . @ . @ . @ . . @ @ . . @ . @ . . . @ @ @ @ . @ . @ @ @ . @ @ @ . @ . @ @ @ @ . @ @ . @ @ @ 
@ @ @ @ @ . . . @ . @ . . . . @ . @ . @ . @ . . @ . . @ @ . @ @ @ @ @ @ @ @ . @ . . . @ . @ @ @ . . @ . . @ . . @ . . . @ . . . @ . . . . @ . @ @ @ . @ . @ . . . @ . . . @ . @ . @ . @ @ . @ . . . . @ 
@ @ @ @ . @ @ . . . . @ @ @ . . . . @ . . . . @ @ @ . . . . . @ @ @ @ @ @ @ @ . @ @ . . @ @ . . @ . . @ @ . . @ . . @ . . @ . @ . . @ . @ . . . @ . . @ @ @ @ . @ . . @ @ @ @ . @ @ . @ . @ @ . @ @ . @ 
@ @ @ . . . @ . @ . @ . . @ . @ @ @ . @ . @ . @ @ . @ @ . @ @ @ @ @ @ @ @ @ . . . @ . @ @ @ @ . @ . @ @ . @ . . @ @ . . @ . . . . @ @ @ @ @ . @ @ @ . . . @ . . . @ @ . . @ . . . @ . . . . . . @ @ . @ 
@ @ . @ . @ @ . . @ @ . @ . . @ @ . . . . @ @ . . . . @ @ . @ @ @ @ @ @ . . @ . @ @ . @ @ @ . . . . . @ . . . @ . @ @ . @ @ . @ . . . @ @ @ @ @ @ . . @ . . @ . @ . @ . @ @ . @ @ . @ @ . @ @ . . @ . @ 
@ @ . . . . . . @ . @ . @ @ . . . @ @ @ . . @ . @ . @ . @ . . @ @ @ @ . @ . . . . . . . @ @ @ . @ . @ . @ @ . . . . @ . @ @ . . @ . @ . @ @ . @ @ . @ . @ @ . . . . . . . @ . . @ . . . @ @ . @ . . @ @ 
@ . . @ . @ @ . . . . . . . @ @ . @ . @ . @ . @ . . . . . . @ @ @ @ . . @ @ . @ . @ . @ @ @ @ . @ . . . . @ . @ . @ . . @ @ . @ . . . . @ . . . . . . . . . . @ . @ . @ @ . @ . . @ . @ . . . . . @ . @ 
@ @ @ @ . . . @ . @ @ . @ . . . . . . . . . . . @ @ @ . @ . . @ @ @ @ . . @ @ @ @ @ . . @ @ @ @ . @ @ . @ . . . @ @ @ . . . @ . @ . @ . . @ @ . @ . @ @ @ . @ . @ @ . @ . . . . @ . . . @ @ . @ . . . @ 
@ . . . @ @ . . @ @ @ . @ . @ . @ @ . @ @ @ . @ . . . @ @ . @ . @ @ . @ . @ @ @ @ @ . @ @ @ @ @ . . . . . @ . @ @ @ @ @ . @ . . . . . @ @ @ . . . @ @ @ @ @ . . . . @ . . @ . @ @ . @ @ @ @ @ . . @ . @ 
@ @ @ . . . @ . @ @ @ @ . @ . . @ @ @ . . . . . @ @ . @ . . . . . . . . . . @ @ @ . . . @ . @ . @ @ @ . @ . . . @ @ @ . . . @ @ @ . @ . @ @ @ . @ @ . @ . @ . @ @ . . @ . . @ @ . . . . . @ . . @ . @ @ 
@ @ . . @ @ . . @ @ @ . . @ . @ . @ . @ . @ . @ . . . @ . @ . @ @ @ . @ . @ . @ . @ . @ @ . . . . @ @ . . @ . @ . @ @ . @ @ . @ . . . . . @ . . . . . . . . @ . @ @ . . . @ @ @ @ . @ . @ . @ . . . . @ 
@ . @ . @ . @ @ @ @ . @ . . @ . . @ . @ @ . . . @ @ . . @ @ . @ . . @ . . . . . . @ . . . @ @ . @ . . . @ @ . . . . . @ @ . . . @ . @ . @ @ @ @ @ @ . @ @ @ . . . @ . @ . . @ @ . . . @ @ . . . @ . @ @ 
@ . . . . . . . . . . @ . @ . @ . @ . @ @ . @ . . . @ . . @ @ . . @ @ @ . @ @ @ . . . @ . @ . . . @ . @ . @ . @ . @ @ . . @ . @ @ @ @ . . @ . . . . . . @ @ . @ @ @ @ . . @ . @ . @ @ . @ . @ @ . @ . @ 
@ @ . @ . @ . @ . @ . . . . . . . . . . . . @ . @ . @ . @ . . @ . . @ @ @ . . . . @ . . @ @ @ @ . . . . . @ . . @ . . . @ . . . @ . . @ @ @ @ @ . @ . @ . @ . @ @ @ @ @ . . . . . . . . . . . . . . . @ 
@ . . . @ . . @ . @ @ . @ . @ @ @ . @ . @ @ . @ . . . . . @ . @ @ . . @ . @ . @ @ . @ . . @ . . . @ . @ . @ . @ . @ . @ . @ . @ . @ . . . @ . . . . @ . . . . . @ @ @ @ . @ . @ @ . @ @ . @ . @ . @ @ @ 
@ @ . @ @ @ . . @ @ @ . . @ . @ . . . @ . . . . . @ . @ . . . . . . @ . . . @ @ @ . . . @ @ @ . @ . @ @ @ . . . . . . . . . . . . . . @ @ @ . @ @ @ . @ . @ . @ . @ @ @ . . @ @ @ @ . . @ @ @ . . @ @ @ 
@ @ . @ @ . . @ @ @ @ @ . @ . . @ . @ @ @ . @ . @ . . @ @ . @ . @ . . @ . @ @ @ . . @ . . @ . . @ . @ @ @ @ . @ . @ . @ @ @ @ @ . @ . . @ . . . . @ . . . . @ . . . @ . @ . . @ . @ . @ . @ . @ . . . @ 
@ . @ . . @ . @ @ @ @ @ @ . . @ . @ @ @ @ @ . @ @ @ @ . . @ . @ @ @ . . . . @ . . @ . . @ . @ . @ . @ @ @ . . . @ @ @ . . . . . @ . . @ @ @ . @ . @ . @ . @ @ @ . @ . . @ . @ . . . . . . @ . . . @ . @ 
@ . @ @ . @ @ @ @ @ @ @ . @ . . . . @ @ @ . . . @ . . @ . . . @ @ @ @ @ . @ @ @ @ . @ . @ . . . @ . . @ @ @ . @ . . . @ . @ . @ . @ . . @ . . . @ . . @ . . @ . . . @ . . . . @ . @ @ . @ . @ . @ . . @ 
@ . . @ . . . @ . @ @ @ . . @ @ . @ @ @ . @ . @ @ @ . . @ @ . @ @ @ . . . . @ @ . . . . . @ @ . @ . @ . . . . . . @ . . . . @ . . @ . @ @ @ . @ . @ . @ @ . . @ @ . . . @ . @ . . . . @ @ . . @ @ @ . @ 
@ . @ . @ . @ . . . . . @ . . @ . . @ . . . . @ @ @ @ . . . . @ . . @ @ . @ @ . @ . @ . @ . . . . . . . @ . @ . @ . . @ . @ . @ . @ . @ @ . . @ . . . . . @ . @ @ . @ @ . . . . @ . @ @ . . @ . . @ . @ 
@ . . . . . . @ . @ @ . @ . @ @ . @ . @ @ @ . @ @ @ @ . @ . @ . @ . @ @ . @ . . . @ . . . @ . @ . @ . @ . . . @ . @ . @ @ @ . . . . . . . @ . . . @ . @ @ . @ . @ . . @ . @ . @ @ . @ . . @ . @ . @ . @ 
@ @ . @ . @ . @ . @ . @ . . . @ . . . . @ . . . @ @ . @ . . . . . . . . . @ @ . @ . @ . @ . @ . . @ . @ @ . @ . . . . . @ @ . @ . @ . @ . @ . @ @ . @ @ . . . . . . @ . @ . @ . . . . @ . . . . . . @ @ 
@ @ @ . @ . . @ . . . . @ . @ . @ @ . @ . @ . @ . . . . . @ @ @ @ . @ @ . @ . . . . . . . . . @ . . @ @ @ @ @ @ . @ . @ @ @ . @ @ . . . @ . . . @ . . . . @ . @ . @ @ . . . . . @ . @ . @ . @ @ @ @ @ @ 
@ @ . . @ . @ . @ . @ . . . . . . . . . . . . . @ . @ . @ . . . . @ . . . . . @ . @ @ . @ . @ . . @ @ @ @ @ @ @ @ . . . @ @ @ @ . @ . @ . @ . @ . . @ . @ . @ @ @ . . @ @ . @ . @ . . . . . . @ . . @ @ 
@ . . @ . . . . . . . @ . @ . @ . @ @ @ @ . @ . . . @ @ . @ . @ . @ @ . @ . @ . . . . @ . . . @ . . @ @ @ @ @ @ @ @ @ @ . @ . . . . . . . . . . . @ @ . . . . @ @ @ . . @ . @ @ . . @ @ . @ @ @ @ . . @ 
@ . @ . @ . @ . @ . @ . @ . @ . @ @ . . . @ . @ @ @ . @ . @ @ . . . . . . @ . @ . @ @ . @ . @ . . @ . @ @ @ @ @ @ @ @ @ . . @ @ . @ . @ @ . @ . @ . . . @ . @ @ @ . . @ . . @ . @ . . . @ @ . @ . @ . @ 
@ . . . . . . @ . . @ . @ . @ . @ . . @ . . . . . . . . . . @ . @ . @ @ @ . . . . @ . . . . . . @ . . @ @ @ @ @ @ @ . . . @ . . . . @ . . . . @ . . @ . @ . . @ . @ . @ @ . . . @ . @ . . . . . . . . @ 
@ . @ . @ . @ . @ . @ . . . . . . @ . . @ . @ . @ . @ . @ . . . . @ @ . @ . @ @ . . @ @ @ . @ . @ @ . @ @ @ @ @ @ . @ @ . . @ . @ @ @ . @ . @ . @ @ . . . @ @ . . . . . . @ @ . @ @ @ @ . @ . @ . @ . @ 
@ @ . . @ @ . . . . @ . @ . @ . @ @ @ @ . . . @ @ . . @ . @ @ . @ @ @ . @ . @ @ @ @ . . @ . @ . @ . . @ @ @ @ @ @ . . . . @ . @ . @ . @ @ . @ . . @ @ . @ @ . . @ @ . @ . . @ @ @ . @ . @ . @ @ . . @ @ 
@ @ @ . . . @ . @ . . . . @ . . . @ . @ @ . @ @ . @ @ . . @ @ @ . @ @ . . @ @ @ @ . @ . . @ @ . . . @ . @ . @ @ . @ @ . @ @ . @ . . . . @ . . . @ . . . . . @ @ @ @ @ . . @ @ @ . . @ . @ . @ . @ . . @ 
@ @ . . @ . . @ @ @ . @ . @ . @ @ . . . . . @ . . @ @ @ . @ @ . . . @ . @ @ . @ . . . . @ @ . @ @ . . . . . . . . . . . . . . . . @ . @ . . @ . . @ . @ . @ @ @ @ @ @ @ . . @ . @ . . . . . . . . @ . @ 
@ @ @ . . @ . . @ . . @ . . @ @ . @ . @ . @ . @ . @ @ . . . @ @ . @ . . . @ . . . @ @ . . . . . . . @ @ . @ @ . @ @ @ @ @ . @ @ . @ . @ @ . . @ @ . . @ . . @ @ @ @ @ @ . @ . . . . @ . @ . @ . @ @ . @ 
@ . . . @ @ . @ . @ . . @ . @ . . . . . @ . . . . . @ @ . @ @ . . @ @ . @ . @ . @ . . . @ . @ . @ . . . @ @ @ @ . @ . . . . @ @ . . @ . . . @ . . @ . @ . @ @ @ @ @ @ . . @ @ @ @ . @ . . @ @ @ . . . @ 
@ . @ . @ . @ . . . . @ @ . . @ . @ . @ . @ @ . @ . . @ . @ . @ . @ . . . . . . @ @ . @ . . . @ . . @ . . @ @ @ . . @ . @ . . . @ @ @ @ . @ . . @ . . @ . . @ @ . @ . @ . . . . . . @ . @ . @ @ @ . @ @ 
@ @ . . @ . . . @ @ . . . @ . . @ . . . . @ @ @ . . @ @ . . . . . . @ . @ . @ . . . @ @ @ . @ . @ . . @ . @ @ . . @ . @ @ . @ . @ @ @ @ . @ . @ . @ @ @ @ . . . . . . . . @ . @ . @ . . . . . @ . . . @ 
@ . @ @ @ @ . @ @ . . @ . . @ @ @ @ . @ @ . @ . @ . @ @ @ . @ . @ . . . . @ . . @ @ @ @ . . @ . . . @ . @ . @ @ . . . . . . . @ @ @ @ @ . . . . . . . . . @ @ . @ @ @ . @ @ @ . @ . @ . @ . @ . @ . @ @ 
@ . . @ @ . . @ @ @ . . @ . @ . @ @ @ . . . . . . . . @ @ . . @ . . @ . @ . @ . . @ @ @ @ . @ . @ . . . . . . @ @ . @ @ . @ @ . . . @ @ @ @ . @ @ . @ . @ @ . . . . . @ @ . @ . . . . . . @ . . . @ @ @ 
@ @ . . . . @ @ @ . . @ . . . . . @ @ @ . @ . @ @ . @ . . . @ . . @ @ @ . . . . @ @ @ @ @ @ . . . @ . @ . @ @ . . . @ . . . @ . @ . . @ . . @ @ . . @ . @ . @ . @ . @ @ . . . @ @ @ . @ @ . . @ @ @ @ @ 
@ . @ . @ . . @ @ @ . @ @ . @ . @ @ @ @ . @ @ . . . . . @ @ . @ . . . @ @ . @ . @ . @ @ @ . @ . @ . . . @ @ @ @ @ @ . . @ . . @ . . @ . . @ . @ @ . . @ @ . @ @ . @ @ . @ . @ @ @ @ . @ @ @ . . @ @ @ @ 
@ . . . @ . @ @ @ . . . . @ . . . . @ @ @ . . @ @ . @ . . . . @ . @ . . @ @ . . . . . @ . . @ . . @ . @ @ @ @ @ @ @ @ . @ . @ . @ . . @ . @ . @ @ @ . . . . . . . . . . . . . @ @ . @ . @ @ . @ . @ @ @ 
@ . @ . . @ . . . . @ . @ @ @ @ . @ @ @ @ @ . @ . @ @ . @ . @ @ . . @ . @ @ @ . @ @ @ . @ . @ . @ . . . @ @ @ @ @ @ . . @ . . . . @ . @ . . . . @ . . @ . @ @ . @ @ . @ . @ . . . . . . . . . . . . @ @ 
@ @ . . @ @ . @ . @ @ . . . . . @ @ @ @ . . . . . . . . . @ @ . . @ . . @ @ . . @ . . . . . . . . @ . @ @ @ @ @ @ @ @ . @ . @ @ . . . . . @ @ @ @ @ . . @ . . . . . @ . . . @ @ . @ . @ . @ @ . @ . . @ 
@ @ @ @ @ @ @ @ @ @ @ @ @ @ @ @ @ @ @ @ @ @ @ @ @ @ @ @ @ @ @ @ @ @ @ @ @ @ @ @ @ @ @ @ @ @ @ @ @ @ @ @ @ @ @ @ @ @ @ @ @ @ @ @ @ @ @ @ @ @ @ @ @ @ @ @ @ @ @ @ @ @ @ @ @ @ @ @ @ @ @ @ @ @ @ @ @ @ @ @ 
3
12 28 4 5
24 71 69 76
50 24 16 46
