25 25
@ @ @ @ @ @ @ @ @ @ @ @ @ @ @ @ @ @ @ @ @ @ @ @ @ 
@ . @ . @ . . . . . @ @ @ @ . . @ . @ . . . . . @ 
@ . . . . @ @ . @ . . @ @ @ . @ . . . @ @ . @ @ @ 
@ @ @ . @ . . @ . . @ . . . . . . @ . . . . . . @ 
@ @ @ . . @ . . @ . @ . @ @ . @ @ . @ . @ . @ . @ 
@ . . . @ . . @ . . . @ @ . . @ . . . @ @ @ . . @ 
@ @ . @ . . @ . @ . @ @ . @ . . @ . @ . @ . @ @ @ 
@ . . @ @ . . . . . . @ . . . @ . . . . . . . . @ 
@ @ . @ . @ . @ . @ . . @ @ . . . @ @ . @ . @ . @ 
@ . . . . @ . @ @ . @ . @ . . @ . . . @ @ @ @ . @ 
@ . @ @ . @ @ . . . . . . @ . . @ . @ @ @ @ @ @ @ 
@ . @ . . . . @ @ @ . @ . . . @ . @ . @ @ @ @ @ @ 
@ @ . @ . @ . @ . @ @ . @ @ . . . @ . @ . . @ @ @ 
@ . . . . . @ . . . @ . . . . @ @ . . @ . @ . @ @ 
@ . @ @ . @ . @ . @ . . @ @ . . @ @ . . . . . . @ 
@ . @ . . . . . . . @ @ @ . . @ @ @ @ . @ @ . @ @ 
@ @ . @ . @ @ . @ . . @ . @ . @ . . . . . @ . . @ 
@ . . . @ . . @ @ . @ . . @ . @ @ . @ . @ @ @ @ @ 
@ . @ . @ . @ @ @ . @ @ . @ . . @ @ . . . @ @ @ @ 
@ @ . . . . . @ . . . @ . @ . @ . @ @ . @ . @ . @ 
@ . @ . @ @ @ . @ . @ . . . . . . . . . . . . . @ 
@ . . . . . . . . . . @ . @ . @ . @ . @ . @ @ . @ 
@ @ . @ . @ . @ . @ . . . @ . . @ . . . @ @ @ @ @ 
@ @ . . @ . . . @ @ @ . @ . . @ @ @ . @ @ @ @ @ @ 
@ @ @ @ @ @ @ @ @ @ @ @ @ @ @ @ @ @ @ @ @ @ @ @ @ 
3
9 11 10 14
14 18 17 19
12 8 17 14
