100 100
@ @ @ @ @ @ @ @ @ @ @ @ @ @ @ @ @ @ @ @ @ @ @ @ @ @ @ @ @ @ @ @ @ @ @ @ @ @ @ @ @ @ @ @ @ @ @ @ @ @ @ @ @ @ @ @ @ @ @ @ @ @ @ @ @ @ @ @ @ @ @ @ @ @ @ @ @ @ @ @ @ @ @ @ @ @ @ @ @ @ @ @ @ @ @ @ @ @ @ @ 
@ . . . . . . . . . . @ @ @ . @ . @ . @ @ @ . . @ @ @ @ @ @ @ @ . . . . . . . . @ @ . @ @ @ @ @ @ @ . @ . @ @ @ @ @ . @ . . . . @ . @ . @ . @ . . . @ @ @ @ @ @ @ @ @ @ @ @ @ @ @ @ @ @ @ @ @ @ @ @ . @ 
@ . @ . @ . @ @ @ @ @ . @ . . @ . . . . @ . . @ @ @ @ @ @ @ @ . . @ . @ . @ @ @ . . . . @ @ @ @ @ . . . . @ @ @ @ . . @ @ . @ . . . . . . . . @ . @ @ @ @ @ @ @ @ @ @ @ @ @ @ @ @ @ @ @ @ @ @ . @ . . @ 
@ @ . . . @ @ @ . @ . . . @ . @ @ @ . @ . . @ . @ @ @ @ @ . . @ . @ . @ . . @ . . @ . @ . @ @ . @ @ . @ @ . @ @ @ @ . . @ . . @ . @ . @ @ . @ . . . @ @ . @ @ . @ @ @ @ @ @ @ @ @ @ . @ @ . . . @ @ . @ 
@ . @ . @ . @ @ . . @ @ . . . . @ . . @ @ . @ . . @ @ @ @ @ . . . . @ . . @ @ . @ . . . . . @ . . @ . . @ . @ @ @ . . @ . @ . . @ . . @ . . @ . @ @ . . . . . . . . @ @ @ @ @ @ @ @ . . . @ @ . . @ . @ 
@ . . . . . . . . @ . @ . @ . @ . @ . . . . . . @ . @ @ @ . @ @ . @ . @ . @ . @ . @ . @ @ @ . . @ . . @ . . . @ @ @ . . . . @ . @ @ @ . @ . . . . @ @ . @ . @ . @ . . @ @ @ @ @ @ . . @ . . . . @ . . @ 
@ . @ . @ . @ @ . . . @ @ @ . . . @ . @ @ . @ @ @ . . @ . . . @ . . . . @ . . . . . . @ @ @ @ . . . @ . . @ @ . . @ @ . @ . . @ @ . . . @ . @ @ @ @ @ @ . . . @ . @ . @ . @ . @ . @ . . @ @ . @ @ @ . @ 
@ @ . . @ @ @ @ . @ . . @ . . @ @ . @ . @ . @ . @ @ . . @ . @ . . @ . @ . @ . @ . @ . . . @ . @ @ . . . @ @ @ @ . . @ . @ . @ @ . @ @ . . . . . @ @ @ @ . @ @ . . . . @ . . . . . . . @ @ @ @ @ @ @ . @ 
@ . @ . @ @ . . @ . . @ @ . @ @ . . @ . . . . . . @ @ . . . . @ . . @ . . . . . @ . . @ @ @ . @ . . @ @ . . . @ . @ . @ @ . . . . . . . @ @ @ . . @ @ @ @ @ @ @ . @ . . @ . @ @ . @ . . @ @ @ @ . . . @ 
@ . . . @ . . @ . @ . . @ . . . @ . . . @ . @ @ . . . @ . @ . . . @ @ @ . @ . @ @ @ . @ . . . . @ . @ @ . @ . . . . . . . @ . @ . @ @ . . @ . @ @ . . @ . @ @ @ @ . . @ @ @ . . . . @ . . @ @ @ @ @ . @ 
@ . @ . . . @ . . @ . @ @ @ . @ . @ . @ @ @ @ . @ . @ @ @ @ @ @ . @ @ @ @ . . . @ . . @ . @ @ . . . . . . . @ . @ @ . @ @ . @ @ @ . @ . @ . . . . @ . . . . @ . @ @ . . @ . @ @ . @ . . @ . @ @ @ . . @ 
@ . . @ @ @ . @ . @ . . @ @ . . . . . . . . . . . @ @ @ @ @ @ . . . @ . . . @ . . @ . . @ . . . @ . @ @ . @ . . . . @ @ . . . . . . . . . . @ . @ . . @ . @ . . . . . @ . . . . @ . . @ . . . @ . @ . @ 
@ . @ @ . . . . . . . @ . @ . @ . @ . @ . @ . @ . @ . @ . @ . @ . @ . @ @ . @ . @ . @ @ . @ . @ . . @ @ . . @ . @ . @ . . @ . @ @ . @ @ . @ . @ @ @ . @ . @ . @ . @ @ . . @ @ @ . @ . . . @ @ . . . . @ 
@ . . . @ @ @ @ @ @ . . . . . . @ . . . @ @ . @ . . . . . . . . . @ . . @ @ . . . . . . . . @ . . @ . @ . @ . . @ @ . @ . . @ . . . . @ @ @ . @ @ . . . @ @ . . @ @ @ . @ . @ @ . @ . @ @ . @ . @ @ . @ 
@ . @ . . @ . @ @ @ @ @ . @ @ @ @ @ @ . . . @ @ . @ @ . @ . @ . @ @ . @ . @ . @ . @ . @ . @ @ @ . @ . . @ @ @ @ . . . . . @ . @ @ . @ @ @ . . @ . @ . @ . @ . @ @ @ . . . . . . . . . . . . . . . . @ @ 
@ . . @ . . . . @ @ . . . . . @ @ @ @ . @ . . . @ . @ . @ . @ @ . . . @ . @ . . @ @ @ @ @ . @ . . . . @ . @ @ . @ . @ @ . @ . @ @ @ @ @ . @ . . . . . . . . . . . . . @ . @ . @ . @ . @ @ @ . @ . @ @ @ 
@ @ . @ . @ . @ @ . @ @ . @ @ @ @ @ @ . @ . @ . . . @ @ @ @ . . @ @ . @ . @ . @ . @ . @ @ . . @ . @ @ . . . . . . @ . . . . . @ @ . . . . . . @ @ @ . @ . @ @ @ . @ . @ . . @ . . . @ . @ . @ @ @ . @ @ 
@ @ . . @ . @ . . . @ @ . . . @ @ @ @ . . @ . . @ . . @ @ . . @ @ @ . @ . . . . . . . . . @ . . . @ @ . @ @ . @ @ @ . @ . @ @ @ . . @ . @ @ . . @ . . . @ . . . . . @ . @ . @ @ . @ . . . . . . . . . @ 
@ @ . @ . . @ @ . @ . @ . @ . @ @ @ @ @ . . @ . . @ . . . @ . . @ @ . . @ . @ @ . @ @ @ . . @ @ . . . . . . @ @ . . @ @ . . . @ @ . @ . @ . @ . . @ . @ @ @ @ . @ @ . . . . . @ @ @ . @ . @ . @ . @ @ @ 
@ @ . . . @ . . . @ . . . . @ @ @ @ @ . @ @ . . @ . . @ @ . . @ @ @ . @ . . . @ . @ . . @ . @ . . @ @ . @ @ @ . @ . . @ @ . @ . . @ . @ . . . . @ . . @ @ @ @ @ . @ . @ . @ @ . @ . . . @ @ @ @ @ @ @ @ 
@ . . @ @ . @ @ . @ . @ @ . . @ @ @ . . . @ . @ @ @ . @ . @ . @ . . . . @ . @ . @ @ . @ @ @ . @ . . . @ @ @ . . . . @ @ . . . @ . . . @ . @ @ . . @ @ . @ @ . @ . . . @ @ . @ . @ . @ @ . @ . @ . . @ @ 
@ @ . @ . . . . . . @ @ . . @ . @ . @ . @ . @ @ @ @ @ . . . . . @ . @ . . . . . . . . . @ . . @ . @ . . @ . . @ . @ @ . @ @ . @ . @ @ . @ . @ . @ . @ . . @ . . @ . @ . @ . . . . . . . . . . . @ . . @ 
@ @ . . @ . @ . @ . . . @ . . . . . . . . . . @ @ @ . @ . @ . @ . @ @ @ . @ . @ . @ . @ @ @ . . . . @ . . @ . . @ . @ . @ . . . . . . . . . @ . . . . @ . . . @ @ @ . . . . @ . @ . @ . @ @ @ @ . . @ @ 
@ @ @ . . @ @ @ . @ . @ . . @ . @ . @ @ @ @ @ @ @ . . . @ . . @ . . @ . . . @ . . . @ @ @ . . @ @ @ @ @ @ @ . @ . . . . . @ . @ . @ . @ . @ @ . @ . @ . @ @ . . @ . @ @ . @ @ @ . . . @ . . . @ . @ . @ 
@ @ . @ . . @ . . . . @ @ . @ . . @ @ . . . . . @ @ . @ . @ . . . @ . @ . @ . @ @ . . @ . . @ . @ @ @ @ @ . . . @ . @ @ @ . . . @ @ @ . . @ . . @ @ @ . @ . . @ @ . . @ @ @ @ . @ . @ . @ @ . @ . @ . @ 
@ . . . @ . . @ . @ . @ . . . @ @ . @ . @ . @ @ . . . . . . . @ @ . . . . . . . @ . @ @ . @ . . @ @ @ @ @ @ . @ @ . . @ @ . @ @ . . . @ @ . @ . . . . . @ @ . . . @ . . . @ . . . . . . . . . . . . . @ 
@ @ . @ . @ . @ @ . . . . @ . . . . . . . @ . . @ . @ . @ . @ . . . @ . @ . @ @ @ . @ . . . . @ . @ . @ . . . . @ . @ . @ . . . . @ . . @ . @ . @ . @ @ . @ . @ . . . @ @ . @ . @ @ . @ @ @ . @ @ . @ @ 
@ . . . . @ @ . . @ . @ . . @ . @ . @ . @ @ . @ . . . @ @ @ . . @ @ . @ . . . @ . @ . @ . @ @ . . @ . . @ . @ . . . . . . . @ @ @ . @ @ . . @ . . @ . @ . @ . @ . @ . . . . . . @ @ @ . @ . . . . @ . @ 
@ @ . @ @ . . . @ . @ @ . @ . @ . . . @ . . . . . @ @ . @ @ . @ . @ . . @ @ @ @ . . . @ . @ @ . @ . . @ . @ @ . @ . @ @ . @ . . . . . @ . @ . . @ . . . . . @ . . . @ @ . @ . @ . @ . . . . @ @ . . . @ 
@ . . . . @ @ . . . @ . . . . @ @ . @ . . @ . @ . . @ . . . . @ . . . @ . . . . @ @ . @ . . . . . @ . . . . @ . . @ . . @ . . @ . @ @ @ . . @ . @ . @ @ . @ . @ . @ . . . . @ . . @ . @ @ . @ @ . @ @ @ 
@ @ . @ @ @ @ . @ @ . @ . @ . @ @ @ . @ . . @ . . @ . . @ @ . @ . @ . . . @ . @ . . . . . @ . @ @ . . @ . @ . . @ @ @ . . @ @ . . . @ . @ . . . . @ @ . . . . @ . . @ . @ @ . @ . . @ . . . . . @ . @ @ 
@ . . . . @ @ . . @ . . . . @ @ @ @ . . . @ @ @ . . . @ . . @ . . @ . @ @ . @ @ . @ @ . @ . @ @ @ @ . @ . @ . @ . @ . . @ . @ @ . @ . . . . @ @ @ @ . @ . @ @ . @ . @ @ . . . @ . @ @ . @ . @ . . . . @ 
@ @ . @ . . . . @ @ @ . @ @ . @ @ @ . @ . . @ . . @ @ . @ . @ . @ @ . . . . . @ @ @ @ . @ . . @ @ . . . @ . . . . @ @ . . . . . . . . @ @ . . . . . . . . . . . . . . @ @ . @ . . . . @ @ @ . . @ . @ @ 
@ @ @ . @ . @ @ . @ @ . . . . . @ . @ @ . @ . @ . . @ . . . . @ @ . . @ . @ . @ . @ . . @ . @ . @ @ . @ . . @ @ . . . . @ @ . @ . @ . @ @ . @ @ . @ @ . @ @ @ . @ @ @ @ . . . . @ . @ . @ @ @ . . @ . @ 
@ . . . . . . . . . @ . @ . @ @ @ . . @ @ . . . . @ . . @ . @ . . @ . . @ . . . . . @ . . . . . . . . . . @ @ @ . @ . @ . . @ . @ @ @ . @ . . . @ . . . @ . @ . @ @ @ . @ . @ . @ . . . . @ . . @ . . @ 
@ @ . @ . @ . @ . @ . . @ . . @ . . @ . @ . @ . @ @ . @ . . . . @ . . @ @ @ . @ @ @ . @ . @ @ . @ . @ . @ . @ . @ . . . . @ . . . . @ . . @ @ . @ . @ @ . . . . . @ . . @ . . @ @ @ @ . @ @ @ . @ . @ @ 
@ @ . @ . @ . @ . . @ . . @ @ @ @ . . . . . . @ @ . @ . @ . @ . @ . @ . @ @ @ . . . . @ . . @ @ @ @ . . @ . @ . @ @ @ . @ @ . @ @ @ @ . @ @ @ . . @ @ @ @ @ . @ @ . @ . . . @ . @ @ . . . @ @ @ @ . . @ 
@ . . @ . @ @ . @ . . @ . . . @ @ . @ @ . @ . @ . . . . . . . @ . . . . . @ @ @ @ @ . @ . @ @ @ @ @ @ . . . . . @ @ @ @ @ @ . . . @ . . . @ . @ @ @ @ @ @ . . . . . . @ @ . . . . @ @ . @ @ . . . . @ @ 
@ . @ . . @ . . @ . @ . . @ @ . @ . @ @ @ . @ @ @ . @ . @ . @ . @ . @ . @ @ @ . @ . . . . . @ @ @ @ . . @ . @ @ . . @ @ @ @ @ . @ . @ . @ . . . . @ @ @ @ @ . @ . @ @ @ . . @ @ @ . @ @ @ @ @ @ @ . @ @ 
@ . . @ . @ . @ . . . @ . . . . @ . . @ . . . @ . @ . . . @ . . . . @ . . @ . . . . @ . @ @ . . @ @ @ . @ @ . . . @ @ @ @ . . . . . . . . . @ . @ @ @ @ @ . . . @ . @ @ @ . . @ . . . . @ @ @ @ . . . @ 
@ . @ @ @ . . @ @ @ . . . @ . @ @ . @ . @ . @ . . . @ . @ . . @ @ . @ @ @ . @ @ @ @ . . . @ . @ . @ . . @ @ @ @ . . @ @ . @ @ . @ . @ . @ . . @ . @ @ @ @ @ . @ . . . . @ . @ . @ . @ . . @ . . @ . @ @ 
@ @ @ @ . @ . @ . . . @ . @ @ @ @ . @ . . . @ . @ . . . . . @ @ . @ . @ . . @ . @ . @ . @ . . . . @ @ @ . @ . @ . @ . . . . . . . @ . @ . @ @ . . @ @ @ @ . . @ @ . @ . . . . . . . @ . @ @ . @ . . . @ 
@ . . . . . . . @ @ . . @ . . @ @ . @ @ @ . @ . . @ @ . @ . . . . . . . @ . . . . . . . . . @ . @ . . @ . . . . . . . @ @ . @ . @ @ . . . . @ . @ @ @ @ . @ . . @ . @ @ . @ . @ . @ @ @ @ . . . @ . @ @ 
@ @ . @ . @ . @ @ @ . @ . @ . . @ . . @ . . @ . @ . @ . . @ @ @ @ . @ . @ . @ @ . @ @ . @ . . @ @ . @ . @ . @ . @ @ @ @ @ . @ . . . . @ @ . @ . @ @ @ . . @ @ . @ . @ . @ . . . @ . @ . . @ @ . . . . @ 
@ . . . @ . . . @ . . . . . @ . @ . @ @ @ . @ . . . @ @ . . @ . @ . @ @ . . . . @ . . . . @ . . . . . . . . @ @ @ . . @ . @ @ . @ . @ . . . @ . . @ . . @ . . . . . . . . @ . @ @ . @ . @ . @ @ @ . @ @ 
@ @ @ @ . @ . @ . @ . @ @ . . . . . . @ . . . . @ . @ @ @ @ . . . @ . . @ . @ @ . . @ . @ . @ . @ @ @ @ @ @ @ . @ . @ . . . . @ @ . . @ @ . . . @ @ @ . . . @ . @ . @ . @ @ . @ . . @ . . . . @ . . . @ 
@ @ @ @ . @ . @ . . . . @ . @ @ . @ @ . . @ . @ . @ @ @ @ @ . @ . . . @ @ . . . @ @ . @ @ . @ @ . . . . . . . . . . . . @ . @ . . @ @ . @ . @ . . @ . . @ . @ . . @ . . . @ @ @ @ . @ . @ . @ . @ . @ @ 
@ @ @ . . . . @ . @ . @ . . @ . @ @ @ @ . @ . . . . @ . @ . . . @ @ @ . . . @ @ . . . . @ . . @ . @ @ @ . @ . @ . @ @ @ @ @ . @ . . . . . @ . . @ @ @ . . @ . . @ @ @ . @ . . @ . . @ . . @ @ . . . . @ 
@ @ @ @ . @ . . @ @ . @ @ @ . . . @ . . @ . . @ . @ . . . . @ . . . . . @ @ . . @ . @ . @ . @ . . @ . @ @ . @ . . . @ . @ . . . @ . @ . @ . @ . @ @ @ . @ . @ . . . . @ . @ . . @ . @ . @ . @ . @ . @ @ 
@ @ @ @ @ . . @ @ . . . @ . @ . @ . @ . . @ . @ @ . . @ . @ . . @ . @ . @ @ . @ . @ . . @ . . . @ . . . @ . . @ @ @ . . . @ . @ . @ . . . . . @ . @ . . @ . @ . @ @ @ . . . . @ . . @ . . . . . . @ @ @ 
@ @ @ @ @ @ . @ @ @ . @ @ . . . . . . . @ . . . . @ . . @ . . @ . . . @ @ @ . @ . . @ . . . @ @ . . @ . . @ . @ . @ . @ @ . . . . . @ . @ . @ @ . @ @ . @ . . . . . . . @ @ @ . @ . @ . @ @ . @ . @ @ @ 
@ @ @ @ . @ . @ @ @ . . . @ @ . @ . @ @ . @ . @ @ . . @ . . @ @ @ . @ @ @ @ . @ . @ . @ . @ . @ . @ . @ . . . . . . . . . . @ . @ . . . . @ . @ . . @ . @ @ . @ . @ . @ @ @ . . . . @ . . . @ @ . . @ @ 
@ @ @ . . . . @ @ . . @ @ . . . . @ . . . . . . @ . @ . @ . . . . @ @ @ @ . . . . . . . . . . . . . . . @ . @ . @ . @ . @ . @ . . @ . @ . . . . . @ @ @ . . . @ . . @ @ @ . @ @ @ . @ . @ @ . . . @ @ @ 
@ @ @ @ . @ . @ . . @ . . @ @ . @ . @ @ . @ @ @ . . . . @ . @ . @ . . @ . . @ . @ @ . @ . @ . @ . @ . @ . . . @ . . @ . . @ . @ @ . @ @ @ . @ . @ . @ . . @ . @ . @ . @ . . @ . . . @ . @ . . @ @ @ @ @ 
@ @ @ @ @ . . @ @ . . . @ . . . . . . . . . . @ . @ . @ @ . @ @ @ @ . . @ . . @ @ @ @ . @ @ . . @ . . . @ . @ . @ . . @ . . . . . . . . . @ . . . . . @ . @ . @ . . . . @ . . . @ . @ . . @ @ @ . @ @ @ 
@ @ @ @ @ @ . @ . . @ @ . . @ . @ @ @ @ @ @ @ . . @ . @ . . @ @ @ @ . @ . . @ @ @ @ @ . . @ . @ @ @ . @ @ @ . . . @ . @ . @ . @ . @ . @ . @ @ . @ . @ @ @ . . @ . @ @ . @ . @ @ . . @ . @ @ . . . . . @ 
@ @ @ @ @ . . . @ . . @ . @ . . . @ . . . @ . . @ . @ . @ @ @ @ @ . . . . @ @ @ @ @ . @ . . . . @ @ @ @ @ . @ . @ . @ . @ . @ . @ . @ . @ @ @ @ . @ @ @ . @ . . @ @ . @ . . @ . @ . @ . . @ @ . @ @ @ @ 
@ @ @ @ @ . @ . . . @ . @ . @ . @ . @ . @ . @ . @ . . . . @ @ @ @ @ . @ @ @ @ @ @ . . . . @ . @ . @ . @ . . . . . . . . . . . . . . . . . @ . . . . @ . . . . @ . @ . . @ @ @ . . . @ . @ @ . . @ @ . @ 
@ @ @ @ . @ . @ @ . . . . . . . . . . . . . . . . . @ . @ @ @ @ @ . . @ @ @ @ @ @ @ @ . @ . . . . . . . . @ @ . @ @ . @ @ . @ . @ . @ . @ @ . @ . @ . @ @ @ @ @ . @ . @ . @ . @ @ . @ . @ . @ . @ . . @ 
@ . @ . . . . . . . @ @ . @ . @ . @ . @ . @ . @ . @ . @ @ @ @ @ @ @ . . @ . . @ @ @ @ . @ @ . @ . @ @ . @ @ @ @ . . @ . . @ . @ . @ . @ @ . . . @ @ . @ @ . . . . . . . . . . . . . . . . . . . . @ . @ 
@ . . @ . @ . @ . @ . . . . @ @ . . @ @ . . @ @ . . . . @ @ @ @ @ . . @ . @ . @ @ @ @ @ . . . @ . @ . @ . @ . @ . @ . @ . . . . . . . @ . @ . @ . . . . . . @ . @ . @ . @ . @ @ . @ . @ . @ . @ . . . @ 
@ @ . @ @ . . . @ . . @ . @ @ @ . @ @ @ @ @ @ @ . @ . @ . @ @ @ . @ . . . . . . @ @ @ . @ @ . . @ . . . . . . @ . . . . . @ @ . @ @ @ @ . . . . . @ @ . @ . . @ . . . @ @ . @ @ @ @ . . @ @ @ . . @ @ @ 
@ . . @ @ @ . @ @ @ @ . . . . . @ . @ @ @ . @ @ @ . . . . . . . . . . @ . @ . @ . @ . . @ . . @ @ @ . @ . @ @ . . @ . @ @ . . @ @ . . . @ @ . @ . @ @ @ @ @ . @ . @ @ . @ @ . @ . @ . @ @ @ . . @ @ @ @ 
@ @ . . @ @ @ @ . @ . @ . @ . @ @ . . . . . . . . @ . @ @ . @ . @ . @ . @ @ . . . . @ . . @ @ . . @ . . @ . @ . @ . . @ . . @ @ @ @ @ . . @ . . @ @ @ . @ . @ . . @ . . . @ . @ . . . . @ @ . @ @ . . @ 
@ @ @ . . @ @ . . . . . . . @ . . . @ . @ . @ @ . . . @ . . . @ . . @ . @ @ . @ . @ . . @ @ . . @ . . @ . . . . . @ . @ . @ . @ @ . @ . @ . @ @ . @ . . . . @ @ @ . @ . @ . . @ . @ . @ . @ @ . @ . @ @ 
@ @ @ . @ . @ @ . @ . @ @ @ . @ . @ . . . @ . @ @ @ . @ @ . @ @ @ . . . . @ @ . . @ . @ @ @ . @ . @ . . . @ . @ @ . @ . . . . . . . . . . . . . . . @ @ @ . . @ . . . . @ . @ . @ . . . . . . . . . . @ 
@ . . . . . @ . @ . @ @ @ @ . . . @ @ . @ . . . . . . . @ . . @ @ . @ @ . . . @ . . . . @ . . . . . . @ @ . @ . . . @ . @ @ @ @ . @ @ @ @ . @ . @ . @ . . . @ . @ . @ . . . . . . . @ . @ @ @ @ . @ @ @ 
@ . @ . @ . . . . . @ @ @ . @ . @ . . . . @ . @ . @ . @ . . @ . @ . . . @ . @ @ . @ . @ . @ . @ @ @ @ . . . . @ . @ . . . . . @ . . . . . @ . . . @ . @ @ . . . . @ . . @ @ . @ . @ @ @ . . . . @ . @ @ 
@ . . @ @ @ @ . @ . @ . . . . @ . . @ . @ @ . . @ . . . @ . . . . @ . @ @ . @ . @ @ . . . . . @ . . . @ . @ @ . . . . @ @ @ @ . @ . @ . @ @ @ . @ . . . . . @ . @ . @ . . @ . @ . . @ . . @ . @ . . @ @ 
@ . @ @ @ @ . . . @ . @ . @ . @ @ @ . . @ . . @ @ @ . @ @ . @ . @ @ . . @ . . . @ . @ @ @ @ @ . @ . @ . . . . . @ @ . . . . . . . @ . @ . @ . @ @ @ . @ . @ . @ @ . @ . @ @ @ . . @ . @ . . @ @ . @ @ @ 
@ . @ @ @ . @ . @ . . . . . @ . @ @ @ . @ . @ . @ @ . . . @ @ . . @ . @ . . @ . . . . . . . . . . . . . @ . @ . . . @ @ @ . @ . @ . . @ . . . @ @ . . . @ @ . @ . . . . . @ @ @ . @ . . . @ . . . . . @ 
@ . . @ @ . . . . @ . @ @ . . . . @ . @ . @ . . @ . @ @ . . . @ . . @ @ @ . @ . @ . @ . @ @ . @ @ . @ @ @ @ . . @ @ @ @ @ @ @ . @ . @ . @ . @ . @ . @ @ . . . @ @ . @ . @ . @ @ @ @ . @ . @ . @ @ @ . @ 
@ . @ . @ @ . @ . @ . @ @ . @ . @ . . @ . @ @ . . . . . @ . @ . @ . . @ . . @ . . @ @ . . @ . . . @ . . @ @ @ . @ @ @ @ @ . @ . . . . . . . . . . . . . . @ . @ . . . @ @ . . @ @ . @ . . . . @ . @ . @ 
@ . . . . . @ . . . . . . @ . . @ @ . . . . . . @ . @ . . . . . . @ @ . @ . . @ . @ @ @ . . @ . @ . @ . . @ @ @ @ @ @ @ @ . @ . @ @ . @ . @ . @ @ . @ . @ . . . @ . @ . @ . @ . . . . @ . @ . . . . @ @ 
@ . @ @ . @ . @ @ . @ . @ . . @ . . . @ . @ . @ . . @ @ @ @ . @ . . . . @ . @ . @ . @ @ . @ . . @ . @ . @ @ @ @ @ @ @ @ . . . . . . @ @ . . @ . . . @ @ . . @ . . . . . . . . . @ @ . . . . @ . @ . @ @ 
@ @ @ . @ @ . @ . . @ . . @ . . @ @ @ . . @ . @ @ @ . . . . . . @ @ . @ . . . . . . . . @ @ @ . . . . . . @ @ @ @ @ . @ @ @ @ . @ . . . @ . @ @ @ . @ . @ @ @ @ @ . @ . @ . @ @ . . @ @ . @ . . . @ @ @ 
@ . . . . . . . . @ . . @ @ @ . @ @ @ @ . . @ . . . . @ @ @ . @ . @ @ . . @ . @ . @ . @ . . . @ @ . @ . @ @ @ @ @ . . . . @ . . @ @ @ . @ . . . . @ . . . . @ @ @ @ . . . @ @ @ @ . . . . @ @ . @ @ @ @ 
@ . @ . @ . @ @ . . @ . @ @ . . . . . . . @ . . @ @ . @ @ . . @ . . . @ . @ . . @ @ . . . @ @ @ @ . . @ . . @ . . @ . @ @ . @ @ @ . @ . @ . @ @ . . . @ @ @ . @ @ @ @ . @ @ . @ . @ @ . @ @ @ @ . @ @ @ 
@ @ . . @ @ . . . @ . . . . @ . @ . @ @ @ @ @ . . . @ @ . @ . @ . @ . . @ . @ . . . @ . @ . . . . . @ . @ . . @ . . . . @ . @ . @ . @ . . @ . @ . @ . . . . . . @ @ @ . . @ . @ . . @ . . . . . . . @ @ 
@ . . @ . @ @ @ @ . @ . @ . . @ . . @ @ @ @ @ . @ . @ . . . . . . . @ . @ . . @ @ . . @ @ @ . @ @ . . . . . @ . @ @ . @ . . . . . . . @ . . . @ . @ . @ @ . @ . @ @ @ . @ . . @ . @ . @ . @ @ @ @ @ @ @ 
@ @ . @ . . . . . . . . . @ . . @ @ @ @ @ @ . . . @ . @ . @ . @ . @ @ @ @ @ . . . . @ . . . @ . . . @ . @ . . . . . . . . @ @ . @ . @ @ . @ . @ . . @ . . . . @ . @ . @ . @ . . . . . . @ . . . . . @ @ 
@ . . @ @ @ @ . @ @ @ . @ @ . @ @ @ @ @ @ . @ @ @ @ . @ @ . . . @ @ @ @ @ @ @ . @ . @ . @ . . @ @ . @ . . @ . @ . @ . @ . @ @ . . @ @ @ . @ . . @ . . @ . @ . . . . . . . . @ . @ @ @ @ . @ . @ . @ . @ 
@ @ . . . . . @ . @ . . . . @ @ @ @ @ @ @ . . . . . . . . . @ @ . @ @ @ @ @ . @ . @ . . . @ . @ . . @ . @ @ @ @ @ @ . . @ . @ . @ @ @ @ @ @ @ . @ . @ @ @ @ . @ @ . @ . @ . . . . . . . . . . . @ @ . @ 
@ @ . @ . @ . . . @ . @ @ @ @ @ @ @ @ @ @ @ @ . @ @ . @ @ @ . . . . @ @ @ . . @ . . . @ @ . @ @ @ . . @ . @ . @ @ . . @ @ . @ @ . @ . @ . . . @ @ . . . . . @ . . . . @ . . @ @ . @ @ @ . @ . @ @ . . @ 
@ @ @ . . . @ . @ @ @ @ @ @ @ @ @ @ @ @ @ @ @ . . . @ . @ . @ . @ . . @ . @ . . @ @ . @ . . . @ . . @ . . . . . . @ . . . . . . . . . . . @ @ . @ . @ . @ @ @ @ @ . @ . @ . . @ . @ @ . . @ @ . . @ . @ 
@ @ @ @ @ @ @ @ @ @ @ @ @ @ @ @ @ @ @ @ @ @ @ @ @ . . . . . . . . @ @ @ . @ . @ . @ . . . @ @ @ @ . . . @ @ . @ . @ . @ . @ . @ . @ . @ @ @ . . . . @ . @ . . . . . . . . @ . . @ @ @ @ . . . @ . . . @ 
@ @ @ @ @ @ @ @ @ @ @ @ @ @ @ @ @ @ @ @ @ @ @ . . @ . @ . @ . @ . . . . . . . . . @ . @ . . . . . @ . @ . @ @ . . @ . . @ . . . @ @ @ . . . . @ @ . . @ @ @ @ . @ . @ . @ @ . @ . @ @ . . @ . . . @ . @ 
@ @ @ @ @ @ @ @ @ @ @ @ @ @ @ @ @ @ @ @ @ @ . . @ . . . @ @ . . @ . @ . @ . @ . @ . . @ . @ . @ @ . . . . . . @ @ . . @ @ @ . @ . @ @ . @ . @ . . . @ . @ . . @ . . @ . . . @ . . . . @ . . @ . @ @ . @ 
@ @ @ @ @ @ @ @ @ @ @ @ @ @ @ @ @ @ @ @ @ . @ . @ @ . @ @ @ . @ . . . @ @ . . @ . . @ . @ @ @ @ @ . @ . @ @ . . . @ . . @ @ @ . . . . @ . @ . . @ . . . . @ . @ @ . . @ . @ . . @ . @ . . @ . . @ @ @ @ 
@ @ @ @ @ @ @ @ @ @ @ @ @ @ @ @ @ @ @ @ . . . . . . . . . . @ @ @ . @ @ . @ @ @ @ . @ . . @ @ @ . . @ . @ @ @ . @ @ . @ @ @ @ @ . @ @ . . @ @ . . @ . @ . . . . . @ . . @ @ . @ . @ . @ . . @ @ . @ @ @ 
@ @ @ @ @ @ @ @ @ @ @ @ @ @ @ @ @ @ @ @ @ . @ . @ @ . @ . @ . @ . @ @ . . @ @ @ @ . . . @ . . . @ . @ . . @ . . @ @ . . @ . @ . . . @ . @ . . @ . . @ . . @ . @ . . @ . . . . . . . . @ . @ . . . . . @ 
@ @ @ @ @ @ @ @ @ @ @ @ @ @ @ @ @ @ @ @ @ @ . . @ . . . @ . . . . . . @ . @ @ . @ @ . @ . @ @ . @ . @ . @ @ @ . @ @ . @ . . . @ . @ . . . @ . . @ . . @ . @ @ . . @ @ . @ . @ . @ @ . . @ . . @ @ @ . @ 
@ @ @ @ @ @ @ @ @ @ @ @ @ @ @ @ @ @ @ @ @ @ @ @ . . @ . @ @ . @ . @ . . . . . . . . . . . . . . . . @ . @ @ . . . . @ @ . @ @ . . . . @ . . . @ . . @ @ @ . . @ . . . @ . . . @ @ @ . @ . @ . . . . @ @ 
@ @ @ @ @ @ @ @ @ @ @ @ @ @ @ @ @ @ @ @ @ @ @ @ @ . @ @ @ . @ . @ . @ . @ . @ . @ . @ . @ . @ . @ . @ . @ @ . @ . @ . . . . . . @ . @ @ @ @ @ . @ . . @ @ . @ . @ @ . @ @ . @ @ @ . . . . . . @ @ @ . @ 
@ @ @ @ @ @ @ @ @ @ @ @ @ @ @ @ @ @ @ @ @ @ @ @ . . . @ @ . @ . . . . . . @ . . . @ . @ . . . @ @ @ @ @ . . . @ . . . @ @ @ . @ @ . . . . . . . . @ . @ . . . . @ . @ . . . . . @ @ . @ . @ . . . . . @ 
@ @ @ @ @ @ @ @ @ @ @ @ @ @ @ @ @ @ @ @ @ @ @ @ @ . @ . . . . . @ . @ . @ . @ . @ . . . @ . @ @ @ @ @ . @ . @ . . @ @ @ @ @ @ @ . . @ @ . @ . @ @ . @ @ @ @ @ . . . . . @ @ @ . . . @ @ . @ . @ . @ . @ 
@ @ @ @ @ @ @ @ @ @ @ @ @ @ @ @ @ @ @ @ @ @ @ @ @ @ @ @ . @ . @ . . @ @ @ . @ @ . @ @ . . . @ . @ . . . . . . @ . . @ @ @ @ @ @ @ . . . @ @ . . . . . @ . . . . @ . @ . . . @ . @ . . . @ @ . . @ @ @ @ 
@ @ @ @ @ @ @ @ @ @ @ @ @ @ @ @ @ @ @ @ @ @ @ @ @ @ @ @ @ . . @ . @ . . . . . . . . . . @ . . . @ @ . @ @ . @ . . @ @ @ @ @ @ @ @ @ . @ . @ . @ @ . @ . @ . @ . . @ . . @ . @ @ . @ . @ . . . @ @ @ @ @ 
@ @ @ @ @ @ @ @ @ @ @ @ @ @ @ @ @ @ @ @ @ @ @ @ @ @ @ @ . . @ @ . @ . @ . @ . @ . @ . @ . . @ . . . @ @ @ @ @ . @ @ @ @ @ @ @ @ @ @ . . . . @ . . . . . @ . . @ . . @ . . @ . . . . . . @ . @ @ @ @ @ @ 
@ @ @ @ @ @ @ @ @ @ @ @ @ @ @ @ @ @ @ @ @ @ @ @ @ @ @ @ @ @ @ @ @ @ @ @ @ @ @ @ @ @ @ @ @ @ @ @ @ @ @ @ @ @ @ @ @ @ @ @ @ @ @ @ @ @ @ @ @ @ @ @ @ @ @ @ @ @ @ @ @ @ @ @ @ @ @ @ @ @ @ @ @ @ @ @ @ @ @ @ 
3
31 85 92 95
1 65 85 73
12 30 59 69
