50 50
@ @ @ @ @ @ @ @ @ @ @ @ @ @ @ @ @ @ @ @ @ @ @ @ @ @ @ @ @ @ @ @ @ @ @ @ @ @ @ @ @ @ @ @ @ @ @ @ @ @ 
@ . . . @ . . @ . @ @ @ @ @ @ @ @ @ @ @ @ @ @ . . . . @ . @ @ @ . @ . @ . . . @ @ @ @ @ @ @ @ @ @ @ 
@ . @ . @ . @ . . . @ @ @ @ @ @ @ @ @ @ @ @ @ @ . @ . . . . @ . . . . . @ . @ @ @ @ @ @ . @ . @ @ @ 
@ . @ . @ . . @ . @ . @ @ @ @ @ @ @ @ . @ . @ @ @ . @ @ . @ . @ . @ . @ . . . @ @ @ @ . . . . . @ @ 
@ @ . . . . @ . . @ . . . @ . @ @ . . . . . . . . . . . . . . . @ . . . . @ @ . . @ . . @ . @ . . @ 
@ . @ @ . @ @ @ . . . @ @ . . . . @ @ . @ @ . @ . @ @ @ @ @ . @ . @ . @ @ . @ . @ . @ . . @ . . @ @ 
@ . @ . . . @ . . @ . . . @ . @ . . . @ . . . @ @ . . . . . . . . . . . . . . . . . . . @ @ @ @ @ @ 
@ . @ . @ @ @ @ . . @ . @ . @ @ @ . @ . . @ . @ . @ . @ . @ . @ . @ . @ . @ . @ . @ . @ . @ . . @ @ 
@ . @ . . . @ . @ . @ @ . . . @ . . . . @ . . . . @ . . @ . . . @ @ . . @ . . . @ @ . . . . @ . @ @ 
@ . . @ @ . . . . . @ @ @ @ . @ @ . @ . @ @ @ . @ . @ @ . @ . @ @ . . @ . . @ . . . @ . @ . . . . @ 
@ . @ @ @ . @ @ . @ . @ . . . . @ @ . . @ @ . . . . . . . @ @ . . . @ . @ . @ . @ . . @ . . @ @ . @ 
@ . . @ . . . . @ . . . @ . @ . @ . @ . . @ . @ @ @ @ @ . @ . . @ . . . . @ @ . . @ @ . . @ @ . @ @ 
@ . @ . @ . @ @ @ @ . @ . . . @ @ . @ @ . @ . @ . . . . . . @ . @ . @ . @ . . . @ @ . @ . @ . . . @ 
@ . . . . . . @ @ . . . @ . @ . . . . . . @ . @ @ @ @ @ . @ @ @ @ . . @ . @ @ . @ @ . . @ @ @ . @ @ 
@ @ . @ . @ @ . . @ . @ . . . . @ . @ . @ . . . . . . . @ @ @ @ @ . @ @ . . . . . . . @ . . . . . @ 
@ . @ . . . @ . @ . . . @ . @ . . @ . @ . @ . @ . @ . @ @ @ @ . . @ @ @ @ . @ . @ . @ . @ . @ @ @ @ 
@ . . @ . @ . . . . @ . . @ @ . @ . . . . . . . @ @ . @ @ @ @ . @ @ @ @ @ @ . . @ . . . . . @ . @ @ 
@ . @ . . . . @ . @ . @ @ @ @ @ . . @ . @ @ . @ @ @ . @ @ @ . . . @ @ @ @ @ @ @ . . @ @ @ . . . . @ 
@ . . @ . @ @ . @ @ . . @ @ @ @ . @ @ . . @ . . . . @ . @ . @ . @ . @ @ @ @ . . @ @ . . . . @ . @ @ 
@ . @ . . . . . . . . @ . @ @ . . . . @ . . @ @ @ . . . . . . . . . . @ @ . @ . @ . @ @ . @ @ . . @ 
@ . . @ . @ . @ . @ . . . . . @ . @ . . @ . @ . . . @ . @ @ . @ . @ . @ . . . . . . . . . . . @ . @ 
@ @ . . . . @ . @ @ @ @ . @ . . @ . . @ @ @ . . @ . @ . @ . . . @ @ @ . . @ . @ . @ . @ @ . @ . @ @ 
@ . . @ @ @ . . . @ . . . . @ @ . @ . . @ . @ . @ . . @ @ @ . @ @ @ @ @ . . @ . . . @ . @ . . . @ @ 
@ @ . . @ . @ . @ @ @ @ . @ @ . . . . @ @ . . . @ . @ @ @ @ . . . @ @ . . @ @ @ . @ . . . . @ @ . @ 
@ . . @ @ . . . . @ . . @ . . . @ @ . @ . . @ @ . . @ @ @ @ @ . @ . @ @ @ @ @ . . . @ . @ . . . . @ 
@ @ . . . @ @ @ . . . @ . @ . @ . . . @ . @ . . @ . @ @ @ @ . . . . . . . @ . @ . @ @ . @ . @ . @ @ 
@ . . @ @ . . . @ @ . . . . @ . . @ . @ . . @ . @ . @ . @ . @ . @ @ @ @ @ . . @ . . @ . @ @ . . @ @ 
@ @ . . @ . @ . . . . @ . @ . . @ . . @ . @ @ . . . . . . . . @ . . . @ . @ . . @ @ . . . . @ . @ @ 
@ . @ . . @ . . @ . @ @ . @ . @ . @ . @ . @ . . @ . @ . @ . @ . . @ . . . . @ . @ . @ . @ @ . . . @ 
@ . . . @ . @ @ . @ . . . @ @ @ . . . @ . . @ . @ @ @ . . @ . @ . @ . @ @ . . . . . . . . @ . @ @ @ 
@ . @ . . . . @ . . @ @ . . @ . . @ . @ . @ . . . @ . . @ . . @ @ . @ . @ @ . @ @ . @ . @ . . . @ @ 
@ @ @ @ . @ . . @ . @ . @ . . @ @ . . @ . . @ . @ @ @ . @ @ . . . . . . . . . . . @ . . . @ . @ @ @ 
@ . @ . @ . @ . . . @ . @ @ . @ @ @ . @ . @ . @ . @ . . . . @ @ . @ . @ . @ . @ . . @ . @ @ @ @ @ @ 
@ . . . . . . @ @ . . . @ . . . @ . . @ . . . . . @ @ . @ @ @ @ . @ . @ . @ . . @ @ @ . . @ @ @ @ @ 
@ @ . @ . @ . @ . @ . @ . @ . @ . @ . . @ . @ @ @ . . . . . . . @ . . . @ . . @ @ . @ . @ @ @ @ @ @ 
@ . . . @ . . . . . . . . . . . . . . @ . . @ . . . @ . @ . @ @ . @ @ @ . @ . @ . . @ @ @ @ @ @ @ @ 
@ @ . @ . @ . @ . @ . @ . @ . @ . @ . @ @ . @ @ . @ . . @ . . @ . . . . . . . . @ . . @ @ @ @ . . @ 
@ @ . @ . @ @ . . . @ . . @ . . @ . . . @ . . @ . . @ . . @ @ . @ @ . @ . @ . @ @ . @ . . @ . . @ @ 
@ @ @ . . . @ @ . @ @ @ @ @ @ . @ @ . @ @ . @ . . @ @ @ . . @ . . . . . @ . . . . . . . @ @ @ . @ @ 
@ @ @ @ . @ . @ . . @ . @ . @ @ . @ . . @ . . @ . @ . . . @ . @ . @ . @ . @ @ . @ . @ . . @ @ . . @ 
@ @ @ . . . . . . @ @ . . . . . . . . @ . . @ @ . . @ . @ . . . . @ . @ . . . . @ @ @ @ @ . . . @ @ 
@ @ @ . @ @ . @ . . @ . @ . @ @ @ @ . @ @ . . @ . @ . . . @ @ . @ @ @ @ . @ @ . @ . @ @ @ . @ @ . @ 
@ @ @ @ . . . . @ . . @ . @ @ @ . . @ @ . @ @ . . . @ . @ @ . . . @ @ . @ . . . . . . . . . . . . @ 
@ @ @ . . @ . @ . . @ @ . @ @ @ . @ @ . . @ @ @ . @ @ . . . @ . @ . . . . . @ . @ . @ . @ @ . @ . @ 
@ . @ . @ . . @ . @ . . . . @ @ . . @ . @ . @ @ . @ . . @ . @ . @ . @ @ . @ @ @ . . . @ . . . . @ @ 
@ . . . . @ . . @ @ @ @ . @ . @ . @ . . . . . @ . @ @ . @ . @ . @ @ . . . . . . @ @ @ @ @ @ . @ . @ 
@ . @ . @ . . @ . @ . @ . . . . . . . @ @ . @ @ . @ . . . @ . . . @ @ . @ . @ @ @ @ @ @ @ @ . @ . @ 
@ . @ . @ @ . . . . . . . @ @ @ @ @ @ . . . @ . . @ @ . @ @ @ . @ @ . @ @ @ @ @ @ @ @ @ @ @ . . . @ 
@ . @ @ . . . @ . @ . @ . . . . . . @ . @ . @ @ . @ . . @ @ . . . . . @ @ @ @ @ @ @ @ @ @ @ @ . @ @ 
@ @ @ @ @ @ @ @ @ @ @ @ @ @ @ @ @ @ @ @ @ @ @ @ @ @ @ @ @ @ @ @ @ @ @ @ @ @ @ @ @ @ @ @ @ @ @ @ @ @ 
3
46 30 33 20
4 30 23 17
18 20 41 39
