50 50
@ @ @ @ @ @ @ @ @ @ @ @ @ @ @ @ @ @ @ @ @ @ @ @ @ @ @ @ @ @ @ @ @ @ @ @ @ @ @ @ @ @ @ @ @ @ @ @ @ @ 
@ @ @ . . . @ . . @ . @ . @ @ . @ . @ @ @ @ @ @ @ @ @ @ @ @ @ @ @ @ @ @ @ @ @ @ @ . @ . @ . . . . @ 
@ . . . @ . . @ . . . . . . @ . . . . @ . @ @ @ @ @ @ @ @ @ @ @ @ @ @ @ @ @ @ @ . . . . . . @ @ @ @ 
@ @ . @ . . @ . @ @ . @ @ @ . @ @ . @ . . . @ @ @ @ @ @ @ @ @ @ @ @ @ @ @ . @ @ . @ . @ @ @ @ @ . @ 
@ @ @ . @ . . . . @ . . @ . . @ . . . @ . @ @ @ @ @ @ @ @ @ @ @ @ . . . . . @ . @ . . . . . @ . . @ 
@ . . . . . @ @ @ . @ . . . @ . . @ . . . @ @ @ @ @ @ @ . @ . @ . @ . @ . @ . . . @ . @ . @ . @ . @ 
@ @ @ . @ . . @ . . . @ @ . . @ . @ . @ . @ @ @ @ @ @ . . . . . . . . . @ . @ . @ . . . @ @ . . . @ 
@ @ @ @ . . @ . @ . @ . @ @ . . @ . . . @ @ @ @ @ @ . . @ @ . @ . @ . @ @ . . . . . @ . . @ . @ . @ 
@ . @ . @ . . . . . @ . . . . @ . . @ @ . @ @ @ @ @ @ . @ @ . . @ . . . . @ @ . @ @ . @ . @ @ . . @ 
@ . . . . . @ . @ . @ . @ @ . . @ . . . . . . @ @ @ @ @ . . . @ @ @ . @ @ . . . @ . . . @ . . . @ @ 
@ . @ . @ . . @ @ @ . . @ @ @ . . . @ @ @ . @ @ @ @ @ . . @ . . @ . . @ . @ @ . . @ @ . @ @ @ . . @ 
@ @ . . . @ . . @ . @ @ . @ . @ @ . . . @ @ @ @ @ @ @ @ @ @ @ . @ . @ . . @ . @ . . . . . @ @ . @ @ 
@ @ @ . @ . . @ . . . @ . @ . @ @ . @ . @ @ @ @ @ @ @ @ @ @ . @ . . . . @ . . . . @ . @ . . . . . @ 
@ @ @ . @ @ . . @ . @ . . @ . . . @ . . . @ @ @ @ @ @ @ @ . . . . @ . @ . @ . @ @ . . . @ . @ @ . @ 
@ @ . . . @ . @ @ . . . @ @ @ . @ @ @ . @ . @ @ @ @ @ @ . @ @ @ . . @ . . . . . @ @ . @ @ . . . @ @ 
@ . . @ @ @ . . @ . @ @ @ @ . . @ @ . . . . . @ @ . @ . . @ . . . @ . @ . @ @ @ . @ . . . @ @ . . @ 
@ @ . . @ . @ . . . . . @ . . @ . @ @ . @ @ @ . @ . @ @ . . @ @ . . . . . . . . . @ . @ . . . @ . @ 
@ @ @ . @ . . . @ . @ @ @ @ . . . . . . . . . . . . . . @ . @ . . @ . @ . @ . @ @ . . . @ . @ @ . @ 
@ @ @ @ . @ @ . . @ . . @ . @ @ @ . @ . @ . @ . @ @ . @ . . . @ . . @ . . . @ @ @ @ . @ @ . . . @ @ 
@ @ @ . . . . . @ @ @ . . . @ . . @ . . . @ . . . . @ . . @ . @ . @ @ @ . @ @ @ @ @ . . . @ . @ @ @ 
@ . . . @ . @ . . @ . . @ . @ . @ @ @ . @ @ @ . @ . . @ @ @ . @ . . @ @ @ @ @ @ @ @ @ @ . @ . . @ @ 
@ . @ . . @ . . @ . @ . @ . . . . @ @ . . @ . . @ . @ @ @ @ . . . @ @ @ @ @ @ @ @ @ @ @ @ . . @ @ @ 
@ @ . @ @ . @ . . . @ @ @ . @ @ @ . . @ @ . @ . @ . . @ @ . @ @ . @ @ @ @ @ @ @ @ @ @ @ @ . @ @ . @ 
@ . . . . . . . @ . . @ . . . @ @ @ . . . . . . . @ . . . . @ . . . @ @ @ @ @ @ @ @ @ @ . . . . . @ 
@ . @ . @ . @ . . @ . @ @ . @ . @ . @ . @ . @ . @ . . @ . @ @ @ . @ . @ @ @ @ @ @ @ @ . @ . @ . @ @ 
@ . . @ . . @ . @ . @ . . . . . . . . @ . @ @ @ . @ . . @ @ @ @ . . . . @ @ @ @ @ @ . . . . @ . . @ 
@ . @ . . @ . . @ . . . @ @ @ @ @ @ @ . . . . . . . . @ . @ @ . . @ . @ @ @ @ @ @ @ @ . @ . @ @ . @ 
@ @ . @ . . @ . @ . @ . . . . @ . . . . @ @ @ @ @ @ . . . . . @ . . @ @ @ @ @ @ @ @ @ @ . . . . @ @ 
@ @ . . . @ . . @ . . @ . @ @ . . @ @ @ . . . . . . . @ . @ @ . @ . @ @ @ @ @ . . @ . . @ . @ . . @ 
@ @ @ . @ . . @ . @ . . @ @ @ @ @ . . . . @ @ . @ @ @ . . . . . . . @ @ @ . . . @ . @ . . . @ . @ @ 
@ . . @ @ @ . . . . . @ @ @ . . . @ @ . @ @ @ @ @ . . @ @ . @ . @ . . @ . @ @ . . . @ @ . @ . . . @ 
@ @ . @ @ . @ @ . @ @ . @ . @ @ . . . @ @ @ @ @ @ @ . @ @ . . @ . @ . . . . @ . @ @ @ @ @ @ . @ . @ 
@ @ . @ . . @ . . @ . . . . . @ . @ @ . @ . @ @ . @ . . @ . @ . . . @ . @ @ . . . . @ @ @ . . @ . @ 
@ @ . . @ . . . @ . @ . @ . @ . . . @ . . . . . . . . @ . @ @ @ @ . . . . @ . @ . @ . @ @ . @ . @ @ 
@ @ @ . . @ @ . . . . . . @ . . @ . . . @ @ . @ . @ @ . . . . . . . @ @ . . . . @ . . . . @ . . . @ 
@ @ . @ . @ . @ @ @ @ . @ . . @ . @ @ . @ . @ . . @ @ @ . @ . @ @ . . @ . @ . @ @ . @ @ @ . @ . @ @ 
@ . . . . . . . . . . . . @ . . . . @ @ @ . . @ . @ . @ @ @ @ @ @ @ @ @ @ . . . @ . . . . . . . . @ 
@ . @ . @ @ . @ . @ . @ . . @ . @ . @ . @ . @ . @ . . . @ @ . @ @ @ @ @ @ @ @ . . . @ . @ . @ . @ @ 
@ @ . . @ @ @ . @ @ . @ @ . @ @ . . @ . . . . . . @ . @ . . . . @ @ @ @ @ . @ . @ @ . @ . @ . @ @ @ 
@ . . @ @ @ . . @ . @ . @ . @ . @ . @ . @ @ . @ . . . . . @ @ @ @ @ @ @ . . . . . . . @ . . . @ @ @ 
@ @ . @ @ . @ . @ . . . . . . . . . . . @ @ @ . @ @ . @ . @ . @ @ @ @ @ @ . @ . @ . @ . @ . @ . @ @ 
@ @ @ . . . . . . . @ . @ . @ . @ . @ . . @ . . @ . . . @ . . @ @ @ @ @ . . @ . @ . . . . . . . . @ 
@ @ . . @ . @ . @ @ @ @ . @ . . . @ . . @ @ @ . @ @ . @ . @ . . @ @ . @ @ . . @ @ . @ @ @ . @ . @ @ 
@ . @ . @ . @ . @ @ @ @ . . @ . @ @ @ . @ @ . . . @ . . . . @ . . @ . . @ . @ . @ . . . . @ @ . . @ 
@ . . . . @ @ @ @ @ @ . . @ @ . @ @ @ . @ . @ . @ . @ @ @ . @ . @ . @ . . . . . . @ . @ . . . @ . @ 
@ @ @ . @ @ @ @ @ @ . . @ @ . . . @ @ @ . . . . . . @ @ @ . @ . . . . . @ @ . @ @ . @ @ @ . @ . @ @ 
@ . . . . . @ . @ . @ . @ . . @ @ @ @ @ @ . @ . @ . . @ . . . . @ . @ @ . . @ @ @ . . @ @ . . . . @ 
@ @ @ . @ . . . . . . . @ @ . . . . . @ . . . @ @ . @ . @ @ . @ . @ . @ . @ . @ @ . @ . . @ . @ . @ 
@ @ @ . . @ @ @ . @ . @ @ @ @ . @ . @ @ @ . @ @ . . . . . . . . . . . . . . . . . . . . @ @ @ @ @ @ 
@ @ @ @ @ @ @ @ @ @ @ @ @ @ @ @ @ @ @ @ @ @ @ @ @ @ @ @ @ @ @ @ @ @ @ @ @ @ @ @ @ @ @ @ @ @ @ @ @ @ 
3
47 21 30 34
17 45 37 13
32 7 44 11
