12 12
@ @ @ @ @ @ @ @ @ @ @ @ 
@ @ @ @ . . . @ @ @ @ @ 
@ . @ . @ . @ @ @ @ @ @ 
@ . . . . . . @ @ @ @ @ 
@ . @ @ @ . @ @ @ @ @ @ 
@ @ . @ . . . . . @ @ @ 
@ @ . . @ @ . @ @ . @ @ 
@ . @ . . @ . . @ . @ @ 
@ . @ . @ @ . @ . . . @ 
@ . . . . . . . . @ . @ 
@ @ @ . @ . @ . @ @ . @ 
@ @ @ @ @ @ @ @ @ @ @ @ 
3
10 5 4 5
10 10 9 2
5 5 6 6
