25 25
@ @ @ @ @ @ @ @ @ @ @ @ @ @ @ @ @ @ @ @ @ @ @ @ @ 
@ @ . @ @ . . . . . . @ @ @ @ @ @ @ @ @ @ @ @ @ @ 
@ @ . . . @ . @ . @ . @ @ @ @ @ @ @ @ @ @ @ @ @ @ 
@ @ . @ . @ @ @ @ . . . @ @ @ @ @ @ @ @ @ @ @ @ @ 
@ @ @ . . . . @ . @ . @ . @ @ @ @ @ @ @ @ @ @ @ @ 
@ @ . @ . @ @ . . . . . . . @ @ @ @ @ @ @ @ @ @ @ 
@ . . . . @ . @ . @ . @ @ . @ @ @ @ @ @ @ @ @ @ @ 
@ . @ @ . . . @ @ . . @ @ @ @ @ @ @ @ @ @ @ @ @ @ 
@ @ @ . . @ . . @ . @ @ @ @ @ @ @ @ @ @ @ @ @ @ @ 
@ . . @ @ . . @ . . . @ @ @ @ @ @ @ @ @ @ @ @ @ @ 
@ . @ . @ . @ . @ . @ . @ @ @ @ @ @ @ @ @ @ @ @ @ 
@ . . . . . . . . . . . . @ @ @ @ @ @ @ @ @ @ @ @ 
@ . @ . @ @ @ @ . @ . @ . . @ @ @ @ @ @ @ @ @ @ @ 
@ @ . . . . . @ . . @ @ @ . . @ @ @ @ @ @ @ @ @ @ 
@ @ @ . @ . @ @ @ @ . @ . @ . @ @ @ @ @ @ @ @ @ @ 
@ @ @ @ . @ @ @ . . . . . . . . @ @ @ @ @ @ @ @ @ 
@ @ . @ . . @ . @ @ . @ . @ . @ . @ @ @ @ @ @ @ @ 
@ . . . . @ @ . . @ @ . . @ . @ . . @ @ @ @ @ @ @ 
@ @ . @ . . @ . @ . @ @ @ . . @ . @ . @ @ @ @ @ @ 
@ . . . @ @ . . . . . . . @ . . . . . . @ @ @ @ @ 
@ @ . @ . @ . @ @ @ . @ . . . @ @ . @ . @ @ @ @ @ 
@ . . . . . . . . . @ . @ @ . . . @ . @ @ @ @ @ @ 
@ . @ . @ . @ . @ @ . . . . . @ . . . . @ @ @ @ @ 
@ @ . . . @ . . . . @ . @ . @ . . @ . @ @ @ @ @ @ 
@ @ @ @ @ @ @ @ @ @ @ @ @ @ @ @ @ @ @ @ @ @ @ @ @ 
3
19 10 23 11
22 1 3 11
9 1 21 14
