100 100
@ @ @ @ @ @ @ @ @ @ @ @ @ @ @ @ @ @ @ @ @ @ @ @ @ @ @ @ @ @ @ @ @ @ @ @ @ @ @ @ @ @ @ @ @ @ @ @ @ @ @ @ @ @ @ @ @ @ @ @ @ @ @ @ @ @ @ @ @ @ @ @ @ @ @ @ @ @ @ @ @ @ @ @ @ @ @ @ @ @ @ @ @ @ @ @ @ @ @ @ 
@ @ . @ . . . @ . @ . @ . @ . @ . @ . . @ @ @ @ @ @ @ . . . . @ . @ . . @ @ . @ . @ @ @ @ . @ . @ . @ @ . @ @ @ @ . . @ @ . . @ @ . . @ . . . . @ . . @ . @ . @ @ @ @ @ @ @ @ . @ @ @ @ @ @ @ @ . @ . @ 
@ . . . . @ . . . . . . . . . . . @ @ . . @ @ . @ @ . . @ . @ @ . @ . @ . . . . . . . @ . . . . @ . . . . . @ @ . . @ . . . @ @ . @ . . @ @ @ . . . @ . . . . . @ @ @ @ @ @ . . @ @ @ @ @ @ @ . . @ . @ 
@ @ . @ . . @ @ @ . @ @ @ @ . @ . . . . @ @ @ . . . @ . @ . @ @ . . . @ . @ . @ . @ . @ . @ @ . . . @ . @ . . @ @ . . @ @ . . . . . . @ @ . . . @ . @ @ @ . @ . . @ @ @ @ . @ . . @ @ @ @ @ . @ . @ . @ 
@ @ @ . . @ @ . @ @ . @ @ @ @ . . @ . @ . @ . @ . @ @ @ . . . @ @ @ . @ . @ . . @ @ @ . @ . . @ . @ . @ . @ . @ . @ . @ . @ . @ . @ . . . @ @ . @ . . @ @ . . @ . . @ . . . . . @ . @ @ @ . . @ . @ . @ 
@ @ @ @ @ . . . . . . @ @ @ . @ @ . . . . . . . . . @ . @ . @ . . . . . . . @ . . . @ . @ . @ . . @ . @ . @ @ . . . . . . . @ . . . @ @ . @ . . @ . @ . . @ @ . @ . . . @ . @ . @ . @ @ @ @ . . . @ . @ 
@ @ @ @ . . @ . @ . @ . @ @ . @ @ @ @ . @ . @ . @ . . . . . . @ . @ @ . @ @ . . @ @ . . @ . . . @ . . . . @ . . @ @ . @ . @ . @ . @ @ @ . . @ @ . . . . @ @ . . . . @ . @ @ @ @ . . @ @ @ . @ @ . @ . @ 
@ @ @ . . @ @ . . @ . . @ . . @ @ @ . @ . @ . . @ @ . @ . @ . @ . @ @ . . . @ . . . @ . @ . @ @ . . @ @ . @ . @ . @ . @ . . . . @ . @ . . @ . . @ . @ @ . . @ . @ . . @ @ @ @ @ @ . . @ . . @ . . . . @ 
@ . . . @ @ . . @ . @ . . @ . @ . . . . . @ @ . . . @ @ @ . . @ @ . . . @ . . @ . @ . . @ . . @ . @ . . . . @ . . . @ @ @ @ . @ . . . @ . . @ . . . . @ @ . . @ . . @ . @ @ @ @ @ . @ . @ . @ @ @ . @ @ 
@ @ . @ @ @ @ . . . . @ . . . . @ @ @ @ . . @ . @ @ @ @ @ @ . . . @ @ . @ . @ . @ . @ . @ . @ @ @ . @ @ . @ . @ . @ . @ @ . . @ . @ . . . @ . @ @ @ . . @ . @ @ @ . . . . . @ . @ . . . . . . . @ . . @ 
@ @ . . @ @ @ @ . @ . . @ @ @ . . . @ . . @ @ @ @ . @ @ @ . . @ @ . @ @ . . . . @ . . . . . @ @ @ . @ . . . . . . . . @ . @ . @ @ . @ @ . @ . . . . . @ . . . @ . . @ . @ . . . @ @ . @ . @ . @ . . @ @ 
@ @ . @ @ @ . @ @ @ @ . @ @ . @ . @ . @ . @ . @ . . . @ . @ . @ . . . . @ . @ . @ . @ @ . @ . @ @ . @ @ . @ @ @ . @ . @ . @ . @ . . . . . @ . @ . @ . . . @ . @ . @ @ @ . @ . @ . . . . @ @ @ . @ . . @ 
@ . . . @ . . @ . @ . . . . . . . . . . . . . . . @ . . . . . . @ @ @ . . @ . . . @ @ . . . . . @ . . @ . . @ . . . @ . . . . @ @ . @ @ . . @ . . . @ @ @ . . @ . . @ . . . @ . @ @ @ . . @ . . . . @ @ 
@ @ . @ @ @ . @ . . @ . @ . @ @ . @ . @ . @ . @ . @ @ . @ . @ . . . @ . @ . @ . @ @ . @ . @ . @ @ . @ . @ @ . @ . @ . @ @ @ . @ @ @ . . . @ . @ @ @ @ @ . @ . . . @ . . @ @ . . . . . . @ @ . @ . @ @ @ 
@ . . . @ . . . . @ . @ . @ . . . . @ . . @ . . @ . . . @ . . @ @ . . . . . . . . . . . . . @ @ . . . . . . . . . . . . . . . @ @ . @ @ . @ . . . . @ . . . @ . @ @ @ . . @ . @ @ . @ @ . . . . @ @ @ @ 
@ . @ . @ @ @ @ . . . . . . . @ . @ @ @ . . @ @ . . @ . . @ . . . @ . @ . @ @ . @ @ . @ . @ . . . @ . @ . @ . @ . @ . @ . @ . . . . @ . . . . @ @ @ @ . @ . @ . . @ . . @ . . . . @ . . . @ . @ . . . @ 
@ . @ . . @ @ @ @ @ . @ . @ . @ . . @ . @ @ . . . @ . . @ . . @ @ . @ . . . @ . . . @ . . . . @ . @ @ . @ . . @ @ . . . @ . @ . @ . . @ . @ @ . . . . @ . . . . @ @ @ . . . @ . @ @ @ @ @ . . . . @ @ @ 
@ . . @ @ . @ @ @ @ . . @ . . @ . @ @ . . . . @ . @ @ . . @ . @ . . @ @ . @ @ @ @ . . @ . @ . . @ . . . . . @ . . . @ @ @ . @ @ . @ . @ . @ . @ . @ @ . @ @ @ . . @ . . @ . @ @ @ @ . @ @ @ . @ . . . @ 
@ . @ . @ . . . @ . @ @ . . @ . . . . @ . @ @ @ @ . . . @ . . @ @ . . . . . @ @ @ . @ @ @ . . @ @ @ . @ @ @ . . @ @ . . . . . . . . . . . . . . . . . . . . @ . @ @ @ . @ . @ @ @ . . . @ . . . @ . @ @ 
@ . @ . @ . @ @ . . . @ @ . @ @ . @ @ . . @ . . . . @ . . @ . . . @ . @ . @ . . @ . @ @ @ @ . @ . . . @ @ @ . @ @ @ @ . @ @ . @ . @ . @ @ . @ . @ . @ . @ @ . . . @ . . . @ . @ . @ . @ . @ . @ . @ @ @ 
@ . . . @ . @ @ @ . @ @ @ @ . . . @ . . @ . . @ . @ . . @ . . @ . @ @ . . . . @ @ . . @ @ . . @ @ @ . . @ @ @ @ @ @ @ . @ . @ . . @ @ @ @ . @ . . @ . . @ . @ . @ @ @ @ . . . . . @ . . . . . . . . @ @ 
@ . @ @ . . . @ . . @ @ @ @ @ . @ . . @ . . @ @ . . @ . @ @ . @ . @ @ @ . @ . . . @ . @ @ @ . @ @ @ @ . . @ @ . @ @ @ @ . . . . @ . . . @ @ @ @ @ @ @ . . . . . @ @ @ . . @ @ . @ @ . @ . @ . @ . @ @ @ 
@ . @ . @ . @ . @ . @ @ @ @ @ @ . @ . . @ . . . @ @ . @ . . @ . . @ @ @ . . @ @ . @ @ . @ . . @ @ @ . . @ . . . @ @ @ . @ . @ . . . @ @ @ @ @ @ . . . @ @ @ @ . @ @ . @ . . @ . @ . . . @ @ . . @ @ @ @ 
@ @ @ . . . . . . . . . . . @ . . . . @ @ . @ . @ . . . @ . @ @ @ . . . . @ @ . @ . @ . @ @ . . @ @ @ . @ . @ @ @ @ @ . @ @ . . @ . . . @ @ @ . @ . @ . . @ . . @ . . . . @ . @ @ @ . @ @ . . @ @ @ @ @ 
@ . . . @ . @ . @ @ @ @ . @ . . @ . @ . . . . @ @ @ @ . . . . . . . @ @ . @ . . . . @ . . . @ . @ @ @ . . . . . @ . . . . . @ @ @ @ . @ . @ . . . . . @ . . @ . . @ @ @ . . . . @ @ . . @ @ . . @ @ @ @ 
@ . @ . @ @ . . @ . . . . . . @ @ @ . . @ . @ @ @ @ . @ . @ . @ . @ . . . . @ . @ @ . @ . @ . . @ @ @ . @ . @ . @ @ @ @ . @ . @ . @ . . . . @ . @ @ . . . @ . . @ . . @ . @ . @ . . . @ . @ . @ @ @ @ @ 
@ . @ @ . . . @ . . @ . @ @ . . @ . . @ . . @ @ @ . . . . @ @ . . @ @ @ @ @ . . . . . . . . . @ . . . . . @ @ @ . . . . . . . . . . . @ @ @ @ @ @ . . @ . @ @ . . @ . @ . @ . . @ . @ . . . @ @ @ @ @ @ 
@ @ . . . @ . . @ . @ . @ . . @ . @ @ . . @ @ @ . @ . @ . . @ @ . . @ @ @ @ @ . @ @ . @ @ @ . . @ . @ . @ . @ @ @ @ . @ . @ @ . @ @ . . @ . . . . . @ . . . @ @ . @ . @ . . @ . @ . @ . @ @ @ @ @ @ @ @ 
@ @ . @ . @ . @ . . @ . . @ . @ . . . @ . @ @ . . . . @ . @ . @ . @ . . @ @ @ . @ . . . @ . . @ @ @ . . @ . @ . . . @ @ . . . @ @ . @ @ . @ . @ . @ @ @ . @ . . . @ . @ . @ . @ . . @ . . @ @ @ . @ . @ 
@ . . @ @ . . . @ @ . . @ . @ . @ . @ . @ . @ @ . @ @ . . . . @ . @ @ . . @ . @ @ . @ @ . @ . @ @ . . @ @ . . @ . @ @ @ . @ @ @ . . . . . . @ . . @ @ @ . . @ . @ . . @ . . . . @ . . . @ @ @ . . @ . @ 
@ @ . @ @ @ . @ @ . @ @ . . . . . . . . . . . @ . . . @ @ . @ . . . . . @ . . . . . @ . . . @ . . . @ @ . @ . @ . . @ . . @ . @ . @ . @ . @ . @ . . @ . . @ . . @ . @ @ . @ . @ . . @ @ . . . @ . . . @ 
@ . . . @ @ @ . . . . . . @ . @ @ . @ . @ @ . . . @ . @ . @ . @ . @ . @ . @ @ . @ . @ @ @ . . . @ . @ . . . . . . @ . @ . . . . . . @ @ . . . @ @ @ . @ . @ @ . @ . @ . . @ @ @ . @ . . . @ @ . . @ . @ 
@ @ . @ . @ . @ . @ . @ . @ . . . @ . . . . @ . @ . @ @ . . . . . . @ . . . . @ . . @ . . @ @ @ . @ . . @ . @ . @ . . . . @ . @ . @ @ . . @ @ . . . . . . . . . . . . @ . @ @ @ . . . @ @ . @ . @ . @ @ 
@ . . . . . . @ @ . @ . @ . . @ . @ @ . @ @ . . . . . @ . @ . @ . @ . . @ . @ @ @ . @ @ . . . . . . @ @ . @ . . . . @ . @ @ @ . . @ . @ @ @ . @ . @ @ . @ @ . @ . @ . @ . . . . . @ @ . . . . . . . . @ 
@ @ . @ . @ . @ . . @ . . @ . . @ @ . . . . @ . @ . @ @ @ . . . @ . @ . . @ @ @ @ @ @ @ @ @ @ @ @ . . . . . . @ . @ . . . @ . . @ . . @ @ . . . . @ . . @ . . @ . . @ . @ . @ . @ @ . . @ @ . @ @ @ @ @ 
@ . . @ @ @ . . @ . . . @ . @ @ . . @ @ @ . @ @ . @ @ @ . @ . @ . . @ . @ . @ . @ . @ @ . . . . . . @ . @ . @ . . @ @ . @ . . @ . @ . @ . @ . @ . @ @ . @ . @ . . @ . . @ . . @ @ @ @ . . . @ . . . . @ 
@ @ . . . . @ @ . . @ @ @ . . . @ . @ @ @ @ @ . . @ @ @ . . . @ . @ . . . . . . . . . . @ . @ . @ @ . @ @ @ @ @ . . . @ @ . @ . . . . . . . . @ @ . . . @ . . @ . . . @ . . @ . @ @ . . @ . . . @ @ @ @ 
@ @ @ @ @ . @ @ @ . . @ @ . @ . @ . @ @ @ . . . @ @ @ @ @ @ . . . . . @ . @ . @ @ . @ . . @ . . . @ . . @ . @ . @ . @ @ . @ . . @ . @ . @ @ . @ . @ . @ . . @ . . @ @ . @ . . . . @ @ . . @ @ . . . . @ 
@ @ @ @ @ @ . @ . . @ . @ . @ . . . @ @ . @ @ . . @ @ @ @ @ @ . @ . @ . . . @ . . . . @ @ @ @ @ . . @ . . . . . . . @ . . @ @ . @ @ . . @ . . @ . . . @ @ . . @ . . @ . @ . @ . @ . . . @ @ @ @ @ . @ @ 
@ @ @ @ @ @ . . @ . . . @ . . @ . @ @ . . @ . . @ @ @ @ @ @ . . . @ . @ . @ @ @ @ . @ . @ . @ . . @ @ @ @ . @ . @ . . @ . @ @ @ . . . @ @ @ . . @ . @ . . . @ . . @ @ . @ . . @ . . @ . . @ @ @ . . . @ 
@ @ @ . @ . @ . @ . @ . @ . @ . @ @ . @ . @ @ . @ . . @ @ @ @ . @ . . . @ . . . @ . . . . . . @ . . . . . @ @ @ . . @ . . @ @ . . @ . . @ . @ @ . @ . . @ . . @ . . @ . . . @ . @ . @ . @ @ @ . @ @ . @ 
@ . . . . . . . . . @ @ . . . . @ . . . . . . . @ . @ . @ . . . . . @ @ @ @ . @ @ . @ . @ . @ . @ . @ . @ @ @ @ @ . . . @ @ . @ . @ . @ . . . . . . . @ . . @ . . @ @ @ . @ @ . @ . . @ @ @ . . . @ . @ 
@ . @ @ . @ . @ @ . @ . @ . @ @ @ . @ . @ . @ . . . . . . . @ . @ @ @ . @ . . . @ @ @ @ @ . . . . @ . . . @ @ @ . . @ . @ . . @ @ . @ . . @ . @ . @ @ . . @ . @ . @ . @ . . . . . . @ @ @ . @ . @ . @ @ 
@ . @ . @ @ @ . @ . . . . . . . . . . @ . . @ @ . @ . @ . @ . . . . . . . . @ @ @ @ @ @ . . @ . @ . @ . @ . @ @ @ . @ . @ @ . . @ . . @ . @ . . @ @ @ . @ . . . . . . . . @ @ . @ @ . @ . . @ . . . . @ 
@ @ @ . . @ . . . . @ @ . @ . @ . @ @ @ @ . @ . @ @ @ . . . @ . @ . @ . @ . . . @ @ @ @ @ . . @ . . . . . . . . @ . . @ @ . . @ . . @ @ . . @ . . @ . @ . @ @ @ . @ . @ @ . @ @ @ @ . . . @ . @ @ . @ @ 
@ . @ . @ . @ . @ . . . @ . . . @ @ . . . @ . . @ . @ @ . @ . . . @ . . . @ . @ . @ @ . . @ . . @ @ . @ . @ @ . . @ . @ . . @ @ @ . @ @ . @ . . @ . . . . . . @ @ . . . @ . @ @ @ . @ . @ . . . . . . @ 
@ . . . . . . . @ . @ @ @ @ . @ @ . @ . @ . . @ . . @ @ @ . @ . @ . . @ @ . . . . @ . . @ . @ @ . . . @ @ @ @ . @ . @ . @ . @ @ . . . @ . . @ @ . . @ . @ @ @ @ @ @ . @ . . . @ . . . . . . @ . @ . @ @ 
@ . @ . @ . @ . @ @ @ . @ . . . @ . . . . @ . @ @ . . @ . . . @ @ @ . . . @ . @ . . @ . . . . @ . @ . . . . . @ . . . . . . . . @ . @ . @ . @ . @ . . @ @ @ @ @ @ . . @ . @ @ . . @ . @ . @ . @ . . . @ 
@ @ . . . @ @ @ . . . . . . @ @ @ . @ . @ . . . @ . @ . @ . @ . @ @ @ . @ @ . . @ @ . . @ @ . @ @ . . @ . @ . . @ . @ . @ . @ . . . . . . . . . . . @ . @ @ @ @ . @ . . . . @ @ . . @ @ . @ . @ . @ . @ 
@ . . @ @ @ . @ @ . @ @ . @ . @ . @ . . . . @ @ . . . . . . . . . @ . . @ @ @ . @ . @ . . . @ @ @ @ @ . . . @ @ . . @ @ @ . . @ . @ @ . @ . @ . @ . . . . @ @ . . . . @ @ . @ . . @ . . @ . . . @ . . @ 
@ @ . . . . . . . @ . . . . . . . @ @ . @ @ . @ @ @ . @ . @ @ @ . @ @ . . @ . @ . . . @ . @ @ @ @ @ @ @ . @ . . @ @ @ @ @ . @ . . @ . . @ @ . . @ . @ . @ @ . @ @ @ . . . @ @ @ . . . @ . @ . @ . @ . @ 
@ . . @ . @ . @ @ . @ . @ @ . @ . . . . . . . @ . @ @ . @ . @ @ . . . . @ . . . @ . @ @ . . @ @ @ @ @ @ . @ . @ @ @ @ . . . @ @ . @ @ . . @ @ . . @ . . . @ . . @ @ . @ . . @ . . @ @ . . . . . . . @ @ 
@ @ @ . . . @ @ @ . . . @ . . @ @ . @ @ . @ @ . . . . . . . . . . @ . @ @ @ @ . . . @ . . @ @ @ @ @ @ @ . . . . @ @ @ @ . @ . . @ @ . . @ @ . . @ @ @ . @ . . @ @ . . . @ @ @ @ . . . . @ @ @ @ @ @ . @ 
@ @ @ . @ . @ @ . @ @ . @ . @ . @ @ . @ . . @ . @ . @ . @ @ . @ . @ . . @ . . @ @ . . @ . . @ @ . @ @ . . @ . @ @ @ @ . . @ . @ . @ . @ . . . @ @ @ @ @ . @ . . . @ . @ @ @ @ @ . @ @ . . . . . . . . @ 
@ . @ . . @ . . . . @ @ @ @ . . . @ . @ @ . . @ . . . @ . . . @ @ . . @ . @ . @ . @ . @ . @ @ . . . @ @ . @ . @ . @ . @ @ . . . . . . . @ @ @ @ @ @ @ @ . . @ . @ . . @ @ @ . . . . @ @ @ . @ . @ . @ @ 
@ . . . @ . @ @ @ . @ . @ . @ . @ . . . . . @ @ @ . @ . @ . @ . . . @ . . . . . . . . . . . . . @ . . . . . @ @ . @ . @ . @ . @ . @ @ . @ . @ @ @ @ . @ @ . . . @ @ . . @ . @ . @ @ . . @ @ @ . . @ @ @ 
@ . @ . . . . . . . @ . . . . . . . @ . @ . @ . . @ @ . @ . @ @ . @ @ @ . @ . @ @ . @ . @ . @ . . @ @ @ . @ . . . . . . . @ @ . . @ . . . . . @ @ . . . . @ . @ . . @ . . . @ . . @ . @ . @ . @ @ @ @ @ 
@ @ . . @ . @ @ . @ @ . @ . @ . @ . @ @ . . @ @ . . . . . @ . . . . . . @ @ @ . . . . @ @ @ . . @ @ . . . @ . @ . @ . @ @ . . @ @ . . @ . @ . . . @ . @ @ . . . @ . . . @ @ . . @ . . . . . . . . @ @ @ 
@ . @ . . @ @ . @ . . . @ @ @ @ @ @ . . . @ . . @ . @ . @ @ @ . @ . @ @ . @ . . @ . @ @ @ @ @ . . . @ @ . @ . @ @ . . @ . . @ @ . @ . @ . . @ . @ . . . . . @ @ . @ @ . . @ . @ . @ . @ . @ @ @ . @ @ @ 
@ . . . @ @ . . . @ @ . @ . @ . @ . . @ . . . @ @ . . @ @ @ . . @ . . . . . @ . @ . @ @ . @ . . @ . @ @ @ @ @ . . @ . @ @ . @ . . . @ . . @ @ . . @ . @ @ . . @ . @ . . @ . . . . . . . @ . @ . @ . @ @ 
@ . @ . @ . @ . @ . . . @ . . . . . @ . . @ . @ . . @ @ @ . @ . @ . @ @ . @ @ @ . @ . . . . . @ . . . @ . @ . @ . . . . . . . @ @ . . @ . @ . @ @ . . . @ . @ . . . @ . . . @ . @ . @ . . . . . . . . @ 
@ @ . . @ . . . . @ @ @ . . @ @ . @ . . @ @ . . @ . @ @ . . . . @ . @ @ @ @ @ . . . . @ . @ . . @ . @ @ . @ . @ @ @ . @ . @ . . . . @ @ @ . . @ @ @ . @ . . . @ @ . . . @ @ @ . @ . @ @ @ @ . @ . @ @ @ 
@ . @ . . . @ . @ . . . . @ . . . . @ . @ . @ . @ . . @ @ @ @ . @ @ . @ . @ . @ . @ . . @ . . @ @ @ . . . . . . @ . . @ . . @ . @ . . @ . @ . . @ @ @ . @ . @ . @ . @ . . @ . @ . @ @ . @ . . @ @ . @ @ 
@ . @ . @ . @ @ @ . @ . @ . . @ . @ @ . @ . @ @ . @ . @ . @ . . @ @ . @ . @ . @ @ @ . @ . . @ @ @ . . @ . @ @ . @ @ . . @ @ @ . . @ . @ . @ . @ . @ . . . . @ . . @ . . @ . . . . @ . . . @ . . . . . @ 
@ . . . . @ . @ . . . @ . . @ . . @ . @ . . @ . . . . . . . . @ . . . . . . . . . . . @ . @ @ @ @ @ . . @ . . . . . . @ . @ . . @ @ @ . . . . . . @ @ . @ . . . @ . . @ . @ @ @ . . . @ @ . . @ @ @ @ @ 
@ . @ . @ @ . @ @ . @ @ @ @ . . @ . . . @ . @ . @ . @ . @ . @ . . @ @ @ . @ . @ . @ . . @ @ @ @ @ . . @ . . @ . @ . @ . . @ . @ . @ @ @ . @ @ @ . . . @ . @ @ . . @ . @ . . . . @ . @ @ @ @ @ @ @ @ @ @ 
@ @ . . @ . . . . @ @ @ @ @ @ . @ @ @ . . . . @ . . @ . @ @ @ . @ . . . . . @ . . @ . @ . . @ @ @ @ . . @ . . @ . . . @ . . . . . @ @ . . . . @ . @ @ @ . . . . @ . . @ @ @ @ . . . . @ @ . . . @ @ @ @ 
@ @ @ . . . @ . @ @ @ @ @ @ @ @ . . . . @ . @ . @ . . @ @ @ @ @ @ @ . @ . @ . @ @ @ @ @ . @ . @ @ . . @ . @ @ @ @ @ . . @ @ @ . @ @ . @ . @ . @ . @ . . . @ @ . . . @ . . . . . @ . @ . @ @ . @ @ @ @ @ 
@ @ @ . @ . . @ @ @ @ @ . @ @ @ @ . @ . @ . . . . . @ @ @ @ @ @ @ @ @ . . @ . @ . @ . @ . . . . @ @ . . . . @ . . . . @ . @ @ @ @ . . . . @ @ . . . @ @ @ @ . @ . @ @ @ . @ . @ . . @ . . . . . @ @ @ @ 
@ @ @ @ . . @ @ @ @ @ @ . . @ . . . . @ @ @ @ . @ . @ @ @ @ . @ @ . @ @ . . . . . . . . . @ @ . . . . @ @ @ @ @ . @ . . . . @ @ @ @ . @ . @ . . @ @ . @ . @ . @ . . @ @ @ . @ . . @ . @ . @ @ @ . @ @ @ 
@ @ @ @ @ . @ @ . . @ @ . @ . . @ . @ . . . @ @ @ . . @ @ . . @ . . . . . @ @ . @ . @ . @ . @ @ @ @ @ @ @ . @ . @ . . @ . @ @ @ @ @ @ @ @ . @ . @ . . . . . . . . @ @ @ @ . . . @ @ . . . . @ . . . @ @ 
@ . @ . . @ @ @ @ . . . . . . @ . . @ @ . @ . @ . . @ . . @ . . @ @ . @ . @ @ . . @ . . . . . . . @ . @ . . . . . @ . . @ @ @ @ @ @ @ @ . . . . . . @ . @ @ . @ . . @ . . @ . @ . @ . @ . @ . @ . @ @ @ 
@ . . @ . . . . . . @ . @ . @ . @ . . . . . . . @ . . @ . . . @ . @ @ . . . . @ @ . @ . @ . @ . @ . . . @ @ @ . @ . @ @ @ @ @ @ @ @ @ . @ @ . @ . @ . . @ . @ @ . @ . @ . . . . . . @ . . . . . . @ @ @ 
@ . @ . . @ . @ @ . . @ @ @ . . . . @ . @ . @ . @ @ . . @ @ . @ . @ @ @ @ @ . . . . @ . @ . . @ @ @ . @ @ . . . . . @ . @ @ @ @ . . . . . @ @ . @ . . @ @ . @ . . . . . @ @ . @ . @ @ @ . @ @ @ @ . @ @ 
@ . . . @ @ @ . . . @ @ . @ @ . @ . . @ @ . . @ @ @ . @ . . . . . . @ @ @ . . @ @ @ @ @ @ @ . . @ . . . @ @ @ @ @ . . . . @ @ @ @ . @ . @ . . . . @ . @ . . . . @ . @ . . . . . @ @ @ . . . @ . . . @ @ 
@ @ @ . . @ @ @ . @ . . . . . . @ . @ @ . @ . @ @ @ @ . @ . @ . @ @ . @ . @ . @ @ @ @ . @ @ @ @ . @ . @ . @ @ . @ @ @ . @ . @ @ @ @ . . . @ . @ . . @ @ @ . @ . @ . . @ . @ @ . . @ . @ . @ . @ @ . . @ 
@ . . . @ @ @ . @ . . @ . @ . @ . @ @ @ . . @ @ @ @ . . @ @ . . . . . . . . . @ @ @ . . . @ . . . . . . . . . . . . . . . . . @ @ . @ . @ . . . @ @ @ @ @ @ . . . @ @ @ @ . . @ . . . . . . . . . . @ @ 
@ @ @ . @ . . . . . @ . . @ @ . . . @ . . @ . @ @ . . @ . . . @ @ @ @ @ . @ . . . . @ . @ . @ . @ . @ . @ . @ . @ . @ . @ . @ @ . . . . . . @ @ . @ @ @ @ @ @ . @ @ . @ . . @ . . @ @ . @ @ @ . @ @ . @ 
@ @ @ @ . . @ @ @ . . @ . . . @ @ . . @ . @ . @ . @ . @ @ . @ . . . . . . . @ . @ . . . . . . . . @ @ . @ . @ . . @ @ . . @ @ @ @ . @ . @ @ . @ . @ @ @ @ @ @ @ . . . . @ . @ @ . . @ @ . . . @ @ @ . @ 
@ @ @ @ @ . . . . @ . @ . @ . . . @ . . . . . . . . . . . . @ @ . @ . @ . @ . @ . . @ . @ . @ . @ @ . . . @ . @ . @ @ . @ @ @ @ @ @ . . . . . . . . @ @ @ @ @ @ @ . @ . . . @ . . @ @ @ . @ @ @ . @ . @ 
@ @ @ @ @ . @ @ . @ . @ . @ . @ @ @ @ . @ . @ @ . @ . @ @ @ . . . . @ . . @ . @ @ . @ . . @ @ @ @ . @ . @ . . @ @ @ @ . @ . @ @ @ . @ . @ @ @ . @ . @ @ @ @ @ @ @ . @ . @ @ . @ . @ @ . . . @ . . . . @ 
@ . @ . @ @ @ @ @ @ @ @ . @ . @ . @ . @ . . . . @ . . . . @ @ . @ @ . @ . . . @ . . . @ . @ @ . . . @ . @ @ . @ . . . @ @ . . @ . . . . . @ . . @ . @ @ @ @ @ @ @ @ . . . . . . . @ @ @ @ . . @ . @ @ @ 
@ . . . . @ @ @ . @ . . . . @ @ . . . @ @ . @ @ . @ . @ @ . . @ . . . . . @ . . @ . @ . . @ . @ . @ . @ . @ . . . @ @ . @ . @ . @ @ @ . @ . @ @ . . . @ @ @ @ @ @ @ @ @ @ . @ @ @ . @ . @ . @ . . . @ @ 
@ @ . @ . . @ . . . . @ . @ . . . @ @ . @ @ . . . . . @ . . @ . @ @ . @ @ . . @ . @ @ @ . . . . . . . . . . . @ . . . . . . . . . @ . . . . . . @ . @ @ @ @ @ @ @ @ . . . . . . . . . . . . . . @ @ . @ 
@ @ @ . . @ . . @ . @ . . @ @ @ . . @ . . . . @ . @ @ @ @ . . . . . . . . @ . . . . @ @ . @ . @ . @ . @ . @ @ @ @ . @ @ . @ . @ @ . @ . @ @ @ . . @ . @ @ @ @ @ @ . @ . @ . @ . @ . @ . @ . @ . . . . @ 
@ @ . @ . @ @ . @ . . @ . . @ . . @ . @ . @ . . @ @ . @ . . @ @ . @ . @ @ . . @ . @ . . . . @ @ @ @ @ . . . . @ . @ @ . @ @ . @ . . . . . . . @ . @ . @ . @ @ @ . . . @ @ . @ . @ @ . . . @ @ . @ @ . @ 
@ . . . . . . . . @ @ . . @ . @ . . . @ @ . . @ @ . . . . @ . . . . @ . @ @ . . @ . . @ . @ . @ @ @ @ @ . @ . . . . . . . @ @ . . @ @ @ @ @ @ . @ @ . . . @ @ . . @ @ . @ . . @ @ . . @ . . . @ @ @ . @ 
@ . @ @ @ @ @ . @ @ . @ . . . . . @ @ . . . @ . . . @ . @ . . @ @ . @ . . . . @ . @ @ @ @ . . @ @ @ . . . . @ @ . @ . @ . . . . @ . . . . . . . . . . @ . @ . @ . @ . . . . @ @ @ . @ . . @ . . . . @ @ 
@ @ . . . . . @ . . . . . @ . @ . @ @ @ . @ . . @ . . @ . . @ . . @ . @ . @ . . . . @ @ @ @ . . @ . @ @ . @ @ @ . . @ @ @ . @ . . . @ @ . @ . @ . @ @ @ @ . . @ . . @ . @ . . @ . @ @ @ . . @ @ . @ . @ 
@ . @ . @ @ . . . @ . @ . @ . @ @ @ @ . . @ @ . @ @ . @ @ . . . @ . . . . @ @ . @ @ @ @ @ . @ . . . . . . . . . @ . . . @ . @ . @ . @ . . . @ . . @ @ @ . @ . . . @ . @ . . @ @ . @ @ @ @ . @ . . @ . @ 
@ . . . @ @ @ . @ . . @ . . @ @ . @ . . @ . . . @ . @ . @ . @ . . @ . @ . . @ . . @ @ @ @ . @ . @ @ . @ . @ @ . . @ @ . . @ . . . @ . @ . @ @ . @ @ . @ . . @ . @ . . . @ . . . . . @ @ @ . . @ . @ . @ 
@ @ . @ . @ . @ . . @ . . @ . @ . . @ . . @ @ . @ . . . @ . . @ . . @ . . @ . . @ . . @ . . . @ @ @ @ . . @ @ . @ @ @ . @ @ @ . @ . . . @ . . . @ . . @ @ . . . . @ . @ . . @ @ . @ @ . @ . @ . . . . @ 
@ @ @ . . . . . . @ . @ @ . . . . @ @ . @ @ . @ . . @ . @ . @ @ @ @ . @ . . @ . @ . @ . @ . @ . @ @ @ @ . . . @ . @ . @ . @ @ . . . @ . @ . @ . @ . @ @ . @ . @ . . . . @ . . . @ @ . . @ @ @ @ . @ @ @ 
@ @ @ . @ . @ . @ . . . @ @ @ . @ @ @ . . . . . @ @ . . . . @ . . . . . . @ @ . . . . . . . . . . . @ . . @ . . . . . . . . . @ . @ . @ . . @ . . . . . . . @ . @ . @ . @ @ . @ @ . . @ . @ @ . . . . @ 
@ @ . . . @ . . . @ @ . . . . . . . . . @ @ @ . . @ @ . @ . . @ . @ . @ . . . @ . @ . @ . @ @ . @ . @ . @ @ . @ . @ . @ . @ . @ . @ . @ . @ @ @ . @ @ . @ . @ . . @ . . . . . @ . @ . @ . @ . @ @ @ @ @ 
@ @ @ . @ @ @ . @ . @ @ . @ . @ . @ . @ . @ . . @ @ @ @ . . @ . . . @ . . @ . @ @ @ @ . . . . @ . . @ . @ . . . @ @ . . @ . . . @ @ . . . . . . @ . . @ . . . . @ @ @ @ @ @ . . . . . . . . . . . . . @ 
@ @ @ @ @ @ . . . . . @ . . @ @ @ . . . . . @ . @ @ @ @ @ . . @ @ @ . @ . . @ @ @ @ . . @ . @ . . @ @ @ . @ . @ @ @ . @ . @ . @ @ . . @ . @ . @ . @ . . @ . @ @ @ @ @ @ @ . . @ . @ @ . @ @ . @ . @ . @ 
@ @ @ . @ . @ . @ @ . @ . @ @ @ . @ . @ . @ @ @ @ @ @ @ @ @ . @ . . . . . @ @ @ @ @ @ . @ . . @ @ @ @ @ . @ . . @ @ . . . . @ . . . @ . . @ @ . . @ @ . @ . . @ @ @ @ @ @ @ . . @ @ . . . @ . . @ @ . @ 
@ @ . . . . . . @ . . @ @ . . . . . . . @ @ @ @ @ @ @ @ @ @ . . @ @ . @ . @ @ @ @ @ @ . @ . @ @ @ @ @ . . . . @ . . . @ . @ @ . @ . . @ . . . . @ @ @ . . . @ @ @ @ @ @ @ @ @ @ @ @ @ . @ @ . @ @ . . @ 
@ @ @ @ @ @ @ @ @ @ @ @ @ @ @ @ @ @ @ @ @ @ @ @ @ @ @ @ @ @ @ @ @ @ @ @ @ @ @ @ @ @ @ @ @ @ @ @ @ @ @ @ @ @ @ @ @ @ @ @ @ @ @ @ @ @ @ @ @ @ @ @ @ @ @ @ @ @ @ @ @ @ @ @ @ @ @ @ @ @ @ @ @ @ @ @ @ @ @ @ 
3
29 44 58 38
25 47 61 64
54 40 63 21
