10 10
@ @ @ @ @ @ @ @ @ @ 
@ @ . @ @ @ . . @ @ 
@ . . . @ . . @ . @ 
@ @ . @ @ . @ . . @ 
@ @ . . . . . @ . @ 
@ . @ @ @ . @ @ . @ 
@ . @ @ . . . @ . @ 
@ . @ . @ . @ . . @ 
@ . . . . . . . @ @ 
@ @ @ @ @ @ @ @ @ @ 
3
7 3 6 5
7 5 2 8
8 2 8 7
