12 12
@ @ @ @ @ @ @ @ @ @ @ @ 
@ . . . . @ @ @ @ @ @ @ 
@ @ . @ . @ @ @ @ @ @ @ 
@ @ @ . . . @ @ @ @ @ @ 
@ . @ @ . @ . . . @ . @ 
@ . . @ . . . @ . . . @ 
@ @ . @ . @ @ . @ @ . @ 
@ . . . . . . . . @ @ @ 
@ @ . @ . @ . @ . . . @ 
@ . . @ . . @ . . @ . @ 
@ @ . @ . @ @ @ . @ . @ 
@ @ @ @ @ @ @ @ @ @ @ @ 
3
5 9 7 4
7 6 10 4
10 10 7 8
