12 12
@ @ @ @ @ @ @ @ @ @ @ @ 
@ . @ . . @ . . . . . @ 
@ . @ @ . . . @ @ . @ @ 
@ . @ . . @ . . . @ @ @ 
@ . . @ . . @ . @ @ @ @ 
@ @ . @ . @ . @ @ @ @ @ 
@ . . . . . . . @ @ @ @ 
@ @ . @ . @ . @ @ @ @ @ 
@ @ @ . . . @ @ @ @ @ @ 
@ @ . @ . @ . @ @ @ @ @ 
@ . . . . . . . @ @ @ @ 
@ @ @ @ @ @ @ @ @ @ @ @ 
3
10 3 5 6
1 1 10 7
8 4 1 8
