100 100
@ @ @ @ @ @ @ @ @ @ @ @ @ @ @ @ @ @ @ @ @ @ @ @ @ @ @ @ @ @ @ @ @ @ @ @ @ @ @ @ @ @ @ @ @ @ @ @ @ @ @ @ @ @ @ @ @ @ @ @ @ @ @ @ @ @ @ @ @ @ @ @ @ @ @ @ @ @ @ @ @ @ @ @ @ @ @ @ @ @ @ @ @ @ @ @ @ @ @ @ 
@ @ @ @ @ @ @ @ @ @ @ @ @ @ @ . . . . @ @ @ @ @ @ . @ . . . . . . . @ . @ . @ . @ @ @ @ @ @ @ @ @ . @ . . . @ @ . . . @ . @ @ . . . . @ @ @ . . . . . . . @ . . . @ . @ . @ @ . @ . . . . . . . . . @ @ 
@ @ @ @ @ @ @ @ @ @ @ @ @ @ @ @ @ . @ @ @ @ @ @ . . @ @ . @ @ @ . @ . . . . @ . @ @ @ @ @ @ @ @ @ . . . @ @ . @ @ . @ . . . . @ @ . @ @ @ @ @ @ . @ . @ . . @ @ . @ . . . . . . . . @ . @ . @ . @ @ @ @ 
@ @ @ @ @ @ @ @ . @ @ @ @ @ @ . . . . @ @ @ @ . @ . . . @ . @ . . . @ @ . @ . . @ @ @ @ @ @ @ @ @ . @ @ . @ . @ . . . @ @ . @ @ . . . . @ . . @ . . @ . @ . @ @ . @ . @ . @ @ @ @ @ . . @ . . @ @ @ @ @ 
@ @ @ @ @ . . @ . . @ @ . @ . @ . @ . @ @ @ . . . . @ @ . . . . @ . @ . . . . @ . @ @ @ @ @ @ . @ . . @ . . . . . @ . @ @ . . @ @ . @ . . @ . . @ @ . . . . . @ . @ . . @ @ @ @ @ @ @ . @ . @ @ @ @ @ @ 
@ @ @ @ @ @ . . @ . . @ . . . . . . @ @ @ . @ @ @ . . . @ @ @ . @ . . @ . @ . . . . @ @ @ @ @ . . . @ . @ @ @ @ @ . . @ . . @ @ @ @ @ @ . @ @ . . . . @ @ . @ . . @ . @ . . . @ @ @ @ @ . @ @ @ @ @ @ @ 
@ @ @ . @ . @ . @ . @ . @ @ . @ . @ @ @ @ . . . @ . @ . . @ . @ . @ . @ . @ . @ . @ . @ . @ @ @ @ . . . . @ @ . . @ . . @ . @ . @ . @ . . . @ @ . @ . . @ . @ . @ @ . . . @ @ . @ . . . . . @ @ @ @ @ @ 
@ @ . . . . . . . . @ . @ @ @ . . . @ . . . @ @ . . . @ . @ . @ . . . . @ . . . @ . . @ . . @ . . . @ . @ @ @ @ . . @ . . . @ . . . . @ . @ . . @ . @ @ . . . . . @ . @ @ . @ . . @ . @ @ @ . @ . @ @ @ 
@ . @ @ . @ . @ . @ . . . @ . @ . @ . @ . @ . @ . @ @ @ @ . . . @ @ . @ . @ . @ @ @ . . @ . @ . @ . . @ . . @ . @ . . . @ @ . @ @ @ . . . . @ . @ . @ . @ @ . @ . . . . . . . . @ . . @ @ @ . . . . @ @ 
@ . . . @ @ @ . . . @ . @ . . @ . . . . . . . . . . @ @ . @ . @ . . . . . . . @ @ . . @ @ . . @ . @ . @ . @ . . . @ @ . . . . @ . . @ . @ . . . @ . . . . . @ . . @ . @ @ @ . @ @ . @ @ @ . . @ @ @ . @ 
@ @ . @ . @ . @ @ . . . @ . @ . . @ . @ . @ @ . @ @ . @ . . . . . @ . @ . @ . . . @ . . @ . @ . . . . . . . . @ @ @ @ . @ . @ @ @ . . @ . . @ . @ . @ . @ @ @ @ . . @ . . . @ @ @ . . @ . @ . @ @ @ . @ 
@ @ . . . . . . . @ @ . . . . @ . . @ . . . . @ . . . @ @ @ . @ . . @ @ @ . . @ @ . . @ . . @ . @ . @ @ . @ . . . . @ . . @ . @ . . @ @ @ . . @ . @ . . . . @ . . @ . @ @ . . @ . . @ . . . . . @ . . @ 
@ . @ . @ . @ @ . . . @ @ . @ . @ @ . @ . @ @ . . @ @ . . . . @ . @ @ @ . @ . . . @ . . . @ . @ @ @ . @ @ . . @ . @ @ . @ . . . @ . @ @ @ @ . . . @ @ . @ @ . @ . . . . . . @ . @ . . @ @ @ . @ . @ . @ 
@ . @ . @ @ @ @ . @ . . . . @ . . . . . . . @ @ . . @ . @ @ @ . @ @ @ . . . . @ @ @ @ @ . . . @ @ . . . @ @ . . @ @ . . . . @ . . . . @ . . @ @ . . . . . @ . @ . @ @ . @ @ . . . . @ @ @ . . . . . . @ 
@ . @ @ @ @ @ . @ . @ @ @ . . @ @ . @ . @ . . @ . @ . @ @ @ @ . . @ . @ @ @ . . @ @ . . . @ . @ . @ @ . . @ . @ . @ @ @ @ @ . . @ . @ . @ . @ . . @ . @ @ . . . . @ . @ . @ . @ . @ . @ . . @ . @ . @ @ 
@ . . . . . . . . . @ . . . @ @ @ @ @ @ . @ . . . . . @ . . . @ . . . . @ . @ . @ . . @ @ @ @ . . @ . . @ . . . . . @ @ . . @ . @ @ . . . . . @ . . @ . . @ @ @ . . . @ . . . . @ . . . @ . @ . @ . . @ 
@ @ @ @ . @ @ @ @ . . @ @ . . @ @ @ . @ . @ . @ . @ @ . . @ @ . @ . @ . . . . . . @ . . @ @ . . @ @ . @ @ @ . @ . @ @ . . @ @ . . . @ @ . @ . @ . @ . @ . @ . . . @ . @ @ @ . @ . @ . @ . . @ @ @ . @ @ 
@ @ . @ . @ . . . @ . . . . @ . @ . . . . . . @ . . . @ . . . . . @ @ @ . @ . @ . . . @ . @ @ . . . . . @ . . @ @ @ . @ . . . . @ . @ @ @ . . . . . . . . . @ @ . . @ . @ . . . . . . . . @ @ @ @ @ @ @ 
@ . . @ @ . @ . @ . @ . @ . @ . . . @ . @ @ . . @ . @ . . @ @ . @ . @ . @ . @ @ . @ . . . . . . @ @ . @ . @ . . @ . . . . @ . @ @ @ . @ @ @ @ . @ . @ . @ . . . . @ . . . @ . @ @ . @ . @ . . @ . @ @ @ 
@ @ . . . . . . @ . @ @ . . . @ @ . . @ . @ . @ . . . @ . @ . @ @ . . . . . . . . . @ . @ . @ . . @ . . . @ . @ . @ . @ . . @ . . @ . . . @ . . @ . @ @ @ @ @ @ . @ . @ . . . . . @ @ @ @ . @ . . . @ @ 
@ @ @ . @ . @ . . . @ . @ . @ @ @ @ @ . . . . . @ . @ . . . . . . @ @ . @ @ @ . @ . @ @ . @ @ @ . . @ @ . . . . . @ @ @ . @ @ . @ . . @ @ . . @ . @ @ . @ . . . . . @ . . @ . @ @ @ @ @ . . . . @ . . @ 
@ @ @ . . @ @ @ . @ . . . . @ @ @ . . @ @ . @ . @ @ . @ @ . @ . @ @ @ @ . . . @ @ @ @ . . . @ . @ @ @ @ @ . @ @ . . @ . . . @ . . . @ @ . . @ . . . . . . @ @ @ . @ . . @ @ . . @ @ @ @ . @ @ . @ . @ @ 
@ @ . @ @ . @ . . @ @ . @ . . @ . @ . @ . . . @ @ . . @ . . @ . @ @ . @ @ @ . @ . @ @ @ . @ . . . @ @ @ @ . @ . @ . . @ . @ @ @ . @ @ . . @ @ @ @ . @ . @ . @ . . . . @ @ . @ . @ @ @ . @ @ @ @ . . . @ 
@ . . . . . @ @ . . . @ . . @ @ . . . . @ @ . . . @ . . @ . . @ @ . . . . . . . . . . @ . . @ . @ . @ @ @ @ . . . @ . . . @ @ . . @ @ . @ @ @ . . @ . . @ . . @ . @ @ . . . . . . . . . @ @ @ . @ . @ @ 
@ . @ . @ @ . . . @ . @ @ . @ . @ @ @ . @ . @ @ . . @ . @ . @ . @ . @ @ . @ . @ . @ @ @ @ . . . . . . @ . . @ @ . . @ @ . . . @ . . @ @ . @ . . @ . @ . @ . @ . . . @ . @ . @ . @ . @ . @ @ . . . . @ @ 
@ @ . . . . @ @ . . @ . . . . . . . . . . . @ . . @ . . . . . . . . . @ @ @ @ @ @ @ @ @ . . @ . @ @ . @ @ . @ . @ . . @ . @ . . . @ . . . . @ . . . . . @ . . . @ @ . . . @ . . . @ . . @ @ @ . @ . . @ 
@ @ @ . @ . . . . @ . @ @ . @ . @ . @ . @ . @ @ . . @ @ . @ @ . @ @ @ @ . @ @ @ @ . @ . @ . @ @ @ . @ . . . . . . @ . . . . @ . @ . @ @ . @ @ @ @ . @ . . . @ @ @ @ @ . @ @ @ . @ @ @ @ . @ . . @ @ . @ 
@ @ @ @ . @ @ @ . @ . . @ . . @ . @ @ @ . . . . @ . @ @ @ . . . @ . . . . . @ . . . . . . . @ @ . . @ @ . @ @ @ . . @ @ . @ . . @ . . . . . . . @ @ @ @ . @ . @ @ @ @ @ @ @ @ @ @ @ @ @ . . @ . @ @ @ @ 
@ @ @ . . . @ . . . . @ . . @ @ . . @ . @ . @ . @ . . @ . @ @ . . @ . @ @ @ @ @ @ . @ . @ . @ . @ . . @ . . . @ @ . @ @ . . @ @ @ @ . @ . @ @ . @ @ @ . . . . . @ . @ @ . @ @ @ @ @ . . @ . . . @ @ @ @ 
@ @ . @ . @ . @ . @ @ @ @ . @ . . @ . . . . . @ . . @ . . . . @ . . . . @ @ @ @ . @ . @ . . @ . . . @ @ @ . @ . . . . . . @ @ . @ . . @ . @ . @ . . . . @ . @ @ . . . . . . @ @ @ . @ . . @ . @ . . @ @ 
@ . . . . . . . . . . @ @ @ . . @ . @ . @ . @ . @ . . @ @ @ . . . @ . @ . @ @ . . @ . . . @ @ . @ . . . @ @ . . @ . @ @ . @ . . @ . @ . . . . @ @ . @ . . @ . . @ . @ @ @ . @ @ . . . . @ . . . . @ @ @ 
@ . @ . @ . @ . @ . @ . @ . @ . . . . @ . . . . . . @ . @ @ @ @ @ . . . . @ . @ . . . @ @ @ . @ . . @ @ @ . @ @ . . @ . . . . @ . @ @ . @ @ . . . @ @ @ . . @ . @ . . @ . . . @ @ . @ . . . @ . @ @ @ @ 
@ @ . . . @ . . @ . . . . . . . @ . @ . @ @ @ @ @ . . . . @ . . . @ . @ . @ . . @ . @ . @ . . @ . @ . . . . @ @ @ . @ @ . @ . . . . . @ @ . . @ @ . @ . @ . @ . @ @ @ @ @ . @ @ @ @ @ . @ . . @ @ @ @ @ 
@ . @ . @ . @ . @ @ . @ . @ @ . @ . . . @ . . . . . @ . @ @ @ . @ @ . @ . . . @ . . . . . @ . . . . . @ @ @ . @ @ @ @ . . @ . @ @ @ @ @ . @ . @ . . . . . . . . . . . . @ . . @ @ @ @ @ . @ . @ @ @ @ @ 
@ . . @ . . . . @ @ @ . . . @ @ . @ @ . @ @ @ @ . @ . . . @ . . @ . @ @ @ @ . @ @ . @ @ @ . @ @ . @ . . . @ . . @ @ . . @ . . . . . . . . . . @ @ . @ @ @ . @ . @ @ . @ . . @ . @ . . . . . . @ @ @ @ @ 
@ @ . . . @ . @ . @ . @ . @ @ . . . . . . @ @ @ @ @ . @ . . @ . . . @ @ . . . . . . . @ . . @ . @ . . @ @ . . @ . @ . @ . . @ . @ . @ . @ . @ . . . @ . . . . @ @ . @ @ @ . . . . @ @ . @ @ . . @ @ @ @ 
@ . . @ . . @ . . . . . . @ . . @ . @ . @ . @ . . . @ . . @ . . @ . @ @ @ @ . @ @ . @ . @ . . . @ @ . . @ . @ . . @ . . @ . @ @ @ . . @ . . . @ . @ . . @ . @ . . . . @ . . @ . @ @ @ @ . @ . @ . @ @ @ 
@ . @ . . @ . @ @ . @ . @ @ @ @ . @ . . . . . @ . @ . @ . . @ @ @ . . @ . @ . @ . . . . . @ @ . @ . . @ . . . . @ . . @ . @ . @ . . @ . @ . @ . @ . @ . @ @ . @ @ . @ @ @ . . @ . @ . @ . @ . . . @ @ @ 
@ @ . @ . . . . . @ . @ @ @ @ . . . @ @ @ @ . . . . . . . @ . @ . . @ . . . @ . @ @ . @ . @ . . . @ . . . @ @ . @ @ . . . . . . @ . @ . . . . . . . . . . . . @ . . . @ . . @ . . . . . . . . @ @ @ @ @ 
@ @ . @ @ . @ @ . @ . @ @ @ . @ . @ . . . . . @ . @ . @ . . . . . @ @ . @ @ . . . . @ @ . . @ @ . . . @ . . @ . . . @ . @ . @ . . @ . . @ . @ . @ . @ @ @ . @ @ @ . @ @ @ . . @ @ . @ @ @ @ . . . @ @ @ 
@ . . . @ @ . . . . . . @ . . . . . . @ . @ . . @ . . . @ @ @ . @ . @ . @ . @ . @ @ @ . @ . @ . @ @ . . @ @ @ @ . @ . . . @ @ @ . @ . @ @ @ . . @ @ @ . . . . @ . . . @ . . @ @ @ @ . @ . @ . @ @ . @ @ 
@ @ @ . @ . . @ . @ . @ @ @ @ @ @ @ @ @ . @ @ . @ @ @ @ . @ . . . . . . . . . . . . . . . . . . . . . @ . . @ @ @ @ @ . @ @ @ @ @ . . . @ . @ . . . . @ . @ . @ . @ . @ . @ . @ . @ . . . . . . . . . @ 
@ . . . . . @ . . @ @ @ @ @ . . @ . . . @ @ @ @ . . . . . @ . @ @ . @ @ @ . @ . @ . @ . @ . @ . @ @ . @ @ . @ @ @ @ @ . . . . @ . @ . @ . . @ . @ . @ @ @ @ . . @ . . @ . . . . . . @ . @ @ @ @ . @ . @ 
@ @ @ @ . @ @ @ . @ . . @ @ @ . . @ @ . . @ @ @ @ . @ @ . @ . @ @ . @ . @ @ . . @ @ @ @ @ @ . . @ . . . . . . @ . . . @ @ . @ @ . . . . . @ . . . @ @ @ @ @ @ . . . @ . . @ . @ @ @ . . @ . . . @ @ . @ 
@ @ @ . . @ . . . . @ . @ @ . @ . @ @ . @ . @ . @ . @ . . . @ . . @ @ . @ . @ @ . . @ @ @ @ @ . @ @ @ . @ . @ . . @ @ @ . . @ @ @ . @ . @ @ @ . @ @ @ @ @ @ . @ @ . . @ . . @ . @ @ . @ . @ @ . . . . @ 
@ @ @ @ . . @ . @ @ . . . . . . . . . . . . . . . @ . @ . @ . @ . . . . . . . . @ . . @ @ @ . . . @ . . . @ . @ . @ . . . @ . @ @ @ . . @ . . . . @ @ @ . @ . @ @ . @ . . @ @ . . . . . . . . @ . @ . @ 
@ @ @ @ . @ @ . . @ @ . @ @ @ @ . @ . @ . @ @ @ . . . . . @ . . . @ . @ . @ . @ @ . @ . . . @ . @ @ @ @ . . . . . . @ . @ . . . . . . @ . @ @ . @ . @ . . . . . . . . @ . . @ @ . @ . @ @ . @ @ @ . . @ 
@ @ @ @ @ . . . @ @ . @ . . . . @ @ @ . . . @ . @ @ . @ . @ @ . @ . . . @ . . . @ . . @ . @ @ @ @ @ @ . . @ @ @ . @ . @ . @ @ . @ @ . . . . @ @ . . . @ . @ @ @ @ . @ @ . @ . . . . @ . @ @ @ @ @ @ . @ 
@ @ @ @ @ @ . @ @ . . . . @ . @ . @ . . @ @ . . . . @ . . . @ @ . @ . @ @ @ . @ . . @ . . . @ @ @ @ . . @ @ @ . . @ . . . @ . . . @ . @ . @ . . . @ @ @ @ @ . @ . . . @ . @ . @ . @ @ . . . @ . @ . . @ 
@ @ @ @ @ . . @ . @ . @ @ . . . . @ . @ . @ @ . @ @ . . @ . . @ . . @ @ @ . . . @ . . @ . @ @ @ @ . @ @ . @ . @ . @ . @ . . @ @ @ . . . @ . @ @ . @ @ @ . @ . @ @ . @ . . . . @ . @ . . @ @ . . . @ @ @ 
@ @ @ @ @ @ . . . @ . . @ @ . @ . @ @ . . . @ . @ . @ . . @ @ . . @ . @ @ @ @ . . @ . . . . @ @ . . @ . . . . . . . @ . . @ . . . . @ . . . . . . . @ . . @ . @ . . . @ . @ . . @ . . @ . @ . @ @ . @ @ 
@ . @ . @ . . @ @ . . @ @ @ @ . . . @ @ . @ . . @ . . . @ . @ . @ . . . @ @ . . @ . . @ . @ @ . @ . @ . @ @ . @ . @ . . @ @ @ . @ . @ . @ . @ . @ . . @ . @ . . @ . @ @ . . @ @ . @ . . . . . . @ . @ @ 
@ . @ . @ . @ @ @ @ . @ @ @ . @ @ . @ . . @ @ . . . @ . . . . . . . @ . @ . . @ . @ . . @ . . . . . . . . @ . @ . . @ . @ . . @ @ . . @ . @ . . @ @ @ @ . . @ . @ . @ . . @ . @ . . . @ . @ @ . @ . . @ 
@ . . . . @ @ @ @ @ @ . . . . @ . . . @ . . . @ @ . @ . @ . @ . @ . . @ . . @ . . @ . @ @ @ . @ . @ . @ @ . @ . @ . . . @ . @ . @ @ . @ . . . @ @ @ @ @ @ . . . . . @ . @ . . @ . @ . . @ . . @ . @ . @ 
@ . @ . @ . @ @ @ @ @ . @ @ . . @ @ . . . @ . . . @ @ . . @ @ . @ . @ . @ . . @ . . . . . @ . @ . @ @ . . . . . . @ @ . . . . . @ . @ . @ @ . @ @ @ @ @ @ . @ @ @ . @ . . . @ . @ @ . @ @ @ . . . @ . @ 
@ @ . . @ . @ @ . @ @ @ @ . @ . @ . @ @ . . @ . @ @ @ . @ . . . . @ . . . @ . . . @ . @ @ . @ . @ @ @ @ @ . @ @ . @ . . @ . @ @ . . . . . @ . . @ @ @ @ @ @ . @ . . @ . @ @ @ . . @ . . @ @ @ @ . . . @ 
@ . @ . . . . . . . . @ . . @ . @ . @ . . @ @ @ @ @ . . . @ @ @ @ . @ . @ @ @ @ . . @ @ @ . . . . . @ . . @ @ . . . @ . @ . . . . @ @ . @ @ @ @ @ @ @ @ @ @ . . @ . . . . @ . . @ @ . @ @ @ . @ . @ . @ 
@ . . @ . @ @ . @ . @ @ @ . . . . . . @ . . @ @ @ . @ . @ . @ . . . . . . . @ . . @ . @ . @ . @ . @ . . @ . @ @ . @ @ @ . . @ . @ . @ @ @ @ . . @ . @ @ @ @ @ . . @ . @ . @ . @ . . . . @ . . . . . @ @ 
@ @ . . . . . @ @ . . . . @ . @ . @ . . @ . @ . @ . . . . . . . @ . @ . @ . . @ . . . @ . . . . @ @ @ . . . . @ . @ @ . @ . . @ . . . . @ . @ . . . . . @ @ . @ . . . . @ . . . @ . @ @ . @ . @ @ . . @ 
@ . @ @ . @ @ . . @ @ . @ @ @ . @ @ @ . . . . . @ . @ . @ . @ . @ . . @ . @ . @ . @ @ . @ . @ @ . @ @ . @ . @ . . . . . . . @ . @ . @ @ . . . . @ . @ . . @ . . @ @ . @ . @ . @ . . @ . . . . . @ . @ @ 
@ . . . . . . @ . @ @ @ @ @ @ . @ @ @ @ @ . @ . . @ . @ . . . @ . @ @ . . . . . . . . . . . . . . . . @ . . . @ . @ @ @ @ . . . @ . @ . @ . @ . . @ . . @ @ @ . . @ . . . . . . @ . . @ @ . @ @ . @ . @ 
@ . @ . @ @ . . . . @ . @ @ @ . @ . @ . @ @ @ @ . . . . @ @ @ . . . . @ . @ @ @ . @ . @ . @ . @ @ . @ . @ . @ . @ . @ . . @ . @ . . @ . @ @ . . @ @ @ . @ . . . @ . . @ . @ @ . @ . @ @ . . . . . . . @ 
@ @ . . . . @ . @ . . . . . @ . . . . . . @ @ @ @ . @ . @ . @ @ @ . @ . . . . . @ @ . @ @ . . @ @ . . . . . . . . . . . @ . . . @ . @ . . @ @ . . @ . . . . @ @ @ @ . . @ . . @ . . @ @ . @ @ . @ @ @ @ 
@ @ @ @ . @ @ @ . @ . @ . @ @ @ . @ @ . @ . . @ . @ . . . . . . . . . @ . @ . @ . . @ . @ @ @ @ @ @ . @ . @ . @ . @ @ . . . @ . . . . . @ . . . @ . @ . @ . . @ @ . . @ . . @ . @ . @ . . . @ @ . . . @ 
@ @ @ @ @ @ . . . . . . @ @ @ . @ . @ . . @ . . . @ . @ . @ . @ . @ . @ . . @ . . @ . . . @ @ . . . @ @ @ @ @ . . @ . @ @ . @ @ @ @ . @ . @ . @ . . @ @ @ . @ . . @ . @ . @ . . @ . . @ . @ . @ . @ . @ 
@ @ @ @ @ @ @ . @ @ . @ @ @ . . @ . . @ . @ @ @ . . @ @ @ . . . @ . . @ @ @ @ @ . . @ @ . . . @ @ . . @ . @ . . @ . . . @ @ @ @ @ . . . . . @ @ @ . . . @ . . @ . . . . . . . @ . . @ @ . . . @ . . @ @ 
@ @ @ @ @ @ . . . . @ @ @ . @ . . @ . . . . . . @ . . @ @ @ . @ . @ . @ . . @ @ . @ @ . . @ @ @ . . @ . . . @ @ . @ . @ . @ . @ . @ . @ . @ @ @ . . @ @ . . @ . . @ . @ . @ @ . . @ . . . @ . . . @ @ @ 
@ @ @ @ @ @ . @ . @ . . . . @ . @ . @ @ @ . @ . @ . @ . @ . . @ . . . . . @ . . . . . . @ . @ . @ . @ @ . @ @ @ . . . . . . . . . . . . @ @ @ . @ . . . @ . . @ @ . . @ . @ . . @ . @ @ . @ . @ . . @ @ 
@ @ @ @ @ . . . @ . . @ @ . . . . . . . . @ . . . . . . . @ @ . @ @ . @ . . @ . @ . @ . . . . . . . . @ . . @ @ @ @ . @ . @ . @ @ @ . @ . @ @ . @ @ . @ . @ . . . @ . . @ @ @ . . . . @ . . @ . . @ @ @ 
@ @ @ @ . . @ . . @ @ . . . @ . @ @ . @ . @ @ . @ @ @ . @ . @ . . @ . @ @ . . . . @ . . @ . @ @ . @ . @ . @ @ @ . . . @ . . @ @ . . . . . . . . . . . . . . . @ @ . @ . . @ . . @ . @ @ . @ @ @ . . @ @ 
@ @ @ @ @ . @ @ . @ . @ . @ . . @ @ @ @ . @ . @ . @ . . . . . @ . @ @ @ . . @ . @ @ @ . @ . . @ @ . . @ . . @ . @ @ . @ . @ . . @ @ . @ @ @ @ . @ @ @ @ @ @ . . . . . . @ . @ . . @ @ . . . @ @ @ . @ @ 
@ @ @ @ . @ . . . . . . . @ @ . . @ . @ . . . . . . . @ . @ . . . . @ . @ @ . @ @ @ @ @ . @ . @ . @ . . . @ @ . . @ . . @ . . @ . . @ @ . . @ . @ . . . . . . @ @ . @ . @ . . . @ . . @ . @ @ @ @ . @ @ 
@ @ @ . . . . @ . @ . @ @ . . . @ @ . . . @ . @ . @ . @ . @ @ . @ . . . . @ . @ @ @ @ . . . @ . . . @ . @ . @ . @ . @ . . @ . . . @ @ @ @ . . @ @ . @ . @ @ . @ @ . @ . @ . @ @ . @ . . . . @ @ @ @ @ @ 
@ . . . @ @ . . @ . . @ . @ @ . . @ . @ . @ @ . . . @ . . @ @ @ . @ @ . @ . . . @ @ . @ . @ @ . @ . . . . . . . . . @ . @ @ @ . @ . @ @ . . @ . . . @ . . @ @ . @ . . @ . . . @ . @ . @ @ @ @ @ @ @ @ @ 
@ @ . @ . . . @ . @ @ . . . . . @ @ @ . . . @ @ . @ @ @ . . @ . . . . . . @ . @ . . . @ . . . @ . @ . @ . @ . @ @ . . @ @ . . . . . . @ . @ . @ @ @ . @ @ . . . @ . @ @ @ . @ . . @ . . @ @ @ @ @ @ @ @ 
@ @ @ . . @ . @ . . . . @ . @ . . @ @ @ . @ @ @ @ . . @ @ . . @ . @ . @ . . . . . @ . . . @ . @ . . @ . @ @ . . @ . @ . . . @ . @ . @ . . . . . @ . . @ . @ @ . . . . @ . . . . @ @ . @ . @ @ @ @ @ @ @ 
@ @ @ @ . @ @ . @ . @ . . @ . . @ . @ @ . . @ . @ @ . @ . . @ @ @ . . . @ @ . @ @ . . @ . . @ . @ . @ . . . @ . @ . . @ . @ . . @ . . @ @ . @ . . . @ . . @ . @ . @ @ . @ . @ @ . . . . . . @ @ @ @ @ @ 
@ @ @ @ @ . . . . . @ @ . . @ . . . . . @ @ @ . @ . . @ @ . @ @ . @ . @ @ . @ @ . @ . . @ . @ . . . . @ @ . . @ @ @ . . . @ @ @ . . @ @ @ @ . . @ @ . . @ . . . . . @ . . . @ . @ . @ . @ @ @ @ @ @ @ @ 
@ @ @ @ @ @ . @ @ . @ . . @ @ . @ . @ @ @ @ @ . . @ . . . @ . . . . @ @ . . . . . . . @ @ . @ @ @ @ . @ . @ . @ . . . @ . . @ . @ . . @ @ . . @ . . @ . . @ . @ . @ . . @ . @ . . . @ . @ @ @ @ @ @ @ @ 
@ @ @ @ @ @ @ . . . @ @ @ . @ . . @ @ @ @ @ . @ . . @ @ . . @ @ @ . @ . . @ @ . @ . @ @ . . . . . . . . . . . . . @ . . @ @ . . . @ . @ . @ . . @ . . . @ @ @ . . . . @ . @ @ . @ @ . @ . @ @ @ @ @ @ @ 
@ @ @ @ @ @ @ @ @ @ . . . . . . @ @ @ @ @ . . . . @ . @ @ . @ . . . . . @ . . . . @ . @ . @ . @ . @ @ @ . @ . @ . . @ @ . . @ @ . . . . . . . @ . @ @ . @ . . @ . @ @ . . . . . . @ . . . . . @ @ @ @ @ 
@ @ @ @ @ @ @ @ @ @ . @ . @ . @ . @ @ . . @ . @ . . . @ . . . . @ . @ . . @ . @ . . . . @ @ @ . @ . . . . @ . @ . @ . . . @ @ @ @ . @ . @ @ . @ . . . . @ @ . @ . . @ @ . @ . @ @ . . @ . @ @ . . @ @ @ 
@ @ @ @ @ @ @ @ @ @ @ . @ . . . . . . @ . . @ @ @ . @ @ @ . @ . . @ . . @ . . @ . @ . @ @ @ @ . . @ . @ @ . @ . @ . . @ @ @ @ @ @ @ . . @ . . . . @ @ . . . . . @ . . . . . @ @ @ . @ . @ . @ . @ . @ @ 
@ @ @ @ @ @ @ @ @ @ @ . . @ . @ @ . @ . @ . @ . . . . @ . . . @ @ . . @ @ @ . . @ . . @ @ @ . @ . @ @ . . . . . @ . @ . @ @ @ @ @ @ . @ @ @ @ . @ . . @ . @ . @ . . @ . @ @ . @ . . @ . . . . . . . . @ 
@ @ @ @ @ @ @ @ . @ . @ . . . . . @ . . . . . . @ @ . . . @ @ @ @ @ . . @ @ @ @ @ . @ @ @ . . . . . . @ . @ @ . @ . . . . @ @ @ . . . . @ @ @ @ @ @ . . @ . . . @ . . @ . @ . . @ . . . @ . @ . @ . @ @ 
@ @ @ @ @ @ @ . . . . @ @ @ . @ @ @ @ . @ . @ . . @ @ @ . @ . @ . . @ . @ . . @ . . . . @ . @ . @ . @ @ . @ . . @ . @ . @ @ . . . @ . @ @ @ @ @ . . . @ . @ @ . @ . @ . . . . @ . . @ @ @ @ @ @ @ @ @ @ 
@ @ @ . . @ . @ . @ . . . . . . . . . @ @ . . @ . @ . . . @ . . @ . @ @ . . @ . @ @ . @ @ @ @ @ @ . @ . @ . @ . . . . @ @ @ @ . @ @ @ @ @ @ @ . @ @ . @ . @ . . @ . . @ . @ . . . @ . @ @ . @ @ @ . @ @ 
@ @ . @ . @ . . . . @ . @ @ . @ @ . @ @ @ @ @ . @ @ . @ @ @ @ . @ . . @ @ . . . . @ @ @ . . @ . . . @ . . . . . @ @ @ . . @ @ @ @ @ @ @ . @ . . . . . . . . @ . @ . @ . @ @ . @ @ . . @ . . . @ . . . @ 
@ . . . . . . @ @ @ @ @ . . . . . @ . @ @ . . . . @ @ . @ . . . . . @ @ . @ . @ . . @ . @ . . . @ @ @ . @ @ @ . @ @ . @ . @ @ @ @ @ . . . . . @ @ . @ . @ . . . . . . . . . . @ @ . @ . @ . @ . @ . @ @ 
@ @ . @ . @ . @ . . . . . @ . @ . . . . . @ @ . @ @ . . . @ @ . @ . . . . @ . @ @ @ . . . @ . @ @ @ . @ . @ . . . . . . . . @ @ @ @ @ . @ . @ . . . @ . @ . @ . @ @ @ @ @ . @ @ . . . . . . . . . . . @ 
@ . . @ . . @ @ . @ @ . @ . . . @ . @ @ . @ . . . . @ @ . @ @ @ . @ . @ . @ . . @ . . @ . . . . @ . . . . . . @ . @ @ @ @ . . @ . . @ @ . @ @ @ @ . . @ @ @ . . . . . @ . . . . . @ @ . @ . @ . @ . @ @ 
@ . @ . . @ @ @ @ . . @ @ @ . @ @ . . . @ @ @ . @ . . . . . . . . @ @ @ . . . @ @ @ . . @ @ @ @ . . @ . @ . @ . . . @ . @ . @ . @ . . . . . . . @ . @ . @ . @ . @ . @ . . @ . @ . . @ @ . @ . @ @ . . @ 
@ @ . . @ @ . @ . @ . @ . . . . . @ . @ . @ . . . @ . @ . @ . @ . . . . @ @ . . @ . . @ . @ @ . . @ . @ @ @ @ . @ @ @ . . . @ . . @ . @ @ . @ . @ . . . @ . . . . @ . @ . @ . . @ . . . . . . @ . @ . @ 
@ . @ @ . . . . . . . . . @ . @ . @ . . . @ @ . @ @ @ . . @ . @ @ . @ . @ . @ . @ @ . . . @ . . @ @ . . . . @ @ . . . . @ . . . @ . @ . @ @ @ . . . @ . @ @ . @ . . . @ @ @ @ . . @ . @ . @ . . . @ @ @ 
@ . . . . @ @ . @ . @ @ @ . . @ . . @ . @ . . . @ @ . . @ . . @ @ @ . . . . . . . . . @ @ @ @ . . @ . @ @ . @ . @ . @ . @ @ @ . . . . . . @ . . @ . @ . @ . . @ . @ . . @ . . . @ @ @ @ . . @ . @ @ . @ 
@ @ . @ . @ . @ . . @ @ . @ . . @ @ @ . @ @ . @ . @ @ . @ @ @ . @ @ @ . @ @ @ @ @ @ . @ . @ @ @ . . @ @ . . . . . . @ @ . . . . @ . @ @ . . . @ . . @ @ . @ . @ . . @ @ @ . @ . @ @ @ @ . @ @ . @ . . @ 
@ . @ . . . . . @ @ . . . . . @ . @ . . @ . . @ . . . . . . @ . . @ . . @ . . . @ . . . . @ @ . . @ @ @ . @ . @ . @ @ @ @ . @ . . @ . . @ . @ . . @ . . . @ . @ . @ . @ . @ . . . @ . . . . . @ . @ . @ 
@ . @ @ . @ . @ @ @ @ . @ @ . @ . . @ @ @ @ @ @ @ . @ . @ @ @ . @ . @ . . @ . @ . @ . @ @ @ @ . @ . @ @ @ @ @ @ @ @ @ @ @ @ . . @ @ @ . @ . @ @ . . @ @ . . . @ . . . . . . @ @ @ . . @ . @ . . . . . @ 
@ . . . . . @ @ @ @ @ @ . . . . . @ @ @ @ @ @ @ @ @ . . . @ . . . . . . @ @ . . . . . . . . . . . . . . @ @ @ @ @ @ @ @ @ @ @ . . . . . . @ . . . @ @ @ @ . @ . . @ @ . @ . @ @ @ @ @ @ . . @ . @ . @ @ 
@ @ @ @ @ @ @ @ @ @ @ @ @ @ @ @ @ @ @ @ @ @ @ @ @ @ @ @ @ @ @ @ @ @ @ @ @ @ @ @ @ @ @ @ @ @ @ @ @ @ @ @ @ @ @ @ @ @ @ @ @ @ @ @ @ @ @ @ @ @ @ @ @ @ @ @ @ @ @ @ @ @ @ @ @ @ @ @ @ @ @ @ @ @ @ @ @ @ @ @ 
3
6 42 51 17
85 19 11 72
30 44 65 40
