50 50
@ @ @ @ @ @ @ @ @ @ @ @ @ @ @ @ @ @ @ @ @ @ @ @ @ @ @ @ @ @ @ @ @ @ @ @ @ @ @ @ @ @ @ @ @ @ @ @ @ @ 
@ . @ . . . @ . . . @ . . . @ . @ . . . . . @ @ @ @ @ @ @ @ . . . . . @ . @ @ . . @ @ . . @ @ @ @ @ 
@ . . @ @ . . @ @ . @ @ @ . @ . . . @ . @ @ . @ . @ @ @ . @ . @ . @ . @ . @ . . @ @ . . @ . @ @ . @ 
@ @ . . . @ . . . . . . . . @ @ . @ . @ @ @ . . . . @ @ . @ . . @ . . . . . . @ @ . . @ . . @ @ . @ 
@ . . @ @ . . @ . @ . @ . @ @ . . . . @ @ . . @ . @ @ . . . @ . @ @ @ . @ . @ @ @ @ . . . @ . @ . @ 
@ @ . @ . . @ @ . . @ . . @ . @ . @ @ . @ . @ . . @ . @ . @ . @ . . @ @ . . . @ @ . . @ @ . . @ . @ 
@ . . . @ @ . @ . @ . @ . @ . . . . . . . . . @ @ . . . . . . . @ . . @ @ . @ . . . @ . @ . @ . . @ 
@ @ . @ @ . . . @ . . . . @ . @ @ . @ . @ . @ @ . @ . @ . @ @ @ . @ . . . . . @ @ . . . . . . . @ @ 
@ @ . @ . @ . @ . @ @ @ . . . . @ @ . . @ . @ . . @ @ . . @ . . . . @ @ @ . @ . @ . @ . @ . @ . . @ 
@ . . . . . . . . . . . . @ . @ @ @ @ . @ @ . @ . . . @ . @ @ @ . @ @ . @ . . . . . . @ . @ @ @ . @ 
@ @ . @ . @ . @ @ . @ . @ @ . . @ @ @ @ @ . . @ . @ @ . . . @ . . . @ . . . @ @ . @ . . . . @ . . @ 
@ @ @ . . @ . @ @ @ . @ . . . @ . @ . . . @ . @ . @ . @ . @ . @ . @ . . @ @ . . @ @ @ . @ . @ . @ @ 
@ @ @ @ @ . . . @ . . . . @ . . . . . @ . . . . . . . . . . . @ . @ @ . . @ . @ . @ . @ @ @ . . . @ 
@ . . . @ @ . @ @ @ @ @ @ . . @ . @ . @ @ . @ @ . @ . @ . @ . @ . . . . @ . . . . . . . @ @ @ . @ @ 
@ @ . @ . . . . . @ . . . @ @ @ @ . . @ @ @ . @ @ @ @ . . . @ . @ @ . @ @ @ . @ @ @ @ @ . @ . . . @ 
@ . . . . @ . @ @ . . @ . . . @ . . @ . . @ . . . @ . @ . @ . . @ . . . @ . . . . @ . . . . @ . @ @ 
@ @ @ @ @ . @ @ . @ . . @ @ . @ @ @ . @ . @ @ . @ . . . . . @ . . @ . @ . @ . @ @ . @ @ . @ . @ . @ 
@ . @ . . . . . . @ . @ . . . . @ . . . . . . . . . @ . @ . . . @ . . . . . . . . . . . . . . @ . @ 
@ . . . @ @ @ @ . @ @ . @ @ . @ . . @ . @ . @ @ @ @ . . . @ @ . . . @ . @ @ . @ . @ . @ . @ . @ . @ 
@ . @ . @ . . @ . . @ . . . . . . @ . . . @ . . . . . @ @ @ @ . @ @ @ @ @ @ . . @ . . . @ @ @ . . @ 
@ @ . . . @ . . @ . @ @ @ . @ @ . @ @ . @ @ @ @ . @ . @ @ @ . . . . @ @ @ . . @ . @ . @ @ . . . @ @ 
@ @ @ . @ @ @ . . . . @ . @ . . . @ . . @ @ . @ . . @ @ @ @ . @ . @ @ @ @ . @ . . . @ @ @ . @ @ @ @ 
@ . @ . @ @ . @ @ . @ . . . @ . @ . . @ . . . . . @ . @ . @ @ @ . @ @ @ . @ @ @ . @ . @ . . . @ @ @ 
@ . . @ . . . . . . . @ . @ . @ . . @ . . @ . @ . . . . . . @ . . . @ . . . @ . . . . . @ . @ . @ @ 
@ . @ @ @ @ @ . @ @ . . . . . . . @ . . @ . @ . . @ @ . @ @ . @ . @ . @ . @ . @ . @ @ . . . . . . @ 
@ . . . . . @ @ . . . @ @ @ . @ . @ @ . . . . @ @ . . . @ . . . . @ . . . . . . . . @ . @ . @ . @ @ 
@ @ @ . @ . @ . @ @ @ @ @ @ @ . @ . . @ @ @ @ . . . @ @ . . @ @ . . . @ . @ @ . @ . @ . . @ . . @ @ 
@ . . . . @ . . . . . @ @ @ . . @ . @ . . . @ . @ . @ . . @ @ . . @ @ . . . . @ @ @ . . @ . @ . . @ 
@ @ . @ . @ . @ . @ . . . . . @ @ . . . @ . . @ @ . @ @ . @ @ @ . . @ @ . @ @ @ @ . @ . . . . @ . @ 
@ . . @ @ . @ @ @ . @ . @ @ . . @ . @ . . @ . @ @ . @ . @ @ @ . . @ . @ . . . @ . . @ . @ @ . @ . @ 
@ @ . @ . . . . @ . . . @ @ @ . . @ . . @ . @ @ @ @ . . . @ . @ . . . . @ @ . @ @ . @ . . . @ @ . @ 
@ . . . @ . @ . @ . @ @ . @ . @ . . @ . . . . @ @ . @ . @ . . . . @ . @ . @ @ . @ . . . @ . . . @ @ 
@ . @ . . @ . . . @ . @ . . . . @ . . . @ . @ . @ . . . . . @ . @ @ . . . . . . @ @ @ . @ . @ . . @ 
@ @ . @ . . @ . @ . . . . @ @ . . @ @ . @ @ . . . @ . @ @ @ . . @ . . @ . @ . @ . . . . . @ @ @ . @ 
@ @ . . @ . . . . @ . @ @ . . @ . @ . . . @ @ @ . @ @ . . . @ . @ @ . @ . . @ . . @ @ . @ @ @ @ @ @ 
@ @ @ . . @ . @ . . @ . . @ . @ . . @ @ . . @ . . . @ . @ @ @ . . @ . . @ @ @ @ @ . . . @ @ @ @ @ @ 
@ @ . @ . . @ . . @ . . @ . . . @ . . . . @ . @ . @ @ . . . . . @ . . @ @ @ @ @ @ @ . @ @ @ @ @ @ @ 
@ . . . . @ . @ . @ . @ . @ . @ . @ @ @ . . . . . . . . @ . @ . . @ . @ @ @ @ @ @ @ @ @ @ @ @ @ @ @ 
@ @ . @ . . . . . . . . . . . . . . . . . @ @ . @ . @ . @ @ @ . @ @ @ @ @ @ @ @ @ @ @ @ @ @ @ @ @ @ 
@ . . . @ @ . @ . @ . @ . @ . @ @ . @ . @ . . @ . . . @ . . . . @ @ @ @ @ @ @ @ @ @ @ @ @ @ @ @ @ @ 
@ @ @ . . @ @ . . @ @ . . @ @ . . . @ . @ . @ . @ . @ @ @ . @ . . . @ @ @ @ @ @ @ @ @ @ @ @ @ @ @ @ 
@ @ . @ . . . @ @ . . . @ . . . @ . . @ . . . . . . @ . . . @ . @ . . @ @ @ @ @ @ @ @ @ @ @ @ @ @ @ 
@ @ . . @ . @ . @ @ . @ . @ . @ @ . @ . . @ . @ . @ . . @ . . @ . . @ @ @ @ @ @ @ @ @ @ @ @ @ @ @ @ 
@ @ @ . @ @ . . . . @ . . . . . @ @ @ @ . @ . . @ . . @ . . @ @ . @ @ @ @ @ @ @ @ @ @ @ @ @ @ @ @ @ 
@ @ . . . . @ . @ . . . @ . @ . @ . . @ . @ @ . @ @ . @ @ . @ . . @ @ @ @ @ @ @ @ @ @ @ @ @ @ @ @ @ 
@ . @ . @ . . @ . @ . @ . . @ . . . @ @ . . . @ . . @ . . . . @ . @ @ @ @ @ @ @ @ @ @ @ @ @ @ @ @ @ 
@ . . . @ @ . @ . . . . @ . @ . @ . . @ . @ . . . @ @ . @ @ . @ . . @ @ @ @ @ @ @ @ @ @ @ @ @ @ @ @ 
@ @ . @ @ . . . . @ . @ @ . @ . . @ @ @ . . @ . @ . . . @ . . @ . @ @ @ @ @ @ @ @ @ @ @ @ @ @ @ @ @ 
@ @ . . . @ . @ . . @ . . . @ . @ @ @ @ @ . . @ @ @ . @ @ @ . @ @ @ @ @ @ @ @ @ @ @ @ @ @ @ @ @ @ @ 
@ @ @ @ @ @ @ @ @ @ @ @ @ @ @ @ @ @ @ @ @ @ @ @ @ @ @ @ @ @ @ @ @ @ @ @ @ @ @ @ @ @ @ @ @ @ @ @ @ @ 
3
19 12 1 33
12 28 32 25
12 20 43 22
