12 12
@ @ @ @ @ @ @ @ @ @ @ @ 
@ . . . . . . . . . . @ 
@ . @ @ . @ . @ @ . @ @ 
@ @ . . . . @ @ . . . @ 
@ @ . @ . @ @ @ @ . @ @ 
@ @ @ . @ @ @ @ @ . @ @ 
@ . . . @ . @ . @ . . @ 
@ @ @ . . . . . . . @ @ 
@ @ @ @ . @ . @ . @ @ @ 
@ @ @ @ @ @ @ @ @ @ @ @ 
@ @ @ @ @ @ @ @ @ @ @ @ 
@ @ @ @ @ @ @ @ @ @ @ @ 
3
2 6 6 7
1 8 3 2
3 9 2 4
