12 12
@ @ @ @ @ @ @ @ @ @ @ @ 
@ @ @ . . . @ . @ @ @ @ 
@ . @ . @ . . . . @ @ @ 
@ . . . @ @ . @ . . @ @ 
@ . @ . . . @ . . @ . @ 
@ @ . . @ . @ @ . . . @ 
@ @ @ . . @ . . . @ . @ 
@ @ . . @ . . @ @ @ . @ 
@ @ @ . @ @ . . . @ . @ 
@ @ @ @ @ . . @ . @ @ @ 
@ @ @ @ @ @ . . @ @ @ @ 
@ @ @ @ @ @ @ @ @ @ @ @ 
3
2 7 6 4
8 6 6 10
2 3 1 4
