20 20
@ @ @ @ @ @ @ @ @ @ @ @ @ @ @ @ @ @ @ @ 
@ @ . . @ @ . . . @ @ @ . @ . @ . . . @ 
@ @ . @ . @ . @ . . @ . . @ . . . @ . @ 
@ @ . . . @ . . @ @ . @ . @ @ . @ . @ @ 
@ . @ @ . @ . @ . . . . . . . . @ . @ @ 
@ . . . . . . . . @ @ @ @ @ @ @ . . . @ 
@ @ . @ . @ . @ . . . . . . . @ @ . @ @ 
@ . . @ . . @ . . @ @ . @ . @ . . . . @ 
@ . @ . . @ . . @ @ . . . @ @ . @ . @ @ 
@ @ . . @ @ @ . . . @ . @ . @ @ . . . @ 
@ @ @ . . @ . . @ . @ . . . . . . @ @ @ 
@ . . . @ @ @ . . @ . . @ . @ . @ . . @ 
@ @ @ @ . . . . @ . . @ . . . @ . . @ @ 
@ . . . @ . @ . . @ @ . @ . @ . @ . . @ 
@ . @ . . . . @ . @ @ . . . . . . . @ @ 
@ @ @ @ . @ @ . . @ . @ @ . @ . @ @ @ @ 
@ @ @ @ @ @ @ @ . . . . @ @ . . . . @ @ 
@ @ @ @ @ @ @ @ @ . @ . . . @ . @ . . @ 
@ @ @ @ @ @ @ @ @ @ @ @ . @ @ . . @ . @ 
@ @ @ @ @ @ @ @ @ @ @ @ @ @ @ @ @ @ @ @ 
3
12 6 2 9
12 14 17 13
14 11 8 4
