50 50
@ @ @ @ @ @ @ @ @ @ @ @ @ @ @ @ @ @ @ @ @ @ @ @ @ @ @ @ @ @ @ @ @ @ @ @ @ @ @ @ @ @ @ @ @ @ @ @ @ @ 
@ @ . . . . . . . @ @ @ @ @ . @ @ . @ . @ @ @ . . . . @ @ @ . @ . @ . @ . . . @ . . @ . . . . @ . @ 
@ @ @ . @ . @ . @ @ @ @ @ @ . . . . . . . @ . . @ . @ . @ . . . . . . . . @ . @ @ . . . @ . @ . . @ 
@ . . . . @ . @ @ . @ @ . @ . @ @ @ . @ . . . @ . . . . . . @ @ @ @ . @ @ @ . @ . . @ . . @ . . @ @ 
@ @ . @ . . . . . . . . . . . . . . @ @ @ . @ @ @ . @ . @ . . . . . @ @ @ @ @ @ @ . . @ @ . @ . . @ 
@ @ @ . . @ . @ . @ . @ . @ . @ . @ @ @ @ @ @ @ . @ @ @ . . @ . @ . @ @ @ @ @ @ . . @ . . . . . @ @ 
@ @ @ @ @ . @ . @ @ @ @ @ @ . . @ @ @ @ . . @ . . . . . @ . . @ @ @ . . @ @ @ @ @ . @ @ @ @ . @ . @ 
@ @ @ . . . . . . @ . @ . @ . @ @ @ @ @ . @ . @ @ @ @ . . . @ @ @ . @ . @ @ @ @ . . @ @ . @ . . . @ 
@ @ . . @ . @ . @ . . . . . . . @ @ @ . . . . . . . . . @ . . @ . . . . . @ @ @ . @ . @ . @ . @ . @ 
@ @ @ . . @ . . . @ . @ . @ . @ . @ . . @ . @ @ . @ . @ . . @ @ @ . @ . @ . @ . . . . . . . . . @ @ 
@ @ @ @ @ . @ @ . @ . . @ . . . . . @ @ @ @ . @ @ . . @ @ @ . @ . . . @ . . . . @ @ @ . @ . @ @ . @ 
@ @ @ @ . . . . . . . @ @ @ . @ . @ . @ @ @ . . @ @ . . . @ . . @ . @ . @ . @ . . . . @ @ . . . . @ 
@ @ @ @ . @ @ @ . @ . @ @ @ @ . . . . @ @ @ . @ . . . @ @ @ . @ . . . . . . . @ . @ . . @ . @ . @ @ 
@ @ @ @ . @ @ . . . @ @ @ @ @ . @ . @ @ @ . . . . @ . . . @ . . . @ . @ @ . @ . @ . . @ . @ . @ @ @ 
@ . . . @ @ @ @ . @ . @ @ @ . . @ . . @ . @ @ . @ . . @ . @ . @ . @ . . . @ . . . @ . . . . . @ @ @ 
@ @ . @ @ @ @ . . . . @ @ . @ . @ . @ . . @ @ @ . @ . @ . . . . @ @ @ . @ @ @ @ . . @ . @ . @ . @ @ 
@ . . . . @ . @ . @ . . . . @ . @ . @ . @ . @ @ . @ . . @ . @ . @ . . . . @ @ . . @ @ @ @ . . . @ @ 
@ @ @ @ . . . . . @ . @ . @ . @ @ . @ . . . . . . . @ . @ . . @ . . @ . @ . @ @ . . @ @ . . @ . . @ 
@ . . . . @ . @ . . @ . @ @ . . . . . @ @ . @ . @ @ @ . . @ . @ . @ . . . . . . @ . . @ @ . . @ @ @ 
@ @ @ . @ . . . @ @ . . . . . @ @ . @ . . . . @ @ @ @ . @ @ . @ . @ @ . @ . @ . . . @ . . . @ @ @ @ 
@ . . . . @ . @ . @ @ @ @ @ @ . . . . @ . @ . @ @ @ @ . . . @ @ @ . . . . @ @ . @ @ . . @ . . @ @ @ 
@ . @ . @ @ . . . . @ . @ . @ @ . @ @ . . . @ . . . @ . @ @ @ @ @ @ @ . @ @ @ @ @ @ . @ . @ @ . @ @ 
@ @ . . . @ @ @ @ @ @ . . . . . . . . @ . @ . @ . @ . . . . @ @ @ @ @ . . @ @ @ . @ . . . @ . . . @ 
@ . @ . @ @ . . . @ . @ . @ . @ . @ . . . . . . . @ @ . @ @ @ @ . @ . . @ @ @ . . . @ . @ . . @ . @ 
@ . . . . @ . @ . . . . @ . @ @ @ . . @ @ @ . @ . @ . . @ . . . . . @ @ @ @ . @ . @ . @ . @ . @ . @ 
@ . @ . @ . @ . . @ @ @ . . . @ @ @ @ . . . . . @ @ @ . . . @ @ @ . . . . . . . . . . . . . . . @ @ 
@ . @ . . . @ @ . . . @ . @ @ @ @ @ @ @ . @ . @ . @ . @ @ . . . . @ . @ @ @ . @ . @ . @ . @ @ . . @ 
@ @ . . @ @ @ . . @ . . . . @ @ @ @ @ @ @ . . @ . . . @ . @ . @ @ @ @ . . @ . @ @ . @ . @ @ . @ @ @ 
@ @ @ . . @ . @ . @ . @ . @ @ @ @ @ @ @ @ . @ @ @ @ . @ . . @ . . . @ . @ @ @ . . . . . . . . . . @ 
@ @ @ @ . . . . . . @ @ @ @ @ @ @ . @ @ @ . . @ . . . . . @ . . @ . @ . . . @ . @ @ . @ . @ @ . @ @ 
@ @ @ . . @ . @ . @ . @ . @ @ @ . . @ @ @ . @ @ @ . @ @ . @ . @ . @ @ . @ . . . @ . . @ @ . . . . @ 
@ @ . @ . . @ . . . . . . . @ . . @ . @ @ . . . . . . . @ . . . . . . . . @ . @ @ @ @ . @ . @ . @ @ 
@ . . . . @ . @ . @ . @ @ @ . @ . . . . . . @ . @ . @ . . . @ . @ @ @ . @ @ @ @ @ @ @ . @ @ . . . @ 
@ @ . @ . . . . @ . . @ @ . . @ @ . @ . @ . . @ @ . . @ . @ . @ @ . . . . @ @ @ @ @ @ . . . @ . @ @ 
@ @ . . @ . @ @ @ @ . . . @ . . . . . @ . @ . . @ . @ . . . . . @ . @ . @ @ @ @ @ @ . . @ @ . . . @ 
@ @ @ @ . . . . . . @ @ @ . . @ @ . @ @ . . . @ . . . @ . @ . @ . @ . @ @ @ @ @ @ . @ . . @ @ . @ @ 
@ . . @ @ . @ @ . @ . . @ . @ @ @ @ . @ @ . @ @ . @ . . @ . . . . . . . @ @ @ @ . . . . @ @ @ @ @ @ 
@ @ . . . . . . @ @ . @ . . . @ . @ . @ @ . . . @ @ . @ @ . @ . @ . @ . . @ @ @ @ @ @ . . . @ . @ @ 
@ @ @ . @ . @ . . . . . @ . @ @ . . . . . . @ . @ . . @ . . . @ . . . @ . . @ @ @ @ @ . @ . . . . @ 
@ @ . @ . . @ @ @ . @ . @ . . @ @ . @ . @ @ @ . . @ . . @ @ . . @ . @ . @ . . @ @ . @ . @ . @ @ . @ 
@ . . @ @ . . . @ . . @ . . @ @ @ @ . . @ . @ @ . . @ . . . @ . @ . . . . @ . . . . . . . @ @ . @ @ 
@ @ . . . . @ @ @ . @ @ @ . @ @ @ @ @ . . . . @ . @ @ . @ @ . @ . . @ . @ . @ . @ @ @ . @ . @ . @ @ 
@ @ @ . @ . . . . @ @ . . . . @ . @ . @ . @ @ . . . . @ . . . @ . @ @ . @ . @ . @ . @ . . . . . . @ 
@ @ . @ . . @ @ @ . @ @ @ . @ @ . . . . . . . @ . @ . . . @ . @ . . @ . . . . @ . . . . @ . @ . @ @ 
@ . . . @ . . . . . . . @ . . @ . @ @ @ @ . @ . . . @ . @ . . @ . @ @ @ . @ . @ @ @ . @ . . @ . . @ 
@ . @ . @ @ . @ . @ . @ @ . @ . . . @ @ @ @ . . @ . . @ . @ . @ @ . @ . . . @ . . . . . @ @ . . @ @ 
@ @ . . . . . . @ . . @ . . . @ @ @ @ @ @ @ @ @ . . @ @ . . . . . . @ @ . @ . . @ @ . @ @ @ @ . . @ 
@ . . @ . @ . @ @ @ . @ @ . @ @ @ @ @ @ @ @ @ . @ . @ @ . @ . @ . @ @ @ @ @ @ . . @ @ @ @ @ @ @ . @ 
@ @ . . @ . . . @ @ . . @ . @ @ @ @ @ @ @ @ . . . . . @ @ . . . @ @ @ @ @ @ @ . @ @ @ @ @ @ @ . . @ 
@ @ @ @ @ @ @ @ @ @ @ @ @ @ @ @ @ @ @ @ @ @ @ @ @ @ @ @ @ @ @ @ @ @ @ @ @ @ @ @ @ @ @ @ @ @ @ @ @ @ 
3
28 47 19 11
25 13 23 27
5 31 5 46
