50 50
@ @ @ @ @ @ @ @ @ @ @ @ @ @ @ @ @ @ @ @ @ @ @ @ @ @ @ @ @ @ @ @ @ @ @ @ @ @ @ @ @ @ @ @ @ @ @ @ @ @ 
@ @ @ @ @ @ @ @ @ @ @ @ @ @ @ @ @ @ @ @ @ . . . @ . @ . @ @ @ @ @ @ @ @ @ @ @ @ @ @ @ @ @ @ @ @ @ @ 
@ @ @ @ @ @ @ @ @ @ @ @ @ @ @ @ @ @ @ @ . . @ @ . . . . . @ @ @ @ @ @ @ @ @ @ @ @ @ . @ @ @ @ @ @ @ 
@ @ @ @ @ @ @ @ @ @ @ @ @ @ . . @ @ @ @ @ . . @ . @ . @ @ @ @ @ @ @ @ @ @ @ @ @ @ @ . . @ @ @ @ @ @ 
@ @ @ @ @ @ @ @ @ @ @ @ . @ . @ @ . @ . . . @ . . @ . . . @ . @ @ @ @ . @ @ @ @ @ . . @ . @ @ @ @ @ 
@ @ @ @ @ @ @ @ @ @ . . . . . . @ . . @ @ . . . @ @ @ . @ . . @ . . . . . . . @ @ @ . . . . @ @ @ @ 
@ @ @ @ @ @ @ @ @ . @ . @ @ . @ . . @ @ . . @ . . @ . @ . . @ @ @ . @ . @ . @ @ @ @ . @ . @ @ @ @ @ 
@ @ @ @ @ @ @ @ . . . . . @ . @ @ . . @ . @ . . @ . . . @ . @ . . . . @ @ . . . @ . . @ . @ @ @ @ @ 
@ . @ @ @ @ @ @ . @ @ . @ . @ . . . @ . . . @ @ @ . @ . @ . @ @ . @ . . @ . @ . . @ . . @ @ @ @ @ @ 
@ . . @ @ @ . . @ @ . . . . . @ @ . @ . @ @ . . @ @ . . . . . . . . @ . . @ . . @ @ . @ . @ . @ @ @ 
@ . @ @ @ . . @ . . @ . @ @ @ @ . . . . . @ . @ @ @ @ @ . @ @ . @ . @ . @ . . @ . . . . . . . . @ @ 
@ . @ . . @ . . @ . . . . . @ . . @ . @ @ . . @ . @ @ . @ . . . @ . . @ . @ . . . @ . @ @ . @ . @ @ 
@ . . @ . . . @ . @ . @ . @ . . @ . @ . @ . @ @ . . . . . . @ . @ . @ @ . . . @ . @ . @ . . @ . . @ 
@ @ . @ . @ . @ . @ . @ . . . @ . . . . . . . @ @ @ @ . @ . @ . @ . . . @ @ . @ . . @ @ @ . @ @ . @ 
@ . . @ @ @ . . . . @ . @ @ . . . @ . @ @ . @ @ @ . . @ @ @ @ @ . @ . @ . . . @ . @ . @ . . @ @ . @ 
@ @ . . . . @ . @ @ @ . @ . . @ @ @ . @ . @ @ @ . . @ @ @ @ @ . . . . . @ @ . @ . @ . . @ . . @ . @ 
@ @ @ @ @ . . . @ . . . . @ . . . . @ . . . @ . @ . @ @ . . . @ . @ . @ . . . . @ . @ . @ . @ . . @ 
@ @ @ @ @ @ @ . @ . @ . @ . . @ . @ . @ @ . . . . . . @ . @ . @ . . @ . . @ . @ . . . . @ . . @ . @ 
@ @ @ @ @ @ . . @ @ . . . @ . . @ . . . @ . @ . @ . @ . @ @ . . . @ . . @ @ . . . @ @ @ . @ @ @ . @ 
@ @ @ @ @ . @ . @ @ . @ . . . @ . @ @ . @ . . @ . . @ . @ @ . @ . . @ @ . . . @ . . . . . . . . @ @ 
@ @ @ @ . . . . . . @ . @ @ . . . . . . . . @ . @ @ . . . . @ @ @ . . . @ @ . . @ . @ . @ . @ . . @ 
@ . @ . @ . @ @ . @ @ . @ . @ . @ @ . @ @ . . . . @ @ . @ @ @ @ @ @ . @ @ @ . @ . . . @ . . . @ . @ 
@ . . . . . @ . . @ . . @ . @ @ . @ @ . . . @ @ @ . @ . @ . @ @ @ @ @ @ @ @ @ . . @ @ @ @ . @ . . @ 
@ @ . @ . @ . @ . . @ . @ . . . . . . . @ . @ . @ . . . . . . @ @ @ . . . @ @ @ . . @ @ @ . @ @ . @ 
@ . . @ @ . . . @ . . . . @ @ @ @ . @ @ . . @ . . . @ @ . @ @ . @ . @ . @ @ @ @ @ . . @ . @ @ . @ @ 
@ . @ . . @ @ . . @ . @ . . @ . @ @ . . @ . . . @ @ . @ @ @ @ . . . . . . @ . . . . @ @ . @ . . @ @ 
@ @ . @ . . . @ . @ @ . . @ . . @ @ @ . . . @ . @ . . @ . . . . @ . @ . @ . . @ @ . . . . . @ . . @ 
@ @ . @ . @ @ . . . . @ . @ @ . . @ . @ @ . . @ @ @ . . @ . @ . @ @ . . . . @ . . . @ . @ . @ . @ @ 
@ . . . . . . @ . @ @ . . @ . . @ . . @ @ @ . @ @ . . @ @ . @ . @ @ @ @ . @ . . @ @ @ . . @ . . @ @ 
@ @ . @ @ @ . . . . . @ . @ . @ . @ . . @ . . . . @ . . . @ @ @ . @ . . @ . . @ @ @ . . @ . . @ @ @ 
@ . . @ @ @ . @ . @ . . . . . . . . . @ . @ . @ @ . @ . @ . @ @ . @ . @ . @ . . . . @ . @ . @ . @ @ 
@ @ @ . @ . @ . . . @ . @ . @ @ . @ . . . . . . . . . . . . . . . . . . . . . @ . @ @ . . . . . . @ 
@ . . . . . . . @ . . @ . . . @ @ . . @ . @ . @ . @ . @ . @ . @ . @ . @ . @ . . @ . . . @ . @ . @ @ 
@ . @ . @ . @ . @ . @ . @ . @ . @ @ . @ . @ @ @ @ . . @ . @ @ @ @ . . . @ . . @ . . @ . . @ . . @ @ 
@ @ . . . @ . . @ . @ . @ . . . @ . @ . . . . @ @ @ . @ @ . . . . . @ . @ @ . @ . @ . . @ . @ @ @ @ 
@ @ @ . @ . @ . @ . @ . @ . @ . @ . . . @ @ @ . @ @ @ . . . @ . @ . @ @ . . . . @ @ @ . . . . . @ @ 
@ @ . @ . . . @ @ @ . . . @ . @ @ @ . @ . . . . . . . . @ . @ . @ @ . . . @ . @ . . . . @ . @ . . @ 
@ . . . @ . @ @ @ . @ . @ @ . . . . . @ @ . @ . @ . @ . @ . . @ . . . @ . @ . . @ @ @ . @ . . @ @ @ 
@ @ @ . . . . . . . . . . . . @ @ . @ . . . . @ . . @ @ . . @ . @ . @ . . . @ . @ . . . . @ . @ @ @ 
@ @ @ @ . @ @ . @ . @ . @ . @ . . . . @ @ . @ . . @ . . . @ . . . . @ @ . @ . . @ . @ . @ . . . @ @ 
@ @ @ . . @ . . @ . @ @ . . @ @ . @ @ . @ @ . . @ . . @ . @ @ . @ . . . @ . . @ @ . @ . @ @ . @ @ @ 
@ @ . @ . . @ . @ @ . . . @ . . . @ . . . . . @ . . @ . . @ . . @ @ . @ @ @ . @ . . . @ . . . . @ @ 
@ . . . . @ @ . @ . @ . @ . . @ . . @ . @ @ . . @ . @ @ . @ @ . . @ @ . @ . @ . @ . @ . @ . @ @ @ @ 
@ @ . @ . @ . . @ . . . . @ . . @ . . @ @ . . @ . @ @ . @ . . . @ . . . . . . . . . . . @ . . . . @ 
@ . . . @ . . @ . . @ . @ . . @ . . @ . @ @ . @ . . . . @ @ . @ @ . @ . @ . @ @ @ . @ @ @ @ . @ . @ 
@ @ . @ @ . @ . . @ . . . @ . @ @ @ . . . . . . . @ @ . . @ . . @ . @ . @ . @ @ @ . . . . @ . . @ @ 
@ . . . . @ . . @ . . @ . . @ . . . . @ . @ . @ . . . @ . @ . @ . . @ . . @ . . . . @ @ . . @ @ @ @ 
@ @ . @ @ . @ . @ @ . @ . @ . @ . @ . @ @ . . . @ . @ . . . @ . . @ . . @ @ @ . @ . . @ . @ @ . @ @ 
@ @ @ . . . . . @ @ . @ . . . . @ . . @ . . @ . . @ @ @ . @ @ @ . @ . @ @ @ @ @ . . @ . . . . . @ @ 
@ @ @ @ @ @ @ @ @ @ @ @ @ @ @ @ @ @ @ @ @ @ @ @ @ @ @ @ @ @ @ @ @ @ @ @ @ @ @ @ @ @ @ @ @ @ @ @ @ @ 
3
24 28 11 38
31 24 26 42
24 5 48 4
