10 10
@ @ @ @ @ @ @ @ @ @ 
@ . @ . . . . . . @ 
@ . . @ . @ @ . @ @ 
@ . @ . . . . @ @ @ 
@ . . @ . @ . @ @ @ 
@ . @ . @ . . . @ @ 
@ . . . . . @ . . @ 
@ @ @ . @ @ . . @ @ 
@ . . . . . @ . . @ 
@ @ @ @ @ @ @ @ @ @ 
3
4 1 1 4
6 2 7 6
2 2 3 1
