10 10
@ @ @ @ @ @ @ @ @ @ 
@ @ . @ . @ @ @ @ @ 
@ . . . . . @ @ @ @ 
@ @ . @ . @ @ @ . @ 
@ . . . @ @ @ . . @ 
@ @ . @ . @ . @ . @ 
@ . . . . . . . . @ 
@ . @ @ . @ . @ . @ 
@ @ @ @ @ . . @ . @ 
@ @ @ @ @ @ @ @ @ @ 
3
3 2 2 3
6 6 6 2
5 6 7 6
