100 100
@ @ @ @ @ @ @ @ @ @ @ @ @ @ @ @ @ @ @ @ @ @ @ @ @ @ @ @ @ @ @ @ @ @ @ @ @ @ @ @ @ @ @ @ @ @ @ @ @ @ @ @ @ @ @ @ @ @ @ @ @ @ @ @ @ @ @ @ @ @ @ @ @ @ @ @ @ @ @ @ @ @ @ @ @ @ @ @ @ @ @ @ @ @ @ @ @ @ @ @ 
@ @ . @ @ . . @ @ . @ @ @ . @ . @ @ @ @ @ @ @ @ @ @ @ . @ . . @ . . @ . @ . . . . @ . @ @ @ @ @ @ @ @ @ @ @ @ @ . . @ @ @ . @ . @ @ @ @ @ @ . . . . . . @ @ @ @ @ . . @ @ @ . @ . @ . . . @ @ @ . . @ @ 
@ . . . . @ . . . . . . . . . . . @ @ @ @ @ @ @ @ @ @ . . . @ . @ . . . @ . @ @ @ . . . @ @ @ @ @ @ @ @ @ @ @ . . @ @ @ @ . . . . @ @ @ @ . . @ @ @ @ @ @ @ . @ . @ . . @ @ . . . . @ . @ @ @ @ @ . . @ 
@ @ @ @ . . . @ . @ @ . @ @ . @ . @ @ @ @ @ @ @ @ @ . . @ . @ . @ . @ . @ . . . . . @ @ @ @ @ @ @ @ @ @ . @ . @ . . @ @ . . @ . @ @ @ @ . @ . . @ . . @ @ . . @ . . . @ @ . @ @ . @ . . . @ . @ . . @ @ 
@ @ . @ @ @ . @ @ @ . @ . . @ @ . @ @ @ @ @ @ @ @ . . @ . . . . . . . @ . . @ . @ . @ @ @ @ @ @ @ @ @ . . . . . . @ @ @ @ . . @ @ @ @ . . . . @ . @ . . @ . @ @ @ @ . . . . . . . . . @ . @ . . @ . . @ 
@ @ . . . . . . . . . . @ . . . @ @ @ @ @ @ @ @ . . @ @ @ @ . @ @ . @ . . @ . . . @ @ @ @ @ @ @ @ @ . @ @ @ . @ . @ @ @ @ . @ @ . @ @ @ . @ . . . . . @ . . @ . @ @ @ . @ . @ @ . @ @ . @ . . @ . . @ @ 
@ . . @ @ @ . @ @ . @ . . . @ . . @ @ @ @ @ @ @ @ . @ . @ @ @ . @ . . . @ @ @ . @ @ @ @ @ @ @ @ @ . . . . @ @ . . . @ @ . . @ . . @ @ @ @ . . @ @ @ . @ @ . . . @ . . . @ @ . . . . @ . . @ . . . @ . @ 
@ @ . @ . @ . . . @ @ . @ . . @ @ . @ @ . . . @ . . . . . @ @ . @ . @ . . @ @ @ @ @ @ @ @ @ @ @ . @ . @ @ . . @ @ . . . @ . . @ . . @ @ . @ . . @ . @ . . @ . @ . @ . @ @ . @ . @ @ . @ . @ . @ . . . @ 
@ @ @ . . . @ @ . @ . @ . @ . @ . . . . @ . @ . @ @ . @ . @ . . . . @ @ @ . . . @ @ @ @ @ @ @ . . . . @ @ @ . @ . @ @ . . . @ . @ . . @ . . . @ @ . @ @ . . . . . . @ . . . . . . @ . . . . . . @ @ @ @ 
@ @ . @ @ . . . . . . @ . @ . . @ @ @ . . . . . . . @ @ @ @ @ @ @ . . @ . @ . @ . . @ @ @ . . @ . @ . . . . . . . @ . . @ @ . . . . @ . @ @ . . . . . . @ @ . @ . @ @ @ . @ . @ . @ @ . @ @ @ . @ . @ @ 
@ . . @ @ @ @ @ . @ . . . . @ @ @ . @ @ . @ @ . @ @ . @ @ @ @ . @ . @ . . . . . @ . . @ . . @ @ @ . @ @ . @ . @ @ . @ . @ . . @ @ . . . @ . @ . @ . @ . @ . . . @ @ @ . . . @ . . @ . . @ @ . @ @ . . @ 
@ @ . @ @ . @ @ @ . @ @ . @ . . . . @ . @ . . . . . . @ @ @ @ . . . . . @ . @ . @ . @ . @ . @ . . . . . @ . . . @ . @ . . @ . . . @ @ . . . . . . @ @ @ . @ @ . . @ @ @ . @ . @ . . @ . . @ . . . . @ @ 
@ @ . . . . . . . . . . . . . @ @ @ . . . @ . @ . @ . . . @ @ @ @ . @ . . @ . . . . . . . . . @ @ . @ @ . @ . @ . . . . @ @ @ . @ . . @ . @ . @ . . @ . . @ @ . @ @ @ @ @ . . . . @ . . @ @ . @ . @ @ @ 
@ @ @ . @ . @ . @ @ . @ . @ . @ . @ . @ . . . @ @ @ . @ @ . @ . . . . @ @ . . @ . @ . @ . @ . . . . . . . . . . @ . @ . . @ @ @ . @ . . . . @ @ . @ . @ . . @ . . @ @ @ @ . @ @ . . @ . . . . . @ . @ @ 
@ @ . . . @ . . @ @ @ . . @ . @ . . @ @ . @ @ . . . . @ . . . . @ . @ . . @ . @ @ @ @ @ @ . @ . @ . @ . @ . @ . . @ . . @ . . . . @ @ @ . @ @ @ . . . @ . @ . @ . . @ @ @ @ @ . . @ . . @ . @ . . . . @ 
@ @ @ @ . @ @ . @ @ @ . @ . . . @ . @ . @ @ @ @ . @ . . . @ . @ . . . @ . . @ . . @ . . @ . . . @ . . @ . @ . . @ . @ . . . @ . @ @ . @ . @ . . . @ @ . . . . @ . @ . @ . . @ @ . @ . @ @ . . @ . @ . @ 
@ @ . . @ @ @ . . . . @ . @ . @ . . . . @ . @ . . . @ . @ @ @ . . @ . . @ . . @ . . @ . @ . @ . . @ . . . . @ . . . . . @ . . @ @ @ . . @ . @ . @ . @ @ . @ . . . . . . . @ . @ . . . . @ . @ @ @ @ @ @ 
@ @ @ . . @ . . @ . @ . . . . . @ @ @ . . . . . @ . . @ . @ @ @ @ @ . @ @ @ . . . @ . . . @ . @ . @ . @ @ . @ . @ . @ . @ @ @ . @ . @ . @ . . . . . . . @ . . @ @ . @ @ . . . @ . @ . @ @ @ @ @ @ @ @ @ 
@ @ @ . @ . @ . . @ . . @ @ . @ . . . . @ . @ . . @ . . . . @ @ @ @ . @ @ . @ @ . . @ @ . @ . @ @ @ @ @ . . . @ @ @ . . . . . . . . . . . . @ @ . @ @ @ . . @ @ @ @ . @ @ @ . . . . @ @ @ @ . @ . @ . @ 
@ @ . . @ . . . @ . @ . . @ . . @ . @ . @ @ . . @ . @ . @ . @ @ @ @ @ . @ . @ . @ . @ . . . . . @ @ @ @ @ . @ @ @ . @ @ . @ . @ . @ . @ @ . @ . @ @ @ @ @ . @ . @ @ . @ @ . @ . @ @ . @ @ . . . . . . @ 
@ . . @ @ . @ . . . @ @ @ . . @ @ @ . @ @ . @ . . . @ @ @ @ @ @ . . . . . . . . . . . @ . @ . @ @ @ @ @ @ @ @ @ . . . @ @ . . @ . . @ @ @ . @ . . @ . @ . @ . . . . . . . . . . @ . . . @ . @ . @ @ . @ 
@ @ . . . @ . . @ @ @ @ @ @ . . @ @ . @ . . . . @ . . @ @ @ @ . @ @ @ . @ . @ @ . @ . . . @ . . . @ @ @ @ @ @ @ @ @ . . @ @ . @ @ @ @ @ . . . @ . . . . . . . @ @ @ . @ . @ @ . . . @ @ . . . @ @ . . @ 
@ . . @ . @ @ . . @ @ @ @ . . @ @ @ . @ @ . @ @ @ . @ . @ @ . . . @ @ @ . . . @ @ . @ @ . @ @ @ @ @ . @ . @ @ @ . @ . @ . @ @ @ @ @ @ . @ . @ . @ @ . @ . @ @ . @ @ @ . . . @ . @ @ . . @ @ . . @ . @ @ 
@ . @ . @ . @ @ @ . @ . . @ . . @ . . . @ . . @ . @ . . @ @ @ . @ @ @ @ @ . @ @ . . . . . @ . . . . . . . . @ . . . . . . . @ @ @ . . . . . . . . @ . . @ . . . @ @ @ @ . @ . . @ @ . @ . @ . @ . @ . @ 
@ . . . @ . . . . . . @ . @ . @ . @ . @ @ @ @ . . . @ . . @ . . . @ @ . . . @ . . @ . @ @ @ @ @ . @ . @ . @ . @ . @ . @ . @ . @ @ @ . @ @ . @ @ @ . @ . @ @ @ . . @ @ @ @ . @ . @ . . . . . . . . . . @ 
@ . @ . . . @ @ @ . @ . . @ . @ . . . . . @ @ @ @ . @ . @ . @ . @ . . @ . @ . @ @ . . . @ @ @ @ @ . . . @ . . . @ . . . @ . . @ @ @ . @ . . . @ . . . @ @ @ @ @ . . @ @ . . . . . @ . @ @ @ . @ . @ @ @ 
@ @ . @ . @ . @ . @ @ @ . . . @ @ @ . @ . . @ @ . . . . . . . . . @ . @ @ @ . @ @ @ . @ . @ @ @ . @ . @ . @ . @ . @ . @ . @ . @ . @ @ . @ @ . . @ . @ . @ @ @ . @ . . . . @ . @ . @ @ @ @ . . . @ @ @ @ 
@ . . . . @ . . . . @ . @ @ . . . @ . @ . @ . . @ . @ @ . @ @ @ . . . . . . . . . . . . . . @ . . . . . . . . . . . . . . . . . . . . . @ @ @ . . . . . . @ . . . . @ @ @ . @ . . . . @ . . @ . . @ @ @ 
@ @ @ @ . . . @ @ @ . . @ . @ . @ . @ . . . . @ . @ @ @ . @ . . . @ @ . @ . @ . @ @ @ @ @ . . . @ . @ . @ @ . @ . @ . @ . @ @ . @ . @ . . . @ @ @ . @ . @ . @ . @ . . @ . . @ @ @ . @ . @ . . @ @ @ @ @ 
@ . . . . @ . . @ . @ . . . . . . . . @ @ @ . @ . . @ @ @ @ . @ @ . . @ . @ . @ @ . . . . . @ . . @ . . . @ @ . @ . . @ @ . . . @ @ . @ @ . . . . @ . . . . . @ . . @ . @ . . . . @ . . . . @ @ @ @ @ @ 
@ . @ . @ . @ . @ . . @ @ @ @ @ . @ . . @ . . . @ . . @ @ @ @ @ . @ . . . . . . . . @ @ . @ . . @ . @ @ . @ . . . . @ . . . @ . @ . . @ . @ . @ @ . @ . @ . @ . @ . . . . . @ . @ @ @ . @ @ . . @ @ @ @ 
@ . . @ . . . . @ @ . . . . @ . @ . @ . . @ . @ @ . @ . @ . . . . . . @ @ . @ @ @ . . @ @ @ @ . @ . . . . . @ . @ . . @ . @ . . @ @ . . . . . . . . . @ . . . . @ . @ . @ @ . @ @ @ . . . @ @ . @ . @ @ 
@ . @ . @ @ @ . . @ @ . @ . . . . . . . @ . . . . . . . . . @ @ . @ . . @ @ @ . @ @ . @ . @ . . @ @ . @ . @ @ @ . . @ @ @ . . @ . . @ @ . @ . @ @ . @ . @ @ @ . . . @ . @ . . @ @ . @ @ . . . . . . . @ 
@ @ . . . @ . . @ . . @ @ @ @ @ @ @ @ . @ . @ @ @ . @ . @ . . . @ . . @ . . . . . . . . . . @ . @ @ @ @ . . @ @ @ @ @ @ @ @ . . @ . . @ . . @ @ @ . . . @ . . @ @ . . @ . @ . @ @ . @ . . @ . @ . @ @ @ 
@ . @ . @ . @ . @ . @ . @ . @ . @ . . . . . . . . @ . . @ . @ . @ @ . . @ . @ @ . @ . @ . @ . @ @ @ . @ @ . . @ @ . @ @ @ . @ . . . @ . . @ @ @ . @ @ . . . @ @ @ @ . . . . . . @ . . @ . @ @ @ @ @ @ @ 
@ . . . . . . . . . . . . . . . . . @ . @ . @ @ @ . @ . . @ . . @ . @ @ @ . @ . . . @ . . . . @ @ @ . . . . @ @ . . @ . @ . . . @ @ @ @ . . @ . . @ . @ . @ . @ @ . . @ . @ . @ . @ . . . @ . @ @ @ @ @ 
@ @ @ @ . @ . @ . @ . @ @ . @ . @ . @ @ . . @ . @ . . . @ @ @ . . . @ . @ @ . . @ . . @ . @ @ . @ @ . @ . @ @ . @ . @ . @ @ @ . . . @ @ . @ @ @ . . . . . . . @ @ @ @ @ @ . . . . . @ @ . . . @ @ @ @ @ 
@ @ . @ @ . . . @ . . . . @ . . . @ . . . @ . . . . @ . . @ . . @ @ . . . @ @ . @ . @ . . @ . . . . @ . @ . . . . . . . . . . . @ . . . @ @ @ @ @ . @ . @ . @ . . . @ @ @ . @ . @ . @ @ @ @ . @ . @ @ @ 
@ . . . . @ . @ . @ . @ . @ @ . @ @ . @ @ . @ . @ . . @ . @ . @ @ . @ @ . . @ . @ . @ . @ . @ . @ . . . . . @ @ . @ . @ . @ . @ . . @ . @ . @ @ . . . @ . . . @ @ . . @ . . @ @ . . . . . . . . . . . @ 
@ @ . @ . . @ @ . @ . . @ . . @ @ @ . . @ . @ . @ . @ @ . @ . @ . . @ . . @ . @ . . @ . @ . . . @ @ . @ . @ . @ @ @ @ @ . . @ @ @ . . @ @ . @ . . @ @ . . @ . . . . @ @ @ @ @ . @ @ . @ . @ @ @ . @ @ @ 
@ @ . . @ . . . . . . @ @ . @ . @ . @ @ . . . . @ . @ @ . @ @ @ @ . @ @ . @ . @ @ . @ . @ @ . @ . . @ . . @ . . @ @ @ . @ @ . @ @ . @ @ . . @ @ @ . . @ @ . @ @ @ . @ @ @ . . . @ @ @ . . . . @ . @ @ @ 
@ . . @ @ @ @ @ . @ . @ . . . . . . . . . @ . @ @ @ . . @ @ . @ . . . @ . . . @ . . @ @ @ . @ @ @ . . . @ @ . @ @ @ . . . . . . . . . @ @ . @ @ @ . @ @ . . @ @ . . . . . @ @ . . . . @ . @ @ . . . @ @ 
@ @ . . @ @ @ . @ . @ . @ @ @ . @ @ . @ . . @ @ @ . @ . . . . . @ . @ . @ . @ . @ @ @ . . . . @ . @ @ . @ . . . @ . . @ @ @ . @ . @ @ @ . . . . . . @ . @ . @ . @ @ . @ . . . . @ . @ @ @ @ . @ . @ . @ 
@ @ @ . . @ . . . . . . . . . @ . @ @ @ . @ @ @ @ . . @ @ . @ . . . . . . . . . . @ @ @ @ @ . . . . @ @ . @ . @ @ @ . . . . @ . . . @ @ . @ . @ @ . . . . . . . . . @ @ @ . @ . . @ @ @ @ . . . . . . @ 
@ @ @ @ . . @ . @ @ . @ . @ . . . . . @ . . @ . . @ . @ @ @ . @ @ @ . @ @ . @ . @ @ @ . . . @ @ @ . . . . . . . @ . . @ . @ @ @ . @ @ . . @ . . @ . @ . @ @ . @ . @ . @ @ @ . . @ . @ @ . @ @ . @ . @ @ 
@ @ @ @ @ @ @ . . @ . @ . . @ . @ . @ @ @ @ @ @ . @ . . @ . . . @ . @ @ . . @ . . @ @ . @ . . . . . @ . @ @ . @ . @ @ @ @ @ @ . . @ . . @ . . @ @ @ @ @ . . . @ . . . . . . @ . @ . . @ . @ . @ . . . @ 
@ @ @ @ . . . . @ . . . @ . @ . @ . . . . . @ . . . @ . . @ . @ . . @ . @ . . @ @ @ . @ @ @ @ . @ . @ . @ @ . @ . . . @ . @ @ @ . @ . @ . @ . @ @ @ @ . . @ . . @ . @ @ @ . . . . . @ . . . . @ @ @ . @ 
@ @ @ . @ . @ . . @ . @ . . . @ . . @ . @ @ . . @ . . @ . @ . . . @ @ . @ . @ @ . @ . . @ . @ . . @ . . . @ . @ . @ @ . . . @ @ @ . @ . . . @ @ @ @ @ @ . @ @ @ . . @ . . @ . @ . @ . @ . @ @ . @ . . @ 
@ . . . . . @ @ . @ . . @ . @ . @ . . @ . . @ @ . @ . . . . @ @ . . . . . . . . . . @ . @ . @ . @ . @ . @ @ . @ . . @ . @ . . @ @ . . @ @ . @ @ @ @ @ . @ @ . . @ @ . @ . @ . @ . . . . . . . . . @ . @ 
@ . @ . @ . @ . . . @ @ . . @ . . . @ . @ . . @ . . @ . @ . @ . @ @ . @ . @ . @ @ . @ . . . . @ @ . . @ @ @ . . . @ @ @ . . @ @ @ @ . . . . . . . . @ . @ . @ . @ . . . . . @ @ @ . @ @ . @ . @ . . . @ 
@ @ . . @ . @ . @ . @ @ @ @ . @ @ . . . @ . @ . . @ @ @ @ . . . . @ . @ @ @ @ . . . . @ . @ . . . . @ @ @ . @ . @ . . @ @ . . @ @ @ . @ @ . @ . @ . . . . . . . . . @ @ . @ . @ . @ . . . . @ . . @ . @ 
@ @ @ @ . @ @ @ . @ . @ @ . . @ . @ . @ @ . . . @ . @ . . @ @ . @ . . @ . @ . @ . @ . @ @ . . @ . @ . @ @ . . . . . @ . @ . @ . @ . @ @ @ . @ . . @ . @ @ . @ . @ . @ . . . . . . . . @ . @ @ @ . . @ @ 
@ @ . . . . . . . . . @ . @ . . . . . . @ . @ . . . . @ . @ . . . @ @ . . . . . @ . . . . @ . . @ . . . . . @ . @ . @ . . . . . . . @ . . @ @ . @ @ @ . . @ . . @ . . @ . @ . @ . @ . @ . @ @ . @ . . @ 
@ . @ . @ @ . @ . @ . . . . . @ . @ @ . @ @ . @ @ . @ . . . @ . @ @ . @ @ @ . @ . @ . @ . @ . @ @ . @ . @ @ . @ . . . . @ @ . @ . @ . @ . . @ . . @ @ @ . . @ . . @ @ . @ . . @ @ . . @ @ . . . . . @ @ 
@ . . . . @ @ @ . @ . @ . @ . @ . @ . . . . . . . . . . @ . . . . . . . . . . . . @ @ . . . . . @ @ . . @ . . . @ . @ . . . @ . @ . . . @ . @ . @ @ @ . . @ . . @ @ . . @ . @ . . . @ . . . @ @ @ . . @ 
@ . @ @ . @ . @ @ @ @ . . @ @ @ . . @ @ . @ . @ . @ . @ @ @ . @ . @ . @ @ @ @ @ . . . @ @ @ . @ . @ @ @ . . @ . @ @ . @ . @ @ . . . @ . . . . . . @ @ @ . @ @ @ . . @ . . @ . . @ . . @ . @ @ . . . @ @ 
@ . @ . . . . . . @ . @ @ . . . . @ @ @ @ . . . @ . . . @ . . . @ @ @ . . . . . @ @ . . . . . . . . . @ @ . . @ . . . . . . . . @ . @ . @ . @ . @ . @ @ . @ . @ @ . . @ . @ . @ . . @ . @ . . . @ . @ @ 
@ . . @ . @ @ @ @ . . . . . @ . @ @ @ @ . @ . @ . @ . @ . @ . @ @ @ @ @ @ . @ . . . . @ . @ . @ @ . @ @ . @ . @ . @ . @ @ . @ . . @ . @ . . @ . . . @ . . . . . . @ . . . . . @ . @ . . . @ . @ . . . @ 
@ @ @ . . @ . . @ . @ . @ . @ . @ @ @ @ . . @ @ . @ @ @ . @ @ @ @ @ @ . @ @ . @ @ @ @ . @ . . @ . . . . . . . . . @ @ . . . @ . @ @ . @ . @ . . @ @ . @ . @ . @ @ @ @ @ @ . @ . . @ . @ . . . . @ . @ @ 
@ @ . . @ . . @ @ @ . . . @ . . . @ @ . . @ @ . . . @ . . . . @ @ @ . . . . . . . . . . . @ @ @ . @ . @ @ . @ . @ . . . @ . @ @ @ . . @ . . @ . @ . . @ @ . . . @ @ . @ . . . @ . @ . @ . @ . @ @ . . @ 
@ @ @ . @ @ . @ @ . @ . @ @ @ . @ @ . @ . @ . @ . @ . @ . @ @ @ @ @ @ . @ @ . @ . @ . @ . . . . . @ . . . @ @ @ . . @ . @ . @ @ . @ . @ . @ @ @ . @ . @ . @ . @ . @ . . @ . @ . @ . . @ @ . @ . . . @ @ 
@ @ . @ . . . . . . . . . @ . @ . . . . . . . . . . . . . . . . @ @ @ @ @ . @ . @ @ @ @ @ . @ . @ @ . @ . @ @ @ @ . . @ . @ . . . . . @ @ . @ . . . . . . . . . . . @ . @ @ @ . @ . @ @ @ . @ . @ . . @ 
@ . . . . @ . @ . @ @ . @ . . . . @ . @ @ @ @ . @ . @ @ . @ @ . . @ @ @ . . . . . . . . . . @ @ . @ . . @ @ @ @ . . @ . . . . @ . @ . . @ . . . @ . @ . @ . @ . @ . . . . . . . . . . @ . . . @ . . @ @ 
@ . @ @ . @ @ . @ @ @ @ @ @ . @ @ . . . @ . @ . . @ @ @ . . @ @ @ @ @ . @ . @ . @ @ @ . @ . @ @ . @ . @ @ @ @ . @ . @ @ . @ . @ @ @ @ . . @ . @ @ @ . . . @ . . @ @ . @ . @ . @ @ . @ . . @ . @ @ . . @ 
@ . . . @ . @ . . @ @ . @ @ . . @ . @ . @ . . . @ @ @ . @ . @ . . . . . . @ . . @ . . @ . @ . . . . . @ @ @ . . . . . . @ . . @ . @ . . @ . . @ @ @ @ @ @ . @ . . @ . @ @ . . @ @ . @ . @ . . . . . @ @ 
@ . @ . . . @ @ . @ . . @ @ @ @ @ . . @ . . @ . @ . . . . . . @ . @ . @ . @ @ . @ . @ @ . @ . @ . @ . @ @ @ @ . @ . @ . @ @ . @ . . @ . . @ @ . @ . @ . @ . @ @ @ . @ . . . @ . . . @ . . @ @ . @ . . @ 
@ @ @ @ @ . @ . . . . @ . . @ . . . @ . @ . . @ @ @ . @ . @ . . . . @ . . . . . . . @ . . . . . @ . . @ . @ @ @ . . . @ . @ . @ . @ @ @ . . . . . . . . . . . . . . . . @ @ . . @ . @ . @ . @ . @ . @ @ 
@ @ @ @ @ @ . . @ @ . . . @ . . @ @ . . @ @ @ @ @ @ @ . . . @ @ . @ @ @ @ . @ . @ @ @ @ . @ . @ @ @ . . . . @ . . @ . @ . . @ . . . . @ . @ . @ @ . @ . @ . @ @ @ . @ @ @ @ . @ . . @ . . . . @ . . @ @ 
@ @ @ @ @ @ @ . @ . . @ @ @ @ . @ . @ . . @ @ @ @ @ @ . @ . @ . . . @ . @ . . @ @ @ @ @ @ . . @ . @ . @ . @ @ @ @ @ . @ @ . @ . @ . @ . . @ . . . @ . . . @ @ @ @ @ . . @ . . @ @ . @ . @ @ @ . @ . . @ 
@ @ @ @ @ @ . @ . . @ @ . @ . @ . . . . @ @ @ @ @ @ @ @ @ @ . @ . @ . . . . @ . @ @ @ . . @ @ @ . . . @ @ . @ . . . @ @ . . . @ . . . @ @ . . @ @ . @ . @ @ @ @ @ . @ . @ . @ . . . @ . . @ . . . . @ @ 
@ @ @ @ @ . . . @ . . . . . . @ @ . @ . . @ @ @ @ @ @ @ . . . . . @ . @ @ @ @ . . @ . . @ . . . . @ @ @ . . . @ . @ @ . @ . @ . @ . @ @ . @ . @ . . . . @ @ . @ . . @ . . . . @ . @ . . @ . . @ @ . . @ 
@ @ @ @ . @ @ . @ @ . @ . @ . @ @ . @ . @ . @ . @ . @ . @ @ . @ @ . . @ @ @ @ @ . . . @ . @ @ @ @ . @ . @ . @ . . . . . . . . . . . . . . . . . @ . @ . @ . . . @ . @ @ @ . @ @ @ @ @ . . @ . @ @ . @ @ 
@ @ @ . . . . . . . @ . . @ . . . . @ . . . . . . . . . . . . @ @ @ . @ @ @ @ . . @ . . . . . . . . . . . . @ . @ @ . @ . @ @ . @ @ . @ . @ . @ . @ . @ . . @ . . . . @ @ @ @ @ @ @ @ . @ . @ . . . @ @ 
@ @ @ . @ @ @ . @ . . . @ @ @ . @ . . @ . @ @ @ . @ . @ . @ @ @ @ . @ . @ @ @ @ @ @ . @ . @ . @ @ @ @ . @ . @ . . . @ @ . . . @ . . . @ @ . . . . . . @ . @ . . @ @ @ @ @ . @ @ @ @ @ . @ . @ . @ . . @ 
@ @ . . @ . . @ . @ @ . @ @ . . @ . @ @ . @ . @ @ . @ @ @ @ . @ . . @ . . @ @ . @ . @ . @ . @ . @ . @ @ . . . . @ . . @ . @ @ . @ . @ @ . @ . @ . @ @ . @ @ @ . @ . . @ . . . @ @ @ . . @ . . @ . . @ @ 
@ @ @ . . @ . @ . . . . . . @ . @ @ @ @ @ . . . @ . . . . . . . . @ . . @ . @ . @ . . . . . . . . . . . . @ . @ @ @ @ @ . . . . . @ . . . . . . @ . . . . @ . . . . @ . . @ . @ @ . @ . @ . @ . @ . . @ 
@ @ @ @ @ . . @ @ . @ . @ . . @ @ @ . @ . @ . @ @ @ . @ . @ . @ . . @ . . . . . . . @ . @ . @ @ . @ . @ . @ . . @ . @ . @ . @ . @ @ @ @ . @ . @ @ @ . @ . . @ . @ . . @ . . @ @ . . . @ . . . . . . @ @ 
@ @ @ . . . @ . @ . . @ . . @ @ @ . . . . . . . @ @ @ @ @ @ @ . . @ . . @ . @ . @ @ . . . @ @ . @ . . @ @ . . @ . . . . . . . @ @ @ @ . . . @ . . . . . @ . . . . @ @ @ . @ @ . @ . @ . @ @ @ . @ . . @ 
@ @ @ @ @ . . . . . @ @ @ . . @ @ @ . @ . @ . @ . @ . @ . @ . @ . @ @ @ . . @ . . @ @ . @ @ @ . @ @ . . . @ . @ . @ . @ @ . @ @ @ @ @ @ . @ . @ . @ . @ @ @ . @ . . . . . . . . . . . . . . . . . @ . @ 
@ @ @ . @ . @ . @ . . @ . . @ . . @ @ . @ . . . . . . . . . . . . . . . . @ . . @ @ . . @ . . . . . . @ @ . . @ . @ @ . . . @ @ @ @ @ @ @ @ . . @ . . . @ . . . @ . @ . @ . @ . @ . @ @ . @ . @ @ . . @ 
@ . . . . . . @ . . @ @ @ . @ . @ . @ . . @ . @ . @ . @ @ @ @ . @ . @ @ . @ @ . . . @ . . @ @ . @ @ . @ . . @ . . @ @ . @ . . . @ @ @ @ @ @ @ . . @ . @ . @ . @ @ @ . . . @ . . . @ . . . . @ @ . @ . @ 
@ @ @ . @ . @ @ @ . . @ . . . . . . . . @ @ @ . @ . . . @ . . @ . . . @ @ . . . @ . @ @ . . @ . @ . . @ @ . @ @ @ . . . @ . @ . @ @ @ @ . @ . @ . @ @ . . . . . . @ @ . @ @ @ . @ @ . @ . @ . . . . . @ 
@ . . . @ . @ @ @ . @ @ @ . @ . @ @ @ . @ @ @ . @ @ . @ . . @ . @ . @ . . @ @ @ . . @ @ @ . . @ @ . @ . . . . @ . @ . @ . . . @ . . @ . . . . . . . . . @ . @ . @ @ @ @ . . . . @ . @ . . @ . @ . @ . @ 
@ @ . @ . . @ . . . @ . . . . @ . @ . . @ @ . . . . . @ @ . . . . . . . @ . @ . @ . . @ @ . @ . . . @ . @ . @ . . . . . @ . @ . @ . . @ @ . @ . @ . @ . @ @ . . . . @ @ @ . @ @ . . . . @ . . @ @ . . @ 
@ . . @ @ . @ . @ . @ . @ . @ @ . @ . @ . . @ . @ . @ . . . @ . @ . @ @ . . . . . . @ . . @ . @ . @ . @ . . . @ . @ . @ @ . . . . . @ . @ @ . . @ @ . . @ . @ @ . @ @ @ . . . @ @ . @ . @ @ . @ . @ . @ 
@ . @ . . . . @ . . . @ . . . . . . @ @ @ . @ . @ @ . . @ . . @ @ @ @ . @ . @ . @ . . . @ . . . . @ . @ @ . @ . @ . . @ @ . @ @ . @ @ . . . . @ @ . @ . . . . @ . . @ . @ . @ @ @ @ . . . . @ . . . . @ 
@ . @ . @ . @ @ @ . @ @ @ . @ . @ @ @ @ . . . . . @ . @ . . @ . . . . . . . @ @ . . @ . . @ . @ . . . . @ . @ . . . @ . . . . . @ . . @ @ . @ @ . . . . @ @ @ @ @ @ . . . . @ @ @ . @ . @ . . @ . @ . @ 
@ @ . . @ @ . . . . . @ . . . @ @ @ @ . @ . @ . @ @ @ . . @ @ . @ . @ . @ @ . . . @ @ @ @ @ @ . . @ @ @ . @ . . @ . @ @ . @ @ @ @ @ . . . @ . . . @ . @ . . . @ @ @ @ . @ . . @ @ . @ @ @ @ @ . @ . . @ 
@ . . @ @ @ @ . @ . @ @ @ . @ @ @ @ . . . . @ . @ @ . . @ @ . @ @ . . @ . . . @ . . @ . . @ . @ . @ . . . . . @ . . . . @ . . . @ . . @ @ @ . @ . . @ . @ . @ . @ @ . @ . . @ . . . . . . . . . . . @ @ 
@ @ . @ @ @ . @ . . . @ @ @ @ @ @ @ @ @ @ . . @ . . . @ @ . . . @ . @ @ . @ . . @ @ . . @ . . . . @ . @ . @ . @ @ . @ @ @ @ . @ . @ . . @ . @ . @ . @ . . . . . . . . . . @ . . @ @ . @ . @ . @ @ . @ @ 
@ @ @ @ @ @ . @ . @ @ @ @ @ @ @ @ @ @ . . @ @ . . @ . . @ . @ . . . @ . . . @ @ @ @ @ . . @ . @ . . @ . . . @ . . . @ @ @ @ . . . . . @ @ . @ . . . . @ @ . @ . @ . @ @ . . @ . . . @ . . @ . . . @ @ @ 
@ @ @ @ . . . . @ . @ @ . @ @ @ @ @ @ @ . @ @ . @ . . @ @ @ . @ @ @ . @ @ @ . @ . @ . @ . @ . . @ . . @ . @ @ . @ . . @ @ @ @ . @ @ . . . . . . @ @ . @ @ @ . . @ @ . . . @ . @ @ . @ . @ @ @ . @ @ @ @ 
@ . @ @ @ @ @ . . . @ . . . @ @ @ @ @ @ . . . . @ @ . . . @ . . . . . . . . . . . . . . . . . @ . . @ @ @ @ . @ @ . @ . . @ @ . . @ @ . @ @ . @ @ @ @ . @ @ @ . @ @ @ @ . . . @ . @ . . @ . . . @ @ @ @ 
@ . . . . @ . . @ @ @ @ @ . . @ . @ . . . @ . @ @ @ @ . @ . @ @ . @ . @ @ @ . @ . @ . @ . @ . . @ . @ . . . . . . . . @ . . . . @ . @ @ . . . @ . @ @ . . . . @ . . . . . @ . . . @ @ . @ . @ @ @ @ @ @ 
@ @ . @ @ . @ . . . @ @ . . @ . . . . @ @ . . . @ @ @ . @ . . @ . @ . @ @ @ . @ @ . . @ @ . . @ @ @ . . @ . @ . @ . @ . @ @ @ @ @ . @ . @ . @ . . @ . @ @ . @ . . @ . @ . . @ . @ . . @ . . . . @ @ @ @ 
@ . . . . . @ . @ . . . . @ . @ . @ . @ @ . @ @ . . @ @ . @ . @ . . @ . . . . . @ @ @ . . . @ . . . . @ @ @ . . . @ . . . . . . . . . . . @ @ . @ . . . . . . . @ . . @ . @ @ . @ @ . . @ . @ @ @ @ @ @ 
@ . @ . @ . @ @ . @ . @ @ . . . @ . @ . . . . . @ . . . . . . . . @ . @ . @ . @ . @ . @ @ . . @ . @ . . @ @ @ . @ @ @ . @ . @ . @ . @ . @ . @ . . . @ . @ . @ @ . . @ . . . . @ . . @ . @ . . @ @ @ @ @ 
@ @ . @ . . . . . . . . . @ @ . @ . @ @ @ . @ @ @ @ . @ . @ . @ . @ . . . @ @ . . . . . . . @ @ @ . . @ . . . @ @ @ . . @ . . @ . . @ . . . . . @ . @ @ . . @ . @ . . @ . @ . @ @ . @ . . . @ @ @ @ @ @ 
@ . . . . @ @ . @ . @ @ . . . . . . . . . . . @ @ @ @ . . . @ . . . @ . @ . . . @ @ @ . @ . @ @ @ @ . . @ @ . . . . . @ . . @ @ @ . @ . @ . @ . . @ . . . @ . . . . @ @ . . @ . . . . . @ . @ @ @ @ @ @ 
@ @ @ @ @ @ @ @ @ @ @ @ @ @ @ @ @ @ @ @ @ @ @ @ @ @ @ @ @ @ @ @ @ @ @ @ @ @ @ @ @ @ @ @ @ @ @ @ @ @ @ @ @ @ @ @ @ @ @ @ @ @ @ @ @ @ @ @ @ @ @ @ @ @ @ @ @ @ @ @ @ @ @ @ @ @ @ @ @ @ @ @ @ @ @ @ @ @ @ @ 
3
57 78 97 58
89 29 52 67
55 81 42 46
