10 10
@ @ @ @ @ @ @ @ @ @ 
@ . . . @ . @ @ @ @ 
@ . @ . . . . @ @ @ 
@ @ . . @ . @ @ @ @ 
@ @ @ . . @ . . @ @ 
@ . . . @ @ @ . @ @ 
@ . @ . . . . . . @ 
@ @ . . @ . @ @ . @ 
@ . . @ . . . . @ @ 
@ @ @ @ @ @ @ @ @ @ 
3
5 1 1 2
2 1 2 4
1 1 8 1
