50 50
@ @ @ @ @ @ @ @ @ @ @ @ @ @ @ @ @ @ @ @ @ @ @ @ @ @ @ @ @ @ @ @ @ @ @ @ @ @ @ @ @ @ @ @ @ @ @ @ @ @ 
@ . . . @ . @ . @ @ @ @ . . . . . . . @ . . . . @ . . @ . . . @ @ . . @ . @ @ @ . . @ @ @ @ @ . @ @ 
@ . @ . @ . @ . . @ . . . @ @ @ @ @ . @ @ . @ . . . @ . . @ @ . @ . @ . . . @ . @ . . @ @ @ . . . @ 
@ . @ @ . . . . @ . @ . @ @ @ . @ . @ @ @ @ @ @ @ . @ . @ @ @ . . . @ . @ . @ . @ . @ . @ . @ . @ @ 
@ . . . @ @ . @ . . . . . @ . . . . . @ . @ @ @ . . . . . . @ . @ @ . . @ @ @ . @ . @ . @ . @ . @ @ 
@ . @ . @ . . . . @ . @ . . . @ . @ . . . . @ @ . @ . @ . @ . . . . . @ @ @ @ . @ . . . . . . . . @ 
@ . . @ @ @ . @ . . @ . @ . @ @ @ . . @ . @ @ @ . @ . @ . . @ . @ . @ . @ . . . . . @ . @ @ . @ . @ 
@ . @ @ @ @ @ @ @ . . . . @ . @ @ @ . @ @ @ @ @ . . @ @ . @ . . . @ . . . @ . @ . @ . @ @ . @ . . @ 
@ . . @ @ @ . @ . . @ . @ @ . . @ @ @ @ . @ @ . . @ . @ @ . @ . @ . @ . @ . @ . . . . . . . . @ . @ 
@ . @ . @ @ . . @ . . @ @ @ . @ @ @ @ . . . . @ . @ . @ . . . . @ . . . . . . . @ . @ . @ . @ @ @ @ 
@ . . . @ . @ . . . @ . @ . . . @ . @ @ . @ . @ . . . . @ . @ @ . . @ . @ @ . @ . @ . @ @ @ . @ @ @ 
@ @ @ . . . . . @ . @ . . @ . @ . . . . @ . . . . @ @ @ . . . @ . @ . @ @ . . . . . . . . . . . @ @ 
@ . . . @ . @ . @ . . @ . . . @ . @ . @ . @ @ @ . @ . . . @ @ . . . . . @ @ . @ . @ . @ . @ @ . . @ 
@ . @ . @ . @ . . @ @ . @ @ . . . . @ . . . @ . . @ @ . @ . @ . @ . @ . . . @ . . . @ . . @ . . @ @ 
@ @ @ @ @ @ . . @ @ @ . @ . @ . @ . . @ . @ . @ . . @ . . . . . . @ @ @ @ . @ @ . @ . @ @ @ @ . . @ 
@ . @ . @ @ @ . . @ . . . . . . . @ . . . @ . . . @ @ . @ . @ . @ @ . @ . @ @ . . . . . . @ @ . @ @ 
@ . . . . @ @ . @ @ @ @ @ @ @ . @ . @ . @ . . @ . @ . . . @ . . . . . . . @ . @ . @ @ @ . . . @ . @ 
@ . @ . @ . @ . . @ . @ . @ . . . . . @ . . @ . @ . @ . @ . @ . @ . @ . @ @ . . . . . . @ . @ . . @ 
@ @ . . . . . . @ @ . . . @ @ . @ . @ . @ . . . . . . . . . . @ . . . @ . @ @ . @ . @ . . @ @ . @ @ 
@ . @ @ . @ @ . . . . @ . . @ . . @ @ . . . @ . @ . @ . @ @ . @ @ @ @ . . . . . @ . @ @ . . . . . @ 
@ . . @ . @ . . @ . @ . @ . @ . @ . @ . @ . . @ . . @ @ @ . . @ @ @ @ @ @ . @ . @ . . . @ . @ . @ @ 
@ . @ @ @ . @ . . @ @ . . @ . . . . . . . @ . @ . @ . @ @ @ @ . . @ @ @ @ @ . . @ . @ . @ . . @ @ @ 
@ . . @ . . . . @ . . . @ . @ . @ @ @ @ @ @ @ @ @ . . @ @ . @ . @ . @ @ @ @ @ . @ . . @ @ . @ @ @ @ 
@ . @ . @ @ @ . @ @ @ . . . . . . . . . @ @ @ @ . @ . . . . . . . . . @ @ @ @ @ @ @ . . . @ . @ . @ 
@ . . . @ @ . . @ . . @ @ . @ . @ @ @ @ . @ . @ . . . @ @ . @ . @ . @ @ @ @ @ @ @ . . @ . . . . . @ 
@ . @ . . . @ . . . @ @ @ . . @ . . @ . . @ . . @ @ . @ @ @ @ @ @ @ @ @ @ @ @ @ . @ . @ . @ . @ . @ 
@ @ . . @ @ . @ @ . . @ . . @ . @ . @ @ . @ . @ . . . . @ . . @ @ @ @ @ @ . @ @ . @ . . @ . . . @ @ 
@ . @ . @ @ . @ @ . @ . @ . . . . . . . . . . . . @ . @ @ . @ @ @ @ @ @ @ . @ . . . . @ . @ . @ @ @ 
@ . . . . . . . . . . . . . @ @ @ . @ . @ . @ . @ . @ @ @ . . . . . . @ . . . @ . @ . . . @ . @ @ @ 
@ @ . @ . @ @ . @ . @ . @ . . . . @ @ . . @ . . . . . . . . @ @ . @ @ . @ . @ . @ @ . @ . . @ @ @ @ 
@ . . . @ . . . . @ @ @ . . @ . @ @ @ . @ . . @ . @ . @ @ . . . @ . . . . . . . . . @ @ . @ @ @ @ @ 
@ @ . @ @ . @ . @ . @ . @ . . @ . @ @ . @ @ @ . . @ . @ . . @ . . @ . @ @ . @ . @ . . @ @ . @ @ @ @ 
@ . . . . @ . @ @ . . . . . @ . . . @ . @ . @ @ . . @ . @ . @ @ . . . . @ @ . . @ @ . . . . . . . @ 
@ @ . @ @ @ . . . . @ . @ . . @ . @ @ . . . . @ . @ @ . @ . . . @ . @ . . . @ @ . @ . @ . @ . @ . @ 
@ . . . . . @ . @ @ . . . @ . . . . @ . @ @ . . @ . . . . . @ . . @ . @ . @ @ . . . @ . . . @ . . @ 
@ @ . @ . @ @ . . . @ @ @ @ . @ . @ . . . . @ @ . . @ . @ . . @ @ . . . . . . . @ @ . @ @ . @ @ . @ 
@ . . . @ . . . @ . @ . . . . @ . . @ . @ . @ . @ . . @ . . @ @ @ @ . @ . @ . @ . @ . @ . @ @ @ . @ 
@ @ . @ . . @ . . @ @ . @ @ . . @ . @ . @ . @ . . @ @ . @ . @ . @ . @ . @ @ . . . . . . . . @ @ @ @ 
@ @ @ . . @ . . @ . . . . @ @ . . @ @ . . @ . @ . @ @ . . . . . . . . . . . @ @ @ . @ . @ @ . @ . @ 
@ @ . @ . @ @ . @ . @ . @ . . . @ . . . @ . . . . . . @ @ . @ . @ . @ . @ . . . . @ . . . . . . . @ 
@ . . . . . @ . @ @ . . @ . @ . . @ . @ . . @ . @ . @ . . . @ . @ . . @ . . @ . @ . @ . @ . @ . @ @ 
@ . @ . @ @ @ . @ . . @ . @ . . @ . @ . . @ . . @ . @ . @ . . @ . . @ @ @ . . @ . . . . . @ @ . . @ 
@ @ @ . . . @ @ @ . @ @ . @ @ . . . . . @ @ @ . . @ @ @ . . @ . . @ . @ @ . @ @ @ . @ . @ . . . @ @ 
@ @ . . @ @ . . @ . @ . . . . . @ . @ . @ @ . . @ @ @ @ @ . @ @ . . . . . @ @ @ @ @ . . . @ @ . . @ 
@ . @ . . . @ . . . @ . @ . @ . . @ @ @ . @ @ . . @ @ @ @ @ @ @ @ @ @ . @ @ @ @ @ . @ . @ @ @ . @ @ 
@ . . . @ . . @ . @ . @ . @ . . @ . @ . . . @ @ . @ @ @ @ @ @ @ @ @ @ . @ @ @ @ . . . . . @ . . . @ 
@ . @ @ . . @ @ . . . @ . @ @ . . . @ @ . @ . @ @ @ @ @ @ @ @ @ @ @ @ @ @ @ @ @ @ . @ . @ . @ . @ @ 
@ . . @ . @ @ @ @ . @ @ . . @ . @ . . . . . . . @ @ @ @ @ @ @ @ @ @ @ @ @ @ @ @ @ @ @ . . . . @ @ @ 
@ . @ @ @ @ @ @ @ . @ @ @ . . . . @ @ . @ . @ . @ @ @ @ @ @ @ @ @ @ @ @ @ @ @ @ @ @ @ @ . @ @ @ @ @ 
@ @ @ @ @ @ @ @ @ @ @ @ @ @ @ @ @ @ @ @ @ @ @ @ @ @ @ @ @ @ @ @ @ @ @ @ @ @ @ @ @ @ @ @ @ @ @ @ @ @ 
3
34 7 38 34
1 25 16 30
4 11 23 19
