25 25
@ @ @ @ @ @ @ @ @ @ @ @ @ @ @ @ @ @ @ @ @ @ @ @ @ 
@ @ @ @ . @ @ . @ @ @ . . @ @ @ . @ @ @ . @ . @ @ 
@ @ . . . . . . . @ . @ . . @ . . . @ . . @ . . @ 
@ @ @ . @ . @ @ . . . . . @ . @ . @ . @ . @ @ . @ 
@ @ @ @ . . @ @ @ . @ @ . . . @ . @ . . . . . . @ 
@ @ @ @ @ . . . . @ . @ . @ @ . . . . @ @ @ . @ @ 
@ @ @ . @ @ . @ @ @ . . . . @ @ . @ @ . . . @ @ @ 
@ @ @ . . . @ @ @ . . @ . @ @ @ . @ . . @ @ . @ @ 
@ @ . @ . @ . @ @ @ @ . . . @ . . . . @ @ . . @ @ 
@ . . . . . . . @ @ @ @ . @ . . @ . @ . @ . @ . @ 
@ @ @ @ . @ . @ @ @ @ . . . @ . . @ . . . . . . @ 
@ @ @ @ . . @ @ @ @ . @ @ . @ . @ . @ . @ . @ . @ 
@ @ @ . @ . @ . . . . . . . . . . . . . @ . . @ @ 
@ @ . . . . @ . @ . @ . @ . @ @ @ @ . @ @ @ . @ @ 
@ . @ . @ . . @ . . . @ @ . . @ . @ @ @ @ @ @ @ @ 
@ . @ @ . . @ . @ . @ @ . . @ . . . @ @ @ @ @ @ @ 
@ . @ . @ . . . . . @ . . @ . @ . @ @ @ @ @ @ @ @ 
@ . . . . . @ . @ . . @ . . . . . . @ @ @ @ @ @ @ 
@ . @ . @ . @ @ . . @ @ . @ . @ @ @ @ @ @ @ @ @ @ 
@ . @ . @ @ . . @ @ @ . @ . . . . . @ @ @ @ @ @ @ 
@ @ . @ . @ . @ . @ . . . @ . @ . @ @ @ @ @ @ @ @ 
@ . . . . . . . . . . @ . . . @ . . @ @ @ @ @ @ @ 
@ . @ . @ . @ @ . @ . @ . @ . . @ . . @ @ @ @ @ @ 
@ . . @ . . . . @ . . @ @ . . @ . . @ @ @ @ @ @ @ 
@ @ @ @ @ @ @ @ @ @ @ @ @ @ @ @ @ @ @ @ @ @ @ @ @ 
3
11 19 6 6
21 4 17 14
19 16 17 10
