100 100
@ @ @ @ @ @ @ @ @ @ @ @ @ @ @ @ @ @ @ @ @ @ @ @ @ @ @ @ @ @ @ @ @ @ @ @ @ @ @ @ @ @ @ @ @ @ @ @ @ @ @ @ @ @ @ @ @ @ @ @ @ @ @ @ @ @ @ @ @ @ @ @ @ @ @ @ @ @ @ @ @ @ @ @ @ @ @ @ @ @ @ @ @ @ @ @ @ @ @ @ 
@ @ @ @ @ @ @ @ @ @ @ @ . . . . . @ . . . . . . @ . @ . @ @ @ @ @ @ @ . @ @ @ . @ @ @ @ @ @ . @ . . @ . . @ . . . @ . . . @ @ @ @ . . @ @ @ @ @ . . @ . @ . @ @ . @ @ . . @ . . @ . . @ @ @ @ . . . @ @ 
@ @ @ @ @ @ @ @ @ @ @ . @ . @ . @ @ @ . @ . @ . . . . . . @ @ @ @ @ . . . . . . @ @ @ @ @ . . . . @ @ . @ . @ . @ . @ . @ . @ . . . @ . . @ @ @ @ . . . . . . . . . @ @ . @ . @ . . @ . @ @ @ . @ @ @ @ 
@ @ @ @ @ @ @ @ @ @ @ . . . . @ @ @ . @ . . . @ @ . @ @ . @ @ @ @ @ @ . @ @ . @ @ @ @ @ @ @ @ . @ . . . . . . . . . . . . . . @ @ . @ @ . . @ @ @ . @ . @ . @ @ . @ . . . . . . @ . @ . . . . . . . @ @ 
@ @ @ @ @ @ @ @ @ @ . . @ . @ @ @ . . . @ @ @ @ @ . @ . . . . @ @ @ . . @ . . . @ @ @ @ @ . . . . . @ @ @ . @ . @ @ @ . @ . @ @ . . . @ . @ . @ . . @ . @ . . . @ . @ @ @ . @ . @ . . . @ @ . @ . @ @ @ 
@ @ @ @ @ @ @ @ @ . . @ . @ . @ . @ . @ @ @ @ @ . @ . @ . @ @ . @ . @ . . @ . @ . @ @ @ . @ @ @ . @ @ . . . . @ @ @ @ . @ @ @ . @ . @ . . @ . @ @ . @ . @ . @ . . . . . . . @ . . . @ . . . @ @ . . @ @ 
@ @ @ @ @ @ @ @ @ @ . . . . . . . . . . @ @ @ @ . . . . . . . . . . . @ . . @ . . . @ . . @ . . . @ . @ . @ . . @ @ . @ . @ . . @ . . @ . @ . . . . . @ . . . @ . @ . @ . @ . . @ . . @ @ . . . @ . . @ 
@ @ @ @ @ @ . @ @ @ @ . @ . @ . @ @ . @ . . @ . @ @ @ @ @ . @ . @ @ . @ . @ . @ . @ . @ . @ @ @ . . . @ @ @ @ @ @ . . . . . @ . . @ . @ . @ . @ . @ @ @ @ . @ @ . . @ @ . @ @ . . @ . . . @ @ @ @ . @ @ 
@ @ @ @ @ . . . @ @ @ . @ @ @ . @ . . . @ . @ . @ . . @ @ @ . @ . @ . . . . . . . . . . . . @ . @ @ . . . @ @ . . @ @ . @ . . @ . . . . . . . . @ . . @ . . . . @ . . . @ @ . . @ @ @ . @ . @ @ @ . . @ 
@ @ @ . . @ @ . . @ . @ . @ . @ @ @ @ . . . . . . @ . . . . . . . . . @ . @ . @ . @ . @ @ . . . @ . @ @ . @ . @ . @ . @ . @ . @ . @ @ . @ . @ . . . @ @ @ @ . @ @ . @ @ @ . @ . @ . . . . . . @ . . @ @ 
@ @ . @ . @ . . @ . . . . @ . @ @ . @ . @ . @ . @ . @ . @ . @ . @ @ . @ @ @ @ . . @ . . @ @ @ . . . . . . . . . . . . . . . . . . . @ @ . . . @ . @ @ @ @ @ . . @ . . @ . . . @ @ . @ @ @ . @ @ @ . . @ 
@ . . @ . @ . @ @ @ @ @ . . . @ . . @ . @ @ . . . . @ @ . @ @ . @ . . @ @ @ @ @ . . @ . @ @ @ @ . @ . @ . @ . @ . @ . @ . @ . @ @ . . @ @ . @ @ . @ . @ @ @ @ . @ . @ . @ . @ . . @ . @ @ @ . @ @ . @ @ 
@ . @ . . @ . . @ . @ . @ . @ . @ . . @ @ @ . @ . @ . @ . . . . . @ . @ @ @ @ @ . @ . . . @ @ @ @ . . . @ . . @ @ . . . @ . @ @ . . @ . . @ . @ . . . @ @ @ @ . @ . . . . . . @ . . . . . . . . @ @ @ @ 
@ . @ . @ . . @ . . . . . . . . . . @ @ . . @ @ . . . @ . @ @ . @ . @ @ @ @ @ @ . . @ . @ . @ . . @ @ . . @ . . . @ . @ . . . @ @ . . . @ @ . . @ . @ . @ @ . @ . . @ . @ . @ . @ . @ @ @ @ . @ . . @ @ 
@ . . . @ @ . . @ . @ @ . @ . @ @ . @ . . @ @ . . @ . . @ . . . . . @ . @ @ @ . . @ . . @ . . @ . . . . @ @ @ . @ @ @ . @ @ . @ . . @ @ . . . @ . . . . . @ . @ @ . . @ . . . . . . . @ @ @ @ @ . @ . @ 
@ . @ . . . @ . . @ . @ @ @ @ @ . . @ @ . @ . @ . @ @ @ . . @ . @ @ @ . @ @ . @ . @ @ @ @ . @ . @ @ . @ @ @ @ . @ . . . . . . . . @ @ . @ @ . . @ . @ . @ . . . . . @ . @ @ @ @ @ @ . @ . . . . . . . @ 
@ @ . @ . @ . @ . @ . . . @ . . @ . @ . . . . . . . . @ @ . @ @ . . . . . . . . . . @ . . . . . . . . . @ . . . . @ . @ . @ @ . @ @ @ . . @ @ . @ . . @ @ @ @ . @ . @ . . @ @ . . . . . . @ . @ @ . @ @ 
@ @ . . . . . . . . . @ . . . @ . . . @ . @ @ . @ . @ . . @ . . . @ . @ . @ . @ . @ @ @ . @ . @ . @ . @ @ @ . @ . . @ . . . . @ . @ @ @ . . . . . . @ @ @ . . @ . . . @ . . @ . @ @ . @ . . @ . @ . @ @ 
@ @ @ @ . @ @ . @ . @ . . @ @ . @ . @ . @ . @ @ . . . . @ . @ @ . . @ . . . @ @ @ @ . . . @ . @ @ . . @ . @ . @ . @ @ @ . @ . . . . . @ . @ . @ . @ . @ @ @ . . @ . @ @ . @ . @ . . . @ . @ . . . @ . @ 
@ @ . . . @ . . . @ . . @ @ @ . . . . . . . . . . @ @ . @ . . . . @ . . @ . . @ . . . @ . . @ @ @ @ . @ . @ . . @ @ @ @ . . @ . @ . @ . @ @ @ . @ . . . @ . . @ . . . . . . . . @ . @ . . . . @ . . . @ 
@ @ @ @ . . @ . @ @ @ . . . . . @ @ . @ . @ . @ . @ . . @ @ @ @ . @ @ . @ . @ . @ @ . . @ . . @ @ @ @ . . . . @ @ @ @ . @ . @ . . @ @ . . . . . . @ . @ . . @ . @ . @ . @ . @ @ . . . @ @ . @ @ @ @ . @ 
@ @ @ @ . @ @ . . . @ . @ . @ @ . . . @ @ . . . @ . @ . . . @ @ @ . . . @ . @ . @ . @ @ @ . @ . @ @ @ . @ @ . . @ @ @ . @ . . @ @ . . . @ @ @ @ . . . . . @ @ . . . @ . . @ . . @ . @ . @ @ @ @ @ @ @ @ 
@ @ @ @ @ . . . @ . @ @ @ @ . . . @ @ . . . @ @ . . @ . @ @ . @ . . @ . . @ . . . . . . . @ @ . @ @ . . @ . @ @ . @ . . . . @ . . . @ @ . . . . . @ . @ @ . @ @ . @ @ . @ @ @ . . . . . . @ @ @ @ @ @ @ 
@ @ @ @ @ @ . @ . @ @ @ @ @ @ . @ . . . @ . . @ @ . . . . . . . . @ . @ . @ @ @ @ @ @ @ . . . . . . . @ . . @ . . . . @ . @ @ @ . @ . @ @ . @ . @ . . . . . . . . . @ . @ @ @ . @ . @ . @ @ . @ @ @ @ @ 
@ @ @ @ @ . . @ . @ @ @ @ @ . . @ @ . @ . . @ @ . . @ . @ . @ @ . . . . @ @ @ @ . . . . . @ . @ . @ @ . @ . . . @ . @ . . . . @ @ . . . @ @ . @ . . @ . @ . @ @ . @ @ . @ . . @ @ . . @ @ @ . . @ @ @ @ 
@ @ @ @ @ @ . . . . @ @ @ @ . @ . . . . @ . @ @ @ . @ . @ @ . . . @ . @ @ . @ @ @ . @ . @ . @ . . . @ . . . @ . . @ . . @ . @ . @ . @ . . . . . . @ . . . @ . . . . @ @ . @ . @ @ . @ . @ . . @ . @ @ @ 
@ @ @ @ @ @ @ . @ @ @ @ . . @ . . @ . @ . @ . . . @ . . @ @ . @ . . @ . . . . @ @ @ . . @ . . @ . @ . @ . @ . . @ . @ . @ . . . . @ @ @ @ @ @ @ . . @ . @ @ @ . @ . . . . . . . . @ @ . . @ . . . . @ @ 
@ @ @ @ . @ @ @ @ @ @ . . @ . . @ . . @ . @ . @ @ @ @ @ . . . @ . @ @ @ @ . @ . @ @ . @ . @ . . . . . @ @ . . @ . . @ . @ . @ . @ . . . . . @ . @ . @ @ @ . @ @ @ . @ . @ @ @ . @ @ . . @ @ . @ . @ @ @ 
@ @ @ . . . @ . @ @ @ . @ . @ . . @ . . . . . @ . @ @ @ @ . @ . . . @ . . . . . . . @ . . . . @ . @ . @ @ . @ . @ . @ . @ . . @ . @ . @ @ . @ . @ @ . . . . . . . . . @ @ . . . @ @ . @ . @ . . @ @ @ @ 
@ . . . @ . . . . . . . . . @ . @ . . @ . @ . . . . . @ @ @ . . @ @ @ . @ . @ . @ . @ @ @ . @ . . . @ @ @ @ . . . . . . @ . @ @ . . @ . . . . . . . @ . @ . @ @ . @ . . . @ @ @ @ . . . . . . @ . @ @ @ 
@ @ . @ . . @ . @ @ . @ @ @ @ @ . . @ . . @ . @ @ . @ . . . @ . . . @ . @ . . @ @ . . . @ @ . . @ @ . . @ . @ @ . @ @ . @ . . . @ . . . @ . @ . @ @ . . . @ . . . @ . @ @ . @ . @ @ . @ . @ . @ . @ @ @ 
@ . @ . @ @ . . @ . . . . . @ . @ . . @ . . @ . . . . @ @ . . . @ . @ @ @ @ . @ . . @ . @ @ @ @ . . . @ . . @ @ @ . . . @ @ . @ @ . @ . @ @ . . . . @ @ . @ @ @ . @ . . @ . @ . . . . . @ @ @ @ . @ @ @ 
@ . . . . . . @ . @ @ . @ . @ . . . @ @ @ @ @ @ @ . @ . . . @ . . @ @ . @ . . . @ @ @ @ @ @ . @ @ @ . @ @ . @ @ . @ . @ @ . . . @ @ . . . @ . @ @ . @ . @ . @ . . . @ . . . . @ . @ . @ . . @ . . . @ @ 
@ . @ . @ . @ . . . @ . @ . @ . @ . . . . . . . @ . @ . @ @ . . @ @ @ . . . @ @ . @ @ @ @ . . . . . . . . . . . . @ . . @ @ . @ . @ @ . @ . . . @ @ @ . @ . . . @ @ . . @ . @ @ @ @ . @ . @ . @ . @ . @ 
@ @ . @ . . . @ . @ @ @ . . . @ . . @ . @ . @ @ @ @ . @ . . . @ @ @ @ . @ . @ . . . @ @ . . @ . @ . @ . @ @ @ @ . . . @ . . . . . . @ @ . . @ . @ . . . . @ @ . @ @ @ . . @ . @ . @ . . . . . . . . . @ 
@ @ . . @ . @ @ . @ @ . @ . @ . @ . . @ @ @ @ @ @ . . @ . @ . @ @ @ . . . @ @ @ . @ @ . @ @ . @ . @ . @ @ . . . . @ . . @ @ . @ . @ @ @ @ . . @ . . @ @ @ . @ . . @ @ @ @ . . . . . . @ @ . @ . @ . @ @ 
@ @ . @ . . . @ . . . . . . . . . . @ @ @ @ @ @ @ @ . . @ @ @ @ @ @ @ . @ . . . . . . . . . . . . . . . . . @ . @ . . @ . . . . @ . @ @ @ . @ . @ . @ . @ . @ @ @ @ @ . . . @ @ . @ @ . @ . @ @ . @ @ @ 
@ . . . @ . @ @ @ @ . @ . @ . @ @ . . @ . . @ @ @ . @ . @ . . @ @ @ . . . . @ @ . @ . @ . @ @ . @ @ . @ . @ @ @ . . @ @ @ . @ . . . . @ . . . . . . . . . . . . . @ . @ . @ . @ @ . . . . @ . . . . @ @ 
@ @ @ . @ . @ . @ @ @ . . @ @ @ . . @ . @ . . @ . . . . . . @ . @ . @ . @ . . . @ . . @ . @ @ @ . . . @ . . @ . @ . . @ . . @ . @ . @ @ . @ . @ . @ @ @ . @ . @ . . . . . . . . . . @ @ . . . @ @ . @ @ 
@ @ . . @ . . . . @ . @ . . . @ . @ . . . . @ @ . @ . @ @ . . . . . . . @ . @ @ . . @ . @ . . . . @ . . @ . @ . @ . @ . . @ . . . @ . . . @ . @ . . @ @ @ . @ @ . @ @ . @ . @ . @ . @ . . @ . . . @ . @ 
@ . @ . @ . @ . @ . . . @ . @ @ @ @ @ @ @ . . . . @ . @ . . @ . @ . @ . . @ @ @ @ . . . . @ . @ . . @ . . @ . . . . . @ . . @ . @ . @ @ . . @ . @ @ . @ @ . . . . . . @ @ @ @ . . @ . @ . @ . @ . . . @ 
@ . . . . . . @ . @ @ . . . . @ @ @ @ @ @ @ @ @ @ . @ @ . @ . . @ . @ . @ @ @ @ . . @ @ . . @ . . @ @ @ . . @ @ @ @ . @ . @ . @ @ . . @ . @ . . @ . . . . @ . @ @ @ . . @ @ . . @ @ . @ . . @ . @ . @ @ 
@ @ . @ @ . @ . . @ . @ @ . @ @ @ @ @ @ @ . . . . . . . . @ @ . @ @ . . . @ @ @ @ . @ . @ @ . @ . @ . . . @ @ @ @ . @ @ . . . . . @ . . . . @ . . @ . @ @ . @ . @ . . @ . @ @ @ . . . . . @ . . . @ . @ 
@ @ @ @ @ @ . @ . . . . @ . . @ . . @ @ @ . @ . @ . @ . @ . @ @ . @ @ . @ @ @ @ @ @ . . . . . . . . @ @ @ @ @ @ . . . . . @ . @ . . . @ @ @ . @ . . . . . . . . . @ . . . . @ @ . @ . @ . @ @ . @ @ . @ 
@ . @ @ @ . . . @ @ . @ . @ @ @ @ . . @ . . @ . @ @ . . . . . . . . . @ @ @ @ @ @ @ @ . @ . @ . @ . . @ @ @ . @ . @ . @ . . @ . . @ . . . . . . . @ @ @ @ @ . @ . @ . @ . @ @ @ @ . @ . . . . . . @ . @ 
@ . . @ . @ @ . @ . . . . @ . @ @ . @ @ @ . @ @ @ . @ . @ @ . @ @ . @ @ @ @ @ @ @ . . . . @ . . . @ @ . . . . . . @ @ @ . @ . @ . . @ . @ . @ . @ . @ @ . . @ @ . . @ @ @ @ @ @ . . @ . @ . @ @ @ . . @ 
@ @ . . . @ . . . @ . @ @ . . . @ . . @ @ @ . . . . . . . @ . . . @ @ @ @ @ @ @ @ @ . @ . @ . @ . @ @ @ . @ @ . @ . . . . . . @ . @ . . @ . @ . @ . @ . @ . @ @ @ . . @ @ @ . . . @ @ . @ . . . . @ . @ 
@ . @ . @ . @ @ . . . . . @ . @ . . @ . . @ . @ . @ @ @ . . @ . @ @ @ @ @ @ @ @ @ @ @ . @ @ @ . . . @ . . @ . @ . . @ . @ @ . . @ @ @ . . @ . . . . . . . . . @ . . @ @ @ @ . @ @ . . @ @ . @ @ @ . . @ 
@ . . . . . . . . @ . @ . . . . @ . . @ . . @ . . . . @ @ . . @ . @ @ @ @ @ @ @ . @ . . @ @ . @ . @ . . @ . . . . @ . . . @ . @ @ @ @ @ . . @ . @ . @ . @ . @ @ @ . . @ . @ . . . . @ . . @ . @ @ @ . @ 
@ . @ @ . @ . @ . @ @ @ @ . @ . . @ . . @ . . @ . @ @ . . . @ @ . . . @ @ @ . . . . . @ . @ . . . . @ . @ @ . @ . @ @ . @ . . . @ @ @ . . @ @ @ . . @ . @ . @ . . . @ . . . . @ @ @ . @ . . . . . . . @ 
@ @ . . . @ . . @ @ @ @ . @ . @ . @ . @ . @ . @ . . @ . @ . . . . @ @ . @ . @ @ @ @ . . . . . @ . @ . @ . . . @ . . @ . . @ . @ . @ @ @ @ . @ @ @ . @ . . @ @ @ @ @ . @ . @ @ . @ . . . . @ . @ . @ . @ 
@ . . @ . . @ @ @ @ @ . . . . . . . . . . . . . . @ . . @ @ @ . @ . . . . . . . . . . @ . @ . @ . @ . . . @ . . @ @ @ . @ . . @ . . @ . @ . @ @ . . @ . @ . . . . @ . . . . . . . . @ . @ . . . @ @ . @ 
@ @ . @ @ . . @ . @ @ @ . @ . @ . @ . @ @ . @ . @ @ @ @ . @ . @ . @ . @ @ . @ . @ . @ . . . @ . . @ @ . @ . . @ @ @ @ . . @ . @ . @ . . . . . . @ @ @ . @ . @ . @ . . @ . @ . @ @ @ @ @ . . @ . . . @ @ 
@ . . @ . @ @ . . @ @ @ @ . @ . . @ @ . . . . @ . . . . . . . . . . . . @ . @ @ @ . @ . @ @ . @ @ . . . @ @ . @ @ @ @ . @ @ . . . . . @ . @ . @ . . @ . . @ . . . . @ . . . @ . . @ . . @ . @ . @ @ @ @ 
@ @ . . . . . . @ @ @ @ @ . . . @ . . . @ . @ @ @ @ . @ @ @ . @ . @ . @ . @ . . . . @ . . @ . . . . @ . . @ @ . . . . . . @ . @ . @ . . @ @ . . . @ @ . @ . @ . @ . @ @ . @ @ . @ . @ . @ @ @ . . @ @ @ 
@ @ . @ . @ . @ . @ @ @ @ @ . @ @ @ . @ . . @ @ . . . @ . @ @ . . @ @ . . . . @ @ @ . . @ @ . @ . @ . . @ @ @ @ . @ @ @ . @ . . @ . . @ . @ @ @ @ . . . . . . . . @ . . . . @ . . . @ . @ . @ @ @ @ @ @ 
@ @ @ . . . @ . . . @ @ . . . @ . @ . @ @ @ @ . @ @ @ . . . . . @ . . . @ @ @ . . . . @ @ @ @ . . . @ . @ . @ @ . @ . . . @ . @ . @ . . . . . . . @ @ . @ . @ . @ @ @ @ . @ @ . @ . . . . . @ @ @ @ @ @ 
@ @ . @ . @ . @ @ . . @ @ . @ . . . . @ @ . . . . @ . @ . @ . @ . . @ . @ @ . @ . @ . . . . . @ . @ @ @ . . . . . . @ @ . @ @ . . . . @ . @ . @ . . @ . . @ . . @ @ @ @ @ . . @ @ @ @ @ . @ @ @ @ @ @ @ 
@ . . . . . . . @ @ . @ . @ . . @ . @ @ @ @ . @ . @ . @ . . @ . . @ . . @ @ . . @ . . @ @ @ . @ @ . . @ . @ @ @ . @ @ . @ @ @ . @ @ . . @ @ . @ @ @ @ . @ . . @ @ . @ . @ . @ @ @ @ @ . . . @ @ @ @ @ @ 
@ . @ . @ . @ . @ . . . . @ @ @ . . @ . . . @ . . . . . . @ . @ . @ @ . @ . . @ @ @ . @ @ . @ . @ . @ . @ @ . @ . @ @ . @ . @ @ . . . @ . @ . . . . . @ @ @ . . . . . . . . . @ @ . . . @ @ . @ @ @ @ @ 
@ . . @ @ @ . @ @ . @ @ @ . . . . @ @ @ . @ @ @ . @ . @ @ . . . . . @ @ @ @ . . @ . . @ . . . . . . . . . . . . . . . . @ . . . @ . @ @ . . . @ @ @ @ . @ @ . @ . @ . @ @ . @ . . . @ @ . @ . . @ . @ @ 
@ . @ @ . @ . @ . . . . . @ . @ . @ @ . . . @ . . . @ . @ @ . @ . @ . @ . @ . @ . . @ . @ . @ @ @ . @ . @ @ . @ . @ . @ @ . @ @ @ . @ . @ @ . . . @ @ . @ . @ . . . @ . @ . @ . @ @ . . . . . @ . . @ @ 
@ @ @ . . . . @ . @ @ . @ . @ . . @ . @ . @ . . @ . @ . @ . @ . . . . . . . . . @ . . . @ . . @ . . @ @ . . . @ . . @ @ . . @ . . . . . . @ . @ . . . . . . . @ . @ @ . . . . . . . . @ @ @ . . @ . . @ 
@ @ @ @ . @ . . @ . @ . . . . @ . @ . . . . . @ . . . . . . @ . @ @ . @ @ . @ . . @ . @ . . @ @ @ . @ @ @ . @ @ . @ . . @ . . . @ . @ @ . @ . . @ . @ . @ . @ @ @ . . . @ . @ @ . @ . . . . @ . @ . @ @ 
@ @ @ @ @ . @ . @ . . . @ . @ . . @ @ . @ . @ @ @ . @ . @ @ @ . . @ . . . @ . . @ . . @ @ . @ @ @ . @ @ @ . @ . . . @ . @ @ . @ @ . . @ . @ . @ . . @ . . @ . @ @ @ @ . @ . @ . . @ @ @ . @ @ @ . . @ @ 
@ @ @ @ . . . . . . @ @ . @ . @ @ . . . @ @ . . . . . @ . . . @ @ . . @ . @ @ . . @ . . @ . . @ . . . @ . @ . . @ . . . @ . @ . . . @ . @ @ @ . @ . . @ . @ . . @ . . . . @ @ @ . @ @ @ @ @ @ @ @ . @ @ 
@ @ @ . . @ @ @ @ . . . . . . . . . @ . . @ @ @ @ . @ . @ . @ . . . @ @ @ . @ . @ @ . @ @ @ . . @ . @ . . . @ . @ . @ . . . @ . @ . . . . . . . @ . @ @ . . . @ @ @ . @ @ @ @ @ . @ @ @ @ @ @ @ . . . @ 
@ . . . @ . . . . . @ . @ @ . @ . @ . . @ . . . . . . . . . . @ @ . . @ @ . @ . . . @ @ @ @ . @ @ . @ @ @ . . . @ . . @ . @ @ @ . . @ . @ . @ . @ . . . @ . @ @ @ . @ @ @ @ @ . . . @ @ @ @ @ . @ . @ @ 
@ @ . @ . . @ . @ @ . . . @ @ @ . @ @ . @ . @ . @ . @ . @ . @ . @ . @ @ @ . @ @ . @ @ @ . @ @ @ @ @ . . . . @ . @ . @ @ @ . @ . @ . . @ @ . . @ . . @ . . @ @ @ @ . . @ @ @ @ @ . @ @ @ @ @ . . . . . @ 
@ . . . @ . @ . . . @ . @ @ @ @ @ . . . . @ . . @ . . @ @ @ . . . . . @ @ . . @ . . @ . . @ . @ @ . @ @ . @ @ . @ . . @ . . . . . . @ @ @ . @ @ . @ . . @ @ @ @ . . @ @ @ @ . . @ @ @ @ @ @ @ . @ . @ @ 
@ @ . @ @ @ . . @ @ . . @ @ @ @ @ @ @ . @ @ . @ . . @ @ @ . @ . @ . @ . . . @ . . @ . @ . . . . . . @ @ @ . . . @ . @ @ @ @ . @ . @ . . . @ @ @ . . @ . . @ @ . @ . . @ @ @ . @ @ @ @ @ @ @ @ @ . . . @ 
@ @ . . @ . @ . . . @ . . @ @ @ . . . . . @ . @ @ . @ @ . . @ . . @ @ @ @ . @ . @ @ . . . @ . @ . @ @ . . . @ . @ . . . . . @ . . . @ . @ @ @ @ . @ . . @ . @ . @ . @ @ @ . . . @ . . @ @ @ @ . @ . @ @ 
@ . @ @ @ . @ @ . @ @ . @ . @ . @ . @ . @ @ @ . . . @ . @ . @ . @ @ @ @ @ . @ @ . @ @ @ . . @ . . . @ . @ . . @ . . @ . @ . @ @ . @ . . . @ @ @ @ @ @ . . . . . . . . . . @ @ . . @ . . . @ . . . . @ @ 
@ . . . . . . . . @ . @ . . . . . . @ . . @ @ @ @ . @ . . . . . @ @ . @ @ . . . . . @ . @ . . @ . @ @ @ . @ . @ @ . . @ @ @ . . . . . @ @ @ @ @ . @ @ . @ . @ . @ . @ @ . . . @ . @ @ . @ . @ . @ . . @ 
@ @ @ . @ . @ @ @ @ . @ @ . @ @ . @ . @ . . @ @ . . @ . @ @ @ . . . . . @ . @ . @ . @ . . . @ . @ @ @ @ . @ @ . . . @ . @ . . @ . @ . . . @ . . . . . . . @ @ @ . . . @ . @ . . . . . . . . . . . @ . @ 
@ . . . @ @ . . . . . . . . @ @ . . . @ @ @ @ . @ . @ . . . @ . @ . @ @ @ @ . . . @ . . @ . . . . @ @ @ . @ . . @ . @ . . @ @ . . . @ . @ @ @ @ . @ @ . @ . @ @ @ . @ @ @ . . @ . @ . @ . @ @ . @ . . @ 
@ @ . @ @ . @ . @ @ . @ . @ . . . @ . . @ . . . . . @ . @ . @ @ . @ @ . @ . @ . @ . @ @ . . @ . @ . @ . . . . @ @ . . . @ . . @ @ . . @ @ @ @ @ @ @ @ . . . @ @ @ . . . @ . @ @ . . @ . . . . @ . @ . @ 
@ @ @ . . . . . . @ @ . . @ @ . @ . . @ . . @ . @ . @ @ . @ . . . . . . . . . . . . . . . @ . . . . . . @ @ . . @ @ . @ @ . @ . . . @ . @ . @ . @ . . . @ . . . . @ . @ . @ . . . @ @ @ . @ @ @ . . . @ 
@ @ . . @ . @ @ . @ @ . @ . . . . @ . . @ @ . . . @ @ @ . . . @ @ . @ @ . @ . @ @ @ . @ . . @ . @ @ @ . @ . . @ . @ . . . . . @ @ . . . . . . . @ . @ . . @ . @ . . @ . . @ . @ @ @ @ . @ . @ @ . @ @ @ 
@ . . @ . . @ @ . . @ @ . . @ . @ . . @ @ @ @ . @ @ @ . @ . @ . . . @ . @ @ @ . . . . @ @ @ @ . @ . @ @ @ @ . . . @ . @ @ . @ . . . @ @ . @ . @ . @ . . @ . . . @ . @ . @ @ @ @ @ . . . . . . . @ @ @ @ 
@ @ . . @ . . . @ @ . . @ @ . . . @ . @ @ @ . . . @ . . . @ . . @ . @ . @ @ . @ . @ . . . . @ @ . . @ . @ . @ . @ . . . . @ . @ @ . . . @ . . @ . . @ . @ @ . @ @ . . . . @ @ @ @ @ . @ . @ . @ @ @ @ @ 
@ . . @ . @ @ @ . @ @ . @ . @ . @ @ @ @ @ @ @ . @ . @ . @ . . @ . . . . . . . . @ @ @ @ @ @ @ @ @ . . . . . . . @ @ . @ @ . . . @ . @ . @ @ . . . @ . . . @ . @ . . @ @ @ . @ @ @ @ . . @ @ @ @ . @ @ @ 
@ . @ . . @ . . . . . . . . . . @ @ @ @ @ @ @ . . . . . @ @ . @ @ @ . @ . @ @ . @ @ @ @ @ @ @ @ . @ . @ . @ . @ . . . . . . @ . @ @ . @ . @ @ . @ . @ . @ . @ @ @ . . . . . . . @ @ . @ . @ . . . . @ @ 
@ . . @ . . . @ . @ . @ . @ @ . . . @ @ . @ . @ . @ @ . @ @ @ . . . @ . . . . @ @ @ @ @ @ @ @ . . . @ . . . @ . . @ . @ . @ . . . . . @ . . @ . . . . @ . . . . . . @ . @ . @ . . . . . . . @ @ . @ . @ 
@ @ . . @ . @ @ @ . . . @ . . @ . @ . . . . . . . @ @ . . @ @ @ . @ @ @ . @ . . . @ @ @ @ @ . @ . @ . @ . @ @ @ @ . . . @ . @ @ @ @ . . . @ @ . @ . @ . @ . @ . @ . . @ @ . @ . @ . @ . @ . . . . . . @ 
@ . . @ . @ @ @ @ @ . @ @ @ . . . @ . @ @ @ . @ . . @ . @ @ @ . . . . . . @ . @ . . @ @ @ @ . . . . . . . . . @ . . @ . . . . . . @ . @ @ . . . . @ . . . . . @ . . @ . @ @ @ . . @ @ . . @ . @ @ . @ @ 
@ @ . . . @ @ @ @ . . @ @ @ @ . @ @ @ . @ @ @ . . @ @ . . @ . . @ @ . @ . . @ . . @ . @ @ @ @ . @ . @ @ . @ @ @ @ . @ . @ . @ @ @ . . . @ . @ . @ @ @ @ @ . @ . @ . . . . . @ @ . . . @ . . @ @ . . @ @ 
@ . . @ . @ @ @ @ @ @ . @ . . . . . . . . @ @ @ . . . @ . . @ @ . . . . @ @ . @ . . . . @ @ @ . @ . @ @ @ @ . @ @ . @ . . @ . @ . @ . @ . @ . . . . . . @ @ . . . . @ . @ . @ . . @ . . @ . . . @ . . @ 
@ @ . @ @ @ @ @ @ . . . @ @ @ . @ . @ . @ . @ . . @ . . @ @ . @ . @ . @ @ @ . . . @ @ . . . @ @ @ @ . . . . . . . . @ . @ @ . . . . @ @ . . . @ @ . @ . . @ @ @ . @ . . . @ . . @ @ . @ @ . @ . . @ . @ 
@ . . . . @ @ @ @ @ @ . . . @ @ @ @ @ . . . . @ . . @ . . @ . . . @ . . @ . . @ . . . @ . @ . . @ @ @ @ . @ . @ . @ . . . . . @ . @ . . @ @ . . . @ . . @ . . . . . @ . @ . . @ @ . . . . @ . . @ @ . @ 
@ @ . @ . . @ @ @ . . . @ @ . @ @ . . . @ . @ @ @ . . @ @ . . @ . @ . @ . @ @ . . @ . . @ @ . @ . @ . . @ . . @ . @ @ . @ @ @ . . . . @ @ @ . @ . . @ @ . @ @ . @ @ @ @ @ @ . . . @ @ . @ @ @ . . . @ @ 
@ . . . @ . . @ . . @ @ . @ . @ @ . @ @ @ . . @ . . @ @ @ @ . . @ . . . . . . @ . . @ . . . . . . @ . @ @ @ . @ . @ . . @ @ @ @ . @ . . @ @ @ . . @ . @ . @ . . . . @ . @ @ . @ . @ . . . . . @ . @ @ @ 
@ @ . @ @ . @ . . @ . @ . @ . . . @ @ @ @ . @ . @ . @ @ @ @ . @ @ @ . @ . @ . . @ . . @ . @ . @ . . . . . . @ . . @ @ . . @ . . . @ . @ @ @ . @ . . . . . . @ . @ . . . . @ . . @ @ @ . @ . @ . . @ @ @ 
@ @ . . . @ @ @ . . . . . . . @ . . . @ . . @ . . . @ @ @ @ . @ @ . . @ . . @ @ . . @ . . . @ @ . @ . @ . @ @ @ @ . . . @ . @ @ . @ @ @ @ . . . @ . @ . @ . @ . . @ . @ . . @ . . @ . . . @ . @ @ . @ @ 
@ @ . @ . . . . . @ . @ . @ . @ . @ . . @ . @ . @ . @ @ @ @ @ @ @ @ @ . . @ @ @ @ . @ @ @ . . . @ @ . . @ @ @ @ @ @ . @ . . . . . @ . @ . @ . @ @ . . @ @ . @ . @ @ . . @ . . @ @ . @ . @ . . . . . . @ 
@ @ @ . . @ . @ . . @ . . . @ @ . @ . @ @ . . @ . . . . @ @ @ @ @ @ @ @ . . . @ . . . . . @ . @ . . . @ @ @ @ @ @ . . . @ @ . @ . . . . . . . . . @ . . . @ @ . . . @ @ . . @ . . . . . . . @ @ @ @ . @ 
@ @ @ @ . . @ @ . @ . @ @ . @ . @ . @ @ @ . @ @ @ . @ @ . @ @ @ @ @ @ @ @ . @ @ @ . @ . @ . . . @ . @ @ @ @ @ @ @ @ . @ @ @ @ . . @ . @ . @ . @ . @ . @ . . @ . @ @ . @ @ . @ . @ . @ . @ . . . . . @ @ 
@ @ @ . . @ . @ . @ . . . . . . . . @ @ @ @ @ @ . . . . . . . . @ @ @ @ @ . @ . . . . @ @ @ . @ . . @ @ @ @ @ @ @ @ @ @ @ @ @ @ . . @ @ . . @ @ @ . . . @ @ . . . . . . . @ . . @ @ . . . @ @ @ . @ @ @ 
@ @ @ @ . . . . @ @ @ . @ @ . @ . @ @ @ @ @ @ @ @ . @ . @ . @ @ @ @ @ @ @ . . @ @ . @ @ @ @ . . @ . . . . . @ @ @ @ @ @ @ @ @ @ @ . . . @ . @ @ @ @ . @ @ @ . @ @ . @ @ . @ @ . . . @ . @ @ @ @ @ @ @ @ 
@ @ @ @ @ @ @ @ @ @ @ @ @ @ @ @ @ @ @ @ @ @ @ @ @ @ @ @ @ @ @ @ @ @ @ @ @ @ @ @ @ @ @ @ @ @ @ @ @ @ @ @ @ @ @ @ @ @ @ @ @ @ @ @ @ @ @ @ @ @ @ @ @ @ @ @ @ @ @ @ @ @ @ @ @ @ @ @ @ @ @ @ @ @ @ @ @ @ @ @ 
3
56 40 30 2
96 41 82 3
83 47 18 15
