50 50
@ @ @ @ @ @ @ @ @ @ @ @ @ @ @ @ @ @ @ @ @ @ @ @ @ @ @ @ @ @ @ @ @ @ @ @ @ @ @ @ @ @ @ @ @ @ @ @ @ @ 
@ @ @ . @ @ @ . . . @ . . @ @ . . @ . @ @ . . @ @ @ @ @ @ . . . @ @ . . . @ @ . . . . . . . @ @ @ @ 
@ . . . @ @ . @ @ . . @ . @ . @ . . . . @ @ . @ @ . @ . . . @ . . . . @ @ . . @ . @ . @ . @ @ @ @ @ 
@ @ . @ @ @ . @ . @ . @ . . . . . @ . @ @ @ . . @ . . @ @ @ . @ @ @ . @ @ @ . @ . . @ . @ @ @ @ @ @ 
@ @ . . @ . . . . . . . @ . @ @ . . @ @ @ . @ . . @ . . . @ . @ . . . @ . . . . . @ @ . . . @ @ @ @ 
@ . . @ @ @ . @ . @ . @ @ . @ . @ . . . . . . . @ . @ . @ . . . @ @ . . @ @ . @ . . . @ . @ . @ @ @ 
@ @ . . @ @ @ @ . @ . . . @ . . . @ . @ @ @ @ . . . . . . . @ . @ . @ . . . @ . . @ . . . . . . . @ 
@ @ . @ @ . @ . @ . . @ @ . @ . @ . @ . . . . . @ . @ @ . @ . . . . . . @ @ . @ . . @ . @ @ . @ . @ 
@ . . . @ . . . . @ . @ . . . . . . @ @ @ . @ . . @ . . . . @ @ @ @ @ . . . . . . @ . @ . . . . @ @ 
@ . @ . . @ . @ . . . @ @ . @ . @ . . . . @ . . @ @ @ . @ @ . . . . . . @ . @ @ . . . . @ @ . @ @ @ 
@ @ . . @ @ @ . @ @ . . @ . . @ . . @ . @ . @ . @ @ @ . . . @ . @ . @ . . @ . . . @ @ @ @ @ @ @ @ @ 
@ . @ . @ . . . @ @ . @ . @ @ . @ . @ . . . @ . . @ . . @ . . @ . . . @ . @ . @ . @ . @ @ @ @ @ @ @ 
@ . . . . @ . @ @ . . . . @ . . @ . . @ . @ @ . @ @ @ @ @ . @ @ @ . @ . . . @ @ . @ . . @ @ @ @ @ @ 
@ @ . @ . @ . @ . . @ @ @ . . @ . . @ @ @ . . . . @ . . . . . @ . . . @ . @ @ @ . . @ . . @ @ @ @ @ 
@ . @ . . . . . @ . . . . . @ . @ . . @ . . @ . @ @ @ . @ . @ @ @ . @ . . . @ . . @ . . @ @ @ @ @ @ 
@ . . . @ . @ . . . @ . @ . @ . . . @ . @ . @ . @ @ @ @ @ . @ @ @ @ @ @ . @ @ . @ . @ . @ @ @ @ @ @ 
@ . @ @ @ @ . @ @ . . @ @ @ . @ @ . . . . @ . @ @ @ @ @ @ @ @ @ @ . @ @ . @ . . . . . . . @ @ @ @ @ 
@ @ . @ @ . . @ . @ . @ @ . . . . . @ @ @ . . . . @ . @ . @ @ @ . . @ @ . @ @ . @ . @ . @ @ @ @ @ @ 
@ . . @ @ @ . @ . @ . . @ @ @ . @ . . @ . @ . @ . . . . . . @ @ . @ @ . @ . @ @ . . @ . @ @ @ @ @ @ 
@ @ . . @ . . . . . . @ . . . @ @ @ . . . . @ . @ @ . @ . @ @ . . . . . . . @ . @ . . @ . . @ @ @ @ 
@ . @ . . @ @ @ . @ . @ . @ @ @ @ @ . @ . @ . . @ . . . @ @ @ @ . @ . @ @ . . . . . @ . @ . . @ @ @ 
@ . @ . @ . . . @ . . . . @ . . @ . . . @ @ @ . @ . @ . . . . . @ . @ @ @ . @ . @ . . . . . @ @ @ @ 
@ . . . . @ . @ . @ . @ . . . @ @ @ . @ @ @ @ . . @ @ @ @ @ . @ . . @ . . . . @ . @ . @ @ . . @ @ @ 
@ @ @ . @ . . . . . @ @ @ @ . . @ . . . @ @ . . @ @ . @ . @ . @ . @ . @ . @ @ . . . . @ . . @ @ @ @ 
@ @ @ . @ . @ . @ . @ . . . @ . . . @ @ . @ @ . . . . . . . . @ . . . @ @ . . . @ . @ . @ . . @ @ @ 
@ @ @ . . @ @ @ . . . . @ . . @ @ . @ @ . @ . @ @ @ @ . @ @ . @ . @ . @ @ @ @ . . @ . . . . @ @ @ @ 
@ @ . . @ . @ @ . @ . @ . @ . @ @ . @ . . . . . @ . @ . @ . . . . . @ @ @ @ @ . @ @ @ . @ . . @ @ @ 
@ @ @ . . . . @ @ @ @ . . . . . @ . . @ . @ @ . . . . @ . . @ @ . @ . @ @ @ . . . . @ @ @ @ . . . @ 
@ @ . @ . @ @ . @ @ . @ @ @ . @ . @ . . @ @ @ @ @ . @ . @ @ @ . . @ . . @ @ @ . @ . . @ @ . @ . @ @ 
@ . . . . . . . . . . . . . . . . . @ . @ . @ . . . . . . @ . @ . @ . @ . . @ @ @ @ . @ @ . . . . @ 
@ @ @ . @ . @ . @ . @ . @ . @ . @ . . . . . @ . @ . @ . @ . . @ . @ . @ @ . @ . @ . @ . @ @ @ . @ @ 
@ @ @ @ . . . @ . . . @ @ . . @ . @ . @ . @ . @ . @ . . . . @ . . . . . @ . . . @ . @ . . @ . . @ @ 
@ @ @ @ . @ . @ . @ @ @ @ . @ . . @ . @ . . . . . @ . @ @ . . @ @ . @ @ . . @ @ . . . . @ . @ . . @ 
@ @ @ . @ . @ . @ . @ . . @ . @ . . @ @ @ . @ . @ . . @ . . @ @ . . . . @ . @ . @ . @ @ . . . . @ @ 
@ @ . . . . . . . . . . @ . . . . @ @ @ @ @ @ . @ @ @ . @ . . . . @ @ . . . . . . . . . @ . @ . . @ 
@ . . @ . @ @ . @ . @ . . . @ @ . . @ @ @ @ @ . . @ . . . @ @ . @ . . @ @ . @ . @ . @ . . @ . . @ @ 
@ . @ . . . @ @ . . @ . @ . . . @ . . @ @ @ @ . @ . @ @ . @ @ @ . @ . . . @ @ @ . @ @ . @ . @ . . @ 
@ @ . . @ @ . @ @ . @ @ . . @ . @ . @ . @ @ @ . @ . . . . . @ @ . @ @ @ . @ @ . . @ . . . . . @ . @ 
@ . @ . @ @ . @ . @ . @ @ . . @ . . . . . @ . . . @ . @ . @ @ @ . . @ . . @ . . @ . @ @ . @ . . . @ 
@ . . . . @ . . . . . . . . @ . @ . @ . @ @ @ @ . @ . @ . . @ . . @ @ . @ . @ . @ . @ @ @ . @ @ . @ 
@ @ @ @ @ . @ . @ . @ . @ . . . @ . . @ @ . . @ . @ @ . @ . @ @ . @ . . . . . . . . . . . . . . . @ 
@ . . . . . . . . @ @ @ . . @ @ . . @ . . @ . @ . . . . . . . . . . . @ . @ . @ . @ . @ . @ . @ . @ 
@ @ . @ . @ . @ @ @ @ @ @ . @ . @ . @ @ . . . . . @ . @ . @ . @ . @ . . @ @ @ @ . . @ . . . @ . . @ 
@ . . . @ . . . @ @ @ @ @ @ . . . . . . . @ . @ . . @ . . . @ . . . @ . . @ @ @ @ @ @ @ @ @ . @ . @ 
@ @ @ @ . @ . @ . @ @ @ @ . @ . @ . @ . @ @ . @ @ @ @ @ . @ @ @ . @ @ . @ @ @ . . . . . . . . . . @ 
@ @ @ . . . . . . . . @ . . . . . @ . . @ . @ . . . . . . . @ . . . . @ . @ . @ . @ . @ @ . @ @ . @ 
@ @ @ . @ @ . @ @ . @ @ @ . @ . @ @ . @ . . . . @ @ . @ @ @ @ @ . @ . . . . . @ @ . . @ . . . . @ @ 
@ @ @ . . . @ . . . . @ @ @ @ @ . . . @ @ . @ . . @ . @ . @ @ . . . @ . @ . @ @ @ @ . . @ @ @ . . @ 
@ @ @ . @ . @ . @ @ @ @ @ @ @ @ @ . @ . . . @ . @ @ @ . . . . . @ . . @ . . . @ @ @ . @ @ . . . @ @ 
@ @ @ @ @ @ @ @ @ @ @ @ @ @ @ @ @ @ @ @ @ @ @ @ @ @ @ @ @ @ @ @ @ @ @ @ @ @ @ @ @ @ @ @ @ @ @ @ @ @ 
3
24 45 35 46
24 12 1 11
26 25 43 27
