12 12
@ @ @ @ @ @ @ @ @ @ @ @ 
@ . . . . . . . @ @ @ @ 
@ @ . @ . @ . @ . @ . @ 
@ . . @ . @ . @ . . . @ 
@ . @ . . . @ . . @ . @ 
@ @ . @ . @ . @ . . @ @ 
@ . . @ . . . . . @ . @ 
@ @ . . . @ @ @ @ . . @ 
@ @ . @ @ . . @ . @ . @ 
@ . . . @ . @ . . . . @ 
@ . @ . . . . . @ . @ @ 
@ @ @ @ @ @ @ @ @ @ @ @ 
3
9 8 4 5
9 2 2 4
5 2 4 7
