25 25
@ @ @ @ @ @ @ @ @ @ @ @ @ @ @ @ @ @ @ @ @ @ @ @ @ 
@ . . . @ @ @ @ @ @ @ @ @ @ @ @ @ @ @ @ @ @ @ @ @ 
@ @ . @ . @ @ @ @ @ @ @ @ . @ @ @ @ @ @ @ @ @ @ @ 
@ . . . . . @ @ @ . @ @ @ . . @ @ @ @ @ @ @ @ @ @ 
@ . @ . @ . @ . @ . @ @ . . @ @ @ @ @ @ @ @ @ @ @ 
@ @ @ @ . . . . . . . @ @ . . @ @ @ @ @ @ @ @ @ @ 
@ @ @ @ @ . @ @ @ @ . @ . @ . @ @ @ @ @ @ @ @ @ @ 
@ @ @ @ . . . @ . . @ . . . . @ . @ @ @ @ @ @ @ @ 
@ @ @ . @ . @ . @ . @ @ . @ . . . . @ @ @ @ @ @ @ 
@ @ . . . . . . . . . . . @ @ @ . @ @ @ @ @ @ @ @ 
@ . @ . @ . @ . @ . @ . @ . . . . @ @ . @ @ @ @ @ 
@ . . @ . . . @ @ @ . . . @ . @ @ @ . . . @ @ @ @ 
@ . @ . @ . @ . @ . @ . @ @ @ @ @ @ @ . @ . @ @ @ 
@ . . . . . @ . . . @ . @ @ @ @ @ @ . . @ . . . @ 
@ . @ @ . @ . . @ @ . . . @ . @ . . @ . . . @ @ @ 
@ @ . . @ @ . @ . . . @ @ . . . @ . . . @ . . @ @ 
@ @ @ . . . . . . @ . . @ . @ . @ @ @ . @ . @ . @ 
@ @ . . @ . @ . @ . . @ . . @ @ . . . . . @ @ . @ 
@ . @ . . @ . . . @ . . . @ . @ . @ . @ . @ . . @ 
@ . . . @ . @ . @ @ . @ . . . . . . @ . @ . @ . @ 
@ . @ . . . . @ . . . . @ . @ . @ . . . . . . . @ 
@ . . @ . @ . @ @ @ . @ @ . . @ . . @ @ . @ . @ @ 
@ . @ @ @ @ @ @ @ @ . . . @ @ @ . @ . @ @ @ . @ @ 
@ . @ @ @ @ @ @ @ @ @ . @ @ . . . . . . . @ . . @ 
@ @ @ @ @ @ @ @ @ @ @ @ @ @ @ @ @ @ @ @ @ @ @ @ @ 
3
23 11 14 14
15 9 4 13
13 7 23 1
