12 12
@ @ @ @ @ @ @ @ @ @ @ @ 
@ . . . @ @ @ @ . . @ @ 
@ . @ . . @ @ . @ . . @ 
@ . . @ . . @ . . . @ @ 
@ . @ @ . @ . @ @ . . @ 
@ . . @ . . . . . . @ @ 
@ . @ . . @ @ . @ . . @ 
@ @ @ @ . @ . . . @ . @ 
@ . . . . . @ . @ . . @ 
@ . @ . @ . . @ @ @ . @ 
@ @ . . @ . @ . . . . @ 
@ @ @ @ @ @ @ @ @ @ @ @ 
3
7 10 9 1
10 2 4 6
10 10 9 10
