25 25
@ @ @ @ @ @ @ @ @ @ @ @ @ @ @ @ @ @ @ @ @ @ @ @ @ 
@ @ @ @ . . @ . . . @ @ @ . @ . @ @ . @ @ @ @ @ @ 
@ @ . . . @ . @ . @ . @ . . . . . @ . @ @ @ @ @ @ 
@ . . @ . . . . . . . @ @ . @ . @ . . . . @ . . @ 
@ @ @ . . @ @ @ @ @ @ . . . @ @ @ . @ . @ . @ . @ 
@ @ @ @ . . @ . @ @ @ . @ . @ @ @ @ . . . . . . @ 
@ . @ . . @ . . . @ . @ . . . . @ @ @ @ . @ @ . @ 
@ . @ @ . @ . @ @ . . . @ . @ @ . @ . @ @ . . . @ 
@ . . @ . . . . @ @ . @ . . . . . . . . . . @ . @ 
@ . @ . . @ @ @ . . . . . @ @ @ @ @ . @ . @ . . @ 
@ . @ @ . . . . @ . @ . @ . . . . . @ . . @ . @ @ 
@ . . @ . @ . @ . . @ . @ . @ @ . @ . @ @ . @ . @ 
@ @ . @ @ . . @ . @ . @ . . . @ . . . . . . . . @ 
@ . . . . @ . . . . . . @ . @ . @ @ @ . @ @ @ . @ 
@ @ . @ @ . . @ @ . @ . . . . . . . @ . . . @ @ @ 
@ . . . @ . @ @ . @ @ @ @ . @ . @ . @ . @ @ . . @ 
@ . @ . . . . @ . . @ . . . . @ @ . . @ @ . @ . @ 
@ @ @ @ @ @ . . . @ . @ . @ . . . @ @ . . . . . @ 
@ @ @ . . . . @ . . . . @ . . @ @ @ . @ @ . @ . @ 
@ @ . @ @ @ . . @ . @ @ @ @ . . . . . . . . . @ @ 
@ . . . . . . @ @ . . @ @ @ @ @ . @ . @ . @ @ @ @ 
@ . @ . @ . @ . . . @ @ @ @ @ @ . . @ @ @ @ @ @ @ 
@ @ . . . @ . . @ . @ @ @ @ . . . @ @ @ @ @ @ @ @ 
@ . . @ @ @ @ . . @ @ @ @ @ @ . @ @ @ @ @ @ @ @ @ 
@ @ @ @ @ @ @ @ @ @ @ @ @ @ @ @ @ @ @ @ @ @ @ @ @ 
3
3 7 19 22
19 19 12 2
10 13 3 13
