50 50
@ @ @ @ @ @ @ @ @ @ @ @ @ @ @ @ @ @ @ @ @ @ @ @ @ @ @ @ @ @ @ @ @ @ @ @ @ @ @ @ @ @ @ @ @ @ @ @ @ @ 
@ . @ . . . . . . . . . . . @ . @ @ @ . @ @ . @ . @ . . . @ @ . . . . . . . @ . . @ @ . @ @ @ @ @ @ 
@ . . @ @ @ . @ @ . @ . @ . . . . . . . . . . . . . . @ @ . . . @ @ . @ @ @ . @ . . . . @ @ . @ . @ 
@ @ . @ . @ @ . . . . @ @ @ . @ . @ . @ . @ @ . @ @ . @ @ . @ . @ @ . @ . . . . . @ @ . . . . . . @ 
@ . . . . . @ . @ . @ @ @ @ @ . . @ . . @ . @ @ . @ . . . . . @ @ . . . @ @ . @ . . @ . @ @ @ . @ @ 
@ . @ . @ @ @ @ . . . @ @ @ @ @ @ . . @ . . @ . . . . @ . @ @ @ @ . @ @ . . . @ @ @ . . @ . @ . . @ 
@ @ . . . @ @ @ . @ . @ @ @ @ @ @ @ . . @ . . @ @ @ . . @ @ . @ . . @ . @ @ . . @ @ . @ . . . . @ @ 
@ . @ . @ @ @ @ . . @ @ @ @ @ @ @ @ . @ . . @ . . @ . @ @ . . . @ @ . . . . @ . . . @ @ @ . @ . . @ 
@ . . . . @ . . . @ @ @ @ . @ @ @ @ . . @ . . @ . . . @ . @ . @ @ @ @ . @ . @ . @ @ . @ @ . @ . @ @ 
@ @ @ . @ @ @ . @ @ . @ . . . @ @ . . @ @ @ . . @ @ . . . @ . . @ @ @ @ . . . . . @ . @ . @ . @ @ @ 
@ @ . . . @ @ @ . @ . . @ . @ . @ @ . . @ . . @ . . . @ . . . @ . @ @ . . @ @ . @ . . . . . . . @ @ 
@ @ . @ @ . . . . @ . @ . . . . . . @ @ . @ . . @ @ . @ . @ @ . . . @ . @ . . . . . @ . @ . @ . @ @ 
@ . . @ . @ . @ . . . . . @ . @ . @ @ . . . @ . . @ . @ . @ . @ . @ . @ . @ @ . @ @ . @ @ . . @ . @ 
@ @ . . . . @ . . @ @ . @ @ @ . . @ @ @ . @ . . @ @ . @ @ . . . . . . @ . . . . . @ . @ . @ @ . . @ 
@ . @ @ . @ . @ . @ . . @ . . @ @ @ @ . . . @ . @ . . @ . @ @ . @ . @ . . @ @ . @ @ . @ . @ @ @ . @ 
@ . . . . . . . . @ . @ . @ . @ . @ . @ @ . . . . @ . . . . . . @ @ . . @ . . . . . . . . @ . @ . @ 
@ . @ . @ @ . @ . . @ . . . . . . . . @ @ @ @ . @ @ . @ @ @ . @ @ @ @ . @ @ @ . @ @ . @ . . . . . @ 
@ @ . . @ . @ . . @ . @ . @ . @ . @ . @ @ @ . . . . . . @ @ . . @ . . . @ . . . . . @ . . @ @ . @ @ 
@ . . @ . . . . @ @ . . . . @ . @ . . . @ . @ @ . @ . @ @ @ . @ @ @ . @ @ @ @ . @ @ . @ . . . @ @ @ 
@ @ . @ @ @ @ . . @ @ @ . @ . . @ @ . @ @ . . . . . @ . @ . . . . @ . @ @ . . . . . . @ @ . @ @ @ @ 
@ @ @ @ @ @ . . @ . . @ . . . @ . . . @ @ @ . @ . @ @ . . @ . @ @ . @ . @ . @ . @ @ . . @ . . . . @ 
@ @ @ @ @ . @ . . . @ @ @ . @ @ . @ . . @ @ @ . . . @ . @ . @ @ . . . . . @ @ . @ . . @ . @ . @ @ @ 
@ @ @ @ . . . . @ . . @ . @ @ @ @ @ . @ . @ . @ . @ . . . . @ @ @ . @ . @ . . @ . @ . . . @ @ @ @ @ 
@ @ @ @ @ . @ . . @ @ . . @ @ @ . . . . . . . . . . @ . @ @ . . . @ . . . @ . . . . . @ @ . @ @ @ @ 
@ @ @ @ @ . @ . @ . @ . @ . @ . @ . @ . @ . @ @ @ . . . . @ . @ . . @ @ . . . @ . @ @ . @ . @ @ @ @ 
@ @ @ @ . @ . . . . . . . . . . @ @ . . . @ . . . @ @ . @ . @ . . @ . . . @ @ . @ . @ . . . . @ @ @ 
@ . @ . . @ @ . @ @ @ . @ . @ @ . @ . @ @ @ @ @ . @ . . @ . . @ . @ . @ . . . . . . . . @ @ @ @ @ @ 
@ . @ . @ . . . . @ . @ . . @ . . . @ @ @ @ @ . . . @ . . . @ . . . @ . . @ @ . @ . @ . . . @ @ @ @ 
@ . . . . @ @ . @ . . . @ @ . @ . @ @ @ . @ @ . @ . . . @ . @ @ @ . . @ . . @ . . @ . . @ . . . @ @ 
@ @ . @ . . . . . . @ @ @ . . . . . . . . . . @ . . @ . . @ @ @ . @ . . . @ . . @ @ . @ @ . @ @ . @ 
@ @ @ . . @ . @ @ . @ . @ . @ @ @ . @ @ . @ @ . @ @ . . @ . @ . . . @ . @ . @ . . @ @ . @ . . . . @ 
@ @ @ @ @ @ @ . . . . . . @ . . . @ . . . . . . . . @ . . . @ @ @ . . . . . . @ @ @ . . @ @ . @ . @ 
@ . . . @ @ . @ . @ . @ . @ @ . @ . @ @ . @ . @ . @ . . @ . @ . @ . @ @ . @ . . @ . . @ . . @ . . @ 
@ @ . @ . . . @ . . @ @ . . @ . . . . @ . @ @ . . . . @ . @ . . . @ @ @ @ . . @ @ @ . . . @ . @ . @ 
@ @ . . . @ . @ . @ @ . . @ . @ . @ . . @ @ @ @ . @ . . . @ @ @ . . @ @ . @ . . @ . . @ . @ . . . @ 
@ @ . @ @ @ @ . . @ @ @ . . . @ @ . . @ @ . . @ @ @ . @ @ . . @ . @ . . . . . @ @ @ . @ . @ @ . @ @ 
@ . . . @ @ @ . @ @ @ . @ @ . @ . @ . @ @ @ . . . @ . . . @ . . . . @ @ @ @ . @ @ . . . @ . . @ @ @ 
@ @ . @ . @ . @ . . . . . . . . . . . . @ . . @ @ . . @ @ . . @ . @ @ @ @ @ . @ . @ . @ . . @ . @ @ 
@ . . . . . . . . @ @ . @ . @ . @ @ . @ . @ . . . @ . . . @ . . @ . . @ . . . . . . . . @ . @ . @ @ 
@ @ . @ . @ . @ . . @ . @ @ @ @ @ @ . . . . . @ . . @ @ . . @ . . @ . @ @ @ . @ . @ . @ . . . . . @ 
@ . . @ @ . . . @ . . @ . @ @ . @ . @ . @ . @ . @ . @ . @ . . @ . . . . . . @ . . . @ . . @ . @ @ @ 
@ @ . . @ @ . @ @ . @ . . . . . . . . . @ @ . . . . . . @ @ . . . @ . @ . @ @ @ . @ . . @ @ @ . . @ 
@ @ . @ @ @ . @ . . . @ . @ . @ . @ @ . . . @ . @ . @ . @ . @ @ . . @ @ @ @ @ . . . . @ . @ . @ . @ 
@ @ . @ @ . . . @ . @ @ @ @ @ @ @ . . . @ @ . . @ @ . . . . . . . @ @ @ @ @ . @ . @ @ . . @ . . . @ 
@ @ @ . . . @ @ . . . @ @ @ . @ . . @ . . @ @ . @ . @ . @ @ . @ . @ @ @ . . . . . . @ @ . . . @ @ @ 
@ @ @ . @ @ . . . @ . @ . . . . @ . @ . @ @ @ @ . . . . . @ . @ . . @ @ . @ . @ . @ . @ . @ . . . @ 
@ @ @ . @ @ @ . @ . @ . @ . @ . . . . @ @ @ @ @ @ . @ . @ . @ . . @ @ . . . @ . . . . . . @ . @ . @ 
@ @ . @ . @ . @ . . . . . . @ @ @ . @ @ @ @ @ @ @ @ . . . . @ @ . @ . @ . @ . @ . @ @ . @ . . . @ @ 
@ . . . . . . . . @ . @ @ . . . @ @ @ @ @ @ @ @ @ @ @ . @ @ . . . . . . . . . @ . . . @ @ @ . @ @ @ 
@ @ @ @ @ @ @ @ @ @ @ @ @ @ @ @ @ @ @ @ @ @ @ @ @ @ @ @ @ @ @ @ @ @ @ @ @ @ @ @ @ @ @ @ @ @ @ @ @ @ 
3
20 45 3 7
42 9 41 30
25 41 42 6
