25 25
@ @ @ @ @ @ @ @ @ @ @ @ @ @ @ @ @ @ @ @ @ @ @ @ @ 
@ . @ . . @ @ @ @ @ @ . @ . . . . . @ @ @ @ @ @ @ 
@ . . . @ . @ @ @ @ . . . . @ . @ @ @ @ @ @ @ @ @ 
@ . @ . . . . . . . . @ . @ . @ @ . @ @ @ @ @ . @ 
@ @ @ @ @ . @ @ @ . @ . . . . . . . . @ @ @ @ . @ 
@ . @ . . @ . . . . @ @ . @ @ @ @ @ . @ @ . . . @ 
@ . . . @ . . @ @ . @ @ . . . . . . @ . . @ @ . @ 
@ @ . @ . @ . . . @ @ . . @ @ . @ . . @ . . . . @ 
@ . . . . . . @ . @ @ @ . . . @ @ . @ @ @ . @ . @ 
@ . @ @ . @ . . @ @ @ @ . @ . . . @ . @ . @ @ . @ 
@ @ . @ @ . . @ . @ @ @ @ . . @ @ . . . . . . . @ 
@ @ . . . @ . . . . @ @ @ . @ @ @ . @ @ . @ . @ @ 
@ . @ . @ @ . @ . @ @ @ . . @ @ @ . . . @ @ . . @ 
@ . . . . . . . @ . @ @ @ . . @ . . @ @ @ @ @ @ @ 
@ @ . @ . @ . @ . . . @ . . @ . @ . . @ . . . . @ 
@ . . . @ . . . . @ @ . @ . . . . . @ . @ @ . @ @ 
@ @ . @ @ @ . @ @ . . . . . @ . @ @ . . . . . . @ 
@ @ @ . . . . . . @ @ . @ . @ @ . @ . @ @ @ . @ @ 
@ @ @ @ . @ . @ . @ @ @ . . . . . . . @ . . . . @ 
@ @ @ @ . @ . . @ @ @ @ @ . @ . @ . @ . . @ . @ @ 
@ @ @ @ @ . . @ @ @ @ @ . . @ . . @ @ @ . @ . . @ 
@ @ @ @ @ @ . . @ . . . . @ . . @ @ @ @ @ . . @ @ 
@ @ @ @ @ @ . @ @ . @ @ . . @ @ @ @ @ @ @ @ . . @ 
@ @ @ @ @ @ @ @ @ @ . . . @ @ @ @ @ @ @ @ @ @ . @ 
@ @ @ @ @ @ @ @ @ @ @ @ @ @ @ @ @ @ @ @ @ @ @ @ @ 
3
11 4 2 5
13 17 9 1
20 22 4 13
