50 50
@ @ @ @ @ @ @ @ @ @ @ @ @ @ @ @ @ @ @ @ @ @ @ @ @ @ @ @ @ @ @ @ @ @ @ @ @ @ @ @ @ @ @ @ @ @ @ @ @ @ 
@ @ . @ @ @ . @ @ @ @ @ . . @ @ @ @ . @ . . . . @ @ @ @ . . @ . . @ . @ @ @ @ @ @ @ @ @ @ @ @ @ @ @ 
@ . . @ @ . . . @ @ @ . @ . @ . . . . . . @ . @ . @ @ . @ . . @ . . . @ @ @ @ @ @ @ @ @ @ @ @ @ @ @ 
@ @ . . . @ @ . . . . . @ . . @ . @ @ . @ @ @ . . @ . . . . @ @ . @ @ @ @ @ @ @ @ @ @ @ @ @ @ @ @ @ 
@ @ @ @ . @ . @ @ . @ . . . @ . . . . @ @ @ . @ . . @ . @ . . . . . @ @ @ @ @ @ @ @ @ @ @ @ @ @ @ @ 
@ @ @ . . . . @ @ @ . @ . @ @ @ . @ . @ @ . . . @ . @ . @ . @ . @ @ . @ @ @ @ @ @ @ @ @ @ @ @ @ @ @ 
@ @ . . @ @ . . . . . . . @ . . . . @ @ . @ @ . . . . @ . . @ @ . @ . . @ @ @ @ @ @ @ @ @ @ @ @ @ @ 
@ . @ @ . . @ . @ . @ @ . . . @ @ @ @ . . . . @ @ . @ @ @ . . @ . . . @ @ @ @ @ @ @ @ @ @ @ @ @ @ @ 
@ . @ . @ . @ @ . . @ . . @ . . . . @ . @ @ . @ . . @ @ . . @ . @ @ . @ @ @ @ @ @ @ @ @ @ @ @ @ @ @ 
@ . . . @ . @ @ . @ @ @ @ @ . @ . @ . @ . . . . @ . . . @ . . . . . . . @ @ @ @ @ @ @ @ @ @ @ @ @ @ 
@ . @ . . . . . @ @ @ @ @ . . . @ . . . @ . @ . @ . @ @ . . @ @ @ . @ @ @ @ @ @ @ @ @ @ @ @ @ @ @ @ 
@ @ . @ @ . @ @ @ @ @ @ . @ . @ . @ . @ . @ @ . . . . @ @ . . @ . @ @ . @ . @ @ @ @ @ @ @ @ @ @ @ @ 
@ . . @ @ . @ . @ @ . @ . . . . . . . . . . . . @ . @ . @ . @ @ . . . . . . @ @ @ @ @ @ @ @ @ @ @ @ 
@ @ . . . . . . . . . . . @ . @ . @ @ . @ @ . @ . . . . . . . . . @ @ . @ . . @ @ @ @ @ @ @ @ @ @ @ 
@ . . @ . @ . @ . @ . @ . . @ @ . . . @ . . . . @ @ . @ . @ . @ . @ . @ . @ @ . @ @ @ @ @ @ @ @ @ @ 
@ @ . . @ @ @ . . @ @ . . @ @ . @ @ . @ @ . @ . @ . @ . . . @ . . @ . . . . . . . @ @ @ @ @ @ @ @ @ 
@ @ @ . @ . . . @ . . . @ @ . . . . . . . @ @ . . . . @ . @ @ @ . . . @ . @ . @ @ @ @ @ @ @ @ @ @ @ 
@ @ @ . @ @ . @ . . @ . . @ . @ . @ . @ . . . @ @ . @ @ . @ . . . @ @ . . . @ @ @ @ @ @ @ @ @ @ @ @ 
@ @ . . @ . . @ . @ . . @ @ @ . @ @ @ . @ . @ @ . @ @ . @ . . @ . @ @ @ . @ . @ @ @ @ @ @ @ @ @ @ @ 
@ @ . @ @ @ @ . . @ @ . @ . . . @ @ . . @ @ @ . . . @ . . . @ . . @ @ @ . . . . @ @ @ @ @ @ @ @ @ @ 
@ . @ . . . . . @ . . . . @ @ . @ . @ . @ . . @ . @ . @ . @ . . @ . @ @ . @ . @ @ @ @ @ @ @ @ . @ @ 
@ . . . @ @ . @ . . @ @ @ . @ . . . . . . . @ . . . . . . @ @ . . . . . @ @ @ @ @ @ @ @ @ @ . . . @ 
@ @ . @ . @ . . @ @ . . . . . . @ . @ @ @ . . . @ . @ . @ . . . @ . @ . . @ . . . @ @ @ @ . @ @ . @ 
@ . @ . . . . @ . . @ . @ @ . @ . . . @ @ @ . @ . . @ @ . . @ . . @ . @ . . . @ @ . . . . . . . . @ 
@ . @ . @ @ @ @ . @ . . @ @ . @ @ . @ @ @ @ @ . . @ . . . @ . . @ @ . @ @ . @ . . . @ @ . @ . @ . @ 
@ . . . . @ @ . . . . @ . . @ . . . @ @ @ @ @ @ . @ . @ . @ @ . . . . . . @ . @ @ . @ . @ . . @ . @ 
@ . @ . @ . @ @ . @ . @ . @ . . @ . . @ @ @ @ @ @ . . . @ . . . @ . @ . @ . . . . . . . . @ @ @ @ @ 
@ @ . @ @ . . . . @ @ @ . . . @ . . @ . @ @ @ @ @ @ . @ . @ @ . . @ . . . . @ . @ . @ . @ @ . . . @ 
@ . . . . . @ . @ . . . . @ . @ @ . @ . . @ @ @ . . . @ . . . . @ @ @ . @ . @ @ . @ @ . @ @ @ @ . @ 
@ . @ . @ @ . . . @ . @ . @ @ . . . @ . @ @ @ @ @ . @ . . @ @ . . @ @ @ . . . @ . @ . @ @ @ . . . @ 
@ @ . . @ @ @ . @ . @ . . @ . . @ . . . . @ @ @ @ @ . . @ . . . @ @ @ @ @ @ . . . . . . @ @ . @ . @ 
@ . . @ . . . . . . . @ @ . . @ @ . @ @ @ . @ @ @ @ @ @ . . @ @ @ @ @ @ @ @ . @ . @ . @ @ . . @ . @ 
@ @ . @ @ . @ . @ . @ @ @ @ . @ @ . . @ @ . @ @ @ @ @ . @ . @ . @ @ @ @ . . . . @ . . @ . @ . @ @ @ 
@ @ @ . . . @ @ . @ @ @ @ @ @ . . . @ . . . . @ . @ . . . . . . . . . . @ @ . @ @ . @ @ . . . . @ @ 
@ @ . @ @ . @ @ . . @ @ @ @ . @ . @ . @ . @ . . . @ @ . @ . @ @ @ . @ . @ @ . @ @ @ . @ . @ @ @ @ @ 
@ . . . @ . . @ . @ . @ @ . . . . . . @ @ . @ @ . . . . . @ @ . . . . @ . . . . . . . . . . . @ @ @ 
@ @ . @ . @ . . . . . . @ @ . @ . @ @ . . . . . . @ @ @ . . @ @ . @ . . @ @ . @ @ . @ . @ . @ . @ @ 
@ . . . . . . @ . @ . @ @ . . . @ . . @ . @ @ @ . @ . . . @ . . . @ . @ @ @ @ . . . . @ @ . . . . @ 
@ @ . @ . @ . . @ . . @ . . @ . . @ . . . . . @ @ . . @ . . @ @ . @ @ @ @ @ . @ . @ . . . @ @ . @ @ 
@ @ @ @ @ . . @ . @ @ . @ . @ . @ @ . @ . @ @ . @ . @ . . @ @ . . . . . @ . . . . @ @ . @ . @ . @ @ 
@ @ @ @ . @ . @ . @ @ . @ @ @ @ . @ . . @ @ . . . . @ @ . . . @ @ . @ . @ @ @ @ . . @ . @ . @ @ @ @ 
@ @ @ . . . @ . . @ . . . . . . . . . @ @ @ @ . @ @ . . . @ @ . @ @ . @ . @ . @ . @ @ . . . . . @ @ 
@ @ @ . @ . @ . @ . . @ . @ . @ . @ . @ . . . . @ . . @ . . . . . . . @ . . . . . . @ . @ @ @ . . @ 
@ @ . @ @ . @ . . . @ . @ . . . @ . . . @ . @ . @ @ . . @ . @ . @ . @ . @ . @ @ . @ . . @ . . . @ @ 
@ @ . . . . . . @ . . . @ @ . @ @ @ . @ . @ @ @ . . . @ @ @ . . @ @ . . @ @ . . . @ @ . . @ @ . . @ 
@ @ . @ . @ @ @ . . @ . @ . @ . . . . . . @ @ @ . @ . @ @ @ @ . . . @ . . @ . @ . . @ . @ . @ . @ @ 
@ @ @ . . @ . . @ . . @ . . . @ . @ @ . @ . @ @ @ @ @ @ @ @ . . @ . . . @ @ @ . . @ @ . . . @ . @ @ 
@ @ @ @ . . . @ . . @ @ . @ @ @ . . @ . . . . @ @ @ @ @ @ @ @ . . @ . @ @ @ @ @ . . @ . @ . . @ @ @ 
@ @ @ @ @ . @ @ @ . . . . . . . @ . @ . @ . @ @ @ @ @ @ @ @ @ @ . . @ @ @ @ @ . . @ . . . @ @ @ @ @ 
@ @ @ @ @ @ @ @ @ @ @ @ @ @ @ @ @ @ @ @ @ @ @ @ @ @ @ @ @ @ @ @ @ @ @ @ @ @ @ @ @ @ @ @ @ @ @ @ @ @ 
3
20 1 31 10
46 47 20 28
47 32 39 5
