100 100
@ @ @ @ @ @ @ @ @ @ @ @ @ @ @ @ @ @ @ @ @ @ @ @ @ @ @ @ @ @ @ @ @ @ @ @ @ @ @ @ @ @ @ @ @ @ @ @ @ @ @ @ @ @ @ @ @ @ @ @ @ @ @ @ @ @ @ @ @ @ @ @ @ @ @ @ @ @ @ @ @ @ @ @ @ @ @ @ @ @ @ @ @ @ @ @ @ @ @ @ 
@ @ @ @ . . . . @ @ @ @ @ @ @ @ @ @ @ @ . . . . . @ . . @ @ @ . . @ . . . . @ @ @ @ @ @ @ @ @ @ @ @ @ @ @ @ @ @ @ @ @ @ @ @ @ @ . . . . . @ . . . . . . @ @ . . . . . @ @ . @ @ @ @ @ . @ @ . . . . . @ 
@ @ @ @ @ @ @ . . @ @ @ @ @ @ @ @ @ @ . . @ . @ @ . @ . . @ . . @ . @ @ . @ . @ @ @ @ @ @ @ @ @ @ @ @ @ @ @ @ @ @ @ @ @ @ @ @ @ @ . @ @ . . . @ . @ @ . . . @ @ . @ @ . . . @ @ @ @ @ . . @ . @ @ . @ @ 
@ @ @ @ . @ . . @ . @ @ @ @ @ @ @ @ @ . @ . . . . . @ . @ . @ . . . . . . . . @ @ @ . @ @ @ @ @ @ @ @ @ @ @ @ @ @ @ @ @ @ @ @ @ @ @ @ . @ . @ @ @ . . @ @ . . . . . . @ @ . . . @ @ . . @ @ @ . . . . @ 
@ . @ . . . @ . . . . . . @ @ . @ @ . @ . @ . @ @ . . . . . . . @ @ @ @ . @ . @ . @ . @ @ @ @ @ @ @ @ @ @ @ @ @ @ @ @ @ @ @ @ @ . @ . . . . . @ . @ . @ . @ . @ . @ @ @ @ . @ . . @ @ . . @ . @ @ . @ @ 
@ . . @ . @ . @ @ @ . @ @ . . . @ . . . . @ . @ . . @ @ . @ . @ . @ . . . . @ . . . . @ @ @ @ @ @ @ @ . @ @ @ @ @ @ @ @ @ @ @ @ . . @ . @ . @ . . . . . . @ @ . . @ @ . . @ . . @ . . . @ . . . . . @ @ 
@ @ . . . . . . . . . @ . @ @ . . . @ . @ @ @ @ @ . @ . @ . . @ . . @ @ . @ @ . @ . @ @ @ @ @ @ @ @ @ . . . @ @ @ @ @ . @ @ @ . . @ @ . . @ . @ . @ . @ . @ . @ . . . . @ @ . @ . . @ . . . @ . @ @ . @ 
@ @ @ @ . @ @ @ . @ . . . . . @ . @ . . @ @ . @ @ @ . . . . @ @ @ . @ . . . @ . . @ @ @ @ @ @ @ @ @ @ . @ . . . @ . @ . @ . @ . @ . @ . @ . . . @ . . @ . . . . @ . @ . @ . . . @ @ . . @ . @ @ @ @ . @ 
@ @ @ . . . @ @ @ . @ . @ @ . . . . @ @ @ . . . @ @ @ . @ @ . @ . . . @ . @ . . @ . @ @ @ @ @ . @ @ . . @ . @ . @ . . . @ . . . . . . @ . @ . @ @ @ @ . @ @ @ . . . . @ . @ . @ . . @ . @ . . . @ . . @ 
@ . . @ . @ @ @ . . . @ . . . @ . @ . @ . @ . @ . @ @ @ . @ . . @ @ . . . . @ . . . . @ . @ @ . @ . @ . @ . . @ . . @ @ . . @ @ . @ @ . . . . . . . . . . . @ @ @ @ . @ . . . . @ . . . . @ @ @ . @ . @ 
@ . @ @ @ . @ @ @ . @ @ @ @ @ . . . . . . . . . . . @ . . . . @ . . @ . @ . @ . @ . @ . . @ @ . . . . . @ . @ . @ . . @ . @ . @ @ . . @ @ . @ @ @ . @ @ . @ . @ . . . . @ @ . @ @ @ @ . @ . . . . . . @ 
@ . . @ . . . @ . . . @ . . @ @ . @ . @ . @ . @ . @ . @ @ @ . . @ . . @ . . @ . . @ @ @ . @ . @ @ . @ @ . @ @ . . . @ @ . . . . . . @ . @ . . . @ @ @ . . . . . @ @ . @ @ @ . . @ . @ . . @ @ . @ @ @ @ 
@ . @ . @ @ . . @ @ . @ . @ . @ . @ @ @ @ . . . @ . . . @ . @ . . . @ @ . @ . @ . . @ . . @ . . . . . @ . @ . @ @ . . @ . @ . @ @ @ . . . @ @ . . . . @ . @ @ . . . . . @ . @ . @ . . . @ . . . . . . @ 
@ . . . . . . @ @ . . . . . . @ . . . @ . @ . @ . @ @ . . . . @ @ . . . . @ . . . @ . @ . . @ . @ . @ . . . . @ @ @ . . . . @ @ . . . @ @ . @ . @ @ . . @ . . @ . @ . @ . . @ . . . @ @ . @ . @ @ @ . @ 
@ . @ . @ @ . . . . @ @ . @ @ @ @ @ @ . . . . . . . . . @ @ . @ . @ . @ @ . @ . @ . . @ @ . . @ . . . . @ . @ @ @ . . @ @ @ . @ @ . @ . @ . @ @ @ @ @ @ . . @ . @ . . @ @ . . @ @ . . . . . . . . @ @ @ 
@ @ . . . . @ @ . @ . . . . . @ . . . @ @ @ @ @ @ . @ . @ . . . . . . . @ . . . . . @ @ . @ . . @ . @ @ . @ . @ . @ . . . . . . . . . . . . . . @ . @ . @ . . . . @ . . . . @ @ @ . @ . @ . @ . @ @ @ @ 
@ . @ . @ . . @ @ . @ @ . @ @ . @ . @ . . . . . . @ @ @ . @ . @ . @ . @ . @ . @ @ @ . @ . @ . @ . . @ . . @ . . . . . @ . @ . @ . @ @ . @ . @ @ @ . . . . . @ @ @ . @ @ @ . @ . @ . . @ @ @ @ @ @ @ @ @ 
@ . . . . @ . @ . . . . . . . . . . . . @ @ . @ . . @ . . . . . @ . . . . @ . . . . . . . . . @ @ . . @ . @ @ . @ @ . . @ . . . @ @ . . . @ @ @ . . @ . @ . . @ . . . @ . . . . @ . @ . @ @ @ @ @ @ @ @ 
@ . @ . @ . . @ . @ . @ @ . @ . @ @ @ . . . @ . . @ @ @ @ @ . @ . @ . @ . . @ @ . @ . @ . @ . @ . . @ @ . @ . @ . @ . @ . @ . @ @ @ @ @ @ @ @ . @ . . @ @ @ @ . @ . @ . @ . @ . @ . @ . @ @ @ @ @ @ @ @ 
@ @ @ @ . . @ . @ . @ . . . @ @ . . . . @ . . @ . . @ . . @ @ . . . . @ . @ . @ @ . . . @ @ @ . @ . . . . . . . . . . . . . @ @ @ @ @ . @ @ @ . . . @ . @ @ . . . . . . . @ . . @ . . . . @ @ @ @ @ @ @ 
@ . @ . @ . . . @ . . . @ . @ . @ @ . @ . @ @ . @ . . . @ . . @ @ @ . . @ . . . . @ . @ . @ . . @ . @ . @ . @ @ . @ . @ @ . . @ @ @ . . . @ . . @ . @ . @ @ @ . @ . @ . @ . @ . . . @ . @ @ @ @ @ . @ @ 
@ . . . . . @ . . @ . @ . . . . @ @ @ . . . . . . @ @ . . @ . @ . . . @ . @ . @ @ . . . . . . @ . . . @ @ @ . @ . . @ @ @ . @ . @ . @ . @ . @ . . @ . . . @ @ @ . . . @ @ . . @ . @ . @ @ @ @ . . . . @ 
@ . @ . @ . @ . @ @ @ @ @ . @ . . . . @ . @ . @ . @ . @ . @ . @ . @ . . . . . @ . @ . @ . @ . @ @ . @ . . @ . @ . @ . @ @ @ . . . . . . . . . . @ . . @ . . @ @ . @ @ . . @ . . . . . . @ . @ . @ @ . @ 
@ . @ @ . . . @ . @ . @ @ @ @ @ . @ @ . @ . @ . . . . . . . . . . . @ . @ @ . @ . . . . @ @ @ . . . . @ . @ . . @ . . . . . @ @ . @ @ . @ . @ . . @ . @ . @ . @ . . @ . @ @ . @ @ @ . @ . . . . @ . . @ 
@ @ . . . @ . . . . . . @ . @ . . @ . . . . . . @ @ . @ @ . @ @ . @ . . @ . . . . @ @ @ . . . . @ . @ @ . . . @ . . @ . @ . @ @ @ . . . . @ . @ . . @ @ . . . . . @ . . . @ . . @ @ . . @ . @ . . @ . @ 
@ @ @ @ . . @ @ @ . @ . @ . . @ @ @ . @ @ . @ @ . . @ @ @ @ @ @ @ . . @ . @ @ . @ . . . . @ . @ @ . . . @ . @ . @ . @ . . @ . @ . . @ . @ . . @ . @ . . . @ @ . @ @ . @ @ @ . @ . . @ . . @ @ @ . @ @ @ 
@ . @ @ . @ . @ . . @ . @ . @ . . @ @ . . . @ . @ . . . @ . . . . . @ . . @ @ . @ @ . @ @ @ @ . . . @ . . . . . . . . @ . . . @ @ @ @ . . . @ . . . @ @ . . @ . @ . . @ . . . @ . @ . . @ . @ @ . @ @ @ 
@ . . . @ . . . @ . @ @ . . . @ . . @ @ . @ . . @ . @ . . @ . @ @ @ . @ . . @ . . @ . . . @ @ @ @ . . @ . @ @ . @ . @ @ . @ @ . . . . . @ @ . @ . @ . . . @ . @ @ @ . @ . @ . . . . @ @ . . . @ . . @ @ 
@ . @ @ . @ @ . . @ @ @ @ . @ . . @ @ @ @ . . @ . . @ . @ @ @ @ . . . @ . @ . @ . . @ . @ . @ . @ . @ @ . . @ @ @ . . @ @ . @ @ @ . @ . @ . . . . . @ . @ . . @ @ @ . . @ . . @ . @ . @ . @ @ . . @ @ @ 
@ . @ . . @ @ . @ @ @ @ @ . . @ . . . @ . . @ . @ . . @ @ @ @ @ @ @ . . . . . . . @ . . . . . . @ . . @ . @ @ . . . @ . @ . . . @ @ @ @ @ @ . @ . @ @ . . . @ @ @ . @ . @ . @ . @ @ . . . . . . @ @ @ @ 
@ . . @ . . . . . @ @ @ . @ . . . @ @ . @ . . . . . @ . . @ . @ . @ . @ . @ . @ . . . @ @ @ @ @ @ @ @ . . @ @ . @ . . . . . @ . @ @ . @ @ @ @ . . . @ . @ . @ @ . . . . . . . . . . . @ . @ . @ @ @ @ @ 
@ . @ . @ . @ @ . . @ . . @ . @ @ . . . @ @ . @ @ . . . @ . . . . . @ . . . @ . @ @ . . @ . . . @ . @ @ . . . @ @ @ . @ . @ . @ @ . . . @ @ . @ @ . @ . . @ @ . . @ . @ @ @ . @ @ . @ . @ @ . . @ @ @ @ 
@ . . . @ @ . . . @ . @ . . . . . @ @ . . . . . @ . @ . . @ . @ @ @ . . @ @ . . . @ . @ @ . @ @ @ . . @ . @ . . . . @ @ . . . @ . @ . @ @ . . . . . @ . @ . . @ . @ @ @ @ . @ @ @ . . . . @ @ @ @ @ @ @ 
@ . @ . . . @ . @ @ . . . @ . @ @ @ @ @ . @ . @ . . . @ @ . . . . @ @ @ @ . @ . @ . . . @ . . . @ . @ . @ @ @ @ . @ @ . . @ @ . . . . . @ . @ . @ . @ . . @ . . . @ @ @ . . @ @ @ . @ . @ @ @ @ @ @ @ @ 
@ . . @ . @ . . @ . @ @ . . @ @ @ @ @ . . . @ . . @ . @ . @ . @ . . @ . @ . . . . @ . @ @ @ . @ . . . . @ @ . @ @ @ . @ @ @ @ @ . @ . @ . @ @ . @ . . . @ @ . @ @ . @ . . @ @ @ . . @ @ . @ . @ @ @ @ @ 
@ @ . . @ . . @ . . @ . @ . @ @ @ @ . @ . @ . @ . @ @ . . . @ . . @ . . @ @ @ . @ . . . @ . . . . @ . @ . . . . . . . @ @ . @ . . @ @ . . . @ @ . @ . @ . @ . . . . . @ . . @ @ . @ . . . . . . @ @ @ @ 
@ @ . @ . @ . . . @ . . . . . @ . @ . @ @ . . . . @ . @ . @ . @ . . @ . @ @ . . . @ . @ . @ . @ @ . @ @ @ . @ . @ . @ . . . . . @ . @ @ . @ . @ . . . . . . . @ @ . @ @ . @ . . @ . . @ . @ . @ . @ @ @ 
@ . . . . @ . @ . @ . @ @ . @ . . . . . @ @ . @ . @ . . . . . . . @ . . . . @ . @ . . . . . . . . . . @ . @ . @ . . @ @ @ . @ . . . . @ . . . @ . @ @ . @ @ . @ . . @ @ . . @ . @ . @ . @ . . . . . . @ 
@ . @ @ . . . . @ . . @ @ . @ . @ . @ . @ @ @ . . . @ @ . @ . @ . @ @ @ @ . . . . . @ . @ . @ . @ @ @ . . . . . . @ . . @ . @ . @ @ . @ . @ @ . . @ . . . @ @ . @ @ . . . @ . . @ @ . . . @ . @ @ @ . @ 
@ @ . @ @ @ . @ . . @ @ . . . @ @ @ . . @ . . . @ . . . @ . @ . . . . . . @ @ . @ . @ . @ @ @ . . @ @ @ @ @ . @ . . @ . . @ . . @ . @ @ . @ . @ @ @ @ . @ . @ . . @ @ @ . @ . @ . @ @ . @ . . . @ @ . @ 
@ . . . @ . . . @ . @ . @ . @ @ @ . @ . @ @ @ . . @ . @ @ . . @ @ . @ . @ @ @ @ @ . @ . . . . @ @ @ @ . . @ @ @ @ . @ . @ . @ . . . . . . . . . . . . . . . . @ . . . . . . . . . . . . . . @ . @ . . @ 
@ . @ . . @ . @ . @ . . @ . @ @ . . . . @ @ . . @ . @ . . @ . @ @ @ . . . @ @ . @ . . @ @ @ . . @ @ . . @ . @ @ . . @ . @ . . . @ . @ . @ @ . @ . @ . @ @ @ @ . . @ . @ . @ . @ . @ . @ . @ @ @ . @ . @ 
@ . @ . @ @ . . . @ @ . . . @ . . @ @ . . . @ . . . . @ . . . . @ . @ . @ . @ . @ @ . . @ . @ . @ . @ . @ . @ . @ . . . @ . @ . . @ . . @ . @ @ @ @ @ . @ . @ . @ . @ @ . . @ . @ . @ @ @ @ @ @ . . . @ 
@ @ . . . @ . @ @ . . @ @ . . @ . @ @ . @ . . . @ . @ . @ @ . @ . . . . . . . . @ . . @ . . . @ . . . . . . . . . . @ @ . . . @ @ @ @ @ . . . . @ @ . . . . . . . . . @ @ . . . @ . . . @ @ @ @ @ @ . @ 
@ . @ . @ @ . . . . @ . . . @ @ . . @ @ @ . @ . . @ . . . . . . @ . @ . @ . @ . . @ . . . @ . . @ . @ . @ . @ . @ . . . @ . @ . @ @ . . . @ @ @ . @ @ . @ . @ . @ . @ . @ . @ @ . . @ @ @ @ @ @ . @ . @ 
@ . . . . . @ @ @ . . @ . @ . . @ @ . @ . @ . . @ . @ . @ . @ @ . . . @ @ @ . @ . @ . @ @ . @ . @ @ . @ . . @ . @ . @ . . . @ . . @ . @ . . . @ . @ @ @ @ . @ . @ . @ . @ @ . . @ . . . @ . @ . . . . @ 
@ . @ . @ . @ @ . . @ @ . . . @ @ . . . . @ @ . . . . . @ . @ . @ . @ . @ . . . . . . @ . . . @ @ . . . @ @ . . . @ . @ @ . @ . @ . @ @ @ @ . @ . @ . . . . . @ . @ . . @ . @ . @ . @ . . . . @ . @ . @ 
@ @ . . . @ @ . @ . . @ . @ @ . @ @ . @ . . . . @ . @ @ . @ . . . . @ . . @ @ . @ . @ . @ . @ @ . @ . @ . @ @ @ @ . . . . . @ . . . @ @ . @ . . . @ . @ @ @ . @ . @ @ . . . . . . @ . . @ . @ @ @ . . @ 
@ . . @ . @ . . . . @ @ . . . . . @ @ . . @ @ . @ . @ @ . @ @ . @ . . . @ . . @ . . @ . . . . @ . . . . . . . @ . @ @ . @ . @ . @ . @ @ . @ . @ . . . . @ @ @ . . . @ . @ . @ . @ @ @ . . @ @ @ @ @ . @ 
@ @ . . @ @ @ . @ . @ . @ . @ . @ . . . @ . @ . . @ . . . @ . . @ @ . @ @ . @ @ @ . @ . @ . @ @ @ @ . @ . @ . @ . @ @ . @ . @ . . @ . @ . . . @ . @ @ @ . @ @ @ . @ @ . . @ . @ @ @ @ . @ . @ @ . @ @ @ 
@ . . @ @ @ @ @ . . @ . @ @ . . . @ . @ . . @ . @ . @ @ . @ @ . @ @ . @ . . @ . . . . . @ @ @ @ @ . . @ @ @ @ . . @ . @ @ . . @ . . . . @ . @ . @ @ @ . . . . @ . @ . . @ @ . . @ . . . . . . . . . . @ 
@ @ . . @ @ . @ . @ . . @ . @ . @ . @ . @ . @ . . . . @ . . . @ @ . @ . @ . . @ . @ . @ @ . @ @ . @ . @ @ @ @ @ . . . @ . @ . @ . @ @ . . . . . . @ . . @ . @ . . @ . @ @ . @ . . . @ . @ . @ @ @ . @ @ 
@ @ . @ . . . . . . . @ . . . . . . . . . . . @ . @ . . . @ @ @ @ . . . . . @ . . . @ @ . . . . . . . . . @ @ . . @ @ . . . . @ . . @ . @ . @ . @ . . @ @ @ . @ . @ . @ @ . . @ . @ . . . @ . . . . @ @ 
@ . . . @ @ . @ . @ . . @ . @ . @ . @ . @ . @ . @ . @ . @ . @ @ @ @ @ . @ . . @ . @ . @ . @ . @ @ . @ . @ . . @ . @ @ @ . @ . @ . @ @ @ . . @ @ @ @ . . @ . . @ . @ . . . @ . . . . @ . @ @ @ . @ @ @ @ 
@ @ . @ @ @ @ . . . @ . @ . . @ @ @ @ @ . . . . . . @ . . . . @ @ @ @ . @ . @ . . . . . . . @ . . . . @ . . @ . . . @ . @ . . @ . . @ @ @ . . . @ @ . @ . @ . @ . . . @ @ . @ @ @ . . @ @ @ @ @ @ @ @ @ 
@ . . . . @ . @ . @ @ @ . . @ @ @ @ @ . @ . @ . @ . @ . @ @ @ @ @ @ @ @ . . . @ @ . @ . @ . . @ @ . @ . . @ . @ . @ . . . @ . @ . @ . . @ @ . @ . . . . . . . @ @ . @ . @ . . @ . . @ @ @ @ @ @ @ @ @ @ 
@ @ . @ @ . . . . . @ @ . @ @ . @ @ . . . @ @ @ . . @ . . @ . @ @ @ @ . @ . @ . @ . @ . @ . @ . @ @ @ @ . . . . . . @ @ . . . @ . . . @ @ @ @ @ @ @ . @ . @ @ . . . . . . . @ @ @ . . @ @ @ @ @ @ @ @ @ 
@ . . . . @ . @ @ @ . @ @ @ @ . @ . @ . @ . @ . @ . @ . @ . . . @ @ @ . . . @ . @ @ . . @ . . . . @ @ . @ . @ . @ . @ . @ @ . . . @ @ . @ @ . . . . . . @ . . . @ . @ . @ . . @ @ . @ @ @ @ @ @ @ @ @ @ 
@ @ @ @ . . . . . . . . @ . . . . . . . . . . . . . . . @ @ . @ @ @ @ @ @ . . . . . @ @ . . @ . @ @ . . . @ @ @ . . . . @ . @ . @ . @ . . . @ . @ . @ . . @ . @ . . . @ . . @ . . . . . @ @ @ @ @ @ @ @ 
@ . . . . @ . @ @ . @ @ . @ @ @ . @ @ . @ . @ . @ @ . @ . . . . @ @ @ @ . . @ @ @ @ @ @ @ . . @ @ @ @ . @ . @ . @ . @ . . . . . @ . . . @ . @ @ @ @ . @ . . @ . . @ @ . . @ @ @ . @ . @ @ @ @ @ @ @ @ @ 
@ @ . @ . @ . @ . @ @ @ . . @ @ @ . @ . . @ . @ . . . . . @ @ @ . @ @ @ @ . . @ . @ @ @ . . @ . . @ . . . . @ . . @ @ @ @ . @ . . . @ @ @ @ . @ @ @ . . . @ . @ . . . @ @ . @ . . @ . . @ @ @ @ . @ . @ 
@ @ @ @ @ @ . @ . @ @ . @ . . @ . . . @ . @ . . . @ . @ . . . @ . . @ @ . . @ . . . @ . @ . @ . @ @ @ . @ . @ . @ . @ @ @ @ . . @ @ . . @ . . @ @ . @ @ . . . . . @ . @ . . . @ . . @ . @ . @ . . @ . @ 
@ @ @ @ @ . . . . . . . . . @ . @ . @ . @ . @ . @ . @ . @ . @ . @ . . @ @ . . @ . @ . . @ . @ . . @ . . . @ . . . . @ @ @ @ . @ . @ . @ . @ . . . . . . . @ . @ . . @ . @ . @ . . @ . @ @ . @ @ . @ . @ 
@ @ @ @ . . @ @ @ . @ . @ . . . . . . . . . @ @ . . . . . . . . . . @ @ @ @ . . . . @ . . . @ . @ @ @ . @ @ @ . @ . . @ @ @ . . . . . . . . . @ @ @ @ @ @ @ @ @ @ @ . . . . . @ . . . @ . . . . . . . @ 
@ @ @ . @ @ . @ @ . @ @ . @ @ . @ . @ @ @ . @ . . @ . @ . @ @ . @ . . . . . @ . @ . . @ @ . @ . . @ . . . @ @ @ . . @ . @ . . @ . @ . @ . @ . . . . . . . @ @ @ . . . @ . @ @ @ . @ . @ . @ @ @ . @ @ @ 
@ . . . . . . . . @ . @ . . @ . . @ @ . . . . @ . . @ . . . . @ . . @ . @ . @ @ . . @ @ @ . @ . @ @ @ . @ . @ . @ . . . . @ . . @ . . @ . . @ . @ . @ . @ . @ . @ . @ . @ @ @ . . . @ . . . @ . . @ @ @ 
@ . @ . @ @ . @ @ . . @ . @ @ @ @ . . @ . @ . . . @ @ @ . @ @ @ @ . . @ . @ @ . @ . . @ . . @ . . . @ . . . @ . @ . @ @ @ @ . @ . @ . . @ . @ . . @ . @ . . @ . . . @ . @ @ . @ . @ . @ . @ . @ . . @ @ 
@ @ . . . @ @ @ @ @ . . . . . @ . @ . . @ . @ @ . . @ @ @ @ @ @ @ @ . . . . @ . . . @ . . @ . . @ @ . . @ @ @ . . . . . @ . . @ . . . @ @ . . @ . . . . @ . . . @ @ @ . @ . . . . . . . . . . . @ @ . @ 
@ . @ . @ . . . @ . . @ . @ . . . . . @ . . . . . @ . @ @ @ @ @ @ . . @ . @ @ . @ . . @ . . @ . . . @ . . @ . @ @ . @ @ . @ . @ @ . @ . @ @ @ . . @ . @ . . @ @ @ @ . . . . @ . @ @ @ . @ @ @ . . @ . @ 
@ . . . . @ . @ . @ @ @ @ @ @ @ . @ . . @ @ . @ . @ . . @ @ @ @ . @ @ @ @ . @ @ . @ . . . @ . @ . @ @ @ . @ . . @ . . . . . . . . @ . . . . . @ @ . @ . @ . . . @ . . @ . @ . @ @ @ @ @ @ . @ . @ @ . @ 
@ @ @ @ . . . . . @ @ @ . . . @ @ . @ . . @ @ . . @ . @ . @ @ . . . @ @ . . . . . @ . @ . @ . @ . @ @ . . . . @ . . @ . @ . @ @ @ . @ . @ . @ @ @ . . . . . @ @ @ . @ . @ @ . @ @ @ @ @ . . . . . @ . @ 
@ . . . . @ . @ . . @ . @ @ . @ . . . . @ . . @ . @ . . . . . @ . @ . . . @ . @ . . @ . . . . @ . . . @ . @ . . . @ @ @ . @ . . . . . . @ @ @ @ @ @ @ . @ . . . . . . . . . . . . . @ . @ . @ . @ . . @ 
@ @ @ @ . . @ @ . @ @ . . . . . @ . @ . . . @ @ . . . @ . @ . @ . . . @ @ . . @ . @ . @ @ . @ . . @ @ . @ . . @ . . @ . . . @ . @ . @ @ . @ @ @ @ . . @ @ @ . @ . @ @ . @ . @ . @ @ . . . @ . @ . @ . @ 
@ @ . @ @ . @ . . @ @ @ . @ @ . @ @ @ . @ . @ . @ . @ @ . . @ @ @ . @ @ . @ . @ . . . . . . . @ . . . . . @ . @ @ @ . @ . @ . . . @ @ . . @ . @ . . @ . @ . . @ @ . . @ @ @ @ @ . @ . @ @ . . . . . . @ 
@ . . @ @ @ . @ . . @ @ @ @ . . . . @ . . @ . . . . . . @ . . . . @ . . . . . . @ . @ . @ . @ . @ @ @ . @ @ . . . @ . @ . . . @ . . . @ . @ . @ . @ @ . . @ . @ @ @ . . @ . @ . . . . . . . @ @ . @ . @ 
@ @ . . @ . . . . @ @ @ @ . @ . @ @ . . @ . @ @ . @ . @ . . @ . @ @ @ . @ @ . @ @ @ @ @ . . . . . @ . . . . . @ @ @ . @ . @ @ . @ @ . @ . @ . . . . . . @ . . . @ . . @ @ . @ . @ . @ . @ @ . . . . @ @ 
@ . . @ @ @ @ @ . @ . @ . . . . @ . @ . @ . @ @ . @ . @ @ . . @ @ @ @ @ . @ @ @ @ . @ . @ . @ . @ . @ @ . @ . . . . . . . . @ . . . @ . . . . @ . @ @ @ . . @ @ . @ . . . . . @ . . . @ @ @ @ @ . @ @ @ 
@ @ . . @ @ @ . . . . . . @ @ . . . . . . . . @ @ . . . @ . @ . @ @ @ . . . . @ . . . . . . . @ @ . . @ . . @ . @ @ @ . @ @ . . @ @ . @ @ . @ . @ . @ . . @ @ @ . . . @ . @ @ . @ . @ @ @ @ . . @ . . @ 
@ . . @ . @ . @ @ . @ . @ . . . @ . @ . @ . @ @ . @ . @ . @ . . . @ . @ . @ . @ . @ . @ . @ . . @ @ . . . @ . @ @ @ . @ . @ . @ . @ . @ . . . . . . . @ . . . @ . @ @ . @ @ @ . . . . @ @ . @ . . . @ @ 
@ @ . . . . . . . . @ @ @ @ . @ . . . @ . . . . . . . . . . @ @ . . . . @ . . . @ . . . @ . . @ . @ . @ @ . . . @ . . . . . . . . . . . @ . @ . @ @ @ . . @ @ . . @ . . . @ . . @ . @ @ . . . @ @ . . @ 
@ @ . @ . @ . @ @ . . . . . @ @ @ . @ @ @ . @ . @ @ @ . @ . @ . @ @ . @ . @ . @ . . @ @ . @ . . . . . . . . @ . . . @ . @ . @ . @ . @ . @ . . @ . . @ . @ . @ . @ . @ . @ . @ . @ . @ @ . @ . . @ . @ @ 
@ . . @ @ . . @ @ . @ @ . @ . @ @ @ @ @ . . . @ . @ @ @ . . . . . . . . . . . . @ @ @ . . @ @ @ @ @ . @ . @ . . @ . @ @ @ . . @ . . @ @ . . @ . @ . . . . . . . . . . . . . . . . @ . . @ . . @ . . @ @ 
@ . @ . . . @ @ @ . . . @ . . . @ . @ @ @ . @ @ . @ @ . @ @ @ . @ . @ @ . @ . @ . @ @ @ . . . . . @ . . @ . . @ @ . @ . @ @ . . @ . @ @ @ . @ . . . @ . @ . @ . @ . @ . @ . @ @ . @ . @ . @ . @ . @ . @ 
@ @ . @ . @ . @ @ . @ @ . . @ @ . . . @ @ @ @ . . . . . @ . @ . . @ @ @ @ . . . . @ @ . . @ @ . @ . . @ . @ . @ @ @ . . . . @ @ . @ . @ . . @ . @ . @ . . @ @ . . @ . . . @ . . . . . . . . . . . . . @ 
@ . . . . @ . . . . @ . . @ . @ @ . @ . @ . @ . @ . @ . . . . @ @ . @ @ . @ . @ . . . @ . . @ @ @ @ . . . . @ . @ . @ . @ @ . @ . . . . @ . . @ . . . @ . . . @ . . @ . @ @ @ . @ . @ . @ . @ @ . @ . @ 
@ @ . @ . @ @ . @ @ . . @ . . . . . . . . . . . @ . . @ . @ . . . . . . . . . @ . @ . . @ . . . @ . . @ @ @ . . . . . . . . . . . @ . @ . . @ . @ . @ @ @ . @ @ . @ . . . @ . . . @ . . . @ . . . . @ @ 
@ . . . @ . @ . . . @ . @ @ . @ . @ . @ . @ . @ . . @ @ @ @ @ @ . @ @ . @ . @ . @ . @ . . @ @ . . @ . . . @ @ . @ . @ . @ . @ . @ . @ . . @ . . . . . @ @ . @ @ . . @ . @ @ @ @ . . @ . @ @ @ @ . @ . @ 
@ @ . @ . . @ @ . @ . . . . @ . . @ . @ @ . . @ . @ . @ . @ . . . @ . . . @ . . . . . @ . @ . @ . @ . @ @ . . . . @ . . @ @ @ . . . @ @ . . @ . @ @ @ . @ . . . @ @ . . @ @ @ @ . @ @ @ . . . . . @ . @ 
@ . @ . . @ . @ @ . @ . @ @ . . @ @ @ . . . @ . . @ . @ . @ @ @ . . @ . @ @ @ . @ @ . . . . . . . . . . . . @ . @ . @ . @ @ @ @ . @ . . . @ . . . @ . . . . @ @ . . @ . . @ . @ @ @ @ @ . @ . @ . . . @ 
@ . @ @ . . . . . . . . @ . @ . @ @ . @ . @ . @ . @ . . . . . . @ @ @ . . @ . . . @ @ . @ . @ . @ . @ . @ . @ . . . . @ . @ @ . @ . @ . @ . @ . @ . . @ @ . @ @ . @ . @ . . . . . @ . . @ @ @ . . @ . @ 
@ . . . . @ . @ @ . @ . . . . . . @ . @ @ . . @ @ . . @ . @ @ @ @ . . . @ @ @ . @ @ @ . @ @ . . . @ @ . . @ . . @ . @ . . . . . . . @ . @ . @ . . @ . @ @ @ @ @ . . . . . @ @ . @ @ @ . @ @ @ @ . . @ @ 
@ @ . @ . . @ . . . @ . @ . @ . @ @ . @ @ @ . @ . @ @ @ . @ . . . . @ . . . @ . . @ . @ . . . @ @ @ @ @ . . @ @ . . @ . @ @ . @ @ . . . . . . . @ . . @ @ @ @ @ @ . @ @ . . @ . @ @ . . . @ @ @ @ . @ @ 
@ @ @ @ @ . @ . @ . . @ . . @ @ . @ . . @ . . . . . . . . . . @ @ . . @ @ @ . . @ @ . . . @ . . . . @ . @ . . . @ . . . . @ . . . @ . @ . @ . @ . @ @ @ @ @ @ @ . @ . . . @ @ . . . @ . @ . @ @ @ . @ @ 
@ @ . . . @ @ @ . @ @ . @ @ @ @ . . . @ . @ . @ . @ . @ . @ . @ @ . @ @ @ . . @ . . @ @ @ . . @ . @ . . . . @ @ . . @ . @ @ . @ . @ . . @ @ . @ . . @ @ @ @ @ . . . . @ . . . @ @ . . . . . @ @ . . @ @ 
@ . @ @ . . . . . . . . . . . . . @ @ . . . . @ @ @ @ . . . @ . . . . @ . @ . @ . @ . @ @ @ @ . . @ . @ . @ @ . . @ . . @ @ . . @ @ . @ @ . . . . @ @ @ @ @ . @ . @ . @ . @ . . . @ . @ . @ . . . @ @ @ 
@ . . . . @ . @ . @ . @ @ @ @ @ . . . . @ . @ . @ @ . @ . @ . @ . @ @ . . . . . . . . . . . . @ . . @ . . . . @ . @ @ @ . @ . @ @ @ @ . @ @ @ . @ @ @ @ @ @ . @ . . @ . . @ . @ @ @ @ @ @ @ @ . @ . @ @ 
@ @ . @ @ . @ . @ @ @ @ . . . . . @ . @ . . . . . . . . @ . . . . . @ @ @ @ . @ @ . @ . @ . @ @ . @ . @ . @ @ . . @ . @ . @ @ . @ . @ . . . . @ @ @ @ @ @ . . . @ @ . @ . @ . @ @ @ @ @ @ @ @ . . . . @ 
@ @ @ @ @ . . . . . . . . @ . @ @ @ @ @ @ . @ . @ . @ . . @ . @ . @ @ @ @ . . @ @ . @ . . @ @ @ @ . . . . @ @ @ . . . . . . . . . . . . @ . @ @ @ @ @ @ . @ . @ . . . . . . @ @ @ @ @ @ @ @ @ @ . @ . @ 
@ @ @ @ @ @ . @ . @ . @ @ . . @ @ @ @ @ @ @ @ . @ . . @ . @ @ . . @ @ @ @ @ . . . @ . . @ @ @ . . . @ . @ @ @ @ @ . @ . @ . @ . @ . @ . . @ @ @ @ @ @ . . . . . . @ @ @ . @ @ @ @ @ @ @ @ @ @ . . . @ @ 
@ @ @ @ @ @ @ @ @ @ @ @ @ @ @ @ @ @ @ @ @ @ @ @ @ @ @ @ @ @ @ @ @ @ @ @ @ @ @ @ @ @ @ @ @ @ @ @ @ @ @ @ @ @ @ @ @ @ @ @ @ @ @ @ @ @ @ @ @ @ @ @ @ @ @ @ @ @ @ @ @ @ @ @ @ @ @ @ @ @ @ @ @ @ @ @ @ @ @ @ 
3
44 17 10 24
12 26 43 60
32 52 51 40
