12 12
@ @ @ @ @ @ @ @ @ @ @ @ 
@ . . . @ @ @ @ @ @ @ @ 
@ @ . @ @ . @ @ @ @ @ @ 
@ . . . . . . . @ @ @ @ 
@ @ @ . @ . @ . . . . @ 
@ . . . . @ . . @ . @ @ 
@ . @ . @ @ @ . . @ @ @ 
@ @ . . . . . @ . . . @ 
@ . . @ . @ @ . . @ . @ 
@ @ . @ . @ . @ . . @ @ 
@ . . . @ @ . . . @ @ @ 
@ @ @ @ @ @ @ @ @ @ @ @ 
3
8 2 5 3
3 4 9 9
7 3 3 6
