12 12
@ @ @ @ @ @ @ @ @ @ @ @ 
@ . . . . . . @ . @ @ @ 
@ @ . @ . @ @ . . . @ @ 
@ @ @ . . . . @ . @ . @ 
@ @ . @ . @ . . . . . @ 
@ . . . . @ . @ . @ @ @ 
@ @ . @ . . @ @ . . . @ 
@ @ @ . @ @ . @ . @ . @ 
@ @ . . . . . . . . @ @ 
@ . @ . @ . @ . @ @ @ @ 
@ . . . . @ . . @ @ @ @ 
@ @ @ @ @ @ @ @ @ @ @ @ 
3
9 5 3 5
8 5 4 8
6 5 2 2
