100 100
@ @ @ @ @ @ @ @ @ @ @ @ @ @ @ @ @ @ @ @ @ @ @ @ @ @ @ @ @ @ @ @ @ @ @ @ @ @ @ @ @ @ @ @ @ @ @ @ @ @ @ @ @ @ @ @ @ @ @ @ @ @ @ @ @ @ @ @ @ @ @ @ @ @ @ @ @ @ @ @ @ @ @ @ @ @ @ @ @ @ @ @ @ @ @ @ @ @ @ @ 
@ @ @ @ @ @ @ @ @ @ @ . @ . @ @ . @ @ . @ @ @ . . . . @ . @ . @ . . . @ @ @ @ @ @ @ @ . . . . . @ . . . . . . . . . . . @ . . . . @ . @ . @ . . . . @ @ @ @ @ . . . . @ @ @ . . @ . @ . @ @ @ @ @ @ . @ 
@ @ @ @ @ @ @ @ @ @ . . . . . . . . @ . . @ . @ . @ @ . . . . . @ . @ @ @ @ @ @ @ @ . @ @ . @ . @ @ . @ @ @ . @ . @ @ . . @ . @ @ . . @ . @ @ . @ @ . . @ . . @ . @ . . . . . @ @ . . . @ @ @ @ @ @ . @ 
@ @ @ @ @ . @ @ @ @ . @ . @ @ @ . @ @ . @ . . @ . . @ @ . @ @ . . . . @ @ @ @ . @ . . @ @ @ . . . @ @ . @ @ . @ @ . . @ @ @ . @ . @ . . . @ . . . @ . @ @ @ . . . . @ . @ . @ . @ . @ . . @ . . @ . . @ 
@ @ @ @ . . . . @ . @ . @ . @ . . . . . . @ . . @ . . @ . @ . . @ . @ . . @ . . . @ . . @ . @ . @ . . . @ . . . . @ . @ . @ . . . . @ . @ . @ . @ . . . @ @ . @ . @ . @ . @ . . . . . @ . @ . @ . @ . @ 
@ @ @ . @ @ . @ . . . . . . . @ . @ . @ . . @ . . . @ . @ . . @ @ . @ . @ . @ . @ . @ . . . . . @ . @ @ @ . @ . @ @ . . . . . @ @ . . . . . . . . . @ . @ @ @ . . . . . . @ @ . @ @ @ . @ . . . . . . @ 
@ @ . . . . . . @ . @ . @ @ . . . @ . @ . @ . @ @ . . . . @ . . @ @ . . . . . . . . . @ @ . @ . . . . . . . @ . @ . @ . @ . @ @ @ @ . @ @ . @ . @ @ @ @ @ @ . . @ @ @ @ @ @ . . . @ . . . @ . @ @ . @ @ 
@ @ @ . @ . @ . . . . @ . . . @ @ . @ . . . . . . @ @ @ . . . @ . @ @ . @ . @ . @ . @ . @ . . @ . @ . @ @ . . @ . . . @ @ @ @ @ @ @ @ . . . . @ @ . @ . @ . @ . . . . @ @ . @ . @ . @ . @ . . . . @ . @ 
@ @ @ @ . . @ . @ . @ @ @ @ @ . . . @ @ . @ @ @ . . . . . @ @ . . @ @ . @ @ . . @ @ . . @ . @ . @ . . @ . . @ . . @ @ . @ @ @ @ . . @ . @ . @ @ . . . . . . . . @ @ . . . . . . . . . . . . @ . @ . . @ 
@ @ @ @ @ . @ @ . . @ @ . . . @ . @ . @ . . @ @ @ . @ @ . . @ . @ . @ . . . @ @ . . @ . . @ . . . . @ . @ . @ @ . . @ . . @ . @ . @ . . . @ . @ . @ . @ @ . @ @ @ . . @ . @ . @ . @ @ . @ . . @ @ @ . @ 
@ @ @ @ @ . @ @ @ . @ . @ . @ . . . . . . @ . . . @ . @ . @ . . . . . . @ . . @ @ . . . @ . @ @ @ @ . . . . . . . @ . . @ @ . . . . . @ . . . . @ @ @ . @ . . . @ @ . @ . @ @ . @ @ . . . @ . . . . . @ 
@ @ @ @ . . . @ @ @ . . . . . . @ . @ @ . . . @ @ . . . . . . @ @ . @ . . @ . @ . @ . @ . . . @ @ . . @ . @ . @ . . . @ @ @ . @ . @ @ @ @ . @ @ . @ . . . . @ @ . @ @ @ @ . . . . . @ . @ . . @ . @ @ @ 
@ @ @ @ @ . @ @ @ @ . @ . @ . @ . . . @ @ . @ @ . @ . @ . @ @ . @ . . @ @ . @ . . . . . . @ @ @ @ @ @ @ . . @ . . @ . . @ . . . @ @ @ @ @ @ @ @ . . . @ . @ . @ . . @ @ @ @ @ @ . @ . @ @ @ . @ . . . @ 
@ @ @ @ @ @ . . @ @ @ @ @ . . . @ . @ . . . @ . . . . . @ @ @ . . . @ . @ . @ @ @ @ . @ @ . . @ @ @ @ @ . @ @ @ . . @ . @ @ . @ . @ @ @ @ @ @ . @ . @ . @ . . @ . @ . @ @ @ @ . . . . . . . @ . . @ . @ 
@ @ @ @ @ @ . @ @ @ @ @ . @ . @ . . . @ . @ . @ . @ . @ . . . @ @ @ @ . @ . @ . @ . . . @ . @ @ @ @ @ . . @ @ . . @ . @ @ . . . . . . @ . . . . . . . . . @ . . . . . . . @ . . @ . @ . @ . . @ . @ . @ 
@ @ @ @ @ . . . @ . @ . . . @ . . @ @ . @ . . . @ . . . . @ . @ . . . . . . . . . . @ @ . . @ @ @ @ . @ @ @ . @ . . . @ . @ . @ . @ @ . @ . @ . @ @ . @ @ . . @ . @ . @ @ . . @ . . . @ @ @ . . @ . . @ 
@ @ @ @ @ @ . @ . . . @ . @ . @ @ . @ . . @ . @ . @ . @ @ . @ . . @ . @ @ @ . @ . @ @ . @ . @ @ @ . . . @ . . . . @ . @ . . . . @ . @ . @ . @ . @ @ @ @ @ . @ . @ @ . . @ . @ . @ . @ @ . . @ @ . @ . @ 
@ @ @ @ @ . . . @ @ . . . . . @ . . . . @ @ . . . . . . @ . . @ @ . . @ @ @ . @ . . @ . . . . @ . @ . @ @ @ . @ . . @ . . @ . @ . . . . . @ . . . @ . . . . . . @ @ . @ . . . . . @ . . @ . @ . . . . @ 
@ @ . @ . @ . @ . . . @ . @ . . . @ . @ . . @ @ @ @ . @ . . @ @ @ @ @ . @ . @ @ . @ . . @ . @ . . . . . @ @ @ . @ . @ . @ @ @ . @ . @ . @ . @ . @ . . @ @ . @ . . @ . @ . @ @ . @ @ @ . . . . @ . @ . @ 
@ . . . . . . @ @ . @ . . . @ . @ @ . . . @ @ @ . @ . . . @ . @ @ . . . . . @ . . . . @ . @ . . @ @ . @ . @ . . . . . . . @ . . . . . @ @ . @ . . . @ . @ @ . . @ . . . . . . @ . @ . . @ . @ . @ @ . @ 
@ . @ . @ @ . @ . . . @ . @ . . . @ . @ @ . @ . . @ . @ . @ . @ . @ @ . @ @ . @ . @ @ . . . @ . . @ . @ . . @ . @ . @ . @ . . @ @ . @ . @ . @ . @ @ . . . . @ . @ @ . @ . @ . . . . @ . @ @ @ . . @ . @ 
@ @ . . @ . . . @ @ @ @ @ @ @ . @ . . . @ . . @ . @ . . @ . . . . . . . . . . . . . . . @ @ @ . @ . @ @ . @ . @ . . . @ @ @ @ . @ . . . . . . . . . . @ . @ @ . @ @ . . @ @ @ . @ . @ . . @ . . @ . @ @ 
@ @ . @ . @ . @ @ . @ @ @ @ . @ . @ . @ . . @ @ . . . @ . @ . @ . @ . @ . @ . @ . @ @ . . . . . . . . . . . . . @ . @ . @ . . . . . @ . @ . @ @ . @ . . @ . . . . @ @ @ . @ . . . @ @ . @ . @ . @ . @ @ 
@ . @ . . . . . . . . @ . . . . . . . . @ . . @ @ . @ . . . . . @ @ . . @ @ @ . . . @ . @ . @ @ . @ . @ @ . @ . . . . . . . @ @ . @ . . . @ . @ @ . . @ . . @ . @ @ @ @ . @ @ . @ . . . . . . . . . @ @ 
@ . . @ . @ . @ . @ . . @ @ @ . @ . @ . @ . @ . @ . . . @ . @ . . . @ . @ . . @ . @ . . @ . . . @ @ . . @ . . @ . @ . @ . @ . @ @ @ . @ . . . @ . @ . @ . @ . @ @ @ @ . . . . . . . @ @ @ @ @ @ @ @ . @ 
@ . @ . @ . . @ @ @ @ . . . . @ . @ . . . . . . . . @ @ . . @ @ . @ . @ . @ . . . @ @ @ @ . @ . . @ . @ . . @ . . . @ . . . . . . @ @ . @ . @ @ . @ @ . . . . @ @ @ @ @ @ @ @ @ @ . . . . . . . . . . @ 
@ . . . . . @ @ @ @ . @ @ @ . . . . . @ . @ . @ @ . . . @ @ . . . . . . . . @ @ . . . . @ . . @ @ @ @ . @ . @ @ . @ @ @ . @ . @ . . . . . @ . . . @ . @ . @ . . @ @ . . @ @ @ @ @ . @ . @ @ . @ @ . @ @ 
@ @ . @ . @ . . @ . . . . . . @ . @ @ . . . @ @ @ . @ @ @ . . @ . @ . @ . @ @ . . @ . @ . @ @ @ @ @ @ . @ @ . . @ @ @ @ @ @ . . @ . @ . @ . @ @ . . . . . . @ . . . @ . . . @ @ . @ @ @ . @ @ . . . @ @ 
@ @ . . @ . @ . . . @ . @ @ . . @ @ @ @ . @ . @ @ . . @ @ @ . . @ . . . @ @ . @ . . @ @ . @ @ @ @ @ . . . @ . @ . @ @ @ @ @ . @ . @ . . . . . . @ @ . @ @ . . @ . @ . . @ @ . @ . . @ . . . . . @ @ . @ 
@ . . @ . . . @ . @ . @ . @ . @ . @ . . . . . . . @ @ @ @ . . @ @ @ . @ @ @ . @ . @ . . . . @ @ @ @ @ . @ . . . . . @ @ @ @ @ . . @ @ . @ . @ @ @ @ @ . . @ @ @ @ . . @ . @ . . @ . @ @ . @ @ . . . . @ 
@ @ . @ . @ @ . @ @ . @ . . @ @ . . . @ . @ . @ @ @ @ @ . . @ @ . @ . . @ . . . @ . @ @ @ . . @ @ @ . . . . @ . @ . @ @ @ @ @ . @ . . @ . . . . @ . @ @ . @ . @ . @ . . . . @ . @ . @ @ @ . . . @ @ . @ 
@ @ . @ . . . . @ . . . @ . @ @ @ @ . . @ @ . @ . @ . . . @ @ @ . . . @ . @ . @ . . @ . @ . @ . @ @ @ . @ @ . @ . . . @ . @ . . . @ . . . @ . @ . . . @ . . . . . . . @ @ . . . . . . @ @ @ @ . . . @ @ 
@ @ @ @ @ . @ . @ @ @ . . . . @ . . @ . @ . . . . . @ @ . . @ . . @ . . . . . . @ . . . . . . . @ @ . . . @ . . @ @ @ . . . . @ . @ . @ . @ . . @ @ . @ . @ @ @ . @ @ . . . @ . @ . @ @ @ @ @ . @ @ @ @ 
@ @ @ @ @ . @ . @ . . . @ . @ . . @ . @ @ @ . @ . @ @ . @ @ . . @ . . @ @ @ . @ @ . @ . @ @ . @ . @ @ . @ @ . @ . @ . @ . @ @ . . . @ . . @ . @ @ @ . @ . . . . @ @ @ @ @ . @ . . @ @ @ @ @ @ @ . @ @ @ 
@ @ @ @ @ @ . . . @ @ @ @ . . @ . @ . @ @ . . . @ @ . . . . . @ @ @ . . . . @ . . . . @ . . @ . . . . . . . . . . . . . . . @ @ . @ @ @ . . @ . . @ . . . @ . @ . @ . . @ @ @ @ . @ @ @ @ @ @ . . . @ @ 
@ @ @ @ @ @ @ . @ @ @ @ . . @ . . . . @ @ @ . @ . @ @ . @ @ . @ . . . @ @ @ . . @ @ @ . @ . @ . @ @ @ . @ . @ . @ . @ @ . @ . . . . @ . . @ . @ . . @ . @ . @ @ . @ . @ . @ @ . . @ . @ . @ . @ . @ . @ 
@ @ @ @ @ @ . . . @ . . @ . . @ @ @ . . @ . @ . . @ . @ . . . @ . @ . @ . @ . @ . @ @ . . . . . . @ . @ . . @ . @ . . @ @ @ . @ @ @ @ @ . . . . @ . . . . . . . . . . . . @ . @ . . . . . . . . . . . @ 
@ @ @ @ @ . @ . @ . . @ . . @ . . . . @ . . . @ . . . @ @ . @ @ @ . . . . . . . . . . . @ @ @ @ @ . . . @ @ @ . . @ . @ . . @ . . . @ . . @ @ . . . @ @ . @ . @ @ @ . @ @ . . @ . @ . @ . @ . @ . @ . @ 
@ @ @ @ . . . . . @ . @ . @ . @ . @ @ . @ . @ . @ . @ @ . . @ @ @ @ . @ @ . @ . @ . @ . . . . . . . @ . @ . @ . @ . . @ . @ . @ . @ . @ . . . @ . @ @ @ @ . . . . . @ . . . @ . . . @ @ . . @ . . @ @ @ 
@ @ @ @ @ . @ @ . . . . . . . . . . . . . . . . . . . . . @ . . . . . . . @ . . . @ @ @ . @ . @ . @ @ @ . . @ . . @ @ . . . . . . . . @ . @ @ . . @ @ @ @ @ . @ . @ @ . @ . . @ . @ @ @ . @ . @ . . @ @ 
@ @ @ @ . . @ . @ . @ . @ . @ . @ . @ . @ . @ @ . @ . @ . . @ @ @ @ . @ . @ @ . @ @ @ @ . . @ . . . . . @ . . @ @ . . @ . @ . @ . @ . . @ . @ @ . @ @ @ @ @ . . @ @ @ @ . . @ @ @ @ @ @ @ . . . . @ @ @ 
@ @ @ . @ @ @ . @ . . @ . . @ @ . . @ . . @ @ @ @ . @ . . @ @ @ @ . . @ @ . . . @ . . . . @ @ @ . @ . @ @ . @ . @ . @ . . . @ @ @ . . @ @ . . . . @ @ @ . . . @ . @ @ @ @ . . @ . @ . @ . . @ @ . @ . @ 
@ . . . . . . . . . @ . @ @ . . . @ . . @ . . @ @ . . . @ @ @ @ . @ . . @ . @ . @ @ . @ @ @ @ @ @ . . . . . . . . . . . @ . @ @ @ @ . @ . . @ @ . @ . @ . @ . @ . . . @ . . @ . . . . . . @ . . . @ . @ 
@ . @ . @ @ . @ . @ . . @ . @ . @ . . @ @ @ . . . . @ @ @ @ @ . . . . @ @ @ . . . @ . @ . @ @ @ @ @ . @ @ . @ . @ . @ . @ @ . @ @ @ @ . . @ . . . . . . @ . . . . @ @ . @ . . . @ . @ . @ . . @ . @ . @ 
@ @ . . @ . . @ . @ . @ . . . . @ @ . . @ . @ . @ . . @ @ @ . @ . @ . . @ @ @ . @ . @ . . . @ @ @ . . . . @ . . . @ . . . . . . @ @ . . @ . . @ . @ @ @ @ @ @ @ . . . . @ . @ . @ @ . . @ @ . @ @ . . @ 
@ @ @ . @ . @ . . @ . . . @ . @ @ . . @ . . . @ . @ @ . @ . . . . @ . @ @ @ . . . . . @ . @ . @ . @ . @ . . @ @ . @ @ . @ @ . @ @ @ @ . @ @ @ . . @ . @ . . . . . @ . @ . . @ @ . . . @ . . . . . . @ @ 
@ @ @ @ . . @ . @ . . @ . @ . @ . @ . . . @ . @ . . . . . . @ . @ . . . @ . @ @ . @ . . . . . . . . @ @ . @ @ . . . . @ @ @ @ @ @ @ @ . @ . @ @ @ . . . @ @ . @ . . @ . . @ . . . @ . @ . @ . @ . @ @ @ 
@ @ @ @ @ . . @ @ . @ . @ . . @ . . . @ @ @ @ @ @ . @ . @ . . @ . . @ . . . . . @ . . @ . @ @ . @ . . . @ @ . @ @ . @ . @ . @ . @ @ @ @ . . . . . @ . @ . @ @ . . @ @ . @ . . @ . . @ @ @ . . @ . . @ @ 
@ @ @ @ . @ . . @ @ . . . . @ @ @ @ . @ . @ . . . . . @ . . @ @ @ . @ . @ . @ . . @ . . @ . . . @ . @ . . . . @ @ . @ . @ . . . . @ @ . . @ . @ . . . . . . . @ . . @ @ . . @ . . @ . @ @ @ . . @ @ . @ 
@ @ @ . . @ @ . . . @ . @ . . @ @ . . . . @ . @ @ . @ @ . @ @ @ @ @ . . @ . @ . @ @ . @ @ @ @ . . @ . . @ . @ @ . . . . . . @ . @ . . @ . @ . . @ . @ . @ @ . @ . @ . @ @ @ @ . @ . . . . . . @ . @ . @ 
@ @ . @ . . . @ . @ . @ . . @ . @ @ . @ @ @ @ . @ @ . . . . @ @ @ @ @ . . @ . . . . @ @ @ . . . @ . @ . . @ @ @ @ . @ @ . @ @ @ . @ . . . @ . @ . @ @ . . @ @ . . . . . @ @ @ @ . . @ @ . @ . . . . . @ 
@ . . . @ . @ @ . . . . @ . @ . . . . . . @ . . . @ @ . @ . . @ @ @ . . @ @ @ @ @ . . @ @ . @ . . . . @ . . @ @ . @ . @ . . . . . . @ @ . . @ @ . @ . @ . @ @ @ . @ . @ @ @ @ @ @ . . . @ @ @ . @ . @ @ 
@ . @ . @ . @ . @ @ . @ . @ . . @ @ . @ . @ . @ @ . . . . @ @ . @ @ @ . . . @ . . . @ . @ . @ . @ . @ @ . @ . . . . . @ . @ @ . @ . . @ . @ @ . . . . . . @ . . . @ @ @ @ @ @ @ @ @ . @ @ @ @ @ @ . . @ 
@ @ . . . . . . . . @ . . . . @ @ . . . @ . . . . . @ . @ . . . . . . . @ @ . @ @ . . . . @ @ @ . . . . @ . @ @ . @ @ . @ . @ . . @ . . . . @ @ @ @ @ @ . . @ @ . . . @ @ @ @ @ @ @ @ @ @ @ @ @ @ . @ @ 
@ . @ . @ . @ . @ . . @ . @ . @ . @ . @ @ @ . @ . @ . . @ . @ . @ . @ . @ . . @ . . @ . @ . . . @ . @ . . . . . . . . . . . @ @ . @ . @ . @ @ . . . . . . @ @ . . @ @ . @ @ @ @ @ . @ @ . @ @ @ @ . . @ 
@ . . . @ @ . . @ @ . . . . @ . . . . @ @ . @ @ . . @ . . @ . . . @ . . . . @ @ @ . . @ . @ . @ @ @ . . @ @ @ . @ @ . @ . @ . @ . . @ . . . . @ . @ . @ . . . @ . . . . . @ @ @ . . . . . @ @ @ . . @ @ 
@ . @ . . @ @ . @ @ . @ . @ @ @ @ . @ . . . . . . @ @ . @ @ @ . @ @ @ . @ . @ @ . @ . . . . . @ @ @ @ @ . @ . . @ . @ @ . . . . @ @ . @ . @ @ . . @ @ . . @ @ @ @ @ . @ . . . @ . @ @ @ . . @ . . @ @ @ 
@ . @ @ @ . . @ . . @ . . @ @ @ @ . . @ . @ @ @ @ @ @ @ @ @ @ @ . . . . . @ . . . . . @ . @ . . @ . . . . . @ . . . . . @ . @ . . . . . @ @ @ @ . . . @ . @ @ @ @ @ . @ @ . @ @ @ . . . . @ . @ . @ . @ 
@ . @ . . . @ @ @ . . @ . . @ @ @ @ . . @ @ @ . . @ . . @ @ @ @ @ . @ . @ @ @ @ . @ . . @ @ @ . @ . @ @ . @ @ . @ . @ . . @ . . @ . @ . . @ . @ @ . @ . . . @ @ @ @ . @ @ . . @ . . @ . @ @ . . . . . @ 
@ @ . @ . @ . @ . @ . . . @ @ @ . . @ . . @ @ @ . @ . @ @ @ @ @ @ @ . . @ @ . @ @ . . @ . @ @ . . . . . @ . . . . @ . . @ @ . @ . . . @ . . . . . @ @ @ . @ . @ @ . . . . @ . . . @ . @ . @ @ . @ . @ @ 
@ . . . . . . . . . . @ . . . . @ . . @ @ @ @ . . . . @ @ @ . . @ . . @ @ . . . . @ . . . . . @ . @ . @ @ @ @ . @ @ . @ @ @ . . @ @ @ @ @ @ . @ . . @ . . @ . . @ @ . @ . . @ . @ . . . . @ . . . @ @ @ 
@ . @ . @ . @ . @ . @ . . @ . @ . @ . @ . @ @ @ . @ . . @ . @ . @ @ . . . @ . @ . . @ . @ . @ . @ @ . @ . . . . . . @ . @ . @ . @ @ @ @ . . . . @ . . @ @ . . @ . . . @ . @ . . . . @ @ @ . @ @ . @ @ @ 
@ . . @ . . . @ . . @ @ . @ . . . . . . . . @ @ @ . @ . . . . . . . . @ . . . . @ . . @ @ . . . . . @ @ @ . @ . @ . . . . . @ . @ @ @ @ . @ . @ . . @ . @ @ . @ @ . @ @ @ . @ . @ . . . . . @ . @ . . @ 
@ . @ @ @ . @ . @ . @ @ @ . . @ @ . @ . @ . . @ . . @ . @ . @ . @ @ . . @ @ . @ @ . @ . . . @ . @ @ . @ . @ . . . @ . @ . @ . . @ @ . . . @ @ . @ @ @ . @ . . . @ . @ @ . . . . . @ . @ . @ @ . . . @ @ 
@ . . @ @ @ . . . . @ @ . @ . . . @ @ @ @ . @ @ @ . @ @ . . . @ . . . @ @ @ . . . @ @ @ . @ . @ . . . . . @ @ . @ @ . @ . . @ . . @ @ @ . . . . . @ @ . . @ . @ . @ . . @ . @ . @ @ . . @ . . @ @ . @ @ 
@ @ @ @ @ . . @ . @ . . . . . @ @ @ @ @ @ . . @ . . @ @ @ . @ @ @ . @ @ @ . @ . @ @ @ . . . . @ @ . @ @ . @ . . . . @ . . @ . @ @ @ . @ @ . @ . @ . . . @ @ . . . . @ . . @ @ @ . . . @ @ @ . @ . . . @ 
@ . . . . . @ . @ @ @ . @ @ . . . . @ . . @ @ . @ . . @ @ . @ . . . @ @ @ . . . . @ @ @ . @ . @ @ . @ . . . @ . @ @ . @ . . . . . . . . @ . @ . @ . @ @ . . @ . @ . @ . @ . . . @ . @ @ @ . . . @ . @ @ 
@ . @ . @ . . . . @ . @ @ . @ . @ @ @ @ . . . . . . @ . . . @ . @ . . . @ @ . @ . @ @ . . . @ @ . @ . @ @ . . . @ . . @ @ . @ @ . @ . @ . @ . @ . . . . . @ @ . . @ @ . @ . @ @ . @ . @ . @ @ . . . @ @ 
@ . @ . @ . @ @ @ . . . . . . . @ . @ . @ . @ . @ @ . @ @ . . @ . . @ . . . @ @ @ @ . @ . @ @ @ . . . . . @ @ . @ @ . . @ @ @ . . @ . . . . . . . @ @ @ @ @ @ . @ . . . . . . . . . . . . . . @ @ . . @ 
@ @ . @ . . . @ . . @ @ @ . @ @ . . . . @ @ . . . @ . . . . @ . @ . @ @ @ . . @ . @ . @ . . . . . @ @ @ @ . @ . . @ . @ . @ . @ . @ . @ . @ . @ . . . . . . . . . . @ . @ . @ . @ . @ . @ . @ @ . . @ @ 
@ . . . . @ . . @ @ . . . . @ @ @ . @ . @ . @ . @ . @ . @ . . . @ . . . . @ . . . . . . @ @ . @ . . . . . . . @ . . . . . . . @ . @ . @ . . @ . @ @ @ . @ @ . @ . @ . . . @ @ . . @ . . . @ @ @ @ . @ @ 
@ . @ @ . . @ . . . @ . @ @ . @ . @ . . . . . . . . . . @ . @ . . @ . @ . . @ @ . @ @ . . @ . . @ @ . @ . @ . . @ . @ . @ . @ @ . @ . . @ . . . . . . @ @ @ . . @ @ . @ @ @ @ . @ . . @ . @ . @ @ . @ @ 
@ . . @ @ . @ . @ @ @ @ . . . . . @ . @ @ @ . @ @ @ . @ @ . . @ @ . . . @ @ . @ @ . . . @ @ . @ @ . @ . @ . . @ . @ . . . @ . @ @ @ . @ @ @ . @ @ . @ @ @ @ . @ @ . @ @ . @ . @ @ @ . @ . . . . . . . @ 
@ . @ . . . @ . @ . @ . @ . @ @ . . . @ @ @ @ @ @ @ . @ . . @ @ @ @ . @ . @ . . @ @ @ . . @ @ . @ . @ . . @ . . . @ @ @ . . . . . . @ @ @ @ @ . . . @ . @ @ . . . . . . . . . @ @ @ @ . @ . @ . @ . @ @ 
@ . @ . @ . . @ . . . . . . . @ . @ . @ @ @ @ @ @ . . @ @ . @ @ @ @ . . . . . @ @ . . . @ . . . . . . . @ . . @ . @ @ @ @ . @ . @ . @ @ @ @ @ @ . @ @ . . . @ . @ . @ @ . @ @ @ @ . . . . . @ . . @ @ @ 
@ . @ . @ . @ . . @ . @ . @ @ . @ . . @ @ @ @ @ @ . @ . . . . @ @ . . @ @ . @ @ @ @ @ . @ . @ . @ . @ @ . . @ . . @ @ @ @ @ . . . @ @ @ @ @ @ @ @ @ @ @ @ . @ . @ . @ @ @ . @ . . . @ . @ . . @ . . @ @ 
@ . @ . . @ . . @ . . @ @ @ @ . @ . @ . @ @ @ . . @ . . @ . @ @ @ @ . . . @ . . @ . . . . . @ . . @ @ @ @ . . @ . . @ @ @ @ @ . @ @ @ @ @ @ @ @ @ @ @ @ . . . @ . . . @ . . @ . @ . @ @ . . @ . @ . . @ 
@ @ . . @ . @ @ . @ @ @ . . . . . . . . . @ . . @ . @ . @ . . @ @ @ . @ . @ . @ . @ @ @ . @ @ . @ @ @ . . . @ @ . @ @ @ @ @ @ @ @ @ @ @ @ @ @ @ @ @ @ @ @ . @ @ @ . @ . @ . . @ @ @ . . . @ @ . . . @ @ 
@ . . @ . . . . . . . . . @ . @ @ @ . @ . . @ . @ . . @ @ @ @ @ @ . @ @ . . . . . . . . @ @ @ . . . . @ @ . @ . . @ @ @ @ @ @ @ @ @ @ @ @ @ @ @ @ @ @ @ . . . . . . . . . . @ @ @ . . @ . @ . @ @ . . @ 
@ @ . . @ @ . @ @ . @ . @ . . @ @ . . . @ @ . . . . @ @ @ . @ @ . . @ @ . @ . @ . @ . @ . @ . @ @ . @ @ @ . @ @ . @ . @ @ @ @ @ @ @ @ @ @ @ @ @ @ @ @ @ @ @ @ @ @ . @ . @ @ @ @ @ @ @ . . . . . @ . @ @ 
@ . . @ @ @ . @ . @ . . . @ @ @ . @ . @ . @ . @ . @ @ . . . . @ @ . @ @ . . @ @ . . @ . . . . . @ . @ @ . @ . . . . . . . @ @ @ @ @ @ @ @ @ @ @ @ @ @ @ @ @ @ @ . . . @ @ @ @ @ @ @ @ @ @ . @ . @ @ . @ 
@ @ . @ . @ @ . . . . @ @ . . . . . . @ . . . . @ @ . @ . @ . . . . . . @ . . . @ . . @ . @ . @ @ @ . . . @ . @ . @ . @ . @ @ @ @ @ @ @ @ @ @ @ @ @ @ @ @ @ @ . @ . @ . @ @ @ @ @ @ @ @ @ @ @ . . @ . @ 
@ . . . . . @ . @ @ . . @ @ . @ . @ . . . @ . @ . . . . . . @ @ . @ . @ . . @ @ . . @ . . . @ . @ @ @ @ . . . . @ . . . @ @ @ @ @ @ . @ @ @ @ @ @ @ @ @ @ @ . . . . . . . @ @ @ @ @ @ @ @ @ . . @ . . @ 
@ @ . @ . @ @ . @ @ . @ . . @ . . . @ . @ . . @ @ @ . @ . @ . . @ . . . . @ . . @ . . . @ @ . . . @ . . @ @ . @ @ @ . @ @ @ @ @ @ . . . @ @ @ @ @ @ @ @ @ @ @ . @ . @ . @ @ @ @ @ @ @ @ @ @ @ . . . @ @ 
@ @ @ . . . @ @ . . . @ . @ . @ . @ . @ . @ . @ . . . . @ . @ . . @ . @ . . @ . . . @ . . . @ . @ . @ . . @ . . @ . . . @ @ @ @ . @ . @ @ @ @ @ @ @ @ @ @ @ @ . @ . . @ @ @ @ @ @ @ @ @ @ @ @ @ . @ @ @ 
@ @ @ @ . @ . . . @ . . . . . . @ . . . . @ . . @ @ . @ @ . @ @ . . @ . . @ . @ @ . . @ . @ . . . . . . @ . @ @ @ @ . @ @ @ . @ . @ . @ . @ @ @ @ @ @ @ @ @ @ @ @ . @ @ @ @ @ @ @ @ @ @ @ @ @ @ @ @ @ @ 
@ @ @ @ @ @ @ . @ . . @ @ . @ . @ . @ . @ @ . @ . . . . @ . @ @ . @ . @ . . . . @ @ . @ . . . @ . @ . @ @ . . . . . . @ @ . . @ . . . . . @ @ @ @ @ @ @ @ @ @ @ @ . @ @ @ @ @ @ @ @ @ @ @ @ @ @ @ @ @ @ 
@ @ @ @ @ @ . . @ @ . . . @ . . . . . @ @ @ @ @ @ . @ @ . . . . . . . . . @ @ @ . . . @ . @ . . @ @ . . @ @ . @ . @ @ @ . @ . . . @ . @ @ . @ @ @ @ @ @ @ @ @ @ @ @ @ @ @ @ @ @ @ @ @ @ @ @ @ @ @ @ @ @ 
@ @ @ @ @ . @ . . @ . @ @ . @ . @ . @ . @ @ . @ . @ @ . . @ @ . @ . @ . @ @ @ @ . @ . . @ . . @ . . . @ @ @ @ @ . . . . . @ @ . @ . @ . @ . . @ @ @ @ @ @ @ @ @ @ @ @ @ @ @ @ @ @ @ @ @ @ @ @ @ @ @ @ @ 
@ @ @ @ . . . . @ . . . @ . . . . @ . . . . . . . @ @ @ . . @ @ . . @ . @ @ . @ @ . . @ @ . @ @ . @ . . @ @ @ @ @ @ @ . @ @ @ . . . . . . . @ @ @ @ @ @ @ @ @ @ @ @ @ @ @ @ @ @ @ @ @ @ @ @ @ @ @ @ @ @ 
@ . @ @ @ @ @ . . @ . @ . . @ . @ @ . @ @ . @ . @ . . . . @ @ @ @ . @ . . . . . @ @ . @ . @ . @ . @ . @ @ . @ @ @ . @ . @ @ . . @ @ . @ . @ @ @ @ @ @ @ @ @ @ @ @ @ @ @ @ @ @ @ @ @ @ @ @ @ @ @ @ @ @ @ 
@ . . . . . . . @ . . @ @ . @ . . . . . . @ @ @ @ @ . @ . . @ @ . @ . . @ . @ . @ . . . . . . . @ . . . . . . @ . . @ . . @ @ . @ @ . . @ @ @ @ @ @ @ @ @ @ @ @ @ @ @ @ @ @ @ @ @ @ @ @ @ @ @ @ @ @ @ @ 
@ @ . @ @ @ . @ . . @ . . @ . . @ . @ . @ @ @ @ @ @ @ . . @ . . . . @ . . @ . @ . @ . @ . @ . @ . @ @ @ @ @ @ . @ . @ @ @ @ . . @ @ . @ @ @ @ @ @ @ @ @ @ @ @ @ @ @ @ @ @ @ @ @ @ @ @ @ @ @ @ @ @ @ @ @ 
@ . . . . . @ . @ @ @ @ . . @ . . @ @ . . @ @ @ @ @ @ @ . @ . @ @ . . . @ . . . . . @ @ @ . . . . . . . . . . . . . . . . . . @ @ @ @ @ @ @ @ @ @ @ @ @ @ @ @ @ @ @ @ @ @ @ @ @ @ @ @ @ @ @ @ @ @ @ @ @ 
@ @ . @ @ . . . . @ . @ . @ @ . @ . . @ . @ @ @ @ @ @ @ @ . @ @ . @ @ . . . @ . @ @ . @ . . @ . @ @ . @ . @ @ . @ . @ . @ . @ @ @ @ @ @ @ @ @ @ @ @ @ @ @ @ @ @ @ @ @ @ @ @ @ @ @ @ @ @ @ @ @ @ @ @ @ @ 
@ . . . . @ . @ . . . . . . @ . . . @ . . . @ @ @ @ @ @ . . @ . . . . @ . @ . . . . . @ . @ . . . . @ . . @ @ @ . . . @ @ @ @ @ @ @ @ @ @ @ @ @ @ @ @ @ @ @ @ @ @ @ @ @ @ @ @ @ @ @ @ @ @ @ @ @ @ @ @ @ 
@ @ . @ . . @ @ @ . @ . @ @ . @ . @ . @ . @ @ @ @ @ @ @ . @ . . @ @ . . . . @ @ . @ . @ . . @ . @ @ . @ . . @ @ @ . @ @ @ @ @ @ @ @ @ @ @ @ @ @ @ @ @ @ @ @ @ @ @ @ @ @ @ @ @ @ @ @ @ @ @ @ @ @ @ @ @ @ 
@ @ . @ @ . . . @ . @ . @ . . . . . . . @ @ @ @ @ @ @ @ . . . @ . . . @ . @ . . . . @ @ @ @ . . @ . . @ . @ . . . . @ @ @ @ @ @ @ @ @ @ @ @ @ @ @ @ @ @ @ @ @ @ @ @ @ @ @ @ @ @ @ @ @ @ @ @ @ @ @ @ @ @ 
@ . . @ @ . @ . . @ @ . . @ . @ . @ . @ @ @ @ @ @ @ @ @ @ @ . . @ . @ . . @ . @ . @ @ @ @ @ @ . . . @ @ @ @ @ . @ . . @ @ @ @ @ @ @ @ @ @ @ @ @ @ @ @ @ @ @ @ @ @ @ @ @ @ @ @ @ @ @ @ @ @ @ @ @ @ @ @ @ 
@ @ @ @ @ @ @ @ @ @ @ @ @ @ @ @ @ @ @ @ @ @ @ @ @ @ @ @ @ @ @ @ @ @ @ @ @ @ @ @ @ @ @ @ @ @ @ @ @ @ @ @ @ @ @ @ @ @ @ @ @ @ @ @ @ @ @ @ @ @ @ @ @ @ @ @ @ @ @ @ @ @ @ @ @ @ @ @ @ @ @ @ @ @ @ @ @ @ @ @ 
3
37 56 19 57
66 76 1 89
90 12 52 68
