10 10
@ @ @ @ @ @ @ @ @ @ 
@ @ @ @ @ . . @ . @ 
@ @ @ @ @ @ . . . @ 
@ @ @ @ @ . . @ . @ 
@ @ @ @ . @ . . @ @ 
@ @ @ . . . . @ @ @ 
@ @ @ @ . @ . . @ @ 
@ @ @ . @ @ . @ . @ 
@ . . . . . . . . @ 
@ @ @ @ @ @ @ @ @ @ 
3
8 8 5 4
8 1 8 2
4 4 2 8
