20 20
@ @ @ @ @ @ @ @ @ @ @ @ @ @ @ @ @ @ @ @ 
@ @ @ @ @ @ @ . @ @ @ . . . . @ @ @ @ @ 
@ @ @ @ @ @ . . . @ . @ . @ . @ @ @ @ @ 
@ @ @ @ @ . @ @ . . . . . @ . . @ @ @ @ 
@ @ @ @ . . . . . @ . @ . @ @ . . . @ @ 
@ . @ @ @ . @ @ @ . . @ . . . @ . @ @ @ 
@ . . . @ @ . . . . @ . . @ @ @ @ @ @ @ 
@ @ @ . . . . @ . @ . . @ . . @ . . @ @ 
@ . . . @ . @ @ @ @ @ . . @ . @ . @ @ @ 
@ . @ . . @ @ @ @ @ @ @ . @ . . . . @ @ 
@ @ . . @ . @ @ @ @ . . . . . @ . @ . @ 
@ . @ @ . . . @ @ . . @ . @ @ . @ . . @ 
@ . . . @ . @ . @ . @ . @ . @ . @ @ . @ 
@ @ . @ @ . . . . . . . . . . . . . . @ 
@ . . . . . @ . @ @ . @ . @ . @ . @ . @ 
@ @ @ . @ @ . @ . @ @ @ @ @ . . @ . . @ 
@ . . . . . . . . . . . . @ . @ @ @ . @ 
@ @ @ . @ . @ . @ . @ . @ . . . . . @ @ 
@ @ . . . @ @ @ @ @ @ . . @ . @ @ . . @ 
@ @ @ @ @ @ @ @ @ @ @ @ @ @ @ @ @ @ @ @ 
3
11 17 7 13
15 15 7 6
12 7 14 7
