10 10
@ @ @ @ @ @ @ @ @ @ 
@ . @ . . @ . @ @ @ 
@ . . . @ . . @ @ @ 
@ . @ . @ . @ . @ @ 
@ @ @ . . . . . . @ 
@ . . . @ . @ . @ @ 
@ . @ . . @ @ @ @ @ 
@ @ @ @ @ @ @ @ @ @ 
@ @ @ @ @ @ @ @ @ @ 
@ @ @ @ @ @ @ @ @ @ 
3
1 6 4 6
3 7 5 7
4 3 2 5
