100 100
@ @ @ @ @ @ @ @ @ @ @ @ @ @ @ @ @ @ @ @ @ @ @ @ @ @ @ @ @ @ @ @ @ @ @ @ @ @ @ @ @ @ @ @ @ @ @ @ @ @ @ @ @ @ @ @ @ @ @ @ @ @ @ @ @ @ @ @ @ @ @ @ @ @ @ @ @ @ @ @ @ @ @ @ @ @ @ @ @ @ @ @ @ @ @ @ @ @ @ @ 
@ @ @ @ @ . . @ @ . @ . @ . . . @ @ . . . . @ @ @ @ @ @ @ @ @ @ @ . @ @ . @ . @ @ . @ @ @ @ @ . @ . @ . @ . @ @ @ @ @ @ @ @ @ @ @ @ . @ . @ @ @ @ . . . . . . . @ . . . @ @ @ @ @ . @ @ . . . @ @ . @ @ 
@ @ @ @ @ @ . . . . . . @ @ . @ . . @ . @ . . . @ @ @ @ @ @ @ . @ . . @ . . . @ @ . . @ @ @ . . . . . . . . @ @ @ @ @ @ @ @ @ @ @ @ . . . . @ @ . @ . @ . @ . @ . . @ @ @ @ @ @ . . . . @ . @ . @ . . @ 
@ @ @ @ @ . @ . @ . @ @ . . . @ . @ @ @ . . @ @ . . @ @ @ @ . . . . @ . . @ @ @ @ . @ . @ . @ @ @ . @ @ @ @ . @ @ . @ @ @ @ . @ . . @ @ @ . . . . . . @ @ @ @ @ . @ . @ @ @ @ @ @ @ @ . . . . . @ @ . @ 
@ @ @ @ @ . . . . @ @ @ . @ . . . . . . @ . @ . . @ . . @ . @ . @ . . @ . . . @ . . . . @ . @ . @ . @ . @ . . . . . . @ @ @ . . . @ . @ @ @ . @ . @ . . @ @ @ . . . . . . @ @ . . . . @ @ . @ @ . @ . @ 
@ @ @ @ . . @ . @ @ . . @ . . @ @ . @ . @ . . @ . . . @ @ . @ @ . @ . @ . @ @ . @ . @ . . . . . . . . . . . @ . @ . @ @ @ . @ @ . . . . @ @ @ @ @ . . @ . @ @ . @ . @ . @ . . . @ . @ . . . . @ . . . @ 
@ @ @ . @ . @ . @ . . @ @ @ . . @ @ @ @ . . @ @ . @ @ . . . . . . . . . . . . . @ @ @ @ . @ . @ @ . @ @ . @ . . @ . . @ . . @ . . @ @ @ . @ . @ @ @ . . . . . . @ @ . @ . @ @ . @ @ @ @ . @ @ . . @ . @ 
@ @ @ . . . . @ . @ . . . @ . @ . @ @ @ @ . . . . . . . @ . @ @ . @ . @ . @ . @ . . @ . . . @ . . . @ @ . . @ @ . . @ . @ . . @ . @ . @ . . . . @ . . @ . @ . @ . . . . . . . . @ . @ . . . @ . @ . @ @ 
@ @ @ . @ @ . . . @ . @ . . . . . . @ @ . . @ . @ . @ . . @ . @ . . @ . . @ @ . @ . . @ . @ . @ . @ . . @ @ @ . . @ . . . @ . . . . . . . @ @ @ @ . @ @ . . @ @ @ . @ . @ . @ . @ . . @ . @ . . . . . @ 
@ @ @ @ @ . @ . @ @ . @ . @ . @ . @ @ . . @ @ @ . . @ . @ @ . . @ @ . @ . . . . . @ . @ @ . . @ . @ . @ @ @ . @ . . . @ . . @ @ . @ . @ . @ . . @ . . @ . @ @ @ . . . @ . . . @ . @ . . . . . @ @ . @ @ 
@ @ . . . . . . . @ . @ . @ @ . . @ @ @ . @ . . @ . . @ . . . @ . @ . . . @ . @ . . . @ . . @ @ @ . . . @ . . . . @ . @ . @ . @ . . @ @ @ @ . @ . @ . @ . . @ . . @ . . @ . @ . . . . @ . @ . . . @ @ @ 
@ . @ @ @ . @ . @ . . . @ . . @ @ @ @ @ @ @ @ . . . @ @ @ @ . . . @ . @ . @ @ @ @ @ . . . @ . @ . @ . @ . @ @ . @ @ @ . . . . . . @ . @ @ . . . . . . @ . @ @ @ . . @ @ . @ . @ . @ @ . . . @ . @ . @ @ 
@ . . . @ @ @ . @ @ . @ . @ . . . @ @ @ @ @ . . @ . @ . . @ . @ . @ @ @ @ @ . . . . . @ @ . . . . . . . . . . . @ . @ @ . @ . @ . . . . . . @ . @ . @ . @ . @ . . @ @ . . @ . . . . . @ . @ . @ @ . . @ 
@ @ . @ @ @ . . . @ . . . . . @ @ . . . @ . @ . @ . @ . @ . @ . . . . . . . @ @ @ @ . . . . @ . @ . @ @ . @ @ . . . . @ . @ . @ . @ . @ . @ @ @ . . . . . . . @ . @ . . @ . . @ @ . @ . @ . . @ @ . @ @ 
@ . . . . . @ . @ . . @ . @ @ . . @ . @ . . @ @ @ @ . . . . . . @ @ . @ @ . . . . . . @ . @ . . @ @ . . @ . . . @ . @ @ . . @ . . . @ . . . @ . @ @ @ . @ @ . . . @ . @ @ . @ . @ . @ . . @ . @ . . . @ 
@ @ @ @ @ . . . @ @ . . @ @ @ @ . . . . @ . . . @ . @ . @ . @ . . @ @ . @ @ . @ . @ @ @ . . @ @ . . @ . @ . @ . @ @ . @ . @ @ @ . @ . @ @ . . . . . @ . . . @ @ @ @ . @ @ @ . . . . @ . @ @ . . @ . @ @ 
@ . . . . . @ . @ @ . @ @ @ @ @ @ @ @ . . . @ @ . . . @ . @ @ @ @ . . . . . . @ . @ . @ . @ . . @ . . . @ @ . . . @ . @ @ @ . @ @ . . . . . @ . @ @ @ @ . @ @ . . . . . @ @ @ . @ . . . . @ . @ . . . @ 
@ @ . @ . @ . . . @ . . @ @ @ @ . . . . @ . . . @ @ . . . . . . . . @ . @ . @ . @ . . . . . . @ @ @ @ . @ . @ . @ . . . @ . . . . @ . @ @ . . @ . @ . . . @ @ @ @ . @ . @ @ . @ . . @ . @ . . . @ . @ @ 
@ @ . . @ . @ @ . . . @ . @ @ @ @ @ @ @ . @ @ . @ . @ . @ . @ . @ . . @ . . . . . @ . @ @ . @ @ . @ . . . . . . . . @ @ . @ . @ . . @ . . . @ . . . @ @ . @ @ @ @ @ . . . . . @ @ . @ @ @ @ . @ @ . @ @ 
@ @ . @ . . @ . . @ . @ . @ @ @ @ . @ . . . . . . . . . @ @ @ @ . . @ . @ . @ @ . . @ . . @ . . . . @ . @ . @ . @ . . . . . . @ . @ . . @ . . . @ . . . @ . . @ @ @ @ . @ @ . @ . . . . @ . . . . . . @ 
@ . @ . @ . @ @ . . @ . . . @ . . . . @ @ @ @ . @ . @ . . . . @ . @ . . . . @ . @ . @ @ . . . @ @ . . . @ @ . . . @ . @ . @ @ . @ . @ . . @ . @ . @ . @ . . @ @ @ . @ . @ . . . . @ . @ . @ @ @ . @ . @ 
@ . . . . . @ @ . @ . @ . @ @ @ . @ . . . . . @ . . @ @ . @ . . @ @ . @ @ . @ . . . @ @ @ @ . @ . . @ @ . . . @ @ @ . . @ @ @ . . . . . @ @ . . . . @ @ @ . . @ . . . @ @ @ . @ . . @ @ . . @ . . . @ @ 
@ @ @ . @ . . . . . . . . . . . . . @ @ . @ . . . @ . . . . @ @ @ @ @ . . . . @ . @ . @ . . . . @ @ . . . @ . . . @ . @ @ @ @ . @ . @ . @ . . @ @ . @ @ . . @ . . @ @ . @ @ @ @ . @ . . . @ @ @ . @ . @ 
@ @ @ @ . @ . @ . @ . @ . @ . @ . @ @ . . . @ @ . @ . @ @ @ @ . @ @ @ @ . @ . . @ . . . @ @ @ @ . @ @ . @ . . @ . @ . . @ @ . . . @ . . . @ . . @ . . @ @ . . . @ @ . . . @ . @ . . @ . @ . @ . . . . @ 
@ @ . . . . @ . . . @ . . . @ . . @ . @ . @ @ . . @ . @ @ @ . . . @ @ @ . @ @ @ . @ . @ . . . . . . . . @ @ . . @ . . @ . . @ . @ . @ . @ . @ . @ . @ . @ . @ @ . @ . @ @ . . . . @ . . . . @ . @ . @ @ 
@ @ @ . @ . @ @ . @ @ @ . @ @ . @ . . . . @ . @ . . @ @ @ . @ . @ . @ . @ . . . . . . . . @ . @ @ @ . @ . @ . @ @ @ . . . @ . . @ . @ . . . . @ @ . . . . . . . . . . . . . @ . @ . @ . @ @ @ @ . . @ @ 
@ @ . @ . . . . . . @ @ . @ . . . @ . @ . . . . @ @ . . . . . . . . . . . . @ @ . @ . @ . @ . . . . @ . . . . . @ . . @ . . @ @ . . . . @ . @ . . . @ @ . @ . @ . @ . @ . @ . @ . . . . . . . . @ . @ @ 
@ . . . . @ . @ @ . . @ @ @ @ @ . @ @ . @ . @ . . @ @ @ . @ @ . @ @ . @ @ . @ @ @ . . . @ . . @ @ . . @ . @ . @ @ . @ . . @ . @ @ . @ . . @ . @ @ . . . @ . @ @ . @ . . @ . . . @ . @ . @ . @ . @ . @ @ 
@ . @ . @ . . @ . . @ @ @ @ @ . . . . . . @ . . @ . . @ @ . . . @ . @ . . . . @ . @ . @ @ @ . @ . @ @ . . . @ @ . . . @ . @ . . . . . @ @ . . @ . . @ . . . . . @ @ . @ . @ @ . @ . . @ . . . @ @ . . @ 
@ @ @ @ . . @ . @ . @ @ @ @ @ @ . @ . @ . . @ . @ @ . . . @ . @ . . . . @ . @ @ . . . . @ @ @ . . . . . @ . . . @ . @ . @ . . @ . @ @ . @ . @ . @ . @ . @ . @ @ . . . . . . . . . . @ . @ . @ @ . . @ @ 
@ @ @ @ @ . @ . . . . @ @ @ @ . @ . . . @ . @ @ @ . . @ . . @ . . @ . @ . @ . . . @ . @ . @ @ @ @ . @ . @ . @ @ @ . . . @ . @ . . . . . . . . . . @ @ . . @ . @ @ @ . @ @ @ . @ . @ . . @ @ . @ . @ . @ 
@ @ @ @ @ @ . . @ . @ . . @ . . @ @ . @ @ @ @ @ . @ . . @ . @ @ @ . . . . . @ . @ . @ . . @ @ @ . @ . . @ . . @ . . @ . @ . . @ . @ . @ . @ . @ . . . @ . . . . @ @ @ @ . . . . @ @ . @ . . . @ . . . @ 
@ @ @ @ . @ . @ . . @ . @ . @ . . @ . . . @ @ . . @ . @ . @ . @ @ @ . @ @ . @ . . . @ . @ . . . . . . @ . . @ . @ . . @ @ @ @ @ . @ . . @ @ . . @ . @ . . @ . @ . . . @ . @ . @ . . . @ @ @ . . . @ @ @ 
@ . @ @ . . . @ @ . . . . . . . @ . . @ . . . @ . . . . . . . . @ . @ . @ @ . @ . @ . . . @ . @ . @ . @ . @ @ . . . @ @ @ . . . . . @ . . . @ . . @ @ @ . . @ @ @ . @ @ @ . . @ . @ . . @ . . @ @ . @ @ 
@ . @ @ . @ @ . . . @ @ @ . @ . @ @ @ . . @ . . @ . @ @ . @ @ @ . . . . . . . . @ . @ @ . . . . @ . . @ . . @ . @ @ . @ @ @ . @ . @ @ . @ @ . . @ @ @ . . @ . @ . . . @ @ @ . . @ . . @ . @ . . . . @ @ 
@ . @ @ . @ . . @ . . . . @ @ @ . @ @ @ . . @ @ . . @ . . @ . . . @ . @ . @ @ @ . . . . . @ . @ . @ . @ . @ . . . . . . @ @ @ . . . . @ @ @ @ . . @ . @ . . . . @ . @ . @ @ @ @ @ . @ . . . . @ @ @ @ @ 
@ . . . . @ @ . @ . @ . @ . @ @ . . @ . @ . . @ @ . . @ . . @ @ . . @ @ @ @ @ @ . @ . @ . @ @ @ . . . @ . . @ @ @ . @ @ . @ . @ . @ . . . @ . . @ . . . . @ . @ @ . @ . . @ @ @ . . . . @ @ @ . @ . @ @ 
@ . @ @ @ . . . @ . . @ . . . . @ . . . . . @ @ . . @ @ . @ . @ . @ . @ . . . . . . @ . . @ @ . . @ . @ . @ @ . . . @ . . . . . . . @ . @ . @ . . @ . @ . . @ . . . @ . @ . @ . @ . @ . . . . . . . . @ 
@ @ . . . . @ . . @ . . . @ . @ @ . @ @ . @ @ . @ . . . @ . . @ . . . @ . @ . @ . @ @ @ @ . . . @ . . . @ @ @ @ @ . . @ . @ . @ . @ . . @ . . . @ @ @ . . @ . @ @ . . . . . . . . . . @ . @ . @ @ . @ @ 
@ . . @ @ @ . . @ . . @ @ @ . . @ . @ . . . . . @ . @ @ . @ . . . @ @ . @ @ @ . . @ @ @ . . @ . . @ @ . . @ @ @ @ . @ . . @ . @ . @ @ @ . @ @ @ . @ . @ . . . . . . @ @ @ @ @ @ @ @ @ . @ @ @ . . . . @ 
@ @ . . @ . @ @ @ . @ @ @ @ @ @ . @ . . @ . @ . @ . . . . . . @ . . . . @ @ @ . @ . . . . @ . . @ . . . @ @ @ @ . . . @ @ . . @ . . . . . . . @ . . . . . @ . @ @ . . . . . . . . . . . . . @ . @ . @ @ 
@ . . @ . . . . . . . @ @ @ @ . . . . @ . . @ . . . @ . @ . @ . @ . @ . @ @ . . @ @ . @ . @ @ . . @ @ . . . @ . . @ . @ . @ . @ . @ @ . @ . @ . . @ . @ . . @ . @ . @ . @ . @ . @ . @ . @ . @ @ . . . @ 
@ @ . . @ . @ . @ @ . . @ @ @ @ . @ . . @ . . @ . @ @ @ @ @ . . . @ . . . @ . @ . . . @ @ . . . @ . @ . @ @ @ . @ @ @ . . . . @ . . @ @ @ @ . . @ @ . @ @ . . . . @ . . @ @ . @ @ @ @ @ . . @ @ @ @ . @ 
@ @ @ @ @ @ . . @ . . @ . @ @ @ @ . . @ . . @ . . . . . @ . @ . @ @ @ . @ @ @ . @ . @ . . . @ . @ . . . . . . @ . . . . @ @ . . @ . @ . @ . @ @ . . . @ . . @ . @ . @ . . . . . @ @ . . . @ . @ @ . @ @ 
@ @ @ . . . @ . @ @ . . . . @ @ . @ . . @ @ . @ . @ . @ . . . . @ . @ @ @ @ @ . @ . @ @ . @ . . @ @ . @ . @ . . @ @ . @ . . . @ . . . . . . . @ . @ . @ . @ @ . . . . @ . @ . @ . . . @ . . . . . . . @ 
@ . @ @ @ . . . @ . . @ @ @ . . . . . @ . @ . . . @ @ . @ . @ @ . . . @ @ @ . . . @ . . . @ @ . . . @ . @ @ @ . @ . . . @ . @ @ @ . @ . @ . @ . @ . . @ . @ . . @ . @ . . . @ . @ @ . . @ @ . @ . @ . @ 
@ . @ . . . @ . . @ . . . @ . @ . @ . . . . @ @ . @ . . . . . . @ . @ . @ . @ . @ @ @ . @ . . . @ . @ . @ . . . . @ . @ @ @ @ @ @ . . @ @ . @ . . . @ . . @ @ . . @ . . @ . . . . @ . @ @ . . . @ @ . @ 
@ . @ @ . @ . . @ @ . @ . . @ . . . @ . @ @ . . @ . . @ . @ @ . . . . . . . . . @ . . . @ . @ . . @ . . . . @ . @ . . . @ @ . @ . @ . . . @ . . @ . . @ . . @ . @ . @ @ @ @ @ . @ . @ . . . @ . . . @ @ 
@ . . @ @ @ @ . . @ @ . . @ @ @ . @ @ . @ @ . @ @ . @ . . @ @ @ . @ . @ . @ . @ . @ . @ @ @ . . @ . . @ . @ . @ @ @ . @ . . . . . . . @ @ . @ . . @ . . @ . @ . . . . . . . . @ @ . . . @ . @ . @ . . @ 
@ . @ . . . . . @ @ . @ . . @ . . . . @ . . . . . . @ @ . . @ . . @ . . @ . . . . @ . @ @ . @ . @ @ @ . . @ . . . . . @ . @ . @ . @ . . . . . @ @ . . @ @ . @ . @ . @ . @ . @ . . @ @ . @ . @ . . @ . @ 
@ . . . @ @ . @ @ . . . . @ . @ . @ @ @ @ @ . @ . @ . . . @ @ @ . @ @ . @ . @ . @ @ @ . . . . . . @ @ . @ @ . @ . @ . . @ . @ @ @ . . @ . @ . . . @ . @ . . @ . . @ @ . . @ . @ . . @ . @ . @ . @ @ @ @ 
@ @ @ . . @ . . . @ . @ . @ . . . @ . @ @ @ @ @ . @ @ @ . @ @ . . @ @ @ . . . @ . . @ . @ @ . @ @ @ . @ . . . @ @ . . @ @ . @ @ @ @ . . @ . . @ @ @ @ . @ . . @ . . . @ . . . . . @ . @ @ . @ . . . . @ 
@ @ @ . @ . . @ . . @ . . . @ . @ . . . @ @ . . @ @ . @ . @ . @ . . @ . @ . @ . . @ . . . . @ . @ . . . . @ . @ @ @ . . . . . . @ @ @ . @ . @ . @ . @ . @ . @ @ . @ . . @ . @ . @ @ . @ @ . @ . @ . @ @ 
@ . . . . @ . . @ . @ @ . @ @ . . . @ @ @ . @ . @ . . @ @ . . . . @ . . . . . @ . . @ . @ . . . . @ @ . @ . . . . @ . @ . @ @ @ @ @ . . @ . @ . . . . . @ . @ @ @ . . @ @ . . @ . @ . . @ . @ @ @ . @ @ 
@ @ @ . @ . @ . . @ . . . . @ . @ @ . @ . . . . . @ . @ . @ . @ . . @ @ @ @ . . . @ @ @ . . @ . @ . @ @ . . @ @ @ . @ . . . . . @ . @ @ . . @ . @ . @ @ . . @ @ @ @ . . . @ . . . . . @ . @ . @ . @ @ @ 
@ . @ . @ . . . @ @ . @ . @ @ @ . @ . . @ . @ @ . . . . . . @ . @ @ . . . . . @ . . . . . @ @ . . . . . @ . . @ . . . . @ . @ . @ . @ . @ . @ @ . . . @ @ @ . . . . @ . @ . . @ . @ . . . . . . . @ @ @ 
@ . . . @ . @ . . @ . . @ @ @ @ . . . @ . . @ . @ . @ . @ . . . @ @ . @ . @ . . @ . @ @ . @ . . @ . @ . . @ . . @ . @ . . @ . . @ . . . . . . . @ . @ . @ @ @ . @ . . . @ @ @ @ . . @ . @ . @ . @ @ @ @ 
@ @ @ . . @ . . @ . . @ @ @ @ . @ @ . . @ @ . . . @ @ @ @ . @ @ . . @ @ @ . . @ @ . @ @ . @ . @ @ . . @ . . @ . @ @ . . @ @ @ . @ . @ . @ . @ . . . . . @ . . . @ . @ . . . . . @ . . @ @ . @ . . @ @ @ 
@ . @ @ @ . . @ . @ . . @ @ . . @ . @ . @ . @ . @ . @ . @ . @ . @ . @ . . . @ . @ @ @ @ @ . . @ . . @ . . @ @ @ . . . @ @ @ @ . @ @ . . . @ . @ . @ . @ @ @ @ . . @ . @ . @ . @ @ . @ . @ . . @ . . @ @ 
@ . @ . . @ @ . . . . @ @ . @ . . . . . . . . . . . . . . . . . . . . @ . @ . . @ @ @ . @ @ . . @ @ . @ . @ @ @ @ @ . . @ . @ @ @ @ @ . @ @ . . . . @ . @ @ @ @ . @ . . . . @ . @ . . . . @ @ . . @ @ @ 
@ . . @ . @ . @ . @ . @ . . @ @ @ . @ . @ . @ . @ @ @ @ @ @ @ @ @ @ . . . . @ . . @ . . . . . @ . . . @ . @ . @ . @ . @ @ . @ @ @ @ . . . . @ . @ . . . @ @ @ . . @ @ . @ . . . . @ @ . @ . @ @ . . @ @ 
@ @ . . . . . . . . @ . @ . @ . @ . @ @ . . . @ . . . . . . . . . . . @ . @ @ . @ . . @ . @ . . . @ @ . . . . . . @ @ @ . . . @ . . @ . @ . . @ @ . @ . @ @ @ . @ . . @ . @ @ @ . . . @ . . . @ . @ . @ 
@ . . @ . @ . @ . @ . . . . . . . . @ . @ . @ @ @ . @ . @ . @ @ . @ . @ . @ . . . . @ . @ . . @ . . . @ @ . @ . @ . . . @ @ . . @ . . @ . . @ @ @ @ . . @ . . @ . . @ . . . @ @ . @ . . . @ . . @ . . @ 
@ . @ @ @ . . . @ . . @ @ . @ . @ . . . . @ . @ . @ . . @ . @ @ . . @ . . . @ @ . @ . . . . @ @ . @ @ . @ . . @ @ @ @ . @ . @ . @ @ . . @ . . @ @ @ @ . . . @ . @ . @ @ . @ . . @ . @ . @ @ . @ . . @ @ 
@ . @ @ @ @ . @ . @ . . @ . . @ . . @ . @ @ . @ . @ @ . . @ . . . @ @ @ . @ @ @ @ . . @ @ . @ @ @ . . . . . @ . . . . . . . . . @ . @ . @ . @ . @ . . . @ . . . . . . . . . @ . @ . @ . @ . @ @ . @ . @ 
@ . . @ @ @ @ . . . . @ . . @ @ @ @ . @ @ . . . . @ . @ . . @ . @ . @ . . @ @ @ @ @ . . . @ . @ . . @ . @ . @ @ . @ @ . @ . @ . . . . . . . . . . @ @ . . @ . @ @ . @ @ . @ . . . . . . . . . . . . . @ 
@ . @ @ . @ @ @ . @ . @ . @ @ . @ @ . . . @ . @ . . . . . @ @ @ . . . . @ . . . . @ @ @ @ . . . @ . . @ . . @ . . . . @ @ @ . @ . @ @ . @ . @ . @ . . . @ @ @ @ @ . @ @ . . @ . @ . @ @ . @ @ . @ . @ @ 
@ . @ . . . @ . @ @ @ . . . . . . @ . @ . @ @ . @ . @ . @ . @ . @ . @ . . @ . @ @ . @ . @ . @ . . . @ @ . @ . @ . @ . . @ @ . . . @ . @ . . . @ . . @ @ @ @ @ @ @ @ @ . @ @ @ @ . . . @ @ @ @ @ . . . @ 
@ . @ . @ . @ . . @ . @ . @ . @ @ . @ . . . . . . . @ @ @ . @ . @ @ . . @ . . . @ . . . . . @ . @ . @ @ . @ . . @ . . @ . . @ . @ @ . . @ . @ . @ @ @ @ @ @ @ @ @ @ . . @ @ @ @ @ . @ @ @ @ @ @ @ . @ @ 
@ . @ . @ . . . @ @ . @ @ @ @ @ @ . @ @ . @ . @ @ @ . . . . . . . . @ . . @ . @ . @ @ . @ . . @ . @ . . . @ . @ @ @ @ . . @ @ @ @ . . @ . . . . @ @ @ @ @ @ @ @ @ . @ . @ @ @ @ @ @ @ @ @ @ @ @ @ . @ @ 
@ @ . @ . @ . @ @ . . . . @ @ @ . . @ . . @ . . . @ @ . @ @ . @ @ @ @ @ . . . . . . @ @ @ @ @ . . . @ @ . . . . . . . @ . . @ . . @ . . . @ . @ . @ . @ . @ @ . @ . . . . @ @ @ @ @ @ @ @ @ @ @ @ @ @ @ 
@ . . @ . . . . . . @ @ @ . @ . @ . @ . @ . . @ . . @ @ . . . . . . . @ . @ @ . @ . . . @ @ @ @ @ . @ . @ . @ . @ . @ . . @ . . @ . . @ . @ . . . . . . . . . . . . @ @ @ @ @ @ @ @ @ @ @ @ @ @ @ @ @ @ 
@ . @ . . @ . @ @ . . . . . . . . . . . @ @ . . @ @ . . . @ . @ @ . @ . . @ @ . . @ . @ . . . . . . . . . . @ . . @ . @ . @ @ . @ . @ . @ . . @ @ @ @ . @ . @ . @ . . @ @ @ @ @ @ @ @ @ @ @ @ @ @ @ @ @ 
@ . . . @ . . @ . @ . @ . @ . @ . @ . @ . . . @ . @ @ . @ . @ . . . . @ . . . @ . . @ @ . @ . @ . @ @ . @ . @ . @ @ . . . . . . . . . . . @ @ . . . . . . @ . . . @ . . . . @ @ @ @ @ @ @ @ @ @ @ @ @ @ 
@ @ @ . . @ @ @ . @ @ @ . . @ . @ . @ . . @ . . . . @ @ @ . @ @ . @ . . . @ . . @ . . . @ @ @ . . @ . @ . . @ @ . . . @ . @ . @ . @ @ . @ . . . @ @ @ . @ . @ . @ . . @ . @ @ @ @ @ @ @ @ @ @ @ @ @ @ @ 
@ . . . @ @ @ . . . . . . @ @ . @ . @ @ @ . . @ . @ . @ @ . . . . @ @ @ . @ . @ . . @ . . @ . @ . . . . @ . . . @ @ . @ @ . . . @ . @ . . @ . @ . . . . . . . @ @ @ . . @ . . @ @ @ @ @ @ @ @ @ @ @ @ @ 
@ . @ . . @ @ @ . @ . @ @ . . . . . . . . . @ @ . . . . . @ @ @ @ . . . . . @ @ . @ . . @ @ . @ . @ . @ @ . @ . . @ . . . @ . @ . . . . @ @ @ . . @ @ . @ . @ @ @ . . @ . . @ @ @ @ @ @ @ @ @ @ @ @ @ @ 
@ @ @ . @ @ @ . @ . . . @ @ . @ @ . @ . @ . . . @ . @ . @ . . . . . @ . @ . @ . @ @ . @ . . . . . @ @ @ . . . @ @ @ @ . @ @ @ @ @ . @ @ @ @ . @ . . . @ . . . . @ @ . . @ . @ . . @ @ @ @ @ @ @ @ @ @ @ 
@ . . . . @ . . . @ . @ @ . . . . @ . . . @ @ . @ . . @ . @ . @ . @ . . @ . . . . . @ . . @ . @ . @ . @ @ . @ . @ @ @ @ @ @ . @ @ . @ . @ . . @ . @ . @ @ . @ @ . . @ . . . . . @ @ @ @ @ @ @ @ @ @ @ @ 
@ @ @ . @ . @ . @ @ . . @ @ . @ . . @ . @ . . . @ @ @ . . . . . @ @ @ . @ . @ . @ @ . . @ @ @ . . @ . . . . . . . . . . @ . . . . . @ . @ @ . . . . @ . . . . . . @ @ @ . @ . @ @ @ @ @ @ @ @ @ @ @ @ @ 
@ . . . . . . . . . @ @ . @ . @ @ @ . . @ @ . @ . . @ . @ . @ . . @ @ @ . . . @ @ @ @ . . @ . @ . @ @ . @ . @ . @ @ @ @ . . @ . @ . . . . . @ @ . @ @ @ . @ . @ . @ @ . . . @ @ @ @ @ @ @ @ @ @ @ @ @ @ 
@ @ @ @ @ . @ . @ @ . @ . . . . . @ @ . . @ @ . @ . . @ . . . @ . @ @ . . @ . . . . . @ @ . . @ . @ @ @ . . @ . . . @ . . @ @ @ . . @ @ . @ . . . . @ . . @ . . @ @ @ . @ . . @ @ @ @ @ @ @ @ @ @ @ @ @ 
@ @ @ @ . @ . @ @ . . . . @ . @ . @ . . @ @ . . @ . @ . @ . @ @ @ @ . . @ . . @ . @ . . . @ . . . @ @ @ @ . . @ @ @ . . @ . @ . @ . @ . . @ . @ . @ . @ @ . . @ . @ . @ . . @ @ @ @ @ @ @ @ @ @ @ @ @ @ 
@ @ . . . . . . . . @ . @ @ . @ @ @ @ . @ @ @ . . . . . . . . . @ . @ . . @ . . @ . . @ . @ @ . @ . . . . . @ . @ . @ . @ . . . @ @ . @ . . @ . . . . . . @ . . . . . @ @ @ @ @ @ @ @ @ @ @ @ @ @ @ @ @ 
@ @ @ . @ . @ @ @ . @ @ . . . @ @ @ . @ . . . . @ . @ . @ . @ . @ . @ . @ . . @ . @ . @ @ . . . @ @ . @ @ . . . . . @ . . @ @ . @ @ . . . @ . @ . @ . @ @ @ @ @ @ @ . . @ @ @ @ @ @ @ @ @ @ @ @ @ @ @ @ 
@ @ . @ . . @ . @ @ @ . @ @ . @ . . . @ . @ . @ . . @ @ @ . @ @ . . . . @ @ . . . . @ . . . @ @ . @ @ . . . @ . @ @ . . @ . . . . . . @ . @ . . . . @ @ @ @ . @ @ @ . @ @ @ @ @ @ @ @ @ @ @ @ @ @ @ @ @ 
@ . . . . @ . . . . . . . . . @ @ @ . . . @ . . @ @ . . . @ @ . @ @ . @ . . . @ . @ @ @ @ @ . . . . . . @ . . @ . . @ . @ @ . @ . @ . . @ @ . @ . @ . @ . . . @ @ @ @ @ @ @ @ @ @ @ @ @ @ @ @ @ @ @ @ @ 
@ . @ @ . @ @ @ . @ @ . @ . @ . . . . @ @ . . @ . . . @ . . . . . . . . @ . @ . @ . @ @ . . . @ @ @ . @ . . @ . @ . @ . . . @ . @ . . @ . @ @ . . @ . . @ . @ @ @ @ @ @ @ @ @ @ @ @ @ @ @ @ @ @ @ @ @ @ 
@ @ . . . @ @ . @ @ . @ . . . @ . @ . . . @ . . @ @ . @ @ . @ @ . @ . @ . . . . . . . @ . @ @ . . @ @ @ @ . . . . . @ . @ . . . @ @ @ @ . @ . @ . . . @ . . @ @ @ @ @ @ @ @ @ @ @ @ @ @ @ @ @ @ @ @ @ @ 
@ @ @ . @ . . . . . . . . @ . @ @ . . @ @ @ @ . @ . . . . @ . . @ . . . @ . @ . @ . @ . . . @ @ . @ . @ . . @ . @ . @ . . @ . @ . . . . . . . . . @ . . @ . @ @ @ @ @ @ @ @ @ @ @ @ @ @ @ @ @ @ @ @ @ @ 
@ @ @ @ @ @ . @ . @ . @ . @ . @ . @ . @ . @ @ . @ . @ . @ @ @ . . . @ @ . . @ . . @ . . @ @ . . . . . . . @ . . . @ . . @ @ @ . @ . @ . @ @ . @ . . @ . . . . . @ @ @ @ @ @ @ @ @ @ @ @ @ @ @ @ @ @ @ @ 
@ @ @ @ @ @ @ @ @ . . . @ @ @ . . . . . . . @ @ @ . @ @ . . . @ . @ @ . @ . @ . @ . @ . @ @ @ @ . @ . @ . @ @ . @ @ . @ . @ . . @ @ . . . . @ . . @ @ . @ @ @ . . . @ @ @ . @ @ @ @ @ @ @ @ @ @ @ @ @ @ 
@ @ @ @ @ @ @ @ @ . @ . . . @ @ . @ . @ . @ . @ . @ . @ @ . @ . . @ . . . . . @ @ . . . @ @ . . . @ @ . . . @ . . . @ . . . @ . @ . @ . @ @ @ @ . . . @ @ @ . . @ . @ @ . . . @ @ @ @ @ @ @ @ @ @ @ @ @ 
@ @ @ @ @ @ . . . . @ . @ @ @ @ @ . . . @ @ . @ . @ . . . . . . @ @ @ . @ . @ . . @ @ . . @ . @ @ @ @ @ . @ . @ . @ . . @ @ . . . . . @ @ . @ . @ . @ @ @ @ . @ . . . . . @ @ @ @ @ @ @ @ @ @ @ @ @ @ @ 
@ @ @ @ @ @ @ . @ . @ . @ @ . @ @ @ @ @ . . . . . . . @ . @ @ . . @ . @ . . . . @ . . . @ @ . . @ . . . . . . @ . @ . @ @ @ . @ @ @ @ . @ . . . . . @ @ @ @ @ . @ @ . @ . . @ @ @ @ @ @ @ @ @ @ @ @ @ @ 
@ @ @ @ @ @ @ @ . . . @ @ @ . . @ @ @ @ @ . @ . @ . @ . . . @ @ . @ . @ @ . @ @ . @ @ @ @ @ . @ . . @ @ . @ . . @ @ . . . . . @ @ . . . . . @ . @ . . @ @ @ @ . . . . . @ . @ @ @ @ @ @ @ @ @ @ @ @ @ @ 
@ @ @ @ @ @ @ @ @ . @ . @ . @ . @ . @ @ . . . @ . . @ @ . @ . . . @ . . . . . . . . @ . @ @ @ . . @ . . . . @ . . . . @ . @ . @ @ @ . @ . @ . . . @ @ @ @ @ @ @ . @ . @ . @ . . @ @ @ @ @ @ @ @ @ @ @ @ 
@ @ @ @ @ @ @ @ @ . @ . . . . . . . . . . @ . . @ @ . . . @ . @ . @ @ @ @ . @ @ @ . . . . @ . . @ . . @ . @ . . @ . @ . . . @ @ @ @ @ . . . @ . @ @ @ @ @ @ @ @ @ . . @ . @ . @ . @ @ @ @ @ @ @ @ @ @ @ 
@ @ @ @ @ @ @ @ @ . . @ . @ . @ . @ . @ . @ . @ @ @ @ @ . @ . @ @ . . . . . . @ @ . @ . @ @ @ @ . . @ . . @ @ . . @ @ @ . @ @ @ @ @ @ @ . @ @ @ @ @ @ @ @ @ @ @ @ @ . . . . . . . . @ @ @ @ @ @ @ @ @ @ 
@ @ @ @ @ @ @ @ @ @ @ @ @ @ @ @ @ @ @ @ @ @ @ @ @ @ @ @ @ @ @ @ @ @ @ @ @ @ @ @ @ @ @ @ @ @ @ @ @ @ @ @ @ @ @ @ @ @ @ @ @ @ @ @ @ @ @ @ @ @ @ @ @ @ @ @ @ @ @ @ @ @ @ @ @ @ @ @ @ @ @ @ @ @ @ @ @ @ @ @ 
3
80 7 20 41
84 37 92 26
17 91 72 28
