100 100
@ @ @ @ @ @ @ @ @ @ @ @ @ @ @ @ @ @ @ @ @ @ @ @ @ @ @ @ @ @ @ @ @ @ @ @ @ @ @ @ @ @ @ @ @ @ @ @ @ @ @ @ @ @ @ @ @ @ @ @ @ @ @ @ @ @ @ @ @ @ @ @ @ @ @ @ @ @ @ @ @ @ @ @ @ @ @ @ @ @ @ @ @ @ @ @ @ @ @ @
@ . . @ . . . @ . . . . @ . . . . . . . . . @ . . . . . . @ . . . . . . . @ . . . . . . @ . . . . . . @ . . . . . . . . . . . . . . . . . . . . . . . . . . . . . . . . @ . @ @ . . . . . . . . . @ . @
@ . . . . . . . . . @ . . @ . . @ . . . . . @ . . . . . . @ . . . . @ . . @ . . . . . . . . . . . . . . . . @ @ . . . @ . . @ . . . . . . . @ . . . . @ . . . . . . . . . @ . . . . . . @ . . . . . . @
@ . @ . . @ . . . . . . @ . . . . . . . @ . . . . @ . . . . . . . . @ . . . @ . . . . . . . . @ . . . . @ . . . . . . . . @ . . . @ . . . . @ . @ @ . . . . . . . . . . . . . . . . . . . . . . . . . @
@ . @ . . @ . . . . @ @ . . . . . . @ . . . . . . @ . . . @ . . . . . . @ . . @ . . . @ @ . . . . . . @ . . . . . . . . . . @ . . . . . . . . . . @ . . . . . . . . @ @ . . . . @ @ . . . . . @ . . . @
@ . . @ @ @ . . . . . @ . . . @ . . . . @ @ . . . . . . . . . . @ @ @ . . . . . . . . . @ @ . . . . . . . . . . @ . . . @ . . . . . . . . @ . @ . . . . . . . . . @ . . . . . @ . . @ @ . . . @ . . . @
@ . . . . . . . . @ . . . . . . @ . . . . . . . . . . @ . . . . . . . . @ @ . @ @ . @ . . . @ @ . @ . @ @ @ . . . @ . . . . . . . . . . . . . . . @ . . . . . . @ . . @ . @ @ . . . . . . . @ @ . @ . @
@ . . . . @ . . . . . . . @ . . . . @ . . . . . . . @ . . . . . . . . . @ . . . . . . . . . . . . . . @ . . @ @ . . . . @ . . . . . . @ @ . . . . . . . . . @ . . . @ . . . . . . . @ . . . . . . . . @
@ . . . . . @ . . . . . . . . . . @ . . @ . . . . . . @ @ @ . . . . . . . . . . @ . . . . . . . @ @ . . . . . . . . . . . . . . . . @ . . . . . . . . @ . . . . . @ . @ . @ . . . . . @ @ . . . . @ . @
@ . . . . . . . . @ @ . . . . . . . . @ @ . . @ . . . . . . . . @ . @ . @ . . @ . @ . . @ . @ @ . . @ . @ . . @ . . . . . . . . @ @ . @ . . . @ . @ . . @ @ . @ . . @ . . . . @ . @ . . . @ . . . . . @
@ . . . . . . . @ . . . . . . @ . @ . . . . . . . @ . . @ . . . . . . . . . @ . . . . . @ . . . . @ . . . . . . @ . . . . . . . @ . . . @ @ . . @ . . @ . @ . @ . . . . @ . . @ . @ . @ . . . . . @ . @
@ . . @ . . . . . . @ . @ . . @ . . . . . . @ @ . . @ . . . . . . @ . . . . . . @ . @ . . . . . . . @ . @ . @ . . @ . . . @ @ . . . . . . . . . . . . . . . @ . . . . . . . . . . . . . . @ . . . . . @
@ . @ . . . . . . . . . . . . . . . . . . . . . . @ . @ @ @ . @ . . . . @ . . @ . . . . . . . . . . . . @ . @ . . . . . . . . @ . . . . . . . . . . @ . . . . . . . . . . . . @ . . . . . . . . . . . @
@ . . . . . @ . . . . . . . . . . . . . . @ . . @ . . . . . . . . . . . . . . . . @ @ . . . . @ . . . . @ . . . . @ @ . . . @ . . . . @ . . . @ . . . . . . . . . @ . @ . . . . . . . . . . . . . @ . @
@ . @ . . . . . @ @ . @ . . @ . . . . @ . . @ . . @ . . . @ . . . . . . . . . . . . . . . . . @ . . @ . . @ @ @ . . . @ . . . . . . . . . . . . @ @ @ . @ @ . . . . . . . . @ . . @ . . . . . . . . . @
@ . . . . . . . . @ . . . . @ @ . . @ . . . . @ . . . . . . @ . . . . @ @ . . @ . . . . . @ . . . . . . . . . @ . @ . . @ . @ @ . . . . . . @ . . . . . . . @ . . . . . @ . . @ . . . . . @ . . . . . @
@ @ . . @ . . @ . . . . . . @ . . . . . . . . . . . . @ . . . . . @ . . . . . . . . . . @ . . @ . . . . . @ . . . . . . . . . . . . . @ . . . . . . . . @ . . . @ . . @ . @ . . . . . . @ . . @ . . . @
@ . . @ . . . @ . . . . @ . . . . . . @ . . . . . . . @ . . . . . . . @ . . . . . . @ . . . @ . . . . . @ . @ . . @ . . @ . . . . . . . @ . . . . . . @ . . @ . . . @ . @ . . . . . . . . . . . . @ . @
@ . . . . . @ . @ @ . . . . . . . @ . . @ . . . . . . . . . . @ @ . . . @ . . . . . . . . . . . . . . . . . . . . . . . . . . @ . . @ . . . . . . . . . . @ . @ . . . . . . . . . . @ . @ @ . . . . . @
@ . . . @ . . . . . . . . . . . . . . . . @ . . @ . . . . . . . @ . . @ . . . . . @ . . . . . . . @ . @ . . @ . . . . . @ . . . . . . . . . . . . . @ @ . . . . . . . . . . @ . . . . . . . @ . . . @ @
@ . . . . . @ @ . . @ . . . . . . @ . . . . @ . @ . . . . . . . . . @ . . @ . @ . . . . . @ . . . . . . . . . . . . . . . . . . . . . . . . @ . . . . @ . @ @ . . . . . . . . @ . . . @ . . . . . . . @
@ . . . @ . . . . . . . @ . . . . . . . . . . . . @ . . . . . . . . . @ . . . . . . . . . . @ . . @ . . @ @ . . @ . . . . @ . . . . . . . . @ @ . . . @ . . . . . . . . @ . . . . . . . . @ . . . . @ @
@ . @ . . . @ @ . . . . . . . . . . . . . . . . . . . . . . . . . . . . . . . . . . . . . @ . @ @ . . . @ . @ . . . . . . . . . . @ . . . . . @ . @ @ @ . . . . . . . . . . . . . . . @ @ . . . . . . @
@ . . . . . . @ . . . . . . . @ . . . . @ @ . . . . . . . @ . . . . @ . . @ . . . . . @ . . . . . . . . . @ . . . . @ . @ @ . . . . . @ . @ . @ @ . . . . . @ @ @ . . . . . . . . . @ . . . . . @ . . @
@ . . . . . . . . . . . . . . . . @ . . . . @ . . . . . . . . . @ @ . . . . . @ . . . . @ . . . . . . @ . . . . . @ . . . @ . . . @ . . . @ . . . . . . . . . . . . . . . @ . . . . . . . @ . . . . . @
@ . @ . . @ . . . . . . . . . . . . @ . . . . . . . . . . @ . . . . . . . . . . . . . . . . . . . . @ . @ . . . @ . @ . . . . . @ . . @ . . @ . . @ @ . . . . @ . . . . . . @ . . . . . . . . . . . @ @
@ . . . . . . . . @ . . @ . . . @ . . @ . . . . . . . . @ . . . . . @ . . . . . @ . . . . . . . . @ . . . @ @ @ . . @ @ . . @ . @ . . . @ @ . @ . @ . . . @ . . . . @ @ . . . @ . . . . . . . . . @ . @
@ . . @ . @ @ . . . . . . . . . . . . @ . . . . . . @ . . . . . . . . . . . . . . . . . @ . . . @ . . . @ . . . . . . . . . @ . . . @ . . . . . . . . . . . . @ . @ . . @ . . . . . . . . . @ . @ . . @
@ . . . @ . @ . . . @ . . . . . @ . . . @ . . . . . . . . . . . @ . . @ . @ . . . . . . . @ @ . @ . . . . . . @ . . . . . . . . . . . . . . @ . . . . . . . . . . @ . @ . . . . @ . . . . @ . @ @ . . @
@ . @ . . . . . . . @ . . . . . . . @ . . @ . . . . . . . . . . . @ . . . @ . . . @ . . . . . . . . . . @ . . . @ . . @ . @ . . . @ @ . . @ . . @ . @ @ @ . . . . . . . . . . . . . . . . . . . . . . @
@ . . . . @ @ . . . . . . . . . . . . . . . . . . . . @ . . . . @ . . . . . . . . @ . . . @ . . . . . @ . @ @ @ . . . . . . . . . . . . . . . . . @ . . . . @ @ @ . . . . . . . . . @ @ . . . . . . . @
@ . . . . . . . . . @ . . @ . . . . . . . . . . . . . . . . . . . . @ . . . . . . . . @ . . . . . . . . . . @ . . . . . . . . . . . . . @ . . . . . @ . . @ . . . . . . @ . . . . . . . . @ . . . . . @
@ . . @ @ . . . @ . . . . . @ . . . . . @ . @ . . @ . . . . @ . . . . . @ . . . @ . . . . . . @ . @ . . . @ . @ . . @ . . . . @ . . . . . @ . . . . @ . . . @ . . . . . . . . . @ . . . . . @ . . . . @
@ . . @ @ @ . . @ @ . . . . @ . . . @ . . @ . . @ . . . . . . @ . . . @ . . . . @ . . . @ . . . @ . . . . . . . . . . . . @ . . . @ . . . . . @ . . . @ . . . . . . . . . . @ . . . . . @ . . . . . . @
@ . . . . . @ . . . . . . . . . @ . . . . . . . . . . . . . . @ . . . . . @ . . . @ . . . @ . . . . . . . . . . . . @ @ . . . . . . . @ . . . @ . . . . . . . . . . . . @ . . @ . . . @ . @ . . . @ . @
@ . . . . @ . @ . . . . . . . . . . . . . . . . . @ . @ . . . . . . . . . . . . . @ . @ . . . . . . @ . . . . . @ . @ . . @ . @ . . . . . . . . . . @ . . . . . . . . . . @ @ . . . . . . . . . . . . @
@ . @ . . @ . @ @ . . . . @ . . . . . . . . . . @ . . @ . . . . . . . . . . . . . . @ . . @ . . . . . . . . @ . . . @ . . . . . . . . . @ . . . . . . . . . . . . . . . . . . . . . . . @ . @ . . . . @
@ @ . . . @ . . . @ . . . . @ . . . . . . . . . . @ . . . @ . @ . @ @ . @ . . . . . . . . . . . . @ . . . . . . . . . . @ . . . . . . . . @ . . . @ . @ @ . @ . . . . @ . . . @ . @ . @ . @ @ . @ @ . @
@ . . . . @ . . . . @ . . . . . . . @ . . . . . . . @ . . . . . . . . . . . . . @ . @ . . . . . . . @ . . . . . . . @ . . @ . . . . . . . . . @ . . . . . . . @ . . . . . . . . . . . . . @ . . . . . @
@ . . . . . . . . . . . . @ . . . . . @ . . . @ . . @ . . @ . . . . . @ @ . . . . . . . . . . . . . . . @ . . . @ @ @ . . . . . . @ . . . . . . @ . . . . . @ . . . . . @ . . . @ . . . . @ . . . @ @ @
@ . . . @ . . . . . . . . . . . . . @ . . . . @ . . . @ . . . . . @ . . @ @ . . . . @ . . . . . . . . . . . . . . . . @ @ . . . . . . . . @ . . . . . @ . . @ . . . . . . . . . . . . @ . . . . . . . @
@ . . . . . . . @ . . . . . . . . @ . . . @ @ . . . . . @ @ . @ . . . . . @ . . . @ @ . . @ . . @ . @ . . . . . . . @ . . @ . . . . . . . . . @ . . @ . . . . . . . . . . . . . . . . @ . @ . . . . @ @
@ . . . . @ . . @ . . @ . . . @ . . . @ . . @ . . . @ . . @ . @ . . . . . . . . . . . . . . . . . . . . . . . @ . . @ . . . . . . . . . . . . . . @ . . . . . . @ . . @ . . . . . . @ . . . . . . . . @
@ . @ @ @ . . . . . @ . . @ . . . . . . . @ . . . @ . . . . . . @ . . . . @ . @ . . . . . @ . . . . . @ . . . @ . . . . . @ . . . . . . . . . . . @ . . . . @ . . . . . @ . . . . . . @ . . @ . . . . @
@ . . . . . . . . . . . . @ . . . . @ . . . . @ . . . . . . . . . . . @ @ . . . . . @ @ . . . @ . . @ . @ . . . . . . . . . @ . . @ . . . . . . . . . @ . @ . . @ . . @ . . . . . . . . . . . . . . . @
@ . @ . . . . . . . . . . . . @ . @ . @ . @ . . . @ . . @ . @ . . . . . . . . . . @ . . . . . . . @ . @ . @ . . . . @ . . . . . . @ . . @ . @ . @ . . . . . . . . @ . . . . . . . . . . . . @ . . . . @
@ . . @ . . . . . . . . @ . . . . @ . . . . . . . . @ . . . . . . . . . . . . . . . @ . . @ @ . . . . . @ . . . . . . . . . . . . . . . . @ . . . . . . . . . . . . . @ . . . . . . . . . . . . . . . @
@ @ . . @ . . . . @ . . . . . . @ . . . . . @ . @ . . . . . . . . . . . @ . . . . . @ . . . . . @ . @ . . @ . @ @ . . . . @ . @ . . @ . @ @ @ . @ @ . . . . . . . @ . . . . . . @ @ . . . . . . @ . . @
@ . . . . . . . . . . @ . . . . . @ . @ . . . @ . @ . . . . . . @ . . @ . . . . . . . . . . . . . . . . . . . . . . . . @ . . @ . . . . . . . . . . @ . . . . @ . . @ . . @ . . . . . . . . . . . . . @
@ . . . . @ . . . . . . . . . . . . . . . . @ . . . . . . @ . . @ . @ . . . . @ . @ . @ . . . . . . . . . @ . . . @ . . . . . . . @ . . @ @ @ . . . . . @ . . . . . . . . . . @ . . . . . . . . . . . @
@ . @ . . . . . . . @ . . @ . . . @ . @ @ . . @ . @ . . . @ . . . . @ @ . . . . . . . . . . . . . . . @ . . . @ . . . . . @ . . . . . . . . . . . @ . . . . . . . . @ . . . . . . . . @ . . @ . @ . . @
@ . @ . . . . . . . @ . @ . . @ @ . . . @ . . . @ . . . . @ . . @ . . . @ . @ . . . . @ . @ . . @ . . . . @ . . . @ . @ . . . . . @ . . @ . . @ . . . . @ . . @ . . . . . . . . . . . . . . . . . @ . @
@ . @ . . . . . @ . . . . @ . . . @ . . @ . . . . . . @ @ . . . . @ . . . . . . @ . . . . . . @ @ . . . . @ . . . . . . . . @ @ @ . . . . @ @ . . . . . . @ . . . . @ . . @ . . @ @ . . . . . . . @ . @
@ . . . @ . . @ . . . . . . . @ . . . . @ . @ . . . . . . . . . . . . . . @ . . . @ . . . . . . . . . @ . . . . . . . . @ . . . . @ . @ . . @ . @ . . . . . . . @ . . . . . . . @ . . @ . . . . . @ @ @
@ @ @ . . . . . . . . . @ . . @ . . . @ . . . . . . @ . . . . @ . . . . . . @ . @ . . @ . . . . . . @ . . . . . . . . @ . . . . . . . . . . . . . . . . . . . . @ . . . @ . . . . . . . . @ . . . . . @
@ . . . . . . . . @ @ . . . . . . . . . . . . . @ . . . . . . . . . . . . @ . . @ . . . . @ . . . @ . . . . . . . . . . . . . . . . . . . . @ . . @ . . @ . . . . . . @ . @ @ . . . . . . . . . . . . @
@ @ . . . @ . . . . . @ . . . . . . @ . . . . . @ . @ . . @ @ . . . . . . . . @ . . . . . . . @ . . . . . . @ . . . . . . . . . . . @ @ . @ . . @ . . @ @ @ . . @ . . . @ . . . . . . . . . . @ . @ . @
@ @ . . . @ . @ . . . . . . @ . . . . @ . . . . . . @ @ . . . @ . . @ . . . . . . @ . @ . . . . @ . . . . . . @ . . . . . . . . . @ . . . . . . . @ . . . . . . . . . . . @ . @ . . . . @ . . . . . . @
@ . . . . . . @ . . . . . . @ . @ . . . . . . . . . . . . . @ . @ @ . . . . . . . . . . . . . . . . . . . . . . @ . . . . . . . . . . . . @ . . @ . . . . @ @ . . @ . . . . @ . . . @ . . . . . . . . @
@ . . . . . . . . . . . . . . @ . . . . . . @ . @ . . . . @ . . . @ . . . . . . . . . . . . @ . . . . . . . . @ . . . . . . @ . . @ @ . @ . @ . . @ . . . @ . . @ . . . . . . . . @ @ . . . . . @ @ . @
@ . . . . . . . . . . . . . . . @ @ . . . . . . . . . . . . @ . . . . @ . . . . @ @ . . . . . @ . . . @ @ . . . . . . @ . @ . @ . . . . . . . @ . . . . @ @ . . . . @ . @ . @ . . . . . . . . . . . . @
@ . . . @ . . . . . . . @ @ . . @ . @ . . . . . @ @ @ . . . . . . . . . @ @ . . . . . . . . . . . . . . . . . . . . @ . . . . . . . . @ . . . . . . . @ . @ @ @ . . . . . . . @ . . . @ . @ . . . . . @
@ . . . @ @ @ . . . . @ . . . . . . . . . . . . . . . @ @ . . . . . . . . . . . . . . . . . @ . @ . . . . . . . . . . . @ . . . . . . . . @ . . @ . . . . . . . . . . . . . . . . @ . @ . . . @ @ . . @
@ . . @ . . . . @ . . . . . @ . @ . . . . . @ . . . . . . . . . . @ . . @ . . . . @ @ . . . . . . @ @ . . . @ . @ . . . . . . . . . . . . . . . . . . . . . . . . . . . . . @ . . . . . . . . @ . @ . @
@ . . . @ . . . . . . @ . . . . . . @ . . . . @ . . . @ . . . . . . . . @ . . . @ . . . . . @ . @ . @ . @ . . . . . @ . . . @ . @ . . . . . . . @ . . . . . . . . . . . @ . . @ . @ . . . . . . @ . . @
@ . . . . . @ . . . . . . . . . . . . . . . @ . . @ . . . . . . @ . . . . . . . . . . . . . . . . @ . . . . . . . . . @ . . . . . . @ . . . . . . . . . . . . . . @ . . . . @ . @ . . . . @ @ . . @ . @
@ . . . . @ . . . . . . . . . . . . . . . . . . @ . . . . . . . @ . . @ @ . @ . . . . . . . . @ @ . . . . @ . . . . @ . @ . . @ . @ . . . . . . . . . . . @ . . . @ . @ . . . . . . . . . . . @ . . . @
@ . . . . . . @ . . . @ . . . @ @ @ . . . . @ . @ @ . . . . . . @ . . . @ @ . . . @ . @ . . . . . @ . . . . . . . . . . . . . . @ . . . . . . . . . . . . . . @ @ . . . . . . @ @ . @ . . . . . @ . . @
@ . @ . @ . @ . . . . . @ . . @ @ . . @ . . . . . @ . . . . . @ . . . . @ . . @ . . . . . . . . @ @ . @ . . . . . . . . . @ . . . . . . . . . . . . . . . . . . . . @ . . . . . . . . . . . . . @ . . @
@ . . . . @ . . . . @ . . . . . . . @ . . . . . . . . . . . . . . @ . . @ . @ . . . . @ . . . @ . . . . . . . . . @ @ . . . @ . . @ . @ . . . . . . . @ @ . . @ . . . @ . @ . @ . . @ . . . @ . . . . @
@ . @ . . . . . . . . @ . . . . . . . @ . . . . . . @ . @ . @ . . . . . . . . . @ . . . . . . . . . . . . @ @ . . . @ @ . . . . . . . . . . . @ . . . . . . . . @ @ . . @ . . . . @ . . @ . @ @ . . . @
@ . . . @ . . @ . . @ . . @ . . . . @ . @ . @ . . @ . . . . . . . . @ . . . . . @ @ . . . . . . . @ . . @ . . . @ . . . . . . . . . . . . @ @ . . . . @ . @ . . . . . . . . . @ @ . @ . . . . . @ . . @
@ . . @ . @ . . . . . . . . . . . . . @ . @ . @ . . @ . . . . . . . . . . . . . @ . . . . . . . . . . . . . . . . . . . . . . . . . . . . . @ . . . . . . @ . . . . . @ . . @ . . . . . . . . . . . . @
@ . . . @ . . @ . . . @ . . . @ . . . @ . . . @ . . . . . . . . . . . . . . . @ . . @ . . . . . . @ @ . . . @ . @ . . . . . . @ @ . . @ . . . . . . . . . . @ . @ . . @ . . . . @ . . @ . . . @ . . . @
@ . . . . . . . . . . . . . @ . . @ . . . . . . . . . . . . . . @ . @ . . @ . @ . . . . . . . . @ . . . @ . . . @ . . . . @ @ . . . . . . . . . @ . @ . @ @ . @ . . . @ . . . . . . @ . . . . . . . . @
@ @ . @ . . . . . . @ . . . . . . . . @ . @ . . @ . . . . . . . . . @ @ . . . . . . . . . . . . . @ . . . . . . . @ . @ . . . . @ . . . @ . . @ . . . . @ . . . . . @ . . . . . . . . . . . . @ . . . @
@ . . . . . . . . . . . . @ . . @ . . . . . . @ . . . . . . . . . . . . @ . . . @ . . . @ @ . . @ . . @ . . . . . @ . . . . . . . . . . @ . . . . . @ . . . . . . @ . . . . . . . @ . . @ . . . . . . @
@ . . @ . . @ . . . . . . . . . . . @ . . @ . . . @ . . . . . . @ . . . . . . . . . @ . . . . @ . . . . . . . . . . @ . . . @ . @ . . @ . . @ . . . . . . . . . . . . . . . . . . . . @ . . . . . . . @
@ . . . @ . . . @ . . . . . . . . @ . . . . . . . . @ . . . @ . . . @ @ . . . . . @ @ @ . . . . @ . @ . . . @ @ . . . . @ @ . . . . @ . . @ . . . @ @ . . . . . . . . . . . . . . @ . . . . @ . . . . @
@ . . . . @ . @ . . . . @ . . @ . . @ . . . . . . @ . @ . . . . @ . . . . . @ . . @ . . . . . . . @ @ . . @ . . @ . . . . . @ . . . . . . . . . @ . . @ . . . . . @ . . . @ . . . . . @ . . . . . . @ @
@ . . @ . . . . . @ . . @ . @ . . @ . . @ . . . . . @ . @ . . @ . . @ . . . . . @ . . . . . . . . . @ @ . . . . . . @ . . . . @ . . . @ . @ . . . . . . . . . @ . . @ . . . . . . @ . . . . @ @ . @ . @
@ . @ . . . . @ . . @ . . @ . . . @ . . . . . . . . . . . . . . . . . @ . . . . @ . . . @ . @ . @ @ . . . . . . . @ . . . . @ . . . @ . . . . . . . @ . . . . . @ . . . @ . @ . . @ @ . . . . . . . . @
@ . . . . . @ . . . . . . @ . . . @ . . . . . . @ @ . . . . . @ . . @ . . . . @ . . . . . . . . . . . . @ . . @ . . . . . . @ . . @ . . @ . @ . . . . . . . . . . . . . . . @ @ . @ . . @ . . @ . . . @
@ . . . . . . . . . . @ . . . . . . . . . . . . . . . . . . . . . . . . . . . @ . . . . . . @ . . . . . . . . . . . @ . . . . . . . @ . . . . . . . . . . . @ . . @ @ @ . . . . . . . . . . . . . . . @
@ . @ . . . . . . . . . . . . @ . @ @ . . . . @ . . . . @ . . . . . . . . . . . @ . . . . @ . . @ . . . @ . . . . . . . @ . . . . @ . @ . . . . @ . . . . . . . . . @ . . . . . . . . @ . . . . . . . @
@ . . . @ . . . . . . . . . . @ . . . . . . . . . @ . . . @ . . . . . @ . . . . . . @ . @ . . . . . . . . @ . . @ . . . . . . . . . . . . . @ . @ . . . . . @ . @ . . . @ . . . . . . . . . @ . . . . @
@ . . . . . . . . . @ . . . . . . @ . . . . . . . . . . . @ . . . . . @ . @ @ . @ @ . @ . @ . @ . . . . . . @ . . . . . . . @ @ . @ . . . @ . . . . . . . . . . . . @ . . . . . @ . . . . . . @ . . . @
@ @ . . . . . . . . . @ . . @ . . @ @ . . . @ . . . . . . . . . @ . . . . . . . . . . . . . @ . . . . . . . . . . @ . . @ . . . . . . . . @ . @ . . . . . . . . @ . . . . . . . . . . . . . . . @ . . @
@ . . . @ . @ . . . @ . @ . . . . . . . . . @ . . . . @ @ . @ . . . . . . . @ @ . . @ . . . . . @ . . . . . . @ . . @ . . . @ @ @ . @ . . . . @ . . . . . @ . . . @ . . . . . . . . @ . . . . . . . @ @
@ . . @ . . . . @ . . . . . . . @ . . @ @ . . . @ . . @ . . . . . @ . . . . . . . . . . . @ . . . . @ . . . . . . . . . . . . @ . @ . . . . . . . @ . . . @ . . . . . . @ . . . . . . . . . @ . . . . @
@ @ . . @ . . . . . . . . . . . . . . . . . . . . . . . . . . . . . . . . @ . . . . . . . . . . . @ @ . . . . . @ . @ . . @ . . . . . . @ . . @ . @ . . . . . . . . @ . . @ . @ . . . . @ . . @ . . . @
@ . . . . . . @ . . . . . . . . @ . . @ . . . . . . . . . . . . . . . . . . @ @ . . @ . . . @ @ . . . . . . . . . . . . . . . . . . @ . . @ . . . @ . . . @ . . . . . . . . . . @ @ . . . . . . . . . @
@ . . . @ . . . . . . . @ . . . . . . . . . . @ @ @ . . . . . @ . . @ . @ . . . . . . . . . . . . . . . @ . . @ . . . . . . . . . . . . . . @ . . . . @ @ . . @ . . . @ . . . . . . . . . @ . . . . . @
@ . . . . . . . @ . . . . . . . . . . . . . . . . . . @ @ . . . . . @ . . . . @ . @ @ . @ . . . . @ @ . . . . . . . . . . @ . . . . . . . . . . . . . . . . . . @ . . . . . . . . . . . . @ . @ . . @ @
@ . . . . . . . . . . . . . . . . . . . . . . . . . . . . . @ @ . . @ . . . . . . . . . . . . . . . . . . . . . . . . @ . . . . . . @ . . . . . . . @ . @ . . . . . . . . . . . . @ @ . . @ . . . . . @
@ . . . . . . . . . . . . @ . @ . @ @ . . @ . . . . . @ @ @ . . . @ . @ . . . . . . @ . . . . @ . @ . @ . . . . . . . . . . . . . @ . . . . . . . . . . . . . @ . @ @ . . @ @ . . . . . . @ @ . . @ . @
@ @ @ . . . . . @ . @ . . . . . @ . . . . . @ . . . . . . . @ . . . . . . . . . . . . . . @ @ . . . . . . . . . . @ . . . . . . @ . . @ . . . . . . @ . . . @ . . . . . @ . . . . . @ . @ @ . . . . . @
@ . . . . @ . . @ . . @ . . . . . . . . . @ . . . . . . @ . @ . . . @ . . . . . . @ . @ . . . . @ . . . . . . @ @ . . . . . @ . . . . . . . . . . @ . @ @ . . . . @ . . . . . . . . . @ . . . @ . @ . @
@ . . @ . . @ . . . @ . @ . . @ @ @ . . . . . . @ . . . . . . . . @ . . . . . . @ . . . . . . . . . . . . . @ . @ . . . @ . @ . . . . . . . . . . . . @ . @ . . @ . . . . . . . . . . . . . . . . . . @
@ @ @ @ @ @ @ @ @ @ @ @ @ @ @ @ @ @ @ @ @ @ @ @ @ @ @ @ @ @ @ @ @ @ @ @ @ @ @ @ @ @ @ @ @ @ @ @ @ @ @ @ @ @ @ @ @ @ @ @ @ @ @ @ @ @ @ @ @ @ @ @ @ @ @ @ @ @ @ @ @ @ @ @ @ @ @ @ @ @ @ @ @ @ @ @ @ @ @ @
3
8 42 83 15
38 9 78 19
85 11 22 29
