12 12
@ @ @ @ @ @ @ @ @ @ @ @
@ . . . . . . . @ @ . @
@ . . . @ @ . . . . . @
@ . . . . @ . . . . @ @
@ . . @ . . @ @ . . . @
@ . . . . . @ . @ . . @
@ @ . . . @ . . . . . @
@ . . . . . @ . @ . . @
@ . @ @ . . . . . . . @
@ . . . @ . . . . . @ @
@ @ . . . . . @ . . . @
@ @ @ @ @ @ @ @ @ @ @ @
3
2 3 8 4
8 10 9 3
10 9 7 3
