12 12
@ @ @ @ @ @ @ @ @ @ @ @
@ . . . . . . . . . . @
@ . . . . . . . . . . @
@ . . @ @ . . . . . . @
@ . . @ . . . . @ . . @
@ . . . . . . @ . . . @
@ . . . . . . @ . . . @
@ . . @ . . . . @ . . @
@ . . . @ . . . @ . . @
@ . . @ . @ . . . . . @
@ . @ . . . . . . . . @
@ @ @ @ @ @ @ @ @ @ @ @
3
9 6 10 10
8 7 8 3
2 6 4 6
