50 50
@ @ @ @ @ @ @ @ @ @ @ @ @ @ @ @ @ @ @ @ @ @ @ @ @ @ @ @ @ @ @ @ @ @ @ @ @ @ @ @ @ @ @ @ @ @ @ @ @ @
@ . . . @ . . @ . . . . . . . . . . . . . . . . . . . . @ . . . . . @ . . . . @ . . . . . . . . . @
@ . . . . . @ . @ . . . . . . . . . . . . . . . . . . . . . . @ . . . . . . . @ . . . . . . . @ . @
@ . . @ . @ . . . . @ @ . . . . . . . @ . @ . . @ . . . @ . @ . . @ . . . . . . . . . . . . . . . @
@ . . . @ @ . . . . . . . . @ . . . . . . . . . . . . . . @ . . . . . . . @ . . . . . . . . . . . @
@ . @ . . . @ . @ . @ . . . . . . @ . . @ . . . . . @ . . . @ . @ . . . @ @ . @ . . @ . . . @ . . @
@ . . . . . . . . . @ @ . . . . . @ @ . @ . . . . . . . . . . @ . . . . . . . . @ . . . @ . . . . @
@ . . . . . . . . @ . . . . . . . . . . . . . . . @ . . . . . . . . . . . . . . . . . . . . @ . . @
@ . . . . @ . . @ . . . . . . . . . . . @ . . @ @ . . . @ . . . . . @ . . . . . . . . . @ . . . . @
@ . . @ . . @ . . . . . . . . . @ . @ @ . . @ . . . . @ . . . . . . . . . . . . . . @ . . . . @ . @
@ . @ . . @ . . . . . . . . . . . . @ . . . @ . . . . @ . . . @ @ . . . . . @ . . . . . . . . . . @
@ . . . . . . . . . @ . . . . . @ . . . . . . . . . . . . . . . . . . . . . . . . . . . . . . . . @
@ . . . @ . @ @ . . . . . @ . . @ . @ . . . . . . . . . @ . @ . @ . . . . . . . . . @ . . . . . . @
@ . . . . . @ . . @ . . . . . @ . . . . @ . @ . . . . . . . . . . . . . . . . . . . . . . . . . . @
@ . . . . . . . . . . . . . . . @ . @ . . @ . . . . @ . . . @ @ . . @ . @ @ @ . . . . @ . . @ . . @
@ . . @ @ . . . . . . . . . . @ . . @ . . . . @ @ . . @ . . . . . . . . . . . @ @ . @ . . . . . . @
@ . @ . . . @ . . @ . . . . @ . @ . . . . . @ . . . . . @ . . . @ @ . @ . @ . . . . . . @ . . . . @
@ . . . . . @ . . @ @ . . . . . . @ . . . . . @ @ . . . . . . @ . . . . @ . . . . . . . . . @ . . @
@ . . . . @ . . . . . . . . . @ . . @ . . . @ . . . . . . . @ . . . @ . . . . . . @ . . . . . . . @
@ . . . @ . . . . . @ . . . @ . @ . . . . @ . @ @ . . . . . . . . . . . . . . . @ . @ . @ . . . . @
@ . @ . @ . @ @ @ . . . . @ . . . . . . . . . . . . . . . . @ . . . . . . . . . . . . . . . @ . . @
@ @ . . @ . @ . . @ . . . . . . . @ . @ . @ . . @ . . . . @ . . . . . . . @ . . . . . . . . . . . @
@ . . @ . . . . . . @ . . . . . . . . . . . . . . . @ . . . . . @ . . . . . . . @ . . . . . . . . @
@ . . . . . @ . @ . . . @ . @ @ @ . . . . . . . . @ . . . . . . . . . . . . . @ . . . . . . . . . @
@ . . . . . . @ . . . . @ . . . . . . . . . @ . @ . . . . . . @ @ . . @ . . . @ . . . . . . . . . @
@ . . . . . @ . . @ . . . @ . . @ . @ . . . . . . @ @ . . . . . . @ . . . . . . . . . @ . . . . . @
@ . @ . . . . . . . @ . . . . . . . . . . . @ @ @ . . . @ . @ . . . . . . . . . . @ @ . . @ . . . @
@ . . . . @ . . . . . . @ . . . . . . . . . . . @ . . . . . @ @ . . . @ . . . @ @ . . . . . . . @ @
@ . @ @ . . . @ . . . . @ @ . . . . . . . . . @ . . . . . @ @ . @ . . @ @ . . . . . . . . . . . . @
@ . . . . @ @ @ . @ . . . . @ @ . . @ @ . . @ . . . @ . . . . @ . @ . . . . . . @ . @ . @ . . @ . @
@ . @ . . . . . . . . . . . @ . . . . @ . @ . . @ . . . . . . . . . . . . . . . . . . . . . . . . @
@ . . . . @ . . . . @ . . . . . . . @ . @ . . . . . . . . . . . . . . . . @ . . . . . . . . . . . @
@ . . @ . . . . . . @ . . @ . . . . . @ . @ . @ . @ . . . . . @ . . . . . . @ . . . . . . . . . . @
@ . . . . . . . . . @ . . . . . @ . @ . . . @ . . . . . @ . . @ . . . . . . . . . . . @ . . . . . @
@ . . . . . @ . @ @ . . . @ . . . . @ @ . . . @ . @ . @ @ . . . . @ . . . . @ . . . @ . . @ @ @ @ @
@ . . . . . . . @ . @ . . . . . . @ . . @ . @ . @ . . . . @ . . @ . . . . . . . . . @ . . . . . . @
@ . . . @ . . . . @ . @ . . . . . . . . @ . . . . . . . . . . . . . . . . . . . . . @ . @ . . @ . @
@ . . . . . . . . @ . . @ . @ . . . . . . . . @ . @ . . . @ @ . . . . . . @ . . . . . @ . . . . . @
@ . . @ . . . . . @ . @ . @ . . . . . . . . . . @ . . . . . @ . . . . . . . . @ @ . . . . . . . . @
@ . . @ . . . . . . @ . . . . @ . . . @ . @ . . @ . @ . . . . . . . . . . . @ . . . @ . . . . . . @
@ . . . . . . . . @ . . @ . . . . . . . @ . . . . . . @ . . . . . . . . . . . . . . . . . . . . @ @
@ . @ @ . @ @ . . . . . . . . . . . . @ . @ . . . . . . . @ . . @ . @ . . . . . . @ . @ . . . . . @
@ . . . . @ . . . . @ . . . . . . @ . . . . @ . . . . . @ . . . . . . . @ @ . @ . @ . . @ . . . @ @
@ . . . @ . @ . . . . . . . . . @ . . . . . . . . . . . @ . . . . . @ . . . . . . . . . . . @ @ . @
@ @ . . . . . @ . . . . . . . @ . . . @ . . . . @ . @ . . @ . . . . . . . . . . . . @ . . @ . . . @
@ @ . . . @ . . . . @ . . . @ . @ @ . @ . . . . . . . . @ . . . . . @ . . . @ . @ . . . . . . . @ @
@ . . . . . @ . . @ . . . . . . . . @ . . . . . . . . . . . @ . @ . . . . . @ . . @ @ . @ . . . . @
@ . . . . . . . @ . @ . . . . . . . @ . @ . . . . . . @ . @ . . @ . . . . @ . . . . . . . . . @ . @
@ . . . @ . . . . @ . @ . . . . . . . . . . @ . . . . . . . . . . . . @ @ . . . . . @ . . . . . . @
@ @ @ @ @ @ @ @ @ @ @ @ @ @ @ @ @ @ @ @ @ @ @ @ @ @ @ @ @ @ @ @ @ @ @ @ @ @ @ @ @ @ @ @ @ @ @ @ @ @
3
33 4 39 48
42 14 10 25
11 3 15 1
