50 50
@ @ @ @ @ @ @ @ @ @ @ @ @ @ @ @ @ @ @ @ @ @ @ @ @ @ @ @ @ @ @ @ @ @ @ @ @ @ @ @ @ @ @ @ @ @ @ @ @ @
@ . . . . . . @ . . . . . . @ @ . . . . . . . . . @ . . . . . . . . . . . . . . . @ . . . . . . . @
@ . . . @ . . . . . . . . . . . . . . @ . . . . . . . . . . . . . . . . . @ @ . . . @ . @ @ . . . @
@ . . @ . . . . @ . @ @ . @ @ . @ . . @ . . . . . . . . . @ . . . . @ . . . . . . . . @ . @ . . . @
@ . . @ . . . @ . . . . . @ . . . . . @ . @ @ . . . . . . . @ . @ . . . . @ . . . . @ . . . . . . @
@ . . . . . . . @ . . . . . . . . . . @ . . . . . . @ . . . . . . . . . . @ . . . . . . @ . @ . . @
@ . @ . @ . . . . @ . . . @ . . @ . @ . . @ . . . . @ . . . . . . . . . . . @ . . . . . . . @ . . @
@ . . . . . . . @ . @ @ . . @ . . . @ . @ . @ @ . . . . . @ . @ . . . . . . @ . . . . . . . . . . @
@ . . . @ . . @ . . . . @ . . . . . . . . . . . . @ . @ . . . . @ . . . . . . . . . . . @ . @ @ . @
@ . . . . . . . . . . . . . . @ . . . . @ . . . . . @ . . . . . . . . . @ . . @ @ . . . . . . . . @
@ . . . . . . @ . . @ . @ . . . . . . . @ . . . . . . . . . . . . . @ . . . . . . . . . . . . @ . @
@ . . . . . . . @ . . . @ @ . @ . . . . . . @ . . . . . . . . . . . @ @ . . @ . . . . . . @ . . . @
@ . @ . . . . . @ @ . @ . . . . @ . . . . . . . . . . . . . . . . . . . . . . . . @ @ . . . @ . @ @
@ . . . . . . . . . . . . . . . . . @ . . . @ . . . . . . . . . . . . . . . @ . . . . . . @ . . . @
@ . . . . . . @ . @ . . . @ . . @ . . @ . . @ . . @ @ . . . . . @ . . . . . . @ . @ . . . . @ . . @
@ . . . . . . @ . . . . . . @ . . . @ . . . @ . . . . . . @ . @ . . . . . . . @ . . . @ . @ . . . @
@ . . . . . @ . . @ . . . . @ . . . . . . . . . . . . . . . @ . . @ . . . . . . . . @ . . . . @ . @
@ . . . . . . @ . . . . . . . . . . . @ @ . . . . . . . @ . . . . . . . . @ . . . . . . . . @ . @ @
@ . . . . . . . . . . . @ . . . @ . . @ @ . . . . . . @ . . . . . . . @ . . @ . . . @ . @ . . . . @
@ . . . . @ . . . @ . . . . @ . . . . . . . . . . @ . . . . . . . . . . @ . . @ . . . . @ . . @ . @
@ . . @ . @ @ . . . . . . . . . . . . . @ . . . . . . . . @ . . . . . . . . . . . . . . . . @ . . @
@ . . @ . . . . . . . @ @ @ . . @ . . . . . @ . . . . . . . @ @ . . @ . . . . . . . . . . . . . . @
@ . @ @ . . . . @ . . @ . . . . . . . . @ . . . . @ @ . @ . . . . . . . . . . . . . . . . @ . . . @
@ @ . @ . . @ . @ . . . @ . . . . @ . . . . . . @ @ . . @ . . . . . . @ . . . . . . . . . . . . . @
@ . . . . . . . . @ . . . . @ . . . @ @ . @ . . . . . . . @ . . . . . . . . @ . . . . @ . . . . . @
@ . . . . . @ . @ @ . . . . . . . . . . . @ . . . . @ . . @ . . . . . @ @ . . . . @ . . . . . . . @
@ . . . . . . @ . . . @ . . . . . @ . . . . @ . @ . . @ . @ . . . @ . . . . . @ . . . @ . . . . @ @
@ . . @ . . . . . @ . . . . . @ . . . @ . . . . . . . @ . . . . . . @ . @ . . . . . . . . @ . . . @
@ . . . . . . . @ . . . . . @ . @ . . . @ . @ . @ . . @ . . @ . . . . . . . @ @ . . . . . @ . . . @
@ . . . . @ . @ . @ . @ . @ . @ . . . . . @ . . . . . @ . . . . . . . . . . . @ . . . @ @ . . . . @
@ @ @ . . @ . . @ . . . . . . . . . . . . . . @ . . . . . @ . . . . @ . . . . . . . @ . . . . . . @
@ . . . . @ . . . . . . . . . @ . @ . @ @ . . @ . . . . . . @ . . . . . . . . . . . . . . . . . . @
@ . . . . . . . . . . . . . . . @ . . . @ . . . . . . @ . . . @ @ . . . . @ . . . . . @ . . @ . . @
@ . . . . @ . . . . . . . . . @ . . . @ . . . @ . . @ . . . . . . . . . . . @ . @ . @ . . . . . . @
@ . . @ @ . . . . . . @ . . @ @ . . . . . . . @ . @ . . . . . . . . @ . . @ . . . . . . . . . . . @
@ . . . . . @ . . . . . . . . @ . . . @ . . . . . . @ @ . @ . . . . . . @ . . . . @ . . . . . . . @
@ . . . . . . . . . . @ . @ . . @ . . . . . . . . . @ . . . . . . . . . . . . @ . @ . . @ . . @ . @
@ . . . . . . . . . . @ . . . . . . . . . . . . @ . . . @ . @ . @ . . . . @ . . . . . . . . . . . @
@ . . . . . . . . . . . . . @ . @ . . . . . . . . . . . . . . . . . . . . . @ . . . . . . @ @ @ . @
@ . . . . . . . . . @ @ . . @ . . @ . . . . . . @ . . . . . . . . @ . @ . . . . . @ . . . . . . . @
@ . . . . . . . . . . . . . . . . . . . . . . . . . . . . . . . . . @ . . @ . . . . . . . . . @ . @
@ . . . . . . @ @ . . . @ . . . . . . . . . @ . . . . @ . . . @ . . . @ . . . . . . . @ . . @ . . @
@ @ . . @ . . . . @ @ . . . . . . . @ . @ . . @ . . . . . . . . . @ @ . . . . . . . . . . . . . . @
@ . . . . . . . . . . . . . . @ . . @ . @ . @ . . @ . . . @ . @ @ . . @ . @ . . @ . . . . . . . @ @
@ . . @ . . @ . . . @ . . . . . . . . . . @ . . . . @ . . . . . . . . . . . . . . . . . @ . @ . . @
@ . . . . . . . . . . . . . . @ . . . . . @ @ . . . . @ . . @ @ . . . . . . . @ . . . . @ . . . . @
@ . . . @ . @ . . . @ . . . . @ . . . . . . . . . . . . @ . . . . . . . . . . . . @ . @ . @ . . . @
@ . . . . . . . . . . . . . @ @ @ . . . . @ . . . @ . . . . . . . . . . . @ . . @ . . . . . @ . . @
@ . @ @ . . . . . . . . . . . . . . @ . . . . @ . . . . . @ . . . . . . . . . . . . . . @ . . . . @
@ @ @ @ @ @ @ @ @ @ @ @ @ @ @ @ @ @ @ @ @ @ @ @ @ @ @ @ @ @ @ @ @ @ @ @ @ @ @ @ @ @ @ @ @ @ @ @ @ @
3
5 10 10 22
14 43 46 23
23 10 29 26
