50 50
@ @ @ @ @ @ @ @ @ @ @ @ @ @ @ @ @ @ @ @ @ @ @ @ @ @ @ @ @ @ @ @ @ @ @ @ @ @ @ @ @ @ @ @ @ @ @ @ @ @
@ . . . . . . . . @ @ . . . . . . . . . . . . . @ . . . . . . . @ . . . . . . . . . . . . . . . . @
@ @ . . . @ . . . . @ @ . . . . . . . . . @ . . . . @ . . . . . @ . . @ . . . . . . . @ . @ . . . @
@ . @ . . . @ . @ . . . . . . . . @ . . . . @ . . . . . . @ . . . @ . . . @ @ . . . . . . @ @ . . @
@ . @ . . . . . . . . @ . @ . . @ . . @ . . . . . . @ . @ . . . . . . . @ . @ . . . . . . . . . @ @
@ . . . . . . @ . . . . . . @ . . . . . . . . . @ @ . . @ . @ . . . . . . @ . . . . . . . . . . . @
@ @ . . . @ @ @ . . @ . . . @ . . . @ . . . . . . . . . . . . . . @ @ . . . @ . . . . . . . . @ . @
@ . . . . . . . . . . . . . . . . . . . @ . . . . . . . @ . . . @ . @ . . . . . . . . . . . . . . @
@ . . . . @ @ . @ . . . . . @ . @ . . . . @ . . . . @ . . . . . . . . . . . . @ . . . @ . . @ @ . @
@ . . . . . . . @ . . . @ . . . . . @ . . . . . . @ . . @ . . @ . . . . . . . @ . . @ @ @ . . . . @
@ . . . . . @ @ . . . . . . . @ @ . . . . . . . . @ . . . . . . . . . . . . . . @ . . . . . . . . @
@ . . . . @ . . . . @ . @ . . . . . @ . . . . . . . . . . . @ . . . @ . @ . . @ . . . . . . . . . @
@ . . . . @ . @ . . . . . . . @ @ @ . . . @ . @ . . . . . . . . . . . . . . . . . . @ @ . . . . . @
@ . . . . . . . @ . . . . @ . @ . . . @ . . . . . . . . . . . @ . @ . . . . . @ . . . . . . . . . @
@ . . . . . . . . . . . . . . . . . . . @ . . . . . . . . . . @ . . . . @ . . . . . @ . . . . . @ @
@ . . @ . . . . @ . . . . . . . . @ . . . @ . . . @ . . . . @ . . . @ . . . . . . @ . . . . . . . @
@ . . . . . . . . @ . . @ @ . . . . . . . . . . @ . . @ . . . @ . . . . . @ . @ . . . . . . @ . . @
@ . . . . @ . . . @ @ . . . . . . . . . . . . . . . . . . @ . @ . @ . . @ . . . . @ @ . . . . . . @
@ . . . . . @ @ . . . @ . . @ . . . @ . @ . . . . . @ @ @ . . . . . . . @ . . @ . . @ . . @ . . . @
@ . @ @ . @ . . . . . . . . . @ . . . . . . . . . @ . . . . . . . . . . . . @ . . @ . @ . . . . . @
@ . . . . . . . . . . . . . . @ . . . . . . . @ . . . . . . . . . . . @ . . . . . . . . . . @ . @ @
@ . . . . @ . . . . . . . . . . . . . @ . . . . . . . . @ . . . . . . . . . . . . . . . . . . . . @
@ . . . @ @ . . . . @ @ . . @ . . . @ . . . . @ . . . . . . @ . . . . . @ . @ @ . . . @ . . @ . . @
@ . . . . . . . . @ . . . . . @ . . . . @ @ . @ . . . @ . . . . . . . @ . @ . . . . @ . @ . . . . @
@ . . . . . . . . . . . @ . . . . . . . . . . @ . @ . . @ . @ . . . @ . . . . . . . . . . . @ . . @
@ . @ . . . @ . . . . . . . . . . . . . . . . @ . . . @ . @ . . @ . . . . . . . . . @ . . @ . @ . @
@ . . . . . . . @ . . @ . . . . . . @ . @ . . @ . . . . @ . . @ . @ . . . @ . . . . . @ . . . . @ @
@ . . . . . . . . . @ . @ . . . . @ . @ . . . . @ . . @ . . @ @ . . . . . . . . . . . . . . . . . @
@ . . . . . . . . @ . @ . . @ . . . . . . . . . @ . . . . . @ . . . . . . . . . @ @ . . . . @ . . @
@ . . . @ . . @ . . . . . . . . @ . . . . @ . . . . . . . . . . @ . @ @ . . . . . . @ . . @ . . . @
@ @ . . @ . @ . . . . . . . . . . @ . . @ . . . @ . . . . . . . . . @ . . . @ @ . . . . . . . @ @ @
@ . . . @ . . . . . . . . . . . . . . . . . . . . . @ . @ @ . . . . . . . . . . . . . @ . . @ . . @
@ . @ . . @ . . . @ . . @ . . @ . . @ . . . @ . . . . . . . . @ . . . . . . @ . . . . . . . . @ . @
@ . . . . . . . @ . . . . . . . . . . @ @ . @ @ @ @ . . . . . . . @ . . @ . @ . . @ . . @ . . . . @
@ . . . . . . . . . . . . . . . . . . @ @ . . @ . . . . @ . . @ . . . . . . . . . . @ @ . . . @ @ @
@ . . . . @ . @ . . . @ . . . . . . @ . . . . . . . . . . . . . . @ . . @ . . @ . @ . . . . . . . @
@ . . . . . . . . . . @ . . . . . . @ . . @ . . . . . . . . @ . . . . . . . . . . . . . . . . . @ @
@ . . @ . . . . . . . . . @ . . . . . . . @ . . . . . . . . . . . . . @ . . . . . @ . @ . . . @ . @
@ . @ . @ . . @ @ . @ . . . @ . . . . . @ . . @ . . . . @ . . . . . . . . . . . . . . . . . . . . @
@ . . . . . . @ . . . . . . . . @ . . . . @ . . . . . . . . . . . . . . . . . . @ . . . . . @ . . @
@ @ . . . . . . . . . . . . . . . @ @ . . . @ . . . . . . . @ . @ . . @ . . . @ . . . . . . . @ . @
@ . . . . . . . @ . . . . . @ . . . . @ . . . . . . @ . . . . @ . . @ @ . @ . . . . @ @ . @ . . . @
@ @ . @ @ . . . . . . . . @ . . . . . . . @ . . . @ . . . @ . . . . . @ @ . . . . . . . . . . . . @
@ . @ @ . . . . . . @ . . . @ . @ @ . . . . . @ . . . . . @ . @ . . . . . @ . . . . @ @ . . . @ . @
@ @ . . . @ . . @ . . . . . . . . . @ . @ @ . . . . . @ . . . . @ . . . . . . . . . . . . . @ . . @
@ . . . . . . . . . . . . . . . . . . @ . . . . . . . . . . @ @ . . . . @ . . . . . . . . . . @ . @
@ . . . . @ . . . . . . @ . @ . @ . . @ . . . . . . . . . . . . . . . . . . . @ . . . . . @ . . . @
@ . . . @ . @ . . @ . . . . . . . . . @ . . . . . . @ . . @ . . . . . . . . . . . . @ . . . . . . @
@ . . @ . . . . . . . @ . . @ . . . @ . @ . . . . . . . . . . @ . . . . . . @ . . . . . . . @ . . @
@ @ @ @ @ @ @ @ @ @ @ @ @ @ @ @ @ @ @ @ @ @ @ @ @ @ @ @ @ @ @ @ @ @ @ @ @ @ @ @ @ @ @ @ @ @ @ @ @ @
3
4 46 7 46
40 38 36 35
31 36 7 21
