12 12
@ @ @ @ @ @ @ @ @ @ @ @
@ . @ . . . . . @ . . @
@ . . . . . . @ . . . @
@ . . @ . @ . . . . . @
@ . . . . @ @ . . . . @
@ . . . @ @ . . . . . @
@ . . @ . . . . . . @ @
@ . . . @ . . . . . . @
@ . . @ . . . @ . @ . @
@ . . . . . . . @ . @ @
@ . . . . . . . . . . @
@ @ @ @ @ @ @ @ @ @ @ @
3
10 3 8 6
10 7 1 5
2 9 6 1
