50 50
@ @ @ @ @ @ @ @ @ @ @ @ @ @ @ @ @ @ @ @ @ @ @ @ @ @ @ @ @ @ @ @ @ @ @ @ @ @ @ @ @ @ @ @ @ @ @ @ @ @
@ . . . . . . . . . . . @ . . . . . . . @ . . . . . . . . . . . . . . . @ . . @ . . . . . . . . . @
@ . @ . @ . . . . . . @ . . . . . . . @ . . . . . . . @ . @ . @ . . . . . . . . @ . . . . . . . . @
@ . . . . . . . . . . . . . @ . @ . . . . . . . . . . . . . . . . . . . @ . . . . . . . . . . . . @
@ . . . @ . . @ . . . . . . . @ . . . @ . . . . . @ . . . . . @ . . @ . . . . @ . . @ . . . . . . @
@ . . . . @ @ . @ . . . . . . . @ . . . . . . . . . . . . . . . . . . . . . . . . . . . . . . @ . @
@ . @ . . . . . . . . @ @ . . @ . . . . @ . @ . . . @ . . . . . . . . . @ . . . . . . . @ . . . . @
@ . @ @ . . . . . . . . . . . . . . . @ @ . . . . @ . . . . @ @ . @ . . . . . . @ . . @ . . . @ . @
@ . . . . @ . @ @ . . . . . @ . . . . . . @ . . . @ . . . . . @ . . . . @ . . . . . @ . . . . . @ @
@ . . . . . . @ . . . . . . . . @ . . . . @ . . . . . . @ . . @ . . @ . . . . . . . . . . . . . . @
@ . @ . @ . @ . @ . . . . . . . . . . . @ . . . . . . . . . . . . @ . . @ . . . . . @ . @ . @ . . @
@ . . @ . . . . . . . . . . . . . . . . . . . . . . . @ . . . . . . . @ . . . . . . @ . . . . . . @
@ @ . @ . . . . @ . . . . . . @ . . . . . . . . . @ @ . . . @ . . @ . @ . @ . @ . . . @ @ . @ . . @
@ . . . . @ . . . . . . . . . . @ @ . . . . . . @ . . . . . . . . . . . @ . . . . . . . . . @ . . @
@ . . . . @ . @ . . @ . . . @ @ . . . . . . . . . . . . . . . . . @ . @ . . . . . @ . . @ . . . @ @
@ . . . . . . . . . . . @ . . @ @ @ . . . . . . @ . . . . . . . . @ @ . . . . . . @ . . . . . . . @
@ . . . . . . . . . @ . . . . @ . . @ . @ . . . @ . . . . . @ . . @ . . . . @ @ . . @ . . . . @ . @
@ @ . @ . . . . . . . . . . . . . . . . @ . @ . . . . . . . . . . . . . . . . @ . . . @ . . . . @ @
@ . . . . . @ @ . . . . . . @ . @ . . . . . @ @ . . @ . . . . . @ @ . . . . . . . . . . . . @ . . @
@ . . . @ . . . . . . . . . . . . @ . . . . . . @ . . . @ . . . . @ . @ . . . . . . . . @ @ . . . @
@ . . . . . . . . . @ . @ . . . . . . . . . . . . @ . . . . . . . . . . . . . . @ @ . . . . . @ . @
@ . . @ . @ . . . @ @ @ . @ . @ . . @ . @ @ . . . @ @ @ . . @ . . . . . . . . . . @ . . . . . . . @
@ . . . . . . . . . . . . . . . . . . @ . . . . @ @ . @ . . . . . . . . . . @ . @ . . . . @ . . . @
@ . . . @ . . . . @ . . . . . . . @ . . . . @ . . @ . . . . @ . @ @ @ . . @ . . . . . @ . . . . . @
@ . . . . . . . . . . . . . . @ . . . . . . . . . @ @ . . @ . @ . . . @ . @ . . . . . . . . . @ @ @
@ . @ . . @ . . . . @ . . . . @ . . . . . . . @ @ . . . . . . . . . @ . @ . . @ . . . . . . . . . @
@ . . . . . . . . . . . . @ @ . . . . . . . . . . . . . . . . @ . . . @ . . @ . @ . @ . . . . @ . @
@ . . . . . . . . @ . @ @ . . . . . . @ . . . . @ . . . @ . . @ . . @ . . . . . . . . . . @ . . @ @
@ . @ . . . . @ . . @ . @ . . . @ @ . . . . . @ . . . . . . @ . . . . . @ . . . . . . . @ @ . . . @
@ . @ . . @ . . . . . @ . @ . . . . . . . @ . . . . . . . @ . . . . . . . @ . . . . @ . . @ . . . @
@ . @ . . . . . . . . . . . . . . . . . . . . @ . . . . . . . . . . . . . . @ . @ @ @ . @ . . @ . @
@ . . @ @ . @ . . . . . . . . @ . . . . . . . . . . . @ . @ . . . . . . . . . . . @ . . . . @ @ . @
@ . . . @ . @ @ . . . . . . . . @ . . . . . . . . . . . . . . . . . . . . . . . @ . . @ . @ . . . @
@ @ . . . . . . . . . @ . . . @ . @ . . . . . . . @ . . . . . . . . @ . . . . @ . @ . . . . . . . @
@ . . . . . . . . . . . . . . . . . . . @ . @ @ . . @ . . @ . . . . . . . . . . . . @ . . . . @ @ @
@ . . @ . . . . . . . . . @ . . . @ . . . . . . @ . @ . . . . @ . . @ . . . @ . . @ . . . . . . . @
@ . . . @ @ . . . @ . . @ . . @ . @ . . . . @ . . @ . . . . @ @ . . @ . . . . . . . . @ . . . . . @
@ . . @ @ . @ . . . . . . @ @ . @ . . . . . . @ . . . @ @ . . . . . . . . . @ @ . @ @ . . . . @ . @
@ @ @ . . . @ . . . @ . . . . . . . @ . . @ . . . . . . . . . @ @ . @ . . . . . . @ . @ @ . @ . . @
@ . . . . . . . . @ . . @ @ . . @ . . @ . . . . @ . . . @ . . . . . . . . . . . . . . @ @ @ . . @ @
@ . . . . . . . . @ . . @ . . . . . . . . . . . . . . . . . . @ @ . . . . . @ @ . . . . . . . @ @ @
@ . . . . . . . . @ . @ . . . . . @ . . @ . . . . @ . @ . . . . @ . @ . @ @ . . . . . . . . . @ . @
@ . . . . . @ . . . . . . . . . . . @ . @ . . . @ . . @ . . @ . . . . . . . . . @ . @ . . . . . . @
@ @ . . @ . . @ . @ . @ . @ . . @ . . . . @ @ . . . . . . @ . . . . . . . . . @ . . . . . . . . . @
@ . . . . . @ . @ @ . . . . . . . . . @ . . @ . . @ @ @ . . @ . . . . . . . . . . @ . . . . . . . @
@ . @ . . . . . . . . . @ . . . @ . . . . . . . . . . . . . . . . . . @ . . @ . . . . @ . . . . . @
@ . . . . . . . . . . @ . . . . . . . . . . @ . . . . @ . @ @ . @ . . . . @ . . . . . @ . . @ @ . @
@ @ . . . . . . @ . . . . . . . . . . . @ . . @ . . @ . . @ . . . . . . . . . . . . . . . . . . . @
@ . . . . . . @ . . . . @ . @ . . . . . @ . . . . . . . . . . @ . . . @ . @ @ @ . . . . . . @ . . @
@ @ @ @ @ @ @ @ @ @ @ @ @ @ @ @ @ @ @ @ @ @ @ @ @ @ @ @ @ @ @ @ @ @ @ @ @ @ @ @ @ @ @ @ @ @ @ @ @ @
3
31 5 1 23
40 15 15 46
3 15 14 39
