25 25
@ @ @ @ @ @ @ @ @ @ @ @ @ @ @ @ @ @ @ @ @ @ @ @ @
@ . . . . @ . . . @ . . . . @ @ . . . @ . . @ . @
@ . . . @ . . . . . . . . . . @ . . . . . . . . @
@ . . . . . @ . @ . . . @ . . . . . . . . . . . @
@ . . . . . . . . @ . . . . @ . . . . . . . . . @
@ . . . @ . . @ . . . . @ . . . . . . @ . . . . @
@ . . . . . . . . . @ . . . . . . . . . @ . . @ @
@ . . . @ . . . . . . . . . . . . @ . . . . . @ @
@ . . . . @ . . . @ @ . . . . @ . . . @ . . . . @
@ . . . . . @ . . . @ @ . . . . . . . . . . . . @
@ @ @ . . . . @ . . . . . . . @ . @ . @ . . . . @
@ . @ . . . . . . . @ . . . . . @ @ . . . . @ . @
@ . . . . . . . . . @ . . @ . . . . . . @ . @ . @
@ . . . . . @ . . @ . . . @ . . . . . . . . . . @
@ . . . . . . . . @ . . . . @ . . . . . . . . . @
@ . . . . . . . @ . . . . . @ . . . . @ . . . . @
@ @ . @ . @ . . . . . . . . . @ . . @ . . . . @ @
@ . . . . . . . . . . . @ . . @ @ . . . . . . . @
@ @ . . . . . . . . . . . . . . . . . . @ @ . . @
@ . . @ . . . . @ . @ . . . . . . . @ . . . . . @
@ . . @ . @ . . @ . @ . . . @ . . @ . . @ @ . . @
@ . . . . . . @ . @ . @ . @ . . . . . . . . . . @
@ . . . . . . . . @ . . . . . @ . . . @ @ . . . @
@ . . . . . . . . . . . . . . . . . . . . . . . @
@ @ @ @ @ @ @ @ @ @ @ @ @ @ @ @ @ @ @ @ @ @ @ @ @
3
14 19 7 22
13 23 3 23
10 3 12 9
