12 12
@ @ @ @ @ @ @ @ @ @ @ @
@ @ @ . . . . @ . . . @
@ . . . . . @ . . . . @
@ . . . . . . @ . . . @
@ . @ . . . . . @ . . @
@ . . . . . . . . . . @
@ . . . @ . . . . . . @
@ . . . @ . . . . @ . @
@ . . . . . . @ . . . @
@ . . . . . . . . . @ @
@ @ . . . . . . . . . @
@ @ @ @ @ @ @ @ @ @ @ @
3
3 8 7 3
5 7 10 9
6 3 10 2
