25 25
@ @ @ @ @ @ @ @ @ @ @ @ @ @ @ @ @ @ @ @ @ @ @ @ @
@ . . . @ . . . . . @ . . @ . . . . . . . @ . . @
@ . . . . @ . . . . . . @ . . . . @ . . . . . . @
@ . . . @ . . @ . . . . @ . . . . . . . @ @ @ . @
@ . @ . . @ . . . @ . @ . . . . @ . . . . . . . @
@ . . . . @ . . . . . . . . . @ . . @ . @ @ . . @
@ . . . . . . . @ . . . . . @ . . . . . @ . . . @
@ . . . . . . . . @ . . . . . . . . . . . . . @ @
@ . . . . . . @ . @ . @ . . . . . . @ . . . . . @
@ @ . . @ . . . @ . . . . . @ . . . . . @ . . . @
@ . . . . . . . . . @ . . . . @ . . . . . . . . @
@ . @ . @ @ @ @ . . . @ . . . . @ . . . . . . @ @
@ @ . . . . . . . @ . . . . . . . @ . . . @ . . @
@ @ . . . . . @ . . . @ . . @ . . . . . . . . . @
@ . @ . @ . . . . . . . . . . . . . . . @ . . . @
@ . . . @ . . . . . . . . . . . . . . . . . @ . @
@ . . . . . . @ @ . . . . . . . . @ . @ . . @ . @
@ . @ . . . . @ @ . . . . . . . . . . . . . . . @
@ . . . @ . . . . . @ . . @ @ . . . . . . . . . @
@ . . @ . . . . . . . . . . . . . . @ @ . . . . @
@ . . . . . . . . . . @ . . . @ . . . . . . . . @
@ . . . . @ . . . . @ . . . . . @ . . . . . . . @
@ . . . . @ @ . . . . . . . . . . . . . @ . . . @
@ . . @ . . . . . . . . . . . . . . . . . . . . @
@ @ @ @ @ @ @ @ @ @ @ @ @ @ @ @ @ @ @ @ @ @ @ @ @
3
14 15 20 23
21 20 14 17
11 22 22 14
