12 12
@ @ @ @ @ @ @ @ @ @ @ @
@ . . . . . . . . @ . @
@ . . . . . @ . . . . @
@ . . . . . @ @ . . @ @
@ . . . @ . . . . . . @
@ @ . @ @ @ . . . . . @
@ . @ . . @ . . . . . @
@ . @ . . . @ . . . . @
@ . . . . . . . . @ @ @
@ . . . . . . . . . @ @
@ . . . . . . . . . . @
@ @ @ @ @ @ @ @ @ @ @ @
3
5 6 2 2
1 10 9 1
7 8 2 9
