12 12
@ @ @ @ @ @ @ @ @ @ @ @
@ . . . . . @ . . . . @
@ . . @ . . . . . @ . @
@ . . . . . . . . @ . @
@ . . . . . . . . . . @
@ . . . . @ @ . . @ . @
@ . . . . @ . @ . @ . @
@ . . . . . . . . . . @
@ . . . . . . @ . . . @
@ . @ . . . . . . . . @
@ . . . . . . . . . @ @
@ @ @ @ @ @ @ @ @ @ @ @
3
10 4 9 1
2 10 9 4
6 1 3 5
