12 12
@ @ @ @ @ @ @ @ @ @ @ @
@ . . . . . . . @ . . @
@ . . @ . @ @ . . . . @
@ . . . . . . . . . . @
@ . . @ @ . . . @ . . @
@ . @ . . . . @ . . . @
@ . @ . @ @ . . @ . @ @
@ @ @ . . . . . . . . @
@ . . . . . . . . . . @
@ . . . @ . @ . . . . @
@ . @ . . . . . . . . @
@ @ @ @ @ @ @ @ @ @ @ @
3
8 10 7 6
10 4 6 7
8 5 1 9
