25 25
@ @ @ @ @ @ @ @ @ @ @ @ @ @ @ @ @ @ @ @ @ @ @ @ @
@ . @ . @ . . . . . @ . . . . . . . @ . @ . . . @
@ @ . . . . . . . . . . . . . . . . . . . . . . @
@ . @ @ . . . @ . . . . . . . . . . . . . . . . @
@ @ . . . . . . . @ . . . @ . . @ . @ . . @ . . @
@ . @ @ . . @ . . . . @ . . . @ . . . . . . @ . @
@ . . . . @ . . . . . . . . . . . . . . . . . . @
@ . . . . . . . . . . . . . @ . . . . @ @ @ . . @
@ . . . . . . . @ . @ . . @ . . . @ @ . . . . . @
@ . . . @ @ @ . . . @ . . . @ . . . . . . . . . @
@ @ . . . . . . . . . @ . . . . . @ . . . . @ . @
@ . . @ . . . . . . . . . . . . @ . . . . . . . @
@ . . . . . . . . . . . @ . . . . @ . . . . . . @
@ . . . . . . . . . @ . . . . . . . . . . @ . @ @
@ . . @ . . . @ . . . @ . . . . . . . . . . . . @
@ . . . @ @ . . @ . . . . . @ . . @ . . . . . @ @
@ . . . @ . @ @ . . . . @ . . . . . . . . @ . . @
@ @ . . . . . . . . . . . . . . . @ . . @ . . . @
@ . . . . . @ . . . . . . . @ . @ . . @ . . . . @
@ . . . @ . . . @ . . @ @ . . . . . @ . . . . . @
@ . . . . . . . . @ . . @ . . . . . . @ @ . . . @
@ . . . . . . . . . . @ . . @ @ . @ @ @ @ . . . @
@ . . . . . . . . . . . . @ . @ . . . . . @ . . @
@ . @ . . @ . @ . . @ . . @ @ . . @ . . . . . . @
@ @ @ @ @ @ @ @ @ @ @ @ @ @ @ @ @ @ @ @ @ @ @ @ @
3
13 20 23 22
18 18 2 3
10 10 8 6
