50 50
@ @ @ @ @ @ @ @ @ @ @ @ @ @ @ @ @ @ @ @ @ @ @ @ @ @ @ @ @ @ @ @ @ @ @ @ @ @ @ @ @ @ @ @ @ @ @ @ @ @
@ . . . @ . . . . . . . . . . . . . . @ . . . . . . . @ . @ . . . . . . . . . . @ @ . . . . . . . @
@ . . . . . . . @ . . . . @ @ @ . . . . . . @ . . . . @ . . . . . . . @ @ . . . . . @ . . . . . . @
@ . @ . . . . . . . @ . . . . @ @ . . . . . . @ . @ . . . . . @ . . . . @ . . . . . @ . . . . @ . @
@ . . . . . . @ . @ . . . . @ . . . @ . . . . . . . . . @ . . @ . . @ . @ . . @ @ @ . @ @ . . . @ @
@ @ . @ . . . . . . . @ . . . @ . . . . @ . . . . . . . . . . @ . . . . @ . . . . . . . . . . . . @
@ . . . . . @ . . . . . . . @ . . @ @ @ . . . . . @ . . . . . . . . @ . . . . . . . . . @ . @ . . @
@ . @ . . @ . . . . . . . @ @ . . . @ . . . . . @ . . . . . . . . . @ @ . . . . . . @ . . @ . @ . @
@ . @ . @ . . . . . . @ . . . . . . @ @ . . . . . . . @ . . . . . . . @ . . . . . @ @ . . @ . . @ @
@ . . @ . . . @ . . @ . . . @ . . . @ . . . . . . . . . @ . . . . @ . . . . @ . . . . @ @ . . . . @
@ . . . . . @ . . . . . . . . @ @ . . @ . . . . @ . . . . @ . . . . . . . . . . . . . @ . . . . . @
@ . . . @ @ . . . . @ . . . @ . . . . @ . . . . . @ . . . . . @ . @ . . @ . . . . . . . . . . . . @
@ . . @ . . . . @ . . @ . . . . . . @ . . . . . . . @ . . . @ . . . . . . @ . . . . . @ . . . @ . @
@ . . . . @ . . . @ . . . . . . . . . . . . . . . . . . . . . . @ . . . @ . . @ . . . . . . . . . @
@ . . . . . . @ . . . . @ . . @ . @ @ . . . . @ . . . . . . @ . @ . . . . @ . . @ @ . . @ . . . @ @
@ . @ . . . @ . . . . @ . . . . . . . . . . . . @ . . . . . . . . @ . @ @ . . . . . . @ . . . . @ @
@ . . . . @ . . . . . . . . . . @ . . . . @ . . . @ . . . . . . . . . . . . . . . . @ . . . . . . @
@ . . . . . . @ . . . . . . . . . @ @ . @ . . . . . . . . @ . @ @ . @ . . . @ @ . . @ @ @ . . . . @
@ . . @ . . . . @ . . . . . @ . . . @ @ . . . . . . . . . . . . . . . . . . . . . . . . . . . . . @
@ . . . @ . @ . @ . @ . . . @ @ . . . . . . . . @ @ @ . @ . . . . . . . . . . . . . @ . . . . . . @
@ . @ @ . . . . . @ . . . . . . . . . . . . . . . . . . . . . . . . . . . @ . . . . . . @ . . . . @
@ . . . @ . . . . . . . . . . . . . @ . . . . . @ . . . . . . . . . . @ . . @ @ . . . @ . . . . . @
@ . . . . . . . . . . . . . @ @ . . . @ . . . . . . . . . . . @ . @ . . . . @ . . . . @ @ . . . . @
@ . . . . . . @ . @ . . . . . . @ . @ . . . . . . . . . . . @ . . @ . . @ . @ . . . . . . . . @ . @
@ @ . . . . . . . @ . . . . @ . . . @ . . . . . @ . . @ @ . . . . . . . . . . . @ . . . @ . . . . @
@ . . . . . . . . . . . @ @ . . . . @ . . @ . . . . . . . @ . . . @ . . . @ @ @ . @ . @ . . . . @ @
@ @ . . . . . . . . . . @ . . . . . . . . . @ . . . . @ . . . . @ . . . . . . . . . . @ . . . . . @
@ . @ . . . . @ . @ . . . . . . . . . . . . . . . . . . . . . . . . @ . . @ . . . . . . . . . @ . @
@ . @ @ . . @ @ . . . . . . @ @ . @ @ . . @ . . . . . . . . @ . . . . . . . . . . . @ . . . . . . @
@ . . . . @ . . . . . . . . . . . . . . . . . . . . . @ . @ . . @ . . . . . @ . . @ . @ @ @ . @ . @
@ . . @ @ @ @ . @ . . . . . . . . . . @ @ @ . . . @ . . @ . . @ @ . . @ . . . . . . . . @ . . . . @
@ . . . . . @ . @ . . @ . . . . . @ . . . @ . . . . . . . . . @ . @ . . @ . . . . . . . . . @ . . @
@ . . . . . . @ . . . . . . . . . . . . . . @ . . . . @ . . @ . @ . @ . . . . . @ . . . . . . . . @
@ . . . . . . . @ . @ . . . . . . @ . . . @ . . . @ . . . . . . . . . . . . . . @ . @ . . @ . . . @
@ . . . @ . . . . . . . . . . . @ . . . @ . . . . . @ . . . @ . . . @ . . @ @ . . . . . . . @ . . @
@ . . . . . . . . . . . . . . . . . . @ . . . . . . @ @ . . . @ @ . . @ . . . @ . . . . . @ . . . @
@ . . . . . . . . . . . . . . . . . @ . . . . . . . . . . . . @ . . . . . . . . @ . . . . . . . . @
@ . . . . @ . @ . . . . . . @ . @ . . . . . . . . . . @ . . . . . . . . . . @ . . . @ . . . . . . @
@ . . . @ . . . . . . . . . @ . . . . . @ . . . . . . . . . . . @ @ . . . . . . . . . . . @ . . . @
@ @ . @ @ . . . . . . @ . . . . . . . . . . . . . . . . . . . @ . . . . . . . . . . . . . . @ @ . @
@ . . . . . @ . . . @ . @ . . . . @ @ . @ . . . . @ . @ . . . . @ . . . . . . . . . . . . . . . . @
@ . . . . . . @ . . @ . . . @ . . . . . @ . . . . . . . . @ . @ @ . @ . . . . . . . . . . . . . . @
@ . @ @ . @ . . @ @ . . . . . . . . . . . . . @ . . @ . @ . . . . . . . . . @ . . . . @ . . . @ . @
@ . . . . . . @ . . @ . . . . . . . . . @ . @ . . . . @ . . . . . . @ . . . . @ . . . . @ @ . . . @
@ @ . . . . . . @ . . @ . . @ . . . . . . . . . . . . @ . . . . . . @ @ . . . @ . . . . @ . . . . @
@ . @ . . . . . . . . . . . . @ . . . . . . . . . @ . . . . . @ . . . . . . . @ . . . . . . . . . @
@ . . . . . . . . . . . . . . . . . . . . . @ . . . . . . . . . . . . . . . . . . . . . . . . @ . @
@ . @ . . @ . . . . . . . . . . . . . . @ . . . . . . . . . . . @ . . . . @ . @ . . . . . . . . . @
@ . . . . . . . . . . . . . . . . . . . . @ . @ . . . @ . . . . . . . . . . . . . . . . . @ . . . @
@ @ @ @ @ @ @ @ @ @ @ @ @ @ @ @ @ @ @ @ @ @ @ @ @ @ @ @ @ @ @ @ @ @ @ @ @ @ @ @ @ @ @ @ @ @ @ @ @ @
3
47 8 19 38
47 43 20 19
5 24 35 36
