12 12
@ @ @ @ @ @ @ @ @ @ @ @
@ . . . . . . . . . . @
@ . . . . . @ . . @ . @
@ @ . . . @ . @ . . . @
@ . . . . . . . . @ . @
@ . . . . @ . @ . . . @
@ @ . . . . @ . . . . @
@ . @ . . . . . . . . @
@ . @ @ @ @ . @ . . . @
@ . . . . . @ . . . . @
@ . . . . . . . . . . @
@ @ @ @ @ @ @ @ @ @ @ @
3
6 7 3 2
5 6 9 1
7 4 4 8
