12 12
@ @ @ @ @ @ @ @ @ @ @ @
@ . . . . . . . . . . @
@ . . . . @ . . . . . @
@ . . @ . . . @ @ . . @
@ . @ . . @ @ . . . . @
@ @ . . . . . . @ . . @
@ . . @ . . . . . . @ @
@ . . . . . . . . . . @
@ . . . . . . . . . . @
@ @ . . . . . @ @ . . @
@ . . @ . . . . . . . @
@ @ @ @ @ @ @ @ @ @ @ @
3
10 6 3 4
2 4 8 7
5 9 9 2
