25 25
@ @ @ @ @ @ @ @ @ @ @ @ @ @ @ @ @ @ @ @ @ @ @ @ @
@ . . . . . . . . . @ . . . . . . . . . . . . . @
@ . . . . . . @ . . . . . @ @ . . . @ . . . . . @
@ . . . @ . . . . . . @ . . . . @ . . . . . @ . @
@ . . . . . @ . @ . . . . . . @ . @ . . . . . . @
@ . @ . . . . . . . . . @ . . . @ . . . . . @ . @
@ . . @ . . . . . @ . . . . . . . . . . . . . . @
@ . . . @ . @ . . . . @ . . . . . . @ . @ . . . @
@ . . . . @ . . . . . . . . . . @ . . . . . . . @
@ . . . . . @ . . @ . . @ . @ . . . . . @ @ . . @
@ . . . . . . . . . @ . . . . . . @ . . . . . @ @
@ @ . . @ . . . . . . @ @ . . . @ . @ @ . . . . @
@ . . . . . . . . . . . . . @ . . @ . . @ @ . . @
@ . . . . . . . . . . @ . . . . . . . . @ . . . @
@ . . @ . @ . @ . . . @ . . . . . . . . . @ . . @
@ . . . . . . . . . . . . . . . . @ . . @ . . . @
@ . . . . . @ @ . . @ . . . . . @ . . . . . . @ @
@ . . . . . . . . . . . @ @ . @ . . . . @ . @ . @
@ . . . . . . @ . . . . . . . . . . . @ . . . . @
@ . . . . . @ . . . . . @ @ . . . . . . @ . . . @
@ @ . . . . . . . . @ . . @ @ . . . . . . . . . @
@ . . . . . . . . @ . @ @ . . . . . . . @ @ . @ @
@ . . . . @ . . . . . . . . . . @ . . . . . . . @
@ . . @ . @ . . . . @ . . . . . . . . . . . . @ @
@ @ @ @ @ @ @ @ @ @ @ @ @ @ @ @ @ @ @ @ @ @ @ @ @
3
14 23 17 3
14 19 12 7
22 15 1 21
