25 25
@ @ @ @ @ @ @ @ @ @ @ @ @ @ @ @ @ @ @ @ @ @ @ @ @
@ . . . . . . . . . . . . . . . . . . . . . . . @
@ . . . . . . . . . . . . . . . . . . . . @ . . @
@ @ @ . . . . . . . . . @ . . . . . . . . . . . @
@ . . . . . . . . @ . . . . @ . . . . . . @ . . @
@ . . . @ . @ . . . . . @ @ . . . . @ . . . . @ @
@ . . . . . . . . . @ . . . . . . . . . . . . . @
@ . . . . . . . . . . . . @ . . @ . . @ . @ . . @
@ . . . . . @ . . . . . . . . . . . . . . . . . @
@ . . . . . @ . . . . . . . @ . . @ . . . . . . @
@ . @ . . . . . . . . . . @ . . . . . . @ . @ . @
@ . . . . . . . . . . . . . . @ . . . . . . @ . @
@ . @ . . . . . . . . . . . . . . . . @ . . @ . @
@ . @ . . . . . . . . @ . . @ . . . . . . . @ . @
@ . . . @ . @ . @ . . . . @ . @ . @ . . . @ . . @
@ . . @ . @ @ . . @ . @ . . . . . . . . . @ . . @
@ . . . . . . . . . . . . . . . . . . . . @ . . @
@ . . . @ . @ @ . . . . . . . . . . @ . . . . . @
@ . . . . . . . . . . . . . . @ . . . . . . . . @
@ @ . . . . @ . . . @ . . . . . @ . . . . . . . @
@ . @ . . . . . . . . . @ . @ . . . . . . . . . @
@ . . . . . . @ . . . . . . . . . . @ . . . . . @
@ . . . . @ . . . . . @ . . . @ . . . . . @ . . @
@ . . . . . . @ . . . . @ . . . . . @ . . @ . . @
@ @ @ @ @ @ @ @ @ @ @ @ @ @ @ @ @ @ @ @ @ @ @ @ @
3
18 14 4 7
5 15 12 4
6 9 12 14
