50 50
@ @ @ @ @ @ @ @ @ @ @ @ @ @ @ @ @ @ @ @ @ @ @ @ @ @ @ @ @ @ @ @ @ @ @ @ @ @ @ @ @ @ @ @ @ @ @ @ @ @
@ . . . . @ @ . . @ . . . . . . . . @ . . . . . . . . . . . . . @ . @ . . . . . . . . . . @ . . . @
@ . . . . . . . . . . . . . . . . . . @ . . @ . . @ . . . @ . . . . @ @ . . . . . . . . @ . . . . @
@ . . . . . . . @ . . . . . @ . @ . @ . . . @ . @ . . . @ . . . . . @ . @ . . . . . . . . @ . . . @
@ . . . @ @ . @ . . . @ @ . . @ . . . . . . @ . . . . . . . . . @ . . . . . @ . . . . @ . . . . . @
@ . @ . . @ . . . . @ . . . . . . . . . @ . . . . . . . . . . . . . @ . . @ . . . . @ . . . . . @ @
@ . . @ . . @ . . . . . @ . . @ . . . . . @ . . @ @ . @ . . . . . . . . . . . . . . . . . . . . . @
@ . . . . . . . . . . . . @ . . . . . . . . . . . . @ . . . . . . . . . @ . . . . . @ . . . . . @ @
@ . . . . . @ . . . . . @ . . @ . . . . . . @ . @ . @ . . . . . . . . . @ . @ . . . . . . @ . . . @
@ . . . . @ . . . . . . . . . @ . . @ . . . . . . . . @ @ . . . . . . @ . . . @ . . . . . . . . . @
@ . . @ . . . . . . @ . . . . . . . . @ . @ . . @ . . . . . @ . . . . . . . . @ . . . . . . . @ . @
@ . @ . . . . . . . . . . . @ . . . . . . @ . . . . @ . . . . . . . . . . @ . . . . . . . . . . . @
@ . . . @ . @ . . . . . . . @ . . . @ . . . . . . . . @ . . . . . . . . . . . . @ . . @ . . . . . @
@ @ . . . . . . @ @ . . . . . . . . . . . . . . . . . . . . . . @ . @ . . . . @ . . @ . . . . @ . @
@ . . . @ . . . . . . . . . . . @ . . @ . . . . . . @ . . . . . . @ . . . . . . @ . @ . . . @ . . @
@ . . . . @ . . @ . . . . . . . . . . @ @ . @ @ @ . . . . . . . . . . @ . . @ . @ . . @ . . @ @ . @
@ . . . . . . . . . . . . . . . . . . @ . . @ . . . . . . . . @ . . . . @ . . . . . @ . . . . . @ @
@ . @ . . @ . . . . . . @ . . . @ @ . @ @ . . @ . . . . . . . . @ . . . . . . @ @ @ . @ . . . . . @
@ . @ . . . . . . . . . . . @ . @ . . @ @ . @ . . . . . . @ . . . @ . . . @ @ @ . . @ . . . . . . @
@ . . . . . @ . . @ . . . . . . . . @ . . . . . . . @ . . . . . . . . . @ @ . . . . . @ . @ . . . @
@ . @ . . . . @ @ . . . @ . . . . . . . . . . . . . . . . . @ . @ @ . . . . @ . . . . . . . . . . @
@ . . . . . . @ . . @ . . . . . . . . @ . . . . . . . . . . . @ . . @ . . . . @ . . @ . . . . . . @
@ . . . . . . . . . . @ . @ . @ . . . . @ . . . . . . @ . . @ . . . . . . . . . . . . @ . . . . . @
@ @ . @ . . . @ . . . . . . @ . . . . . @ . . @ . . . . . . . . @ @ . @ @ . . . . . . . . . . @ . @
@ . . . @ @ @ . . . . . @ . . . . . . @ . . . . . . . . . @ . . . . @ . . . . . @ . . . . . . . @ @
@ . @ @ . . . . . . . . . . . . @ . . . . . . @ . . . @ . . . . . . . @ @ @ . . @ . . . . . . . . @
@ . @ . . . . . . . . . . . . . . . . . @ . . . @ . @ . . . . . . @ . . @ . . . @ . . . . @ . . . @
@ @ @ @ . . . . @ . @ . . . . . . . @ . . . @ . . . @ . @ . @ . @ . @ . . . . . . . . . . . @ . . @
@ @ . . @ . . . . . . . . @ . . . . . . . @ . . . . . . . . . . . . . . . @ . . . . @ . . . . . . @
@ . . . . . . . . @ . . @ . . . . . . . . . . @ . . . . . . . . . . . . . . . . . . . . @ . . . . @
@ . . @ . @ . . . . . . . . @ . . . . . . . . @ . . . . . . . . . . @ @ . . . @ . . . @ . . . . . @
@ . @ . . . @ . @ . . @ . @ . . . . . . . . . @ . @ @ . . . . . . . . . . @ @ . . @ . . . . @ . . @
@ @ . . . @ . . . @ . . . . . . @ . @ . . . . @ . . . . . @ . . . . . . . . . . . . @ . @ @ . . . @
@ . . . . . . . . @ . . . . @ . . . . . @ . . . @ . @ . . . . . . . . . @ . @ . . . . . . . . . . @
@ . . . . @ . @ . . . @ . . @ . . @ @ . . . @ . @ . . . . . . . . . . . . @ . . . . . . @ . @ . @ @
@ . . . . . . . . . @ . . . @ . . . . . . . . . . . @ @ @ . . . . . . . . . @ . . . . . . . . @ . @
@ . . @ . . @ . . @ . @ . . . . . . . @ @ . . . . . . . . . . . . . . . . . . . . . . . . . @ . . @
@ . . . @ . . . . . . . . @ . . . . . . . @ . @ . . @ . . . . @ . . . @ . . . . . . . . . . @ . . @
@ . @ . . . @ . @ . @ . . . . . . . . @ . . . . . . . . . . @ . . . . . . . . . @ . . . . . . . . @
@ . . . . . @ . . . . . . @ . . . . . . . . . . . . . . . @ . . . . . . . @ . . . . . . . . . . . @
@ . @ . . . . . . @ @ . . . . @ . . . . . . . . . . . . . . @ . . . . @ . . . @ @ . . . . . . . . @
@ . . @ @ . . . . @ . . . . . . @ . . @ . . . . . . . . . . . . . . . @ . . . . . . . . . @ . . . @
@ . . . . @ . . . . . . . . @ @ . . . . . . . . . . . . . @ . . . . . . . . . @ . . . . . @ . . @ @
@ . @ @ . . . . . . . . . . . . . . . . . @ . . . . . . . . . . . . . . . . . . @ @ . . . . . . . @
@ . . @ . . . . @ . . . . . . . . . . . . . . @ . . . . . @ . . . . . . @ @ . . . . . . @ . . @ . @
@ . . . . . . . . @ @ . . . . @ @ @ . . @ . . @ . . . . . @ . . @ . . @ . . . @ . . . . . . . . . @
@ . . . @ @ . . @ . . . . . @ . . . . . . . @ . . . . . . . . . . . . . @ @ . . . @ . . . . . . . @
@ . @ . . . . @ . . . @ @ . . . . . . @ . . @ . . . . @ . @ . . @ . . . . . . . . . . . @ . . @ . @
@ . . . . . . . . @ . . . . . . . @ . . . . . . . @ . @ . . . . . . @ . . @ . . @ . . . . . @ . . @
@ @ @ @ @ @ @ @ @ @ @ @ @ @ @ @ @ @ @ @ @ @ @ @ @ @ @ @ @ @ @ @ @ @ @ @ @ @ @ @ @ @ @ @ @ @ @ @ @ @
3
37 14 33 13
34 15 44 35
20 39 44 2
