50 50
@ @ @ @ @ @ @ @ @ @ @ @ @ @ @ @ @ @ @ @ @ @ @ @ @ @ @ @ @ @ @ @ @ @ @ @ @ @ @ @ @ @ @ @ @ @ @ @ @ @
@ . . . @ . @ . . . . @ . . . . . @ @ . @ . . . . . @ . . . . . @ . . . . . @ . . . . . @ . . . . @
@ . . . @ @ . . . . @ . . . . @ . . . . . . . @ . . @ . . . . @ . . . . @ . @ . . @ . . . . @ . . @
@ . . . . . . . . . . . . . @ . . . @ . @ . . @ . . . @ . @ . . . . . @ . . . . . @ . . @ . @ . . @
@ . . @ . . . . . . . . . . . . . . . @ . . . @ . . . @ . . . . . . @ . . . . . . . @ . . . . . . @
@ . . . @ . . . @ . . . . . @ . . . . . . . . . . . . . . . . @ . @ . . . . . @ . . . @ . . @ @ . @
@ @ . @ . . . . . . . @ . . . @ . @ . . . . . . . . . @ . . . . . . . @ . . . . @ . . . . . . . . @
@ . . . @ @ . . . @ . . . . . . . . . . . . . . . @ . @ . . . . @ . . . . . . . . . . . . . . . . @
@ . . @ . . @ . @ . . . . . . @ . . . . . . . . . . . . @ . . @ . . . . . . @ . . . . @ . . . . . @
@ . . @ . . . . @ . . . . . . . . . @ . . . @ @ @ . . . . . . . . . . . @ . . . @ . . . . . @ . . @
@ . . @ @ @ . . @ . @ @ . . . . . @ . . . @ . . . . . . . . . . @ . . . . . . . . . . . . @ . . . @
@ @ . . . . . . . . . . @ @ . . . . . . . @ . . . @ . @ . . . @ . . . . . . . . . . . . . . . . . @
@ . . . @ . . . . . . @ @ @ . . . . . @ . . . . @ . . @ . @ @ . . . . @ . . @ . . . . . . . . @ . @
@ . . . . @ . @ . . . . . @ @ . . . . @ . @ . . . . @ . @ . . . . . . . @ . . . . . . . . . . . . @
@ . . . @ . . . . . . . . @ . . . @ . . . . . . . . . @ . . . . . . . . . . . . . . . . @ . @ @ . @
@ . . . . . @ . @ . . @ . . . . @ . . . . @ . . . @ . . . . . @ . . . . . . @ . . . . . . . . . . @
@ . . . @ . . @ . . . @ . . @ . @ . . . . . . @ . . . . . . . . . . . . . . . . @ . . . . . . . . @
@ . . . @ . . . . . . . . . . . . @ @ . . . . . . @ . . . . . @ . @ . @ . . @ . . . . . . . . . . @
@ . . . . . . @ . . . . . . . . . . . . . . @ @ . @ . . . @ . . . . . @ . . . . . . . @ . . . . . @
@ . . . . . @ . @ . @ . . . . @ . @ . . @ . . . . . . . . . . @ . . . . @ . @ . . . @ @ . . . @ . @
@ . . . . . . . . . . @ . . @ . . . . . . @ . . . @ . @ . . . . @ . @ . @ @ . . . @ . . @ . @ . . @
@ . @ . . . . . @ . . . . . . @ . @ . @ . . . @ . . . @ @ . @ . . . . . . . . . @ . . . . . @ . . @
@ . . . . . @ . . . @ . . . . . . . . . . @ . . @ . . . . . . . . . . . . . . @ . . . . . . . @ @ @
@ . . . . @ . . . @ . @ . . . @ . . . . . . . . . . @ . . . . . . . @ @ @ . @ @ . . . . . @ . . . @
@ . . . . . . @ . . . . . . . . . . . @ . @ . . . . . . @ @ @ . . . . . . . . . . . . . . . @ . . @
@ . . . @ . . . @ . . . . . . . . . . . . @ . . @ @ . . . . . . @ . @ . . . . . . . . . . . . . @ @
@ . . . . . @ . . . . . . . . . . @ . . . . . . . . . . . @ . . @ . . . @ . . . . . . . . . . . . @
@ . . . @ . @ . . . @ @ . . . . . . . . . @ . . . . . @ . . @ @ . . . . . @ @ . . . @ @ . @ . . @ @
@ . . . . . . . . . . . . . . @ . @ . . @ . . . @ . @ . . . . . . . . . . . @ . @ . . . @ . . . . @
@ @ . . @ . . . . @ . . . . . . . . . . . . . . . . . . . @ . . . @ . . @ . . . . . . . . @ . . . @
@ . . . . . . @ . . . . . . . . @ . . . @ . . . . . @ . . . . . . . @ . . . @ . . . . . . . . . @ @
@ . . . . . . . . . . . . @ . . . . . . . . . . . @ . . . . . . . . . . . . . . . . . @ . @ . . . @
@ . . . . . . . . . . . . . . . . @ . . . @ . . . @ . . . . . . . . . . . . . . . @ . . . @ . . . @
@ . . . @ . @ @ @ . . . . @ . . . @ . . . . . . . @ . . @ . . . . . @ . . . . . . . . . . . . . . @
@ . . . . . . . . . . . . . . @ . @ @ . . . . . . . . . . . . . . . @ . . . . . . . . . @ . . . . @
@ . @ . . . . . @ @ . @ . . . . . . . @ . . . . . . . . . . . . . @ . . . . . . . @ . . . . . . . @
@ . . . . . . . . . @ . . . . . @ . . . @ . @ . . @ . @ @ . . . . . . . . . . . . . . . . . @ . @ @
@ . . . . . . @ . . . . @ . . . . . . . . @ . . . . . . . @ . . . . . . . . . @ . . @ . . . . . . @
@ . . . . . @ . @ . . . . . . . . . . @ . . @ . . . . @ . . . . . . . . @ . @ . . @ . . . . @ . . @
@ . . . . . . . . . @ @ . . . . @ . @ . . . . @ . . @ . . . . . . . . . . . . . @ . @ . @ . . . . @
@ . . . . . . @ . . . @ . . . . @ @ . . . @ . . . . . @ . @ . . . . . . . . . . @ @ . @ . . . . @ @
@ . . . . . . . . @ . . . @ . . . . @ . . . . . . . . @ . . @ . @ . . @ . @ . . @ . . . . . @ . . @
@ . . . @ . @ . . . . . @ . @ . . . . . . . . . . . . . . @ . @ . . . . . . . . . . . . . @ . @ . @
@ . . . @ . . @ . . . . . @ . . . . . . @ . . . . . . . . . . . . . . . . . . . . . . . . . . . . @
@ . . . . @ . . . . . @ . . @ . . . @ . . . . . . . . . . . . . . @ . . . . . . @ . @ @ . . . . @ @
@ . . . . . . . @ . . . . . . . @ @ . . . . . . . @ . @ . . . . . . . . . @ . . . . . . . . . . . @
@ . . . @ . . . . @ @ . @ @ . . . . . . . . @ . . . . . . . . @ . . . . @ . @ . . . . . . . . . . @
@ . @ . . . . . @ . . . . . . . . @ . . . . . @ . @ @ . . . . @ . . . . . . . . . . . . . . . . . @
@ . @ @ . . . . @ . . . . . . . . . . . . . . @ . . . . . . . . . @ @ . . . @ . . . . @ . . . . . @
@ @ @ @ @ @ @ @ @ @ @ @ @ @ @ @ @ @ @ @ @ @ @ @ @ @ @ @ @ @ @ @ @ @ @ @ @ @ @ @ @ @ @ @ @ @ @ @ @ @
3
34 35 7 47
32 30 8 1
42 1 17 27
