25 25
@ @ @ @ @ @ @ @ @ @ @ @ @ @ @ @ @ @ @ @ @ @ @ @ @
@ . . . . @ . . . . . . . . @ . . . . . . . . . @
@ . . . @ . . . @ . . . . @ . . . . . . . @ . . @
@ @ @ . . . . @ . . @ . @ . . @ . . . . . . . . @
@ . . . . . . @ . . . . . @ . . . . . . . @ . . @
@ . @ . @ . . . . . . . . . . . . @ . . . . @ . @
@ . @ @ . @ @ . @ . . . . . @ . . . @ . . . . . @
@ . . . @ @ . . . . . . . . @ . @ . . . . . . @ @
@ . . . . . . . . . @ . . . . @ . . . . . . . . @
@ . . . . . . . . . . . . . . @ . . . . . . @ . @
@ @ @ @ @ . . . . . . @ . . . . . . @ . . . . . @
@ . . . @ . . @ @ . . . @ . . . . @ . . @ . . . @
@ @ . @ . . @ . . . @ . @ . . . . . . . . . . . @
@ . . . . . . . . . . . . @ . @ . @ @ . . . . @ @
@ @ . @ . . . . . . . . @ . . . . . . . . @ . . @
@ . . . . . @ . . . . . . . . . . . . . . . . . @
@ . . . . . . . . . . @ . . @ . . @ . . @ . . . @
@ . . . @ . . . . . . . . . . . . . . . . . . . @
@ . . . . . . . . . . . . . . . @ . . @ . . @ . @
@ . @ . . . @ . . @ . . . . . . . . . . . . @ . @
@ . . . @ . . . . . . . . . . . . . . . . @ . . @
@ . . . . . . @ . . . . . . . . . . @ . . . . . @
@ . . . . . . . . . . . @ . . . @ . . . @ . . . @
@ . . @ . . . . @ . @ . . . . . . . . . . . . . @
@ @ @ @ @ @ @ @ @ @ @ @ @ @ @ @ @ @ @ @ @ @ @ @ @
3
20 20 5 16
23 9 4 15
6 7 4 10
