12 12
@ @ @ @ @ @ @ @ @ @ @ @
@ . . . . . . . . . . @
@ . . @ . . @ @ @ . . @
@ @ . . . . . @ . . . @
@ . @ @ . . . @ . . . @
@ @ . . . @ @ . . . . @
@ . . . . . . . . . . @
@ @ . . . @ @ . . @ . @
@ . . . @ . . . . . . @
@ . . . . . @ . . . . @
@ @ . . @ . . @ . . . @
@ @ @ @ @ @ @ @ @ @ @ @
3
2 5 8 5
8 3 8 1
5 3 10 6
