25 25
@ @ @ @ @ @ @ @ @ @ @ @ @ @ @ @ @ @ @ @ @ @ @ @ @
@ . . . . . @ . @ . . @ . @ . . . . . . . . . . @
@ . @ . @ . @ . . . @ . . . . . . . . . . . . . @
@ . . . @ . . . . @ . . . . . @ . . . . . . . . @
@ . . . . @ @ . . . . . . . . . . . . . . . . . @
@ . @ . . . . . . . . . . . . . . @ . . @ . @ . @
@ . . . @ . . . . . . . . . . . @ . . . . . @ . @
@ . . . . . . . @ @ . . . . . . . . . . @ . . . @
@ . @ . . @ . . . . @ @ . . . . . . . . . . @ . @
@ . . . . @ . . @ . @ . . . @ . @ @ @ . . . . . @
@ . . @ . . . . . . @ . . . . . . . . @ . . . . @
@ . . . . @ . @ @ . . . . . . @ . @ . . @ @ . @ @
@ . . . . . . . @ @ . . . . . . . . . . . . . . @
@ . . @ . . . . . . . . . . @ . . . @ . . . . @ @
@ . . . . . @ . @ . . . @ @ . . . . @ . . . . . @
@ . . . @ . . . @ . . . . . . . . . . @ . . . @ @
@ . @ . . . . . . . . . . . . . . . . . @ @ . . @
@ . . . . . . . . . . . @ . . . . . . . @ . @ . @
@ . . . . . . . . @ . @ . . . . . . . . . . . @ @
@ . . . @ . . . . . . . . . . . . . . . @ @ . . @
@ . . . . . @ . . . @ @ . . . . . . . . . . @ . @
@ . . . . @ @ . . . . @ . . . . . . . . . . . . @
@ @ . . @ . . @ . . . . . . . . . @ @ . . . . @ @
@ . @ . @ . . . . . . . . . . . @ . . . @ @ . . @
@ @ @ @ @ @ @ @ @ @ @ @ @ @ @ @ @ @ @ @ @ @ @ @ @
3
7 19 13 11
2 11 3 22
15 13 12 19
