12 12
@ @ @ @ @ @ @ @ @ @ @ @
@ . . @ . . @ . @ . . @
@ . @ . . . . . . . . @
@ . . . . @ . . . . @ @
@ . @ . . . . . . . . @
@ . . . . . . . . . . @
@ . . . . @ . . . . . @
@ . . . . . . . . . . @
@ . . . . . . . . . . @
@ . @ . . . @ . @ . . @
@ @ . @ . @ . . . . . @
@ @ @ @ @ @ @ @ @ @ @ @
3
1 7 5 1
1 4 7 1
7 8 2 8
