12 12
@ @ @ @ @ @ @ @ @ @ @ @
@ . . . . . . . . . . @
@ . . . @ @ @ . @ . . @
@ . . . . . @ @ @ . . @
@ . . . . . . . . @ @ @
@ . . . . . . @ @ . . @
@ @ . . @ . . @ . . . @
@ @ . . . . . . . @ . @
@ . . . . @ . . . . @ @
@ . . . . . . . . . . @
@ . . . . . . . . @ . @
@ @ @ @ @ @ @ @ @ @ @ @
3
1 4 9 5
4 8 6 9
9 4 4 2
