12 12
@ @ @ @ @ @ @ @ @ @ @ @
@ . . . . @ . . . . . @
@ . . . . . . . @ . . @
@ . . @ . . . . . . . @
@ . @ . . @ . @ . . @ @
@ @ @ @ . . . . . . . @
@ . . . . . . . @ @ . @
@ . . . . . . . . @ . @
@ . @ . . . . . . . . @
@ @ . . . . . . . @ @ @
@ . . . . . . . . . . @
@ @ @ @ @ @ @ @ @ @ @ @
3
7 7 4 8
3 8 3 2
2 9 10 6
