50 50
@ @ @ @ @ @ @ @ @ @ @ @ @ @ @ @ @ @ @ @ @ @ @ @ @ @ @ @ @ @ @ @ @ @ @ @ @ @ @ @ @ @ @ @ @ @ @ @ @ @
@ . . @ . @ . . @ . . . . . @ . @ . . . . . . . . . . . . . . . . . . . . . . . @ . . . . @ . @ . @
@ @ . . . . . . @ . . . . @ . . @ . . @ @ . . . . . @ . . . . . . . . . . . . @ . . . . . . @ . . @
@ . . . . . . @ . @ . . . . @ . . @ . . @ . . . . . . . . @ . . . . @ . . . . . . @ . . . @ @ . @ @
@ . . @ . . . . . . . . . . @ . . . . . . @ . . . . . . . . . @ . . . . . . . . . . . . . . . . . @
@ . . @ . @ . . . @ . . . . . . . . @ . @ . . . @ @ . . . . @ . . @ . @ @ . @ . . . . . . . . . . @
@ @ . . . . . . . . @ . . . . . . @ . . . . . . . . . . @ . . @ . . . . . . . . . . . . . . . . @ @
@ . @ . . . . . . . . . . . @ . . @ . @ . . . @ . . . . . . . . . . . . . @ . . . . . . . . . @ . @
@ @ . . . @ . . . . @ . . . . @ . . @ . . . . . . @ . @ . . . . . @ . @ . . @ . . @ . . . @ . . @ @
@ . @ . . . @ . . . . . . . @ . . . . . . . . . @ . . . . . @ . . . . . . . . . . @ @ . . @ . . @ @
@ . . . . . @ . . @ . . . @ . @ . . . . . . . @ @ . . . @ @ . . . . . . . . . . . . . . . @ . . . @
@ . . . @ . . . . . @ . . . . . @ . @ . @ . . . . . @ . . . @ . . . . . . . . . . @ . . . . . . . @
@ . . . . @ . @ @ . . @ . @ . . . @ . . . . . . . . . . . @ . . . @ . . . . . . . @ . . @ . . @ @ @
@ . . @ . . . . . @ . . . . @ . @ . . . @ . @ . . @ . . . . . . . . @ @ . @ . . . . . @ @ . @ . . @
@ . . . . . . . . . @ . @ . . . . @ @ . . . @ . . . . . @ . . . . . . . . . @ . . @ . . @ . . @ . @
@ @ @ . . . . . . . @ . . @ . . . . . . . . . @ . @ . . . @ @ . . @ . . @ . . . . . . . . . . @ . @
@ . . . @ . . . . . @ . . . . . . . . . . @ . . . . . . . . . . . @ . @ . . . . . . @ . . . . . . @
@ . . . . . . . . . . . . . . . . . @ . . . . @ . . . . . . @ . . . . . . . . . . . @ . . . . @ . @
@ . . . @ . . . . . . . . . . . . . @ . . . . . @ . . . @ . @ . . . . . @ . . . . . . . . . @ . . @
@ @ . . . . . @ . . . . . . . . . . @ . . . . . . . . . . @ . . . . @ @ . @ . . . . . . . @ . . @ @
@ . . @ . . . @ . . . . . @ . . . . . @ . . . . . @ . . . . . . . . . . @ . . . . . . . @ . . . . @
@ . . . @ . . . @ . . . . . . . . @ . . . @ . . . . . @ @ . . . . . @ . . . . @ . . . . . . . . @ @
@ . . . . . . . . @ @ . . . . . @ . @ . . . . . . . @ . . @ @ @ @ . . . . . @ . . . . . . @ . . . @
@ . @ . . @ . . . . . @ . . . . @ . . . . . . @ . . @ . . . @ . . . . . . @ . . @ . . . . . . . . @
@ @ . . @ . . . . . . . . . . . . . . . . . @ . . . . . . . . . . . . . . . . . . . . . . . . @ . @
@ . . . @ . . @ . @ . . . @ . @ . @ . . . . . . . . . . . . . . . . . . . @ . . . . . . . . . . . @
@ . . . . . . . @ . . . . . . @ . . . @ . @ . . . . . . . . . . . . @ . . . . . . . . . . . . . . @
@ . . . . . @ . @ . . . . . . @ @ . . @ . . . @ . @ . . . . . . . . . . @ . . . . . . . . @ . @ . @
@ . . . @ . . . . . . @ . . . . @ @ . . . . . . . . . . @ . . . . . . . . . @ . . @ . . . . . . . @
@ . . . . . @ . @ . . . @ . . . . . . . . . @ . . . . . @ . . @ . @ @ . . . . . . . . @ . . @ . . @
@ . . . . . . . . . @ . . . . @ . . . @ . . @ . . . . . . . . . . . . . . . . . . . . . . . . . . @
@ . @ . . @ . . . . . @ @ . @ . . . @ . @ @ . @ . . @ @ . . . . @ . . . . . . . . @ @ . . . . . . @
@ . . @ . @ . . . . . . . . . . @ . . @ . . @ . . . . . . . . . @ . . . . . . . . . @ . . . . . . @
@ . . . @ . . @ . . @ @ . . @ . . . . . . . . @ . . . . . @ . . @ . . . . . . . . . . . @ @ . . . @
@ . . @ . . . . . . . . . . @ @ . . . . @ . . . . . . . . . @ . . . . . . . . . @ . . . @ . @ . . @
@ . . . . . . . @ . . . . . . . . . . . . . . @ . . . . @ . . @ . . . . . @ . . . . . . . . . . . @
@ . . . . @ . . @ . @ @ . . @ . . . . . . . . . . @ . . . . @ . . . . . . . @ . . . . . . . . . . @
@ . . . @ . . . . @ . @ @ . @ . . . . . . . . . . @ . . . . . . . . . . . . . . . . . . . . . . . @
@ . @ . . . . . . . . . . . . . @ @ @ . . . . . . . . . . . . . . . . . . . . @ . . . . . . . . . @
@ @ . @ @ . . @ . . . . . @ @ . . . . . . @ . . @ . . . . . . . . . . . @ . . . . . . . . @ . . . @
@ . . . . . . . . . . . . . @ . . . . . . . . @ . . . . @ . . . . . . . . . . . . . . @ . . . . . @
@ . @ . @ @ . @ . . . @ . . . . . . . . . @ . . . . @ . . . . @ . . . . . . . . @ . @ @ . . . . . @
@ . . . . . . . . . . . . . . . . . . @ . . . @ . . @ . . . . . . . . . . . . . . @ . . . . @ . . @
@ . . @ . . . . . . . @ @ @ . . . . . . . . . . . . @ . . . . . . . . . . . . . . . @ . @ . . . . @
@ . . @ . . @ . . . . . . . . @ . . . . . . . . . @ . . @ . . @ . . . @ . @ @ . . . . . @ @ . . . @
@ . . . . @ @ . . @ @ . . . . . . @ . @ . . . . . @ @ . . . . . . @ . . . . . . . . @ . . @ . @ . @
@ . . . . @ . . . . . . . . . . @ . . . . @ . . @ . . . . . @ . . . . . . . . . . . . . . @ . . . @
@ . . . . . . @ . @ . @ @ . @ . . . . @ . . . . . . . . @ . . . . . . @ . . @ . . . . . . . . . . @
@ . . . . @ . . @ . @ . . . @ . . . . . @ . . . . . . . . . . . . . . . . . . @ . . . @ . . @ . . @
@ @ @ @ @ @ @ @ @ @ @ @ @ @ @ @ @ @ @ @ @ @ @ @ @ @ @ @ @ @ @ @ @ @ @ @ @ @ @ @ @ @ @ @ @ @ @ @ @ @
3
12 28 9 11
36 13 6 47
7 31 34 18
