100 100
@ @ @ @ @ @ @ @ @ @ @ @ @ @ @ @ @ @ @ @ @ @ @ @ @ @ @ @ @ @ @ @ @ @ @ @ @ @ @ @ @ @ @ @ @ @ @ @ @ @ @ @ @ @ @ @ @ @ @ @ @ @ @ @ @ @ @ @ @ @ @ @ @ @ @ @ @ @ @ @ @ @ @ @ @ @ @ @ @ @ @ @ @ @ @ @ @ @ @ @
@ @ . . . @ . . . . . . . @ . @ . . . . . . . @ . @ . . . . . . . . . @ . . . . . . . . . . . . @ . . . . @ . . . . . . . . . . @ . . . @ . . . . . . . . @ . @ . . . @ . @ . . . . . @ . @ . . @ . . @
@ . . . . . . @ . . @ . . . @ . . . @ . . . . @ . . . . . . . . . . . . . . @ . . @ @ . . . . . . @ @ . @ . . . . . . . @ . . . . . . . . . . @ . . . . . . . . . . . . . . . @ . . . . . . . . . . . @
@ . . . . . @ . @ @ @ . . . . . @ . @ . . . @ . . . . . . . . . . . . . . . @ . . . . . @ . @ . @ . . . . @ @ . . . @ @ . . . @ . @ . . @ . . . . . @ . . . . . @ @ . @ @ . . @ . . . . . . . . @ . . @
@ . . . . . . . . . . . . . . @ . . . . . @ @ @ . @ . @ . . @ . . . . . . . . @ . @ . . . . @ @ . . . . . . . @ . . . . . . . . . . @ . . @ . . @ . . . . . . . . . . . . . . . . . . . @ . . . @ . . @
@ . . . . . . . . . . . @ . . . . . @ . @ @ . . . . . . . @ . . @ . . . @ @ . . . . . . . @ @ . . . . . . . . . @ . @ . . . . . @ . . @ . . @ . @ . @ . . . . . @ . @ . . . . . . . . . . @ . . . . . @
@ . . . . . . . . . . . . . . . . . . @ @ . . . . . . . @ . . . @ . . . . . . . @ . . . . . . . . . @ . . . . . . . @ . @ . . . . @ . . @ . . @ . . @ . @ . . . . . . . . @ @ . . . . @ @ . . . . . . @
@ . . . . . @ . @ . . . @ . @ . . . . @ . @ . @ . @ . . . . . @ @ . @ @ . . @ . . . @ . . @ @ @ @ . . . . . . . . . @ . . . . . . . . @ . . . . . . @ . . . . @ . . @ . . . @ . . . @ . . . . . . . . @
@ . . @ @ . @ . . . @ . . @ . . . . . . @ . @ . . . . . @ . . . . . . . . . . . @ . . . . . . . @ . . . . . . . @ . . . . . @ . . . . . . . . @ . . . @ . . . . . . . @ . . @ . . . . . . . . . . . . @
@ . @ . . @ . . @ . . . . . . . . . . . . . . . . @ . . . . . . . @ @ . . @ . . . . . @ . . @ @ . . . . . . . @ . . . @ . . . . . . . . . . @ . . . . . @ . . @ . . . . . . . . . . . . @ @ . . . . . @
@ @ . . . . . . . . @ . . . . . . . . . . . . . . . . @ . . . @ . . . . . . . . . . . . . . @ . . . . @ . . @ . . . . . . @ . @ . . . . . . . . . . . . . . @ . . . . . . . . . . @ . @ . . @ . . . . @
@ . . @ @ . . . . @ . . . . . . @ . . . . @ . . . @ . . . . . . . . . . . . . . . . . . . . . . . @ . . . . . . @ . . . . . . @ . @ . . . . . @ . . . @ . . . . . . . . . . . @ . @ . @ . . . @ . . . @
@ . . . . . . . @ . . . . . . . . . . . . @ . . @ . . . @ . @ . . . @ . . . @ . . @ . . . . . @ @ . . . . @ . . . . . @ . @ @ . . . . . . . . . @ . . @ @ . . . . . . . . . . @ . . . . . @ . . . . . @
@ @ . . @ . . . . . . @ . . . @ @ @ . @ @ . . . . . . . @ . . . . . . . . . @ . . . . . . @ @ . . . . . . . . @ . @ . . . . . . @ . . . . . . . . . . . . . . . . . . . . . . . . . . @ . . @ . . . . @
@ . . . . . . . . . @ . @ @ . . @ . . . . . . . . @ @ @ . . . . . . . . @ . . . . . @ . . . . . . . @ @ . . . . . . . . . . . . @ . . . . @ . . . . . @ . . . . . . @ . . . @ . . . . . . @ . . . @ . @
@ . . . . . @ . . . . @ . . . @ . @ . . . . . @ @ . . . . . . . . . . . . . @ . . . @ . @ . . . . . @ . . . . @ . . . . . . . . @ . . . . . . . . . . . . . . @ . . . . . @ . . . . @ . . . . @ . . . @
@ . . . @ . . @ . . . . . . . . . . . . . . . . . . . . @ @ @ . . . . . . . . . . . . . . . . . . . . . . . @ . . . . @ @ . @ . . . . . . . . . . . @ . . . . @ . . . @ . . . . . . . . . @ @ @ . . @ @
@ . @ . . . @ . . . . . . . . . . . . . . @ . . . . . . . . . . @ . . . . . . . . . . @ . . . . . . . . . . . @ . . @ . @ . @ . . . @ . @ . . . . . . . @ . . . . . . . . . . . @ . . . . . . . . @ . @
@ . . . . @ . . . . . . . . @ . . . @ . . . @ @ . . . . . @ . . . . . . . . . . . . . . @ . . . @ . @ . @ . . . . . . . . . . @ . . . . . . . . . . @ . . . . @ . . . @ . . . . . . . . . . . . . . . @
@ . . . @ . . . . . . . . . . . . @ @ . . . . @ @ . @ . . @ . . . . . . @ . . . . . . . . . @ . . @ . @ . . . @ @ . . . . . . . @ . . . . . @ . . . @ @ @ . @ . . . . . . . . @ . . . @ @ . . . . @ . @
@ @ . @ . @ . . . . . . . . . @ . . . . @ . . . . @ . . . . . . . . . @ . . @ . . . . . . . . @ . . . . . . . . . . . . @ . . . @ . . . . . @ . . . @ . . . . . . . . . . . . @ . . @ . . . . @ . @ @ @
@ . . . . @ . . . . @ . @ @ . . . . @ . . . . . . . @ . . . . . @ . . . @ . . @ . . . . . . . @ . . . . @ . . . . . . . . . @ . @ @ . . . . . . . . @ . . . . . . . . . . @ . @ . . . . @ . . . . . . @
@ @ . . . . . . . . @ . @ . @ . . . @ @ . . . @ . . . . . . . . . . . . . . . . . @ . @ . . . . . @ . . . . . . . . . . . . . . . . @ . . . . . . . @ . . . . . . . . @ . . . . @ . . . . . . . . . . @
@ . . @ . @ . . @ @ . . . . . . . . . . . . @ . @ . . . . . . . . . . @ . . . @ . . . . @ . . . . @ . . . @ . . @ @ . . . . . . . . @ . . . @ . . @ . . . . . . . . . . . @ . . . . . . . . . @ . . . @
@ @ @ . . . . @ . . @ . . . . . . @ . . . . . . . . . . . . . . . . @ @ . . @ . . . . . . . @ . . . . . @ . @ . . . @ . . . . . @ . . . . . . . . . . . . . . . @ . @ . . . . . . . . @ @ . . . . @ . @
@ . . @ . . . @ . . . . . . . . . . . . . @ @ . . @ @ . @ . . . . . . . @ . . . . . . . . . . . . . . . . . . . @ @ . @ . @ . @ . . . @ . @ . . . @ @ . . . . . . . . . . . . . . . . . . . . . . . . @
@ @ . . @ . . . . . . . . . @ . . . . . @ . . . @ . . . . . . . @ . . @ . . . @ . @ . . . @ . @ . . @ . . @ . @ . . . . . . @ . . @ . . . . . . . . . @ . . . . . . . . @ . . @ . @ . . . . . . . . . @
@ . . @ . . . @ @ . . . . . . . @ . . . . . . . @ . . . . . . . . . . . . @ . . . @ . . . . . @ . . . . . . . . . @ . @ . . . . . . . . . . . . . . . . . . . . @ . . . . . . . . . . . . . . . . @ . @
@ . . . . . @ . . . . . . . @ . . . @ . . . . . . . @ @ . @ @ @ . @ . @ . . . . . . . . . . . . . . @ . . @ . . . . . . @ . . . . . . . @ . . . . . . . @ . . . @ @ . @ . . @ . . . . . . @ . . . . . @
@ . . . @ . @ . . . . . . . . . @ . @ . . . . @ . . . . @ . . . . . . . . . . @ . . . . . . . . @ . . . . . @ . . . . . . . . . @ @ . . . . . . . . . . . . . . . . . . . . . . . . @ . @ . @ . . . . @
@ @ @ . . . . . @ . @ . . . . @ . . . . . . . . . . . . . . . . . @ . . . . . @ . . . . . . . . . . @ . . . . . . . @ . . . . @ . . . . . @ . . . . . @ . . @ . @ . . . . @ . . . . . @ . . . @ @ . . @
@ @ . . . . . . . . . . . . . . . . @ . . . . . . . @ . . . @ . @ . . . . . . @ . . . . . . @ . . @ . @ . . @ . . . . . . @ . . . . . . . . @ @ . . . . . . . . . . . . . . . . . . . . . @ . . @ . . @
@ . . . @ . . . . @ . . . . . @ . . . . . . @ @ . . @ . . . . . . . . @ @ . @ . . . @ . . @ . @ . @ . . . . . . . . . . . . . . @ . . . . . . . . . . . . . @ . . . . . . . @ . . . . . . . . . @ . . @
@ . . . . . . @ . . . @ . . @ . @ . . @ . . . . . . @ . . . . . @ . @ . . . . . . . . . @ @ . . . . . . . @ . . . . @ . . . . . . . . @ . @ . . . . . . . @ . . . @ . . . . . @ . @ . . . . . . . @ . @
@ . . . . . @ . . @ . . . . . . . . . @ . . . . . . . . . @ . . . . . . . . . @ . @ . . . . . @ @ . . . . . @ . @ . . . . . . @ . . . . . . . . @ . . . . . . . . . . . . . @ . . . . . @ @ . . . . . @
@ . @ . @ . . . . . . . . . . . . . . . . . . . @ . . . . . . . . . @ . . . . . . @ . . . . @ @ . . @ . @ . . @ . . . . . @ . @ . . . @ . . . . . . . . . . . @ . @ . . . . @ @ . . . . . @ . . . . . @
@ . . . . . . @ . . @ . . . . . @ . @ . . . . . . . . . . . . . @ . . . @ . . . . @ . . . . . . . . . @ . . . . . @ . . . . . @ . @ . @ . . @ . . . . . . . . . . . . . @ . @ . . . . . . . . . . . . @
@ . . . . . . . . . . . @ . . . @ @ . . @ . . . . @ . . . . . . . @ . . @ . @ . . . . . . . @ . . . . . . . . . . . @ @ . @ . . . . . . . . . . . . . . . . . . . @ . . . @ . @ @ . . . . @ @ . . . . @
@ . . . . . . . . . . . . . . . . . . . . . . . . . . . . @ . . @ . . . . . . . . . . . @ . . . . . @ . . . @ . @ . . . @ . . . @ . . @ . . . . . @ . . @ . . . . . . @ . . @ . . . . . @ . . . . . . @
@ . . . . @ @ . . . . . . . @ . . . . . @ . . . @ . . . @ . . . . . . . . . . @ @ @ . . . . . . @ @ @ . . . . @ . . . . . . . . . @ . . . . . . . . . . . . . . . . . . . . . . . . . . . @ . . @ . . @
@ . . . . @ . . . . . . . . . . . @ . . @ . . . . . . . . . @ . . . @ @ . . . . . . @ . . . . . . . . . . . . . . . . . . . @ . . @ . . . . . . . @ . . @ . . . . . . . . . @ . . . . . . . . . @ . . @
@ @ . . . . . . . . . @ . . . . @ @ . . . . . . . . . . . . @ @ . . . . . @ . . . . . . . . @ . . . . @ . . . @ . . . . . . . . . @ . . . . @ . . . @ . . . . . . . @ . . . . . @ . . . . . . @ . . . @
@ . @ . . . . @ . . . @ . . . . . . @ . . . . @ . @ . . . . @ . . . . @ . . . . . @ . . . . . @ @ . . . . . . . . . . . . @ . . . . . . . . . @ . . . . . . . @ . . @ @ . . @ @ . @ @ . . @ . . @ . . @
@ . . . . @ . . . . . @ . . . . . . . . @ . . @ . . . @ . . . . . . @ . . . . . . . . @ . @ . . . . @ . . . . . . . . . @ @ . . . @ . . . @ . . . . . . . . . @ . @ @ @ . . @ . . . @ . . . . . . . . @
@ . @ . . . . . . . . . . . @ . . . . . . . . . @ . . @ . . . . @ . @ @ . . . @ . . @ . . . @ . . . @ . . . . . . @ . . . . @ . . . . . . . @ . . . . . @ . . @ . . . @ . . @ . . . . . . . . . . @ . @
@ . . . @ . @ . . . @ . . . . @ . . . . @ . . . . @ . . . . . @ . . . . . . . . . . . . . . . . . @ @ . . . . . . . @ . . @ @ . . . . . . @ . @ . . . . . . @ . . . . . . . . . . . . . . . . . . @ . @
@ . . @ . . @ . . . . . . . . . @ @ . . . . . . @ . . . @ . @ . @ . . . . @ . @ . . @ . . . @ . . @ . . . . . @ @ . . @ . . . . . @ . . . @ . . . . . . . . @ . . . . . . . . . . . . . . . . . . . . @
@ . @ . . @ . . . . . . . . @ . . @ . @ . . . . . . . . . . . @ . . . . . . @ . . . . . . @ @ . . . @ . . @ . . . . . . . @ . . . . . . . . @ . . . . . . . . . . @ . . . . @ @ . @ . . . . @ @ . . . @
@ @ . @ . . . @ @ . . . . . . @ @ . @ . . . @ . . . . . . . . @ . . @ @ . . . . . . . . . . . @ . . @ . . . . . . . . . @ . . . . . . . . . . . @ @ . . . . @ . @ . . . . @ . . . . . . . . @ . @ . . @
@ . . . @ . . @ @ . @ . . . @ . . . . . . @ . . . @ . . @ . . . @ @ @ . @ @ . . @ . @ . . . . . . . . . . . . . . @ . . . @ . @ . . @ . . . . . . . . . . . . . . . . . . . . . . . . . @ . . . . . . @
@ . @ . @ @ . . . . . . . . . . . . @ . . . @ . @ . . . . . . . . . . @ . . . . . @ . . . . . . . . @ . . . . . . . . . @ . . . . . . . . @ . @ . @ . . @ . . . . @ . . . . . . . . . . . . @ @ . . . @
@ . . . . . . . . . @ . . . . . . . . . . . @ . . . . . . . . . @ . . . @ . @ @ @ @ . . . @ . . . @ . . . . . . . . . @ . . . . . . . . . . . . . . . . . . . . . . @ . . . . @ . . . . . . . @ . . . @
@ . . @ . . . . . @ . . . @ . . . . . . . . . . . . . . . . . . . @ . . . . . . . . . . @ . . . . . . . . . . . . @ . . . . . @ . . @ @ @ . . . . . . . . @ . . @ . . @ @ . . . . @ . . . . . . . . @ @
@ . . . @ . . @ . . . . . . . . . . . @ . . . . . . . . . @ @ . . @ . . . @ . . . . @ . @ . . @ . . . . . . . . . . . . . . . . @ . . . . . . . . . . . @ @ . . . . @ . . . . . . . . . . . . . @ . . @
@ . . . . . . . . . . . @ . . . . @ . . . . . . . @ . @ @ . . @ . . . @ . . . @ . . . . . @ . . . @ . . . @ . . . @ . . . . . . . @ . . . . . . . . . . . . . . . @ . . . . . . . . . @ . . . . . . . @
@ . @ . . . . . . . . . @ . . @ . . . . . . . @ . @ . . . . @ . . . . . . . . . @ . . . . @ @ @ . . . . . . . . . . . @ @ . . . . @ . . . @ . . . . @ . @ @ . @ . . @ . . . . . . . . . . . . . . . . @
@ . . . . . . . . . . . . @ . . . @ . . @ . . . . . . . . . . . . @ . . . . . . . . . . @ . @ @ . . . . . . . . . . . . . . . . . . @ . . . . . . . . . . . @ . . . . . . @ . . . . . . . . . . . . . @
@ @ . . . @ @ . . . . . . @ . . . . . . . . . . . . . . @ . . . . . . . @ . . . . @ . . . . . . . . . . . . . . . . . . . @ . . @ @ @ . . . . . . . . . @ . . . @ . . . @ . . @ . . . . . . @ . @ . . @
@ . . . . . . . @ . . . . . . @ @ . . . . @ @ . @ . . @ @ @ @ . . . @ . @ . . @ . . . . . @ . . . @ @ @ . @ . . . . . @ . . . . . . . . . . . @ . . . . . . . . . @ . @ . @ . . . . . . . . . . . . . @
@ . . . @ . @ . . . . . . @ . . . . . . . . . . . @ . . . . . . . . @ . . . . . . . . @ . . . . @ . . . @ . . . . . . @ . . . @ . . . @ . @ . . . . . . . . . @ . . . . @ . . . @ . @ @ . @ @ @ . . . @
@ . . . . . . . . . . . . @ . . . . . @ . . . . . . . . . . . . . . . . @ @ @ . @ . . . . . . . . . . . . . . . . . . . . . . . . . @ @ . . . @ . . . @ . . . . . . . . . . . . . @ . . . . . . . . . @
@ . @ . @ . @ . . . . . . . . . . . . @ @ . . . . @ . . . . . @ . . . . . . . . . . . . . @ . . . . . . . . . @ . . . . . . . . . . . . . . . . . . . . @ . @ . . . @ . @ @ . . . @ . . . . @ @ . . . @
@ @ . @ . . . . @ . . . . . . . @ @ . . . @ . @ . . @ . . . . . . . . @ @ @ . . @ . . . . . . . . . . @ . . . @ @ . . @ . . . . . . . . . @ . . . . . @ . . . . @ . . . . . @ @ . . . @ . . @ . . . . @
@ . . . . . . @ . . . . . . . . . . @ @ . . . . @ . . @ . . . @ . . . . @ . . . . . @ . . @ . . @ . @ . . . @ . . @ . . . @ . . . @ . . @ @ . . . . . . . . . . . . . . . . . . . . . . . . . @ . . . @
@ . . . . . . . @ . . @ @ . . . @ . . . . . @ . . . . . . . . @ . . . . . @ @ @ . . . . @ . . . . . . . . @ . . . . . @ @ . . . . . . . . . . @ . . @ @ . . . . @ . . . . . . . . @ . . . . . @ . . . @
@ . . . . . . . . . . . @ . . @ . . . . . . . . . @ @ @ . . @ . . . . . . . . @ @ . . . . . . . . . . . . . . . . . . . . . . . . @ . . . . @ . . . . . . . . . . . . . . @ . . . . . . . . . . @ . . @
@ . . . . . . @ . . . . . . . @ . . . . . . @ . . . @ . . @ . @ . . . . . . . . . . . . @ . . . . . @ @ . . . . . . . . . . . @ . . . . . . . . . @ . . @ . @ . . . . . . . . @ . . . . . . @ . . . . @
@ . @ @ . . . . . . . . . @ . . . @ . . . . . . @ . . . . . . . . . . . . . . . . . . . . . @ . . . . . . . @ . . . . . . . . @ . . . . @ . . . . . @ . . . . . . . @ . @ . . . . . . . . @ . . . . . @
@ . . . . @ . . . @ . @ . . . . . . . @ . @ . . . . . . @ . . . . . @ . . . . . . . . @ @ . . @ . . . . @ . . . . @ . . @ . @ . . . @ . . . . . . @ . . . . @ . @ . . . . . . . . . @ . . . . @ . @ . @
@ @ . . . . . . . . . . . @ . . . . . . @ . . . . . . . . @ . @ @ . . . . . . @ . . . . . @ . . . . . . . . . . @ . @ . @ . . . @ . . . . . . . . @ @ . @ . . . @ . . . . . . . @ . . . . . . . . . @ @
@ . . . . . @ . . . . @ . . @ . @ . . . . . . . . @ . . . . . . . @ @ . @ . . . @ . . . . . . . @ @ . @ . . @ . . . . @ . . . . . @ . @ @ . . . . . . . . . @ . @ . @ . . . @ . . . . . . . . . . . . @
@ @ . . @ @ . . @ . . . . . . . . . . . . . . . . . . @ . @ . . . . . . . . . . . . @ . . . . . . . . . . . . . . . . . . . . . . . . . . . @ . . @ @ . . @ . . . . . . . . . . . . . . . . . . @ . @ @
@ . . . . @ . . @ . . . . . . . . . . . @ . . . @ . @ @ @ . . . @ @ . . . . . . . . . . . . . . . . . . . . . . . . . . . . . . . . . @ @ @ . . . . . . . . . . . . . . . . . . . . @ . . . . . . @ . @
@ . . @ . . @ . . @ . . . . . . . . . @ . . . @ . . . @ . @ . @ . . . . @ . . . . . @ . @ . . . . . . . . @ . . @ . . @ . @ . . . . @ . . . . . . @ . . . . . . . . . . @ . . @ . . @ . . . . . . . . @
@ . . . . . . . . . @ . @ . . . . @ . @ . . @ . . . @ . . . . . . . . . . . . . @ . . . . @ . . . @ . . . . . . . . . . @ . . @ . . . @ @ @ . . @ . . . . . . . @ . . . . @ . . . @ . . @ . . @ @ . . @
@ . . . . . @ . . . . . . . . . . . @ . . . . . . @ . . @ . . @ . . . . . . . . . @ @ . . . @ . . . . . . . @ . . @ . . . . . . . . @ . . . @ . . . . . . @ . . . @ . . . . . . @ . . . @ . . . . . . @
@ . . . @ . . . . @ . . . . @ . . . . . . @ . . . . . . . . . . . @ . . . . . . @ . . . @ . . . @ . . . . . . @ . . . . @ . . . @ . . . . . . . . . . . . . . @ @ . @ . . . @ @ . . . @ . . . . . . . @
@ . . . . . @ . . . . . . . . . . . @ . . . . . . . . . @ @ . . @ . . . . . . . . . . @ . . @ . . . . . . . . . @ . . @ . @ . . . @ . . . . . @ . @ . @ . . . . . . . . . . . . . . . . . . . . . . . @
@ @ @ . . . . . @ . . . . . @ . . . . . . @ . . . . . . @ . . . . @ . . . @ . @ @ . . . . . . @ . . . . . . @ . . . . . . . . . . . . . . . @ . . . . . @ . . . . . . . @ . . . . . . . . . . @ @ . @ @
@ . . . . @ . . . . @ . . . . . . . . @ . . . . . . . @ . . . . . . . . . . . . . @ . . . . . @ . . . . @ . . . @ . . . . . . . . . @ . . @ . . . . . . . . . . . @ . @ . . . . . @ @ . . . . @ . @ . @
@ . . @ @ . @ . . . . . . . . . @ . . . . . . . @ . . @ @ . . . . . . . . . . . . . . . @ @ . . . . . . . . . . @ . . @ . . . @ @ . . @ . @ . . . . . . . @ @ . . . . . . . . @ @ . . . . . . . . . . @
@ . @ . . @ . . @ @ . @ . . . . . . . @ @ @ . @ . . . @ . @ @ . . @ . . . . . @ . . . . . . . . . . . . . . . . . . . @ . @ . . . . . . @ . . @ @ . . . . . . . @ . . . . . . . @ . . . . . . . . . . @
@ . . @ . . . . @ . . . @ . . . . . @ . . . . . . @ . . . . . . . . . . . . . @ . . @ . @ . . @ . . . @ . . . . . . . @ . @ . . . @ . . . @ . . . . . @ . . . . . . . . . . . . . @ . . . . . . @ @ . @
@ . . . @ @ . . @ . . . . . . . . @ . . @ . @ . @ @ @ . @ . . @ . . @ . @ . . . . . . . . @ . . . . @ . . @ . . @ . . . . . . . . . . . . . . . . . . . . . @ . @ . . . @ . . . @ . . @ . . . . . . . @
@ @ . . . . @ . . . . @ . @ . . . . . @ . . . . . . . . . . . . . @ . . . @ . @ . . @ . . . . @ . . . . . . @ . . . . . @ . . . . . . . . . @ . . @ . . . . . . . . . . @ . . . . @ . . . . . . . . . @
@ . . . . . . . . . @ . . . . . . . . . @ . . . . . . @ . . . . @ . . . . . . . @ . . . . . . @ . . . . . . . . . @ . . . . . . @ . . . . . . . @ . . . . . @ . @ . . . @ . . . . . . . . . . . . @ . @
@ . . . . . . @ . . . . . . @ . @ @ . . . . . . . @ . . @ . @ . . . . . . @ . . @ . . @ . . . . . . . @ . . . . . . . . . . . . . . . @ . . @ . . @ @ . . . . . . . . . . . @ . . @ . @ @ @ @ . @ . . @
@ . . . . . . . . . . . @ . . . . @ . . . . . . . . . . . @ . @ . . . . . . . . . . . . . . . @ . . . . . . . . . . . @ . . . . . . . @ . . @ . . . . . @ . . @ . . . @ . @ . . . . . . . . . @ . . @ @
@ . . . . . . . . . @ . . @ . . . . . . . @ . @ . . . . . . . . @ . @ . . . @ . . . . . @ . . . @ . @ . . @ . . @ . . . . . . . . @ . . @ . @ . . . . . . . . . . . @ . . . @ . . . @ . . . . . . . . @
@ . . . . . @ . . . . . . . . . . . . . . . . . @ . @ . . . . . . @ . . @ . . . . . . @ . @ . . . . . . @ . . . @ . . . @ @ @ . . . . . . . . . . . @ . . . . . . . . . . . . @ . . . . . . . @ . @ . @
@ . . . . . . . . . @ . . . . . . @ . . . . @ @ . . . . . @ . @ @ . . . @ @ . . @ . . . . . . . . . . . . . . @ . . . . . . @ . @ . @ . @ . @ . . . @ . @ . @ . . . . . . . . . . . . @ . @ . . @ . . @
@ . @ . @ . @ @ . @ . . @ . @ . . . . . . . . . . @ . @ . . . @ . . @ . . @ . . . @ . . . @ . . . . . . . . . . . . . . . . . @ . . . . . . . . @ @ . . . . . . . . . . . . @ . . . . . @ . . @ . . . @
@ @ . . . . . . . . . . @ . . . @ . . @ . . . . . . . . . . . . . @ . . @ @ . @ @ @ . @ @ . . . . . . . . . . @ . . @ . . . @ . . . . . . @ . . . . . . . . . . . . @ @ @ . @ @ . @ . . . . . . . . . @
@ . . @ . . @ . . . . . . . . . . . @ . . . . . . @ @ . @ . . . . . @ . . . . . . . . . . . . . . . . . . . . . . . . . @ . . . . . @ . . . . . @ . . @ . . . . . . . . . . . . . . . @ . . . @ . . . @
@ . . . . . . @ . . . . @ . @ . @ . . . . . @ . . . . . . . . . @ . . . @ . . . @ . . . . . . . . . . . @ . . . @ . . . @ . . @ . . . . @ @ . . . . . . @ . . @ @ . . . . . @ . . . . @ . . . . . . . @
@ @ . . . . . . . @ . . . . . . . . . . @ . . . . . @ . . @ . @ . . . . @ . . . . . . . . . . @ . . . . @ @ . . . . . . @ . . . . @ . . @ . @ . . . . . . . . . . . . . . . . @ . . . . . . . . . @ . @
@ . . . . . @ . . @ @ @ . . @ . . . . @ . . @ @ . . . . . . . . @ . . . . @ . . . . @ @ . . . @ . @ @ . . . . @ . @ . . . . . . @ . . . . . @ . @ . . . . . . . . . . . . . . . . . . @ . @ . @ . . . @
@ . @ . . . @ . . . . . . @ . . . . . . . . . . . . . @ . . . . . @ @ . . . . . . . . . . . . . . . . . . . . . @ . . @ . . . . . . @ . . . . @ . @ . . . . . . . . . @ . . @ . @ . . @ . . @ . . . . @
@ . @ . . . . . . @ . @ . . @ . . . @ . . @ . @ . . . . . . . . @ . . . . @ . . . . . @ . . . . @ . . . . @ . . . . . . . @ . . . . . . . . . . . @ . . . . . . . . . . . . . . . . @ . @ . . @ . . . @
@ @ @ @ @ @ @ @ @ @ @ @ @ @ @ @ @ @ @ @ @ @ @ @ @ @ @ @ @ @ @ @ @ @ @ @ @ @ @ @ @ @ @ @ @ @ @ @ @ @ @ @ @ @ @ @ @ @ @ @ @ @ @ @ @ @ @ @ @ @ @ @ @ @ @ @ @ @ @ @ @ @ @ @ @ @ @ @ @ @ @ @ @ @ @ @ @ @ @ @
3
67 37 31 73
79 62 70 88
71 16 88 78
