12 12
@ @ @ @ @ @ @ @ @ @ @ @
@ . . . @ . . . . . . @
@ . . @ @ . @ . @ . . @
@ . . . . . . . . . . @
@ . . . . @ . . . . @ @
@ . . @ . . . . . . . @
@ . . . . . . . . . . @
@ . . . . . . . . @ . @
@ . . . . @ . . . . . @
@ . . . . . . . . . . @
@ . . . . . . . . . . @
@ @ @ @ @ @ @ @ @ @ @ @
3
8 4 2 10
4 4 4 3
7 4 8 3
