12 12
@ @ @ @ @ @ @ @ @ @ @ @
@ . . @ . . . . @ . . @
@ . . . . . . @ . . . @
@ . . . . . . . @ @ . @
@ . . . . @ . . . . . @
@ . . . . . . @ . @ . @
@ . . @ . . . . . . . @
@ . . . . @ . . . . . @
@ . . . . . . . . . . @
@ . . . @ @ . . . . @ @
@ . . . . . . @ @ . . @
@ @ @ @ @ @ @ @ @ @ @ @
3
9 7 4 6
4 4 8 2
7 6 3 7
