50 50
@ @ @ @ @ @ @ @ @ @ @ @ @ @ @ @ @ @ @ @ @ @ @ @ @ @ @ @ @ @ @ @ @ @ @ @ @ @ @ @ @ @ @ @ @ @ @ @ @ @
@ . . . . . . . @ . . . . . @ . . . . . @ . . . @ . . . . . . @ . . . . . . . . . . @ . . . @ . @ @
@ . . . @ . . . . . . . @ . . @ . . . @ . @ . . . . @ . . @ . . @ . . @ . . . . . . . . . . . . . @
@ . . . @ . . . . . . . . @ . . @ . . . . . . . @ @ . . @ . . . . . . . . @ . . . . . . . . . . . @
@ . . . . . . . @ @ . . @ @ . . . . @ . @ . @ . . . @ @ . . . . . @ . . . . @ . . . . . @ . @ . . @
@ . . . . . @ . . . . . . . @ . . . . . . . . @ . @ . . @ . . . . . . . . . . . . . . @ . @ . . . @
@ @ . . . . . . . . . . . @ . . . . . . @ . . . @ . . . . . . . @ . @ . . . . @ . . . . . . . @ @ @
@ . @ @ @ @ @ . @ . . . @ . . @ @ . . . . @ . . . @ . . . @ . . . . . @ . . . . . @ . . @ @ . @ . @
@ . . . . . . . . . . . . . . . . . . . . @ . @ . . . @ . . @ . . . . . . . . . @ . . . . @ . . . @
@ . . . . . . . . . @ . . . . . . . . @ . . . . . . . . . @ @ . . . . . @ . . . . . @ . @ @ . . . @
@ @ . . . . . . @ . . @ @ . . . . . @ . . . . . @ @ . . . @ . . . . . @ . @ . . @ . . . . . . . . @
@ . . . . @ . @ . . . . . @ . @ . . @ . . . . . . @ . @ . . @ . . . @ . @ . . . . . . . . . . . . @
@ . . . . @ @ @ . . . @ . . . . . . @ . . . . . . . . . . . . . @ . . . . . . . . . . @ . . . . @ @
@ . . . . @ . . . . . . @ . . . . . @ . . . . . . . . @ @ . . . . . . . . . @ . . . . @ @ . @ . . @
@ . . . . . . . . . . . . . . . . . . . . . . . . . . . . . . . . . . @ . . @ . @ . . . . @ . @ . @
@ . . . . . . . . . @ . . @ . . . . @ @ . . . @ . . . . . . . @ @ . @ . . @ . @ . . . . . . . @ . @
@ @ @ . . @ @ . . . @ . . @ . . . . @ . . . . @ . . . . . . . . . . . . @ . . . . . @ . . . . . . @
@ . . . . . . . . . . @ . . . . . . @ . . @ . . @ . . . . . @ . @ . . . . . @ . . . . . . . . . . @
@ . . . . . . @ . . @ . . @ @ . . . . . . . . @ . . . . . . . . . . . . . . . . . . . . . @ . @ . @
@ . . . . . . . . . @ . @ . @ . . . @ . . . . . . . . . . @ . . . . . . . @ . . . @ . @ . . . . @ @
@ . . @ . . . . @ . . @ . . . . . @ . . . @ . @ @ . . . . @ . . . . . . . . @ . . . . . . . . . . @
@ @ . . . . . @ . . @ . @ . . . . . @ . @ . . . . @ . @ . . . . . . . . . @ . . @ . . . . . . . . @
@ . . . @ . . . . . . . . @ @ . . . . . . . @ @ . . . @ . @ . @ . . @ . . . . . . @ . . . . . . . @
@ . . . . @ . @ . . @ . . . . . . @ . @ . . . . @ . . . @ @ . . @ @ . . @ . . . . . . @ . . . . . @
@ . . . . . . . . . . . . . . . . . @ . @ @ . . . . @ . . . . @ . . . . . @ . . @ . . . @ . . . . @
@ . @ . @ . . . . . . . . @ . . . . . . . . @ . . . . . @ . . . . @ . @ . . . . . . . . . . . . . @
@ . . . @ @ . . . . . . . . @ . . @ . . . . . @ . . . @ . . . @ @ . . . @ @ . . . . . . . . . . . @
@ . . . . . @ . . . . . . . . @ . . . . . @ . . . @ @ @ . . . . . . . . . . . . . . . . . . @ . . @
@ . . . @ . . . . . . . . . . . . @ . . . @ . . . . . . . . . . . @ . @ @ . . . . . @ . . . @ . . @
@ . . . . . . . @ . . . @ . . . . . . . . . @ . . . . . . . . . . . . . . @ . . . . . . . @ . . . @
@ . @ . @ . . . @ . . . . . . @ . . . . . . . @ . . . . . . . . . . @ . . . . . . . . . . . . . . @
@ . . . . . . . . . @ . @ . . . @ . . . . @ . . @ . . . @ . . . . . . . . . . @ . @ . . @ . . . . @
@ @ . . . @ . . @ . . . . . . . @ . . @ . . @ . . . @ . @ . . . . . @ . @ . @ . @ . . . . . . @ . @
@ . @ . . . . . @ . . @ . . . @ . @ . . . . . . . . . . . . @ @ . @ . . . . . . . . . . @ . . . . @
@ . @ . . . . @ . . . . . . . @ . . . . . . . . . . . . . . . . @ . . . . @ @ @ . . . @ @ . . . @ @
@ . . @ . . @ . . . . . . . . . . @ . @ . . @ . . . . . @ . . . . . . @ . . . . @ . . . . @ . . . @
@ . @ @ . . . . . . . . . . . . . . . . . . . @ . . . . . . @ . . . . . . @ @ . . . . . @ . . . . @
@ . . . . . @ @ @ . . . @ . . . . . . . . @ . @ . . @ . @ . @ . . . . . @ . . @ . . @ . . . . @ . @
@ . . @ . @ . . . . . . @ . . @ @ . . . . . . . . @ . . . . . . @ @ . @ . . . . . . @ . . . . @ . @
@ . . . . @ . . @ . . @ . @ . . . . @ . . @ . . . @ . @ @ . . . . . @ . . . @ . @ . @ . . . . . . @
@ . @ . . @ . @ . . . . . . . . . . . . . . . . . @ . . . . . . . @ . . . @ . @ . @ . . . . . @ . @
@ . @ . . . @ . @ . . . . . . . . . . . @ . @ . . . . . . . . . . . . . . . @ . . . @ . @ . . . . @
@ . @ . @ . @ . . . . @ . . @ . . @ @ . @ . @ . . . @ @ . . . @ @ @ @ . @ @ . . . . . . . . . . . @
@ . . . . . . . . @ @ . . . . . . . . . . . . @ . . . . . @ . . . . . . . . . . . . . . . . @ . . @
@ @ . @ . . @ . @ . . . . . . @ . . @ . . . . . . @ . . . . @ . . . . . . . . @ . @ @ . @ . . . @ @
@ . . @ . . . . . . . . . . . . . . . . . . . . @ . . . . . . . . . . . @ @ . . . . . @ . . @ . . @
@ . . . @ . . . . . . . . . . . . . @ . @ . . . . . . @ . @ . @ . . . @ . . @ . . . . . . @ . . . @
@ . . . . . . . . @ . @ . . . . . . . . . . . @ @ . @ . @ . . . . . . . . @ . . @ @ . . . . . . . @
@ @ . . . @ . . . . . . . . . . . . . @ . . . @ . . . . @ . . . . . . . . . . . . . . . . . . . . @
@ @ @ @ @ @ @ @ @ @ @ @ @ @ @ @ @ @ @ @ @ @ @ @ @ @ @ @ @ @ @ @ @ @ @ @ @ @ @ @ @ @ @ @ @ @ @ @ @ @
3
9 28 2 17
17 44 28 48
27 48 19 23
