25 25
@ @ @ @ @ @ @ @ @ @ @ @ @ @ @ @ @ @ @ @ @ @ @ @ @
@ . . . . . . . . . . @ . . . . . . . . @ @ . . @
@ . . . . . . @ @ @ . . @ . . . . . . @ . . . . @
@ . . . @ . . . . . . . . . . . . . . . . . . . @
@ . . . . . . . . . . . . . @ . . . . . . . . . @
@ . . . . . . . . @ . . . . . . . @ . . @ . . . @
@ @ . . @ . . . . . . . . . @ . . . . . . . . . @
@ . . . . @ . . . . . @ . . . . . @ . . . . . . @
@ @ . . @ . . . @ @ . @ . . . . . . . . . @ . . @
@ . @ @ . @ . . . . . @ . . @ . . @ . . . . . . @
@ . . . . . @ @ @ . . . . . . . . @ . . @ . . . @
@ . @ . . . . . . . . . @ . . . . . . @ . @ . . @
@ . . . . @ . . . . . . . . . . . @ . . . . @ . @
@ . . . . . . . . . . @ . . . . . . . @ . . . . @
@ . . @ . . @ . . @ @ . . . . . . . . . . . . . @
@ . . . . . . . . . . @ . . . . . . @ . . @ . . @
@ . . . . . . . . @ . . . . . . . . . . @ . . . @
@ . . . . . . . . @ . @ @ . . . . . @ . . . . . @
@ . . . . . . . . . @ . @ . . . @ . . . . . . . @
@ . . . . . . . . . . . . . @ . . @ . @ . @ . @ @
@ . . . . . . . . . . . @ . . . . . . @ . @ @ . @
@ . . . . . . @ . @ . . . . @ . @ . . @ . . . . @
@ . . . . @ . @ . . . . . . . . @ . @ . . . . . @
@ . . @ . . . . . . @ . . . . . . . . . @ . . . @
@ @ @ @ @ @ @ @ @ @ @ @ @ @ @ @ @ @ @ @ @ @ @ @ @
3
9 22 20 11
18 14 20 23
14 8 5 14
