50 50
@ @ @ @ @ @ @ @ @ @ @ @ @ @ @ @ @ @ @ @ @ @ @ @ @ @ @ @ @ @ @ @ @ @ @ @ @ @ @ @ @ @ @ @ @ @ @ @ @ @
@ . . . . @ . @ . . . . . @ . . . @ . . . . . . . . . . . . . . . . . . . . @ . . @ . . . . @ . . @
@ . . @ . . . . @ . . . @ . . . . . . @ . @ . @ @ . . . . . @ . . . . @ . @ . . . . . . . @ . @ . @
@ . . . . . . @ . . . . . @ . . @ . . . . . . @ @ . . . . @ . . . . . . . . . . . . @ @ . . . . . @
@ . @ . @ . . . . . . . @ . . . @ . . . . . . . . . . . @ . . . . . @ @ . @ . @ . . . . @ @ . . . @
@ . . . @ . . . . . . . . . @ . . @ . . . @ . @ @ . @ . . . @ . @ . @ . . . @ . . @ . . @ @ . @ . @
@ . . . . . . . @ . @ . . . @ . . . . . . . @ . . . . . . . . . . . @ . . . . @ . . . . . . . . @ @
@ . . . . . @ . . @ . . @ . . . . . . @ . @ . . . . . . . . @ @ . . . . @ @ . @ . . . . @ . @ @ . @
@ . . . @ @ . . @ . . . . . . . . . . @ . . . . . @ . . . . . . . . . . . @ @ . . . . . . . . . . @
@ . . . . . . . . . . . . . . . . @ @ . . . . . . . . . . . @ . . @ . . . @ . . . @ . . . . . . . @
@ . . @ . . . . . @ . @ . @ . . . @ @ @ . . . . . . . . . . . . . . . . @ . . . . . . . . . . . . @
@ . . . . . . . . . . . . . . . . . . . @ . . . @ . . . . . . . . . . @ . . . . @ . . . @ . . . . @
@ @ . . . @ . . . . . . @ . @ . @ . . . . . @ . . @ . . . . . . @ @ . . . . . . . . . @ . . . . . @
@ . @ . . . . @ . . . . . . . @ . . . . . . . . @ . . @ @ . . . . . . . @ . . . . . @ . . . @ . . @
@ . @ . . @ @ . . . . . . @ . . . . . @ . . @ . . . @ . . . . @ . . . @ . . . . . @ . . @ . @ . . @
@ . @ . . . . . . . @ . . @ . . . . @ . @ . . @ @ . . . . . . . . . . . . . . . @ . . @ . @ . . . @
@ . . . . . . . . . . . . . . . . . . . . . . . . . . . . . . . . @ . . @ @ . . . . @ . . . @ . . @
@ . . @ . . . @ @ @ @ . @ . @ . . . . . . . . . . . . @ . @ . . . . . . . . @ . . . . @ . . . . . @
@ . . . . . . . . @ . . . . . . @ . @ . . . . . . . @ . . @ . . . . @ . @ . . . . . . . . . . . . @
@ @ . @ . . . . @ . . . . . . @ . @ . . @ . @ @ . @ . . . . . . . . . . . . @ . . . . . . . . . @ @
@ . @ . . . . . . . . . . . . @ . . . @ . . . . . @ . . . . . . . . . . . . . . . . . . . . @ . . @
@ . . . . @ . . @ @ @ . . . . . @ . . . . . . . . . . . . . . . . . . . . . @ . . . . . . @ . . . @
@ . . . . @ . . @ . . @ . . @ @ . . @ . . . . @ . . . @ @ . . . . . . . . . @ @ . . . . . . @ . . @
@ . . @ . . . . . . . . . . @ . . . @ . @ @ . . @ . . . . . . . . @ . . . . . . . @ . . @ . . . . @
@ . . . . . . . . . . . @ . . . . . @ . @ . @ . . @ . . . . . @ . . . . . . . . . . @ . . . . . . @
@ . . . . . . . . . @ . . . . . . . . @ . . . . . . . . . . . . . . @ @ . . @ . . . . . . . . @ . @
@ . . . . . . . . . . . . . @ . . . . . . . . . . . . . @ . @ . . . . . . . . . . @ . . . . . . . @
@ . . @ . . . . . . . . . . . . . . . . . . . . . . . . . . @ . . . . . @ . . . @ . . . . @ . . . @
@ . . @ . @ . . . . . @ . . . . . . . . . . . . . . . . . . . @ . . . . . @ . . . . . @ . . . . . @
@ @ . . . . . @ . . . . @ . . . . . . . . . . @ @ . . . . @ @ . . . . . . @ . . @ . . . @ . . @ . @
@ . . . . . @ . @ . . . . . . @ . . . . . . . . @ . . @ . . . . . . . . . @ . . . . . @ . . . . . @
@ @ . . . @ . . . . @ . . . . . . @ . . . . . . . . . @ . . . . . @ . @ . . . . @ . . . . . . @ . @
@ . @ . . . . . . . . . . . @ . . . . @ . . . @ . . . . . @ . . @ . @ @ @ . @ . . . @ . . . . . . @
@ . . @ . . . . . @ . @ . . @ . . . . . . . @ . @ . . . . . . . . . . . . . . . . . . . . . . . . @
@ @ @ . @ @ @ . . . . . . . . . . . . @ . @ @ . @ . @ . . . @ . @ . . . . . . . . @ . . . . @ . . @
@ . . @ . . . . . . . . . . . . . . . . . . . @ . @ . @ . @ . . . . . . . @ . . @ @ . . . . . . . @
@ . . . @ . . . . . . . . . . @ . . . . . . . . @ . . . . . . . . . . . . . @ . @ . . . @ . . . . @
@ @ . . @ . . . . . . @ . . . . . . . . . @ . . . @ . . . . . . . . . . . . @ @ . @ . . . . @ @ . @
@ . . @ . . . @ . . . . . . . @ . . . . . . . @ . @ . . . . . . . . . . . . . . . . . . . . . . . @
@ . . . . . @ . . . @ . . . . . . . @ . . @ . @ . . . @ . . . . . . . @ . . . @ . . . . . . . . . @
@ . . . . . . @ @ . . . . . . . @ @ . . . . . @ @ . . . . . . . @ . . . . @ . . . @ . @ . . . . . @
@ . @ . . . . . @ . . . . . . . . . . . . . . . . . . @ . . . . @ . . @ . . @ . . . @ . @ @ . . . @
@ . . . . @ @ . . . . @ . @ . . . . . . . . . . . . . . . . . . . @ . . . @ . . . @ . . . . . . @ @
@ . . @ @ . . @ . @ @ . . . . . . . . . . . . @ . @ . . . @ @ . . . . . . . . . . . . . @ @ . . . @
@ . . . . . . . . . . . . . . . . . . . . . . . . . . @ . @ . . . . . . . @ . . . . . . @ . @ . . @
@ @ . . . . . . . . . . . . . @ . . @ . . . . . . . . . . . . . . . . . . @ . @ . . @ . . . . . . @
@ . @ . . . . . . . @ @ . . . . . . . . . . @ . . . . . . . . @ . . @ . . . . . . . @ @ @ @ @ . . @
@ . . . . . . . . . . . @ . @ . . . . . . . . . . @ . . @ . . . . @ . . . . . . . . . . @ . . . . @
@ . @ . . . . . . . . . @ . . . . . . @ . . . . . . . @ . . @ . @ . . . . . . . @ . . . @ . . @ . @
@ @ @ @ @ @ @ @ @ @ @ @ @ @ @ @ @ @ @ @ @ @ @ @ @ @ @ @ @ @ @ @ @ @ @ @ @ @ @ @ @ @ @ @ @ @ @ @ @ @
3
18 4 37 14
24 48 29 19
40 3 8 17
