100 100
@ @ @ @ @ @ @ @ @ @ @ @ @ @ @ @ @ @ @ @ @ @ @ @ @ @ @ @ @ @ @ @ @ @ @ @ @ @ @ @ @ @ @ @ @ @ @ @ @ @ @ @ @ @ @ @ @ @ @ @ @ @ @ @ @ @ @ @ @ @ @ @ @ @ @ @ @ @ @ @ @ @ @ @ @ @ @ @ @ @ @ @ @ @ @ @ @ @ @ @
@ . @ . @ . . . . . @ . @ . . . . . . . . . . . . . . . . . . . . . . . . . . . @ . . . . @ . . . . @ . . . . . . . @ . . @ . . @ . . . . . . . . . . . . . . . . @ . . . . . . . . . . . . . . . . . @
@ . . . @ . . . . . . . . . @ . . @ @ . . . . @ . . . . . @ . . @ . . . . @ . . @ . @ . . . . . @ . . . . . . @ @ @ . . . . . . @ . @ . . . @ . . @ . @ . @ . . . . . . . @ @ . . . . . . . . . . . . @
@ . @ @ . . . . . . . . . . . . @ . . . @ @ . @ . @ . . @ . . . . . . . . . . @ . @ . . . . . . . . . . @ . . . . . . @ @ @ @ . . @ @ . . . . . . . . . . . . . . . . . . . . . . . . . @ . . . . @ . @
@ . . . . . . . . @ . . . . . . . . @ . @ . . . . . . . . . . . . . @ . . . @ . . @ . . @ . . . . . . . . . @ . . . . . . @ . @ . . @ @ . . . . . . . . . . . . . . . . @ . . @ @ . @ . . @ . . . . . @
@ . . @ . . . @ . . . . . @ . . . . . @ . . . . . @ . . . . . . . . . . . . . . . . . . . . . . . @ . . . . . . . . . @ . . . . . . . . @ . . @ . @ . . . . @ . @ . @ . . @ . . . . @ . . . . . @ . . @
@ . @ . . @ . . . . . . . . @ @ . . @ . . . . . @ . . @ . . . @ @ . . . . @ @ . . . . . . . . . . . . . . @ . @ @ . . . . . . . . . . . @ @ . . . @ . . . . . @ . . . @ @ . . . . . . . . @ . . @ . . @
@ . . . @ . . . @ . @ @ . . . . . . . . . @ . . . @ @ . . . @ . . . . . . . . @ . @ . @ @ . . . . . . . . . . . . . @ . . . . . . @ . . . . . . . . . . . . . @ . . . . . @ @ . . . . . . . . . . . . @
@ . . . . . . @ . . . . . . @ @ . . . . . . @ @ . . @ . . . . @ . . . . . . . . . . . . . . . . . @ . @ . . . . . . . . @ . @ . . . . . @ . . . . @ . . . . . . . . @ . . . . . . . . . . . . . . @ @ @
@ @ . . @ . . . @ . . . . . @ . . . . @ @ @ . . @ . . . . . . . . . . . . . @ . . . . . . . . . . @ @ . @ . @ . . . . . . . . . . . . . . @ @ . @ @ . . . . @ . . . @ . @ . @ . . @ . . @ . . . . @ . @
@ . . . . . . . . . . . . @ . . . . @ . . . . . . . . . . @ . . . . @ . . . . . . . . @ . @ . . . . . @ . @ . . . . . . . . . . @ . . . @ . . . . . . . @ . . . . . . . . @ . . @ . . @ . . . . . @ @ @
@ . . . @ . . @ . . @ . . . @ . . . . . . . . . . . . . . . . @ . . . . . . . @ . . . . @ . . @ . @ . . . @ @ . @ . @ @ . . . . @ . . . @ @ . . . . . @ . . . @ . . . . . . . . @ . . . . . . . . . . @
@ . . . . @ @ . . @ . . . . . . . . . @ . . . . . @ . @ . @ . @ . . . @ . . . . . . . . @ . . . @ . . @ . . @ . . . . . @ . . @ . . . . . . . . . @ . @ . . @ . . . . @ . . . . . . . . . @ . . . . . @
@ @ . . . . @ . . . . @ @ . @ . . . . . . . . @ @ . . . . . @ . . . . . . . . . @ @ . . . . . @ . . . . . . . . . . . . . @ . . @ . . @ . . @ . . . @ . . . . @ . . . . . . . . . . . @ . . . . . . . @
@ . . @ . . . . . @ . . . . . . . . . . . @ @ . . . . . . . . . . . . . @ . . . . . @ . @ @ . . . . . . . . . @ . @ . . . . @ . . @ . . . . . . . . . . . . . . . . . . . . @ . . . . . . . . . @ . . @
@ . . @ . . . . . . . @ . . . . @ . . . . @ . . @ . . . . . @ . @ @ @ . . . . . . . @ . . . . . . . . . . . . . . . . . @ . . . . . . @ @ . . @ . @ @ . . . . . . @ . @ . . . . . . . . @ . . . . . @ @
@ . . . . . . . @ . . . @ . @ . . . @ @ @ . . . . . . . . . . @ . @ . @ @ @ . . . @ . . . . . . . . . . . . . . . . . . @ . @ . @ . . . . . . @ . @ . . . . @ . . . . . . . . . @ @ . . . . . . . . . @
@ . . . . . . @ . . . . . . . . @ . . . . . . . . . . . @ @ . . . . . . . . . . . . . . . . . @ @ @ . . @ . @ . . . . . . . . . . @ . . . . . . . . . . . . . . . . @ . . . . . . . . . . . . . @ . . @
@ . . . . . . . . . . . . @ . . . . . . . . . . . . @ . . . . . . @ . @ . @ . . . . . @ . @ . . . . . @ . . . . . . . . . . . . . . . @ . . . . . . . @ . . . . @ . . . . . . @ . . . . @ . @ . . . @ @
@ . . . . @ . . . . @ . . . . . . . . . . @ . . . . . . . . . . . @ . @ @ . . . . @ . @ . . . . . @ . . . . . . . . . @ . @ . . @ . @ . . . @ . . . . . . @ . . @ . . @ . . . . . . . . . . . . . . . @
@ . . . . . . . . . . . . @ . . . . . @ . . . . . . . . . @ . . . @ . . . . . . @ . . . . . . . . . . . @ . . . . . . . . . . . . . . . . . . . . . . @ . . @ . @ . . . . @ . . . . . . . . . @ . . . @
@ . @ . . . . . . . . . . . @ . . . . . . . . . @ . . . . . @ . . . . @ . . . @ . . . . @ . . . . . . . @ . . @ . @ . . @ . @ . . . @ . . . . . . . . @ . . . . . . @ @ @ . . . @ @ @ . @ . . . . @ . @
@ . . . . . @ . . . . . . . . . . @ . . . . . @ @ . . . . . . . @ . . . . . . . . . . . . @ . @ . . @ . . . . . . . . . . . . . . @ . . . . . . . . . . . . . . . . . . . . . . . . . . . . . . . . . @
@ . . . . @ . . . @ . . . @ . . . . . . . . . . . . . . . . . @ . . . . . @ . . . @ . . . . . . . . . . . @ . . . . . . . . @ . . . @ @ . . . . @ @ . . @ . . . . @ @ . . . . . . . . . . . . . . @ . @
@ . . . . . . @ . . . . . @ . . . . . . . @ @ . . . . @ . . @ . . . . @ . . . . . . . . . @ . . . . @ . . . . . @ . . . . @ . . . @ . @ . . . . . . . @ . @ . . @ . . . . . . @ . @ . . . . . . . . . @
@ . @ . . @ @ . @ . . . . . . . @ . . . . @ . . . . . . . . . . . @ . . . . . . . . . . . . @ . . . . . . . . . @ . . @ . . . . @ . @ . @ . . . @ . . . . . . . . . . . @ . . . @ . . @ . . @ . . . @ @
@ . . . @ . @ . @ . . @ . . . . . . . . . @ @ . . @ . . @ . . . . @ . . . . . . . @ . . . . . . . . . . . . . @ . . . @ . . . . . . @ . . . @ . . . . . . @ . @ . . . . . . @ . . @ . . @ . . @ . . @ @
@ . @ . . . . @ . . . . . . . . @ . . . @ @ . @ . . . . @ @ . . . . @ @ . . @ . . . . . . . @ . . . . . . . . . . . . . . @ . . . . . . . . . . @ . . . . . . . . @ . . . . . . . . . . . . . . . . @ @
@ . . . . . . . . . . . . . . . . . @ . . . @ . . . @ . . . . . . . . . . . @ @ . . . . @ . @ . @ @ . . @ . @ . . . . . . . . . @ . . . . . . . . . . . . . @ . . . . . . . @ @ @ . @ . . . . . . . . @
@ . . . . . . . . . . . . . @ . @ . . . . . . . . . . . @ . . @ . . . . . . . @ . . . . . . . @ . . . . @ . . . . . @ . . . . . . . . @ @ . @ . . @ . . . . . . @ . . @ . . . . . . @ . . @ . . . . . @
@ . @ . . @ . . . @ . . @ . . . @ . @ . @ . . . . . . . . @ . . @ . @ . . @ . . . . . . . . . . @ . . . . . @ . . . . . @ . . . . . . @ . . . . . . . . . @ @ @ . . . . . . . . . . . . . . . . . . . @
@ . . . . . @ . . . . @ . . . . . . . . . . . @ . @ . . . . . . @ . . . . . @ . . @ . . . . . . . . . . . . . . . . . . . . . . . . @ . . . . . . . . . . . @ . @ . . @ . . . . . . @ . . @ . . . @ . @
@ . . . . . . . . @ . . . . @ . @ @ . . . . . . . . . . . . . @ . @ . . @ . . . . . @ . @ . . . . @ @ . . . . . . . @ . . @ . . . . . . . @ . . . @ . . . . . . . . @ @ . . . . @ . . . . @ @ . . @ . @
@ . . @ @ @ . . @ . . . . . . . . . . . . . . . . . . . @ @ @ . . . . . . @ @ . @ @ . @ . . . @ . . . . . . . . . . . . . . . . @ @ . . . . . . . . @ @ . . . . @ . . . . @ . . @ . . . . . . @ @ . . @
@ . . . . . @ . . . . . . . . . @ . . . . . @ . . . . @ . . . . . . @ . . . . . . . . @ . . . . . . @ . @ . . . . . . @ . . . . . . . . @ . . . . . . . . . . . . . . . . . . . . . . . . . @ . . @ . @
@ . @ . . . . . . . . @ . . @ . . . . . @ . @ . . . . . . @ . . . . @ . . . . . . @ . . @ . . . . . . . . . . . @ . @ . @ . . . . . . . . @ . . @ @ . . . . @ . . . . . @ . . . . @ . . . . . @ . . . @
@ @ . . . . . . . . . . . . . . . . . @ . @ . . @ . . . . . . . @ . . . @ . . . . . @ . . . . @ . @ . . . . . . . @ . . . . . . . . . . . . . . . . . @ . . . . . . . . . . . . . . . . . . . @ . . . @
@ . . . . . . . @ @ . @ . @ @ . @ . . @ . . . . . . . @ . . . @ . . @ . . . . . . @ . . @ . . . @ . . . . @ . . . @ . . . . @ @ @ . . . . . @ . . . . . . . @ . @ . . . . . . . @ . . . . . . . . . . @
@ . . . . @ @ @ . . @ . . . . . . . . . @ . . . . . . . . . @ . . . . . . . @ @ . . . @ . . . . . . . . @ . @ @ . . @ . . @ @ . @ . . . . . . . @ . . . . . . . @ @ . . . . @ . . . . . . @ . . . . . @
@ . @ . . . . . . . @ . . . @ @ . . . . . . . . . . . . @ . . . . @ . . . . . . @ . . . @ @ @ . . @ . . . . @ . @ . . . . . . . . . @ @ . . . @ . . . . @ . . . . @ . . . @ . . . . @ . @ . . . . . . @
@ . . . @ . . . . . . . . . . . . . . . @ . . . . @ . . @ . . . . @ . . @ . . . . . . . . . . . . . . . . . . . . . . . . . . @ . . . . @ . @ . @ . @ . . . . . . . . . . . . . . . . . . . . . . . . @
@ . . @ . . . . @ @ . . . . . . . . . @ . . . . . . . . . . . @ . . . . . . . . . . . . . . . @ @ . . @ . . . . . . @ @ @ . . @ . . @ . . @ . @ @ . . . . . @ . @ . . . . . . @ . . . . . @ . . @ . . @
@ . . . . . . . . . . . . . . . . @ @ @ . @ . . @ . . . . . . . . @ . . . . @ . @ . . . . . @ . . . . . . . . . . . . . . . . . @ . . . . . @ . @ . @ . . . . . . . . . . . . . . . . . @ . . . . . . @
@ . . . . . . . . . . . @ . . . . @ . . . @ . @ . . . @ . . @ . @ @ . . . . @ . . @ . . . @ . @ . . . @ . @ @ . . . . . . . @ . . . @ . . . . . . . . . @ . @ . . . @ @ . . @ . . . @ . @ . . . . . . @
@ . . . . . . . . . @ . . . @ . @ . . @ . . @ . . . @ . . . . @ @ . . . . . . . . . @ . . . . . @ . . . . . . . . @ . . . @ . . . . . . . . . . . . . . . . . . @ . . . @ . . @ . . . . . @ . . @ . . @
@ . @ . @ . . @ . . . @ . @ . . @ . . . . . . . . @ . . . . . . @ . . . @ . . . . . . . . . . @ . . @ . @ . . . . . . @ . . . . . . . . . @ . . @ . . . . . . @ . . . . . . @ . . . . . @ . @ . . . @ @
@ . . @ . . . . @ . @ . . @ . . . . . . . . @ . . . . . . . . . . @ . . @ . . . @ @ . @ . . . . . @ @ . . . . . @ . . @ . . . . . . . @ . . . @ . . . . . @ . . . @ . . @ . . @ . . . . @ . . . . . . @
@ . . . @ . . . . . . @ . @ . . . . @ . . . @ @ . . . . . @ @ . . @ . . . . @ . . . . . . @ @ . . . . . . . . @ . . . . @ . . . @ . . . . . . . . . . . . @ . . . . . . . @ @ . . . . . . @ . . . @ . @
@ . . . . . . . . . . . . @ . . . . @ . . . . . @ @ @ . . . . . . . . @ . @ . . . . @ . . . . . . . . . . . . . . . . . . . . . . . . . . . . . . . . . . . . @ . @ @ . . . . @ . . @ @ . . . . . . . @
@ . . @ @ @ . . . . . . . . . . . . . . @ . . . . . . @ . . . . . @ . . . . . @ . . @ @ . . . @ @ . . . . @ . . . . . . . @ . . . . . . . . . . @ . . . . . . . @ . . . . . @ . @ . . . . . . . . . . @
@ . . @ . . . . . . . @ . . . . . . . . . . . . . . . . . . @ . . . . . . . @ . . . . . @ . . . . @ @ . . . @ . . . . . . . @ . . . . @ . . . . . . . . . . . @ . @ @ . . . . . . . @ . . . @ . @ . . @
@ . . @ @ @ . . . . . . . . . . . . . . . . . . . . . . . @ . . @ . . . . @ . @ . . . @ . @ . . . . . . @ . . . @ . . . @ . . . . . . . @ . . . @ . . . . . . . . . . . . . @ . @ . . @ . . . . . . @ @
@ @ . . . . @ . . . @ . . . . . @ @ . . . . . . @ . @ @ . @ . . . @ @ . . . @ . . . @ . . . . @ . . . . . @ . . . . . . @ . . . . . . . . . . . @ @ . . . . . @ @ . . @ . . . @ . . . . . . . . @ . . @
@ . . . . @ . . . . . . . . . . . . @ . @ . . @ . @ . @ . . . . @ . . . . @ @ . . . . . . . . . . . . . . @ . @ . @ . @ . . @ . . . @ . @ . . . . . . . . . . . . . @ . . . . . @ . . . @ . . . . . @ @
@ . @ . . . . @ . @ . . . . . . . @ . . . . . @ . . @ . . . . @ . . @ . . . . . . . . @ . @ . . @ . . . @ . . . @ . . . . . . . @ . @ . . . @ . @ . . . . . . . . . . @ . @ . . . . . . . . @ @ . . . @
@ @ . . . . . . . @ @ . . @ . . . @ . @ . . . . . . . . @ . . . . @ . . . . . . . . . . . . . . . . @ . . . . @ . @ @ @ . . . @ . @ . @ @ . . . @ . . . . . . . . . . . @ . @ . . . . . . . @ . . . . @
@ . @ . . . @ . . . . . @ . . . . . @ . . . . . . . . . . . . @ . . @ . . . @ . . . @ . @ . . . @ . . . . . . . . . . . . . . . . . . . . . . . @ @ . . . @ . @ . . . . . @ . . . . . . @ . . . @ . @ @
@ . . . . . @ . . . . . . . . . . . . . @ . @ . . . . . . . . . . @ . @ @ . . . . . . . . @ . . . . . . @ . . . . . . . . . . . . @ . @ . . . @ . . . . @ . . . . . . . . . . @ @ . . . . . @ . . @ . @
@ . . @ . . . . @ . . . . . . . @ . . . . . @ . . . . . . . . @ . . . . . @ @ . . . . . . . . @ . . . . . . . . @ . . . . . . . . . . . . . . . . @ @ . . . . . . . @ . . . . . . . . . . . . @ @ . . @
@ . . . . . . . . . . @ . . @ . . . @ . @ . . @ . . . . . . . . . . @ . @ . . . . @ . . . . . @ @ . . . . . . . . . . @ . @ . @ . . . . . . . @ . . . . . . . . @ . @ . . . . . @ . . . @ @ . . . . . @
@ . . @ . . @ . . . @ . . . @ @ . . . . . . @ . . . . . . . . . . . . @ . . . . . . @ . . @ . . . . . @ @ . . . . . . . @ . . . @ . . @ . . . . . . @ . . . . . . . . . . . . . . . . . . @ . @ . . @ @
@ . . . . . . . . @ . . @ . . . . . @ @ . . . . . . . . @ . . @ . . . . . . @ . . . . . . . . . . . . @ . . . @ . . . . . . . . . . . . @ . . . . . . @ . . . . @ . . . . . @ . . . . . . . @ . @ . . @
@ . . . . . . . . . . . . . . . @ . . . . . . . . . . . . @ @ . . . . . . . . . @ . . . . . . . . . . . @ @ . . . . . . . . . . . . @ . . . @ . . @ . . @ @ . . . . . . . @ . . . @ . . . . . . . @ . @
@ . . @ . . . . . @ . . . . . . . . . . . . . . . . . . . @ . . @ . . . . . . @ . . . . . . . @ . . . . . . . . . . . . . . . . . . . @ . . . . . . . . . . . . @ . . . . . . @ . . @ . . @ . . . . . @
@ . . . . @ . @ . . . @ . . . . . . @ . @ . . @ . @ . . @ . @ @ . . . . . . @ . . . . . . @ . . . . . . . . . . . . . . . . . . @ . @ . @ . . @ . . . . . . . . . @ . . @ . . @ @ @ . . . . . . . . . @
@ . . . . . . . . . . . . . . . . . . @ . . @ . @ . . . . . . . . . . . . . . . . . @ . . . @ . @ . . . @ . @ . . . . . . . . @ . @ . . . . . . . . . . . . . @ @ . . @ . @ . . . . . @ . @ . . . . @ @
@ . . . . . . . . . . . . . . . . @ @ @ @ . . . . . . . . . . . @ . . . . . @ . @ . . @ . . . . . . @ . @ . . @ . . . . . . . . . @ . . . . . @ . . . @ . @ @ . . . . @ . . . . @ . @ . @ @ . @ @ . . @
@ . . . . . . . . . . @ . . @ . . @ . @ . . . . . @ . . . . . . @ . @ . . . . . . @ @ . . . . @ . . @ . . . . . @ @ @ . . . . . . . . . . . . . . . . . . . . @ . . . . @ . . . . . . @ . . . . . . . @
@ . . . . @ @ . . @ . . . . @ . . . . . . . . . . . . . . . . . @ . . . . . . @ @ . . . . . . . . . @ . @ . . . . . . . . . @ . . @ . . . . . @ . . . . . . . . . @ . . . . @ . . . . . . . . . . @ @ @
@ . . @ @ . . . @ . . . . . . . . . . . . . . . . . . @ . . . @ . . . . . @ . @ . . . . . . . . . . . @ . . . . . . . . @ @ . . . . . . @ . @ . @ . . . . . @ . . . . . . . . . . . . @ . . . . @ @ . @
@ . . . . . . . . . . . . . . @ . . . . . @ . @ . . . . @ . @ . . . . . . . . . . . . . . @ @ . . . . . @ . . . . . @ . . . . . @ . . . . . . . @ . @ . @ . . . . . . @ . . @ . . . . . @ . . @ . . . @
@ @ . . @ . . . . . @ @ . . . . . . . @ . @ . . . @ @ . . . . . . . . . . . . . . . @ . . . . . @ @ . . . . . @ . . . . . . @ . . . . . . . @ . @ . . . @ . . . . . . . @ . . . . . . . . . . @ . . . @
@ . . @ . @ . @ . @ . @ . . . . . . . . @ @ . . . . . . . @ . . . . @ . @ @ . @ . . @ . . . . . . . @ . . . . . . . . . . . . . . . @ . . . . . . . @ . . . . @ . @ . . . . . . @ . . . . . . . . @ . @
@ . . . @ . . @ . . . . . @ . . . . . . . . . . . @ . . . . . . @ . . . . . . . . @ . . @ . . . . @ @ . . . . . . . . . . . @ . . . . . @ . . . . . . . @ . . . . . . . @ @ @ . . . . . . . . . @ . . @
@ . . . . . . . @ . @ . . . . . . . . . . . . @ @ . . . . . . @ . . . . . @ . . . . . . @ . . @ . . . . . . . @ . . . . . . . . . . . @ . . . . . . . . @ . . @ . . . @ @ . . . @ . . . @ . . . . . . @
@ . @ . @ . . . @ . . . . @ . . . . . @ . . . . . . . . . . . . @ . . . . . . . . . @ . . . . . . @ @ . . @ . . @ @ . . . . . @ @ . . . . . . . . @ @ . . . . . . . @ . . . . . . . . . . . . . . . . @
@ . . . . . . . . @ @ . . . . . . . . . . . . . . . . . . @ . . . . @ @ . . . @ . . . . . . . . . . . @ . . . . @ . . . . . . . . . . . . . . . @ . . @ . . @ . . . . . . . . . @ @ . . . . @ . . . . @
@ . . . . . . . @ . . . . @ @ . . . @ . . . . . . . @ . . . . . . . . . . . . @ @ . @ . . . . . . @ . . . . . . . . . . . . . . . . . . . . @ . . . . . . . @ . . . @ . @ . . . . . . @ . . . . . @ . @
@ @ . . @ . @ . . . @ @ . . . . . @ . . . @ . . @ . @ . . . @ @ . . @ . . @ . @ . @ . . . . . @ . . @ . @ . . . @ . . . . . . . . @ . . . . . . @ . @ . . . . . . @ . . . . . . . . . . @ . . . . . . @
@ . @ @ . . . . . @ . . . . . . . @ . . @ . . @ . . . . . @ . . . . . . . . . . . . . . @ . . . . . . . . . . . . . . . . @ . . @ . . . . . . . . . @ . . @ . . . . @ @ . . . @ . . . . . . . . . . . @
@ . . . . . . @ . . . . . . . . @ . @ . . . . . . . . . . . . . . . . . . . . . @ . . . . . . . . @ . @ . . . . . . . . . . . @ . @ . . . . @ . . . . . @ . . . . @ . . . . . . . . . . . @ . . . . . @
@ . . . . . . . . . . . @ . . @ . . @ . . . . . . . . . . . . . . . . @ . . . . . . . @ . . @ . . . . . . . . . . . . @ @ . . . @ . @ . . . @ . . . @ . . . @ . . . @ . . @ . . . @ . . . . @ @ . . . @
@ . . . . . . . . . . . . @ . . . . . . . . . @ @ . . @ . . . . . @ . . . . @ @ . . . @ . . . . . . . . . . . . . . . . @ . . @ . . @ . . . . . . . . . . . . @ . . . . . . . @ . . @ @ . . @ . . . . @
@ . . @ . . . . . . . . . . . . . . @ . @ . . . @ . . . . @ . . . @ @ . . . . . . @ . . . . . @ . @ . . . . . . @ . . . . . . . . . . @ . . @ . . . . @ . @ . . . @ . . . @ . . @ . . . . . @ . @ @ . @
@ . . . . . . @ . . . . . @ . @ . . . . . . @ . @ . . . . . . . . . . . . . . . @ . . . . . . . . . . . @ . . @ . . . . . . @ @ . . . . . @ . @ . . . . . . . . . @ . . . @ . . . . . . . . . . . . . @
@ . . . @ . . . @ . @ . . . . @ . . @ . . . . . . . . . . . . @ . . . @ . . . @ . . . . . @ . . @ . . . . . . . @ . . . . @ . @ . . . . . . . . . . . . . . . @ . . . . @ . . . . . . @ . . @ . . @ . @
@ . @ . . @ . @ . . . . . . . . . . . . . . . . @ . . . . . . . . . . . . . . . . @ . . . . . . . . . @ . . . . . . . . . @ @ . @ . . . . @ . . . . @ . . . . . . . . . . . . @ . . . . @ @ . @ . . . @
@ . . @ . . . . . . @ . . . . . . . . . . @ . . . . . . . . . . . . . . . . @ . . . . . @ . . . . . . @ @ . . . . . . @ . . . . . . . . . . . . . @ . . . . . . . . . . . . . @ . . . . . . . . @ . . @
@ @ . . @ @ . . @ . . . . . . . . . . @ . . . . @ @ . . . . . . . . @ . . . @ . . @ . @ . . @ . . @ . . . . . . @ . . . . . . . . . . @ @ . @ . . . . . . . . . @ . @ . . . @ . . @ . @ . . . . . . . @
@ . . . . . . . . . . . . . @ . . . . . . . . @ . . . . . @ . . . @ . . . . . @ . . . . . . @ . . . . . . @ . . . . @ . . . . . . . . . . . . . . . . . . . . . . . . . . . . . . @ . . . . . @ . . . @
@ @ . . . . . . . @ . . @ @ . . . . . @ . . . @ @ . @ @ . . . . . . . . @ @ . . . @ . . @ . . @ . @ . @ . . @ . @ . . . . . . @ . . . . . . . . . @ @ @ . . . . . . . . . . . . . . . . @ . . . @ . . @
@ . . . . . @ . . . . @ . . . @ . . . . @ . . . . . . . @ . . . . . . . . . @ . . . . . . . . . . . . . . . . . . . . . . . . . @ . . . . . . . . . . . @ . . @ . . @ . . . @ @ . . . . . . . . . @ . @
@ . . . . @ . . . . . @ . . . @ . . . . . . @ @ . . . . . . . @ . @ @ . . . . . @ @ . . @ . . . . . @ . @ . . . . . @ . @ . . . @ . @ . . . . . . . . . . @ @ . @ @ . . . @ . . . . . . @ . . . . . . @
@ . @ . @ . . @ . . . . . . . . @ . . @ . . @ . . . . . . . . . . . . . . . @ . @ . . . @ . . . . . . . . . @ . . . . . . . @ . . . . . . . . @ . . . . . . . . . . @ . . . @ . . . @ . . . . . . @ . @
@ . . . . . @ . . . . . . . . @ . . @ . . @ . . . @ . . . . . . @ @ . . . . @ . . . . . . . . . @ . . . @ . . . . . . . . . . . . . . . . . @ . @ @ @ . . . . @ . . . . @ . . . @ . . . @ . . . . . @ @
@ @ . . @ . . @ . . . . @ . . . . . . @ . @ . . . . @ . . . . @ . . . . . . . @ . @ . @ . . @ . . . . . . @ . . . . . @ . . . . . . . . . . . . . . . . . . . . . @ @ @ . . . . . . @ . . . . . . . . @
@ . @ . . @ . . @ . . . . @ @ . @ . . @ . . . . . . . . @ . . @ . @ . @ . . . . . . @ . . . . . @ . @ . @ . . . . @ . @ . . . . . @ . @ . . . . . @ . . . . . . . . . . @ . @ @ . . . . . . . . . . . @
@ . . . . . @ . . . . . . . . . . . . . . . . . . . @ . . . @ . . . . . . . . . @ @ . . @ @ . . . . . . @ . . . . . . . . . . . @ . . . . . . . . . . . . . @ @ . . . . . . @ . . . . @ . . . . . . . @
@ . . . @ . . . . @ . @ . . @ . . . . . . . . . . . . @ . . @ . . @ @ . . @ . . . . . . . . @ . . . . . . @ . . . . . . @ . . . . . . . . @ . @ . . . . . . . @ . . . . . . . . . . @ . . . . . . . . @
@ @ @ @ @ @ @ @ @ @ @ @ @ @ @ @ @ @ @ @ @ @ @ @ @ @ @ @ @ @ @ @ @ @ @ @ @ @ @ @ @ @ @ @ @ @ @ @ @ @ @ @ @ @ @ @ @ @ @ @ @ @ @ @ @ @ @ @ @ @ @ @ @ @ @ @ @ @ @ @ @ @ @ @ @ @ @ @ @ @ @ @ @ @ @ @ @ @ @ @
3
70 54 16 44
29 51 86 85
81 58 47 2
