12 12
@ @ @ @ @ @ @ @ @ @ @ @
@ . . . . . . . . @ . @
@ . . . . . . @ . . . @
@ . @ . . . . . . . @ @
@ . . @ . . @ @ . . @ @
@ @ . @ . . . . . . . @
@ . @ . . . . @ . . . @
@ . . . . . @ . . . . @
@ @ . . . . . . . @ . @
@ . . . . . . . . . . @
@ . . . . . . . . . . @
@ @ @ @ @ @ @ @ @ @ @ @
3
6 10 1 6
2 10 4 9
10 8 7 4
