12 12
@ @ @ @ @ @ @ @ @ @ @ @
@ @ . @ . . . . . . . @
@ . . . . . . . . . . @
@ @ . . . . @ . @ . . @
@ . . . @ . . . . . . @
@ . . @ @ @ . @ . . . @
@ . . . . . . @ . . . @
@ . . @ . . . . . . . @
@ . . . . . . . . . @ @
@ @ . @ . . @ . . . . @
@ . . . . . . . @ . . @
@ @ @ @ @ @ @ @ @ @ @ @
3
8 3 4 8
2 10 5 6
1 5 3 9
