25 25
@ @ @ @ @ @ @ @ @ @ @ @ @ @ @ @ @ @ @ @ @ @ @ @ @
@ . . . . . . . . . @ . . . . . . @ . . . . . . @
@ . . . . . . . . . . @ . . . . . . . . . . . . @
@ . . . . @ . . . . . . @ . . . @ @ . . . @ . . @
@ . . . . . . . . . @ @ . . @ . @ . . . . . @ . @
@ . . . . . . . . . . @ . @ . . @ . . . . . . . @
@ . . . . @ . @ . . . @ . . . . . . . . @ @ . . @
@ @ . . . @ . . . . . . . . @ . . . @ . @ . . . @
@ . @ . . . . . . . . . . . . . @ . . . . . . . @
@ . . . . . . . @ . @ . @ @ . . . . . . . . . . @
@ . . . . . . . . . . . . . . @ . . . . . . @ . @
@ . . . . . . . . @ . . @ . @ @ . . @ . . . . . @
@ . . . . . . @ . . . . . . . . . . . . @ . . . @
@ . . . @ . . . . . @ . . @ @ . . . . . . . @ . @
@ . @ . . . . . . @ . . . . . . . . @ . . . . . @
@ . . @ . . . . . @ @ . . . @ . . . . . @ . . . @
@ . . . @ . @ . . @ . . . . . . . . . . . . . . @
@ . . . @ . @ . . . . . . @ . @ . . @ . . . . @ @
@ . . @ . . . . @ . . . . . . . . . . . . . . . @
@ . . . @ . . . . . . @ . @ . @ . . . . . . . @ @
@ . . . . @ . . . @ @ . @ . . . . . . . . . . . @
@ . . @ . . . . . . . . . @ . . . . . . . @ . . @
@ . . . . . . . . . . . . @ . . . @ . @ . @ . . @
@ . . @ @ . . . . . . . @ . . . @ . . . . . . . @
@ @ @ @ @ @ @ @ @ @ @ @ @ @ @ @ @ @ @ @ @ @ @ @ @
3
8 10 13 20
8 8 18 4
17 14 6 22
