12 12
@ @ @ @ @ @ @ @ @ @ @ @
@ . . . . . . . @ . . @
@ . . @ @ . . . . . . @
@ @ . @ . @ . . . . . @
@ . . . . . . . . . . @
@ . . @ . @ . . . . . @
@ . . . . @ @ @ . @ @ @
@ . . . . . . . @ . . @
@ . . . . . . . . . . @
@ @ . . . . . . . . . @
@ . . @ . . . . . . . @
@ @ @ @ @ @ @ @ @ @ @ @
3
7 7 2 1
6 2 4 5
10 2 4 6
