50 50
@ @ @ @ @ @ @ @ @ @ @ @ @ @ @ @ @ @ @ @ @ @ @ @ @ @ @ @ @ @ @ @ @ @ @ @ @ @ @ @ @ @ @ @ @ @ @ @ @ @
@ . . . @ . . . . . . . . @ . . @ . . . @ . . . . . . . . . . . @ @ . . . . . . . . . . @ . . . . @
@ @ . @ . . . . . . . . @ . . . . @ . . . . . . . . . . @ . . . . . . . @ . . . . . . . @ . . . . @
@ . @ . @ . . . . . @ @ . . . . . @ . . @ . . . . @ . . . . . . . . . . . . . @ . . . . . . @ . @ @
@ . . @ . . . . . . . . . . . . @ . . @ . . . . @ . @ . . . . . . . . . . . . @ . . @ . . . . . . @
@ . . . @ . . @ . . . @ . . . . . . . . . . . . @ . . . @ . . @ @ . . . @ . @ . . @ . . . . . . . @
@ @ . . . . . . . . . . @ . . . . . . . . . @ . . . @ . @ . . . . @ @ . . . . . @ . . . . . . . . @
@ @ . . . @ . . . . @ . . . @ . . . . . . . . @ . . . . @ . @ . . @ . . . . . . . . . . @ . @ . . @
@ . . . . . @ . @ . . . . @ . . . . . @ @ . . . . @ . . . @ . . . . . . . . . . . . . @ . . . . @ @
@ . . . . @ . . . . . . . . . . . . @ . . . @ @ @ . . @ . . . . . . . . . @ @ . . . . . . . . . . @
@ @ . @ @ . . . @ . . @ . . . . . . @ . . . . . . . . . . . . . . . . . @ . . . . . @ @ . . . @ . @
@ . . . . . . . . . . . . . . . . . @ . . . . . . . . . . . @ . . . . . . . . . . . . . . . . . . @
@ . . . . . . . @ . @ . . @ . . . . . . @ . . . . . . @ . . . . @ @ . . . @ . . @ . . . . @ . . . @
@ . . @ . . . . . . . . . . @ . . . @ . . . @ . . @ . . @ . . @ . . . . . . . . @ . . . . . . @ . @
@ . . . . . . . . @ . . . @ . . . . . @ . . . . . @ . . . . . . . . . . . . @ . . @ . . . . . @ . @
@ @ . . . . . . . @ . . @ @ . . @ . . . . . . . @ . . . . . @ . . . . . . . . @ . . @ . . @ @ . . @
@ . @ . . . . . . . . . . . @ . . @ . . @ @ . . . . . @ . . . . @ . . . . . . . . @ . . . . . . . @
@ . . . . @ . . @ . @ @ . . . @ @ . . . @ . . . . @ . . . @ . . . @ . . . . . . . . . . . . . . . @
@ @ . . . . . . . . . . . . @ . @ . @ @ . @ . . @ . . . . @ . . . @ @ . @ . . . . . . . . @ . . . @
@ . @ . . @ . . . . . . . . . . . . . . . . . . . . . @ . . . . . . @ . . . . . . . @ . . @ . . . @
@ . . @ . . . . @ . . . . . @ . . . . . . . @ . @ @ @ . . . @ . . . . . . @ . @ . . . @ . @ . . . @
@ @ . . . @ . . @ . . . @ . . @ . @ . . @ . . . . . . @ @ . . . . . @ . . . . . . . @ . . . . . . @
@ . @ @ . @ . . . . . . . . @ . @ . . . . . . . . @ . . . . . . . . . . . . @ @ . . @ . . . . @ @ @
@ @ . . . . . . . . . @ . @ . . . @ . . . . . . . . . @ . . @ @ . . . @ . . . @ . . . . @ . . . . @
@ . . . . @ . . . . . . @ . @ @ . . @ . . . . @ . . . @ . . . . . @ . . . . @ . . . . . . . @ . . @
@ . . . @ @ . . . @ @ . . . @ . . . . . . . . . @ . . . . . . @ . @ . . . . . . . @ . . . . . . . @
@ @ . . . . . @ @ . . . @ @ . . . . . . . . . . @ . . . . @ . . . @ @ . . . . . . . . @ . @ . . @ @
@ . @ . . . @ . @ . @ . . . . @ . . . . @ . . @ . @ . @ . @ . . . . . . . . @ . @ @ . @ . . @ . . @
@ . . . . @ . . . . . . . . . . . . @ @ . . . @ . . . @ . . . . . . . . @ @ . . . . . @ . . . . . @
@ @ @ . . . . @ . . . . . @ . . . . @ . . . . . . . . . . . . . @ . . . . @ . @ . . @ . @ @ . . @ @
@ @ . @ . @ . . . . . . . . @ . . . . . @ . . . . . @ . . @ @ . @ . . . . . @ . . . . . . . . . . @
@ . . . @ . . @ . . @ @ . . . . . @ . . . . @ . . . @ . . @ . . @ . . . . . . . . @ . @ . @ . @ . @
@ . . . . . . . . . . . . . . @ . . . . . . . . . . . . . . . . . . . @ . . . . . . . . . . . . @ @
@ . . . . . . . . . . . . @ . . . . . . . @ . . @ @ . . . @ . . . . . . . . . . . . @ . @ @ . @ . @
@ @ . . . . @ . @ . . . . @ . . . . . @ . . . . . . . . . . . @ . . . @ . . . . . @ . . . . . . . @
@ . @ . . . . . . @ . . . . . . . . . . . . . . . . . . @ . . @ . . . . . . . . @ . . @ . . . . @ @
@ . @ . . . . @ . @ . . @ . . . . . @ . . @ @ . . . . . . @ . @ . . . @ . @ . . . . . . . . . . . @
@ . . . . @ . . . . . . . . . . . . . . . . @ @ . . . @ . . . . . @ . . . . . . @ . . @ . . . . . @
@ . . @ . . . . . . . . @ . . . . . @ . @ . . . . @ . @ . . @ . . . . . . . . . . . . . . . . @ . @
@ . . . @ . . . . . . . . . . . . . . . . . . . . . . . . . . @ . . . . . . . . . . . . . . . . . @
@ @ . @ . . . @ @ . @ . . . @ . @ . . . . @ . . . . . . . . . . . @ . . . . . . @ . @ . . . . . @ @
@ . @ . . . . . . . . . . . . @ . . . . . . . . @ . . . @ @ @ . @ . . . . . . . . . . . . . . . . @
@ . . @ @ . @ . . @ . . @ . . . . @ . . . . . . . . . . . . . . . . . . @ . . . @ . . . . . . @ . @
@ . . . . @ . @ . . @ . . @ . . @ . . . . . . . . . . . . . . . . @ . . . . . . @ . . . . . . @ . @
@ @ . . . . . . . . . . . . @ . . . . . @ . . . . . @ @ @ . . . . . . . . . . . @ . . . . @ . . . @
@ @ . . . . . . . . . . . . . . . . . . . . . . . . . . . . . @ @ . . . . @ . . . @ @ . . . . . . @
@ . . . . @ @ . . . . @ . . . . @ . . @ @ . . . . . . @ . . . . . . . . . . . @ . . . @ . . . . @ @
@ @ . @ . @ . . . . . . @ . @ . . @ @ . . . . . @ . @ . . . . @ . . . . . @ . . . . . @ . . @ . @ @
@ . . @ . . . . . . . . . . . . . . . . . . @ . . . . @ . . . . . . @ . . . . . @ . . . . . . . . @
@ @ @ @ @ @ @ @ @ @ @ @ @ @ @ @ @ @ @ @ @ @ @ @ @ @ @ @ @ @ @ @ @ @ @ @ @ @ @ @ @ @ @ @ @ @ @ @ @ @
3
8 39 11 5
11 48 30 45
24 11 31 46
