50 50
@ @ @ @ @ @ @ @ @ @ @ @ @ @ @ @ @ @ @ @ @ @ @ @ @ @ @ @ @ @ @ @ @ @ @ @ @ @ @ @ @ @ @ @ @ @ @ @ @ @
@ . @ . . . . . @ . . . . . . . . . @ . . . . . . @ . @ . @ . . . @ . . @ . . . . . . . . . . . @ @
@ @ . . . . . . @ . . . @ @ . . . . . . @ . . . . . . . . . . . @ . @ . . . . . @ . . . . . . @ . @
@ . . . . . . @ . . . . @ . . . . . . . . . . @ . . . . . . . . @ . . @ . @ @ . . . @ . . . . . . @
@ . . . @ . . . @ . . . . @ @ . . . . @ @ . . . . @ @ . . . @ . . . . . . . . @ . @ @ . . . . @ . @
@ . . @ @ . @ . . @ @ . . . @ . . . . @ . . . . . . . . . . . . @ . . . . . . . . . . . . . @ . . @
@ . @ . . . . . . . . @ . . . . . . . . . . . . . . . . @ . @ @ . . . . . @ @ . . . @ . . . . . . @
@ . . . . @ . . . . . @ . . . . . . . . @ . @ . . . . . . . . . . @ . . . . . . . . . . . . . . . @
@ . . . . . . @ . . . . @ . . . . @ . . . . . @ . . @ . . . . @ . . . . . . . @ . . @ . . . . . . @
@ . . . . @ @ . . . . . . . . @ . . @ . . . . . . . . . . @ . @ . . @ . . . . . . @ . . . . @ . . @
@ . @ . @ . . . . @ @ . . . . . . @ . . . . . @ . . @ . . . . @ . . . . @ . . . @ . . . . . . . . @
@ . . . . @ . . . . . . . . . @ . . . @ . . . @ . . . . . . . . . @ . . . . . @ . @ . . . . . . @ @
@ . . . . . @ . . . @ . . . @ . . . @ . . . . . . @ . . @ . . @ . . . . . . . . . . . @ . . . . . @
@ . . . . . . . . @ . . . . . . . @ . @ . . @ . . . . . . @ . . @ . . . . . . @ . . @ . . . . . @ @
@ . @ @ . . @ . . . . @ @ @ . @ . . . . . . . . . . . . . . . . . . . . . . . @ . . @ . . . . @ . @
@ . . . . . . . . . . @ . . . . @ . . . . . . . . . . . . . . . . . . . . . . . . @ . @ . . @ . . @
@ . @ . . . . . . . @ . . @ . . . . @ . . . . . @ . . @ . . . . . @ . . . . @ . . . . . . @ . . @ @
@ . @ . . @ @ . . . . @ . . . . . . . . @ . @ . . @ . . . . . . @ @ @ . . @ . . . . . @ . . . @ . @
@ . @ @ . . . . . . @ . . . . . . . . . . @ . . . . . . . . . . @ . . . . . . . . . . . . . . . . @
@ . . . . . . . . . . . @ . @ . . . . @ . . . . . . . . . . . @ . @ . . . @ . . @ . . . . . . . . @
@ . @ . . . . @ . . . . . @ . . @ . . . . . @ @ @ . @ . . @ . . . . . . @ @ . . @ . . . . . @ . . @
@ . . . . @ @ . . . . . . @ . . . . . . . . . . . . . . . . . . @ . . @ . . . . @ . . . . . @ . . @
@ . . . . . . . . . . . . . @ . @ . . @ . . . @ . . . @ @ . . @ . . . . . . . . . . . . . @ . . . @
@ @ . . @ . . . . . . . . . . @ . . @ @ . @ @ . . . @ . . . . . . . . @ . . . @ . . @ . . . . . . @
@ . . @ . . . . . . @ . . . . . @ @ . . . . @ . . . @ . . . @ . . . . . . . . . @ . . . . . . . @ @
@ . . . . . . . . . . @ . @ . . . . . . . . . @ . @ . . . . . @ . . @ . . @ . . . . . . . . . @ . @
@ . . . . . . . . . . . @ . . @ . . @ . . @ . . . . . . . . . @ . . . . . . . . . . . . . . . . . @
@ . . . @ . . . . @ . . @ @ . . . . . . . . . . . . . . . . . . @ . . . @ . . . . . . . . . . . @ @
@ . . . . @ . . @ . . . . . . . @ . . . . . . @ . . . . . . @ . . . . . . . . . . . @ . @ . . . . @
@ . . . . . . . . . @ @ . . . . . . @ . . . . . . . @ . . . . . @ . . . . . . . . . . @ . @ . . . @
@ . @ . . . . @ . . . . . . . @ . . . . . . @ . . @ . . . . . @ . . . . . . . . . . . . . @ . . @ @
@ . . @ @ . . . @ . . . . . . @ . . @ . . @ . . . . . . . . . . . @ . . . . . @ . . @ . . . . . . @
@ . . . . . . . @ . . . . . . . . . . . . . . . . . . . @ . . @ @ . . . . . . . @ . . . . @ . @ . @
@ . . . . . . @ @ . . @ . @ . . . . . . . . @ . . . . . . @ . . . . @ . . . . . . . . . @ . . . . @
@ . . . . . . @ . . . . . . . . . . . @ . @ . . @ @ . . . . . @ . . @ . @ . @ . @ . . . . @ . . . @
@ @ . . . . . . . . . @ . . . . . . . . @ @ . . @ . . @ . . . . . . . . @ . . @ @ . . . . . @ @ @ @
@ . . . . . . . . . . . . . . @ . . . @ . . . . . . . @ . . . @ . . . . . . . . . . . . . . . . . @
@ . . . @ . . . . . . @ . . . . . . . . . . . . . @ . @ . @ . @ . . . @ @ . . . . @ . @ . . . . . @
@ . . . @ . . . . . . . . @ . . . . . . . @ . @ . . . . . . . . @ . @ . . . . . @ . . . . . . . . @
@ . @ . . . . . . @ . . @ . . . . . @ . @ . . . . . @ . . . @ @ . . . @ . . . . @ . @ . @ . . @ . @
@ . . . . . . . . . . . . . . . . @ . . . . . . . @ @ . . . . . . . . @ . . @ @ . . . . . . . . . @
@ . . . . @ . . @ . . @ @ @ . . @ . . . . . . . . . . . . . . @ @ . . . . . . . . @ . . . . . . . @
@ . . . . . . . . . . . . . . . . @ @ . . . . . @ . . @ . . . . . . @ @ . @ . . . . . . @ . . . . @
@ . @ . . @ . . @ . . . @ . . @ . . . @ @ . @ . @ . . . . @ . @ . @ . . . @ . . @ . . . . . . @ . @
@ . . . . . . . . . @ . . . . . . . . . . . . @ . . . . . . . @ . @ . . . . . . . . . @ . . . @ . @
@ @ . . . . . @ . . . . . @ . . @ . . . . . . . @ . . . . . @ . . . . . . . . . . @ . . @ . . . @ @
@ . . . @ . . @ . . @ . . . . @ . . . . . . . . . . . . . . . . . . @ . . . . . . . . . . . . . . @
@ . . . . . . . . @ . . . . . . . . . . . . . . . . @ . . . @ @ . @ . . . @ . @ . . . . . . . . . @
@ . . . . @ . . @ . . . @ @ . . . . . . . . . . . . . . . @ . . . . . . @ . . . . . . . . . . . . @
@ @ @ @ @ @ @ @ @ @ @ @ @ @ @ @ @ @ @ @ @ @ @ @ @ @ @ @ @ @ @ @ @ @ @ @ @ @ @ @ @ @ @ @ @ @ @ @ @ @
3
22 26 36 26
37 12 7 44
48 7 12 17
