12 12
@ @ @ @ @ @ @ @ @ @ @ @
@ . . @ . . . . @ . . @
@ . @ . . . @ @ . . . @
@ . @ . . . . . . . @ @
@ . . . @ . . . . . . @
@ . @ @ . . . . . . . @
@ . @ . . . . . @ . . @
@ @ . . . . . . . @ . @
@ @ . @ . . . . . . . @
@ . @ . . . . @ . @ . @
@ @ . @ @ . . . . . . @
@ @ @ @ @ @ @ @ @ @ @ @
3
4 5 5 6
2 10 6 4
4 1 6 5
