100 100
@ @ @ @ @ @ @ @ @ @ @ @ @ @ @ @ @ @ @ @ @ @ @ @ @ @ @ @ @ @ @ @ @ @ @ @ @ @ @ @ @ @ @ @ @ @ @ @ @ @ @ @ @ @ @ @ @ @ @ @ @ @ @ @ @ @ @ @ @ @ @ @ @ @ @ @ @ @ @ @ @ @ @ @ @ @ @ @ @ @ @ @ @ @ @ @ @ @ @ @
@ . . . . . . @ . . @ . . . . @ . . . . . . . . . . . . . @ . . . . . . . . . . . . . . . . . . @ . . @ . . . . . . . . @ . . . @ . . . @ @ . . . . . . . . . . @ . . @ . . . . . . . @ @ . . @ . . . @
@ . . @ . . . . . . . . . @ . . . . @ @ . . . . . . . . . @ . . . . . @ . . . . . . . . . @ . . . . . @ @ . . . . . @ @ . @ . . . . . . . . @ . . . . . . @ . . . . . . . @ . . . . @ . @ . . . . . . @
@ . . . . . . . . . @ . . . . . @ . . . . . @ . . . . . . . . . . . . . . . @ . . . @ @ . . . . . . . @ . . . @ . . . . . @ . . . . . . . . . . . . . . . . . . . . . . @ . . @ . . . . . @ . . . . . @
@ . . . . . . . . . . . . . @ @ . @ . . . . . . . . . . @ . . @ @ . . . . . . . . . . . . . . . . . . . . . . . . . . . . . . . . . @ . . . . . @ . . . . . . . . . . . . @ . @ . @ . . . . . @ . . . @
@ . . @ . . . . . . . . . @ . . @ . . . . . . @ . . . . @ . @ . . . . . . . . . . . . @ . . . @ . . . . . . . . @ . . . . @ @ . . . @ . . @ @ . . . @ @ . . . . . . . . . . . . . . . @ . @ . . @ . . @
@ . . . @ . . . . . . @ . @ . . . . . . . . @ . . . . . . . @ . . . . @ . . . . . . . . . . . . . . . @ . . . . . @ . @ . . . . . . @ . @ @ . @ @ . . . . @ . . @ . . . . . . @ . @ . . . . . . . . . @
@ . . @ . . @ . . . . . . @ @ . @ . . @ . . . . . . . . . . . . . . . . @ . . . . . . . . . . . @ @ . . . . @ . . . @ . . . . . . . @ . . . . . . . . . . . . . . . . . . @ . . . . @ . . . . . @ . . @
@ . @ . . @ @ . . @ @ . . . . . . . @ . . @ . . . @ . @ . . @ . . @ @ . @ . @ @ . @ . @ . . . @ . @ . . @ . . . . . . . . . . . @ . . . . . . . . . . . . . . . . . . . . . @ . . . @ @ . . . . . . . @
@ . @ . @ . . @ . . . . @ . . . . . @ . . . . . . @ . . @ . @ . . . . . . . . @ . . . . @ . . @ . . . . . @ . . . . . @ . . . . . . . . @ . @ . . . . . . . . @ . @ . . . . . . . . . . . . . . . . . @
@ . . @ . . . . . . . . . . . . . @ . . . @ . . . . . . @ . @ . . @ . @ . . . @ . . @ . . . . . . . . . @ . . . . . @ @ . . . . . . @ . . @ . . . . @ @ . . . . @ . . . @ . . @ . . . @ . . . . @ . @ @
@ . . . . @ . . . @ . . @ . . . . . . . . . . . . @ . . @ . . . @ . . . @ . . . . . . . . @ . . . . . . . . . . @ . . . @ . @ . . . . . . . . . @ . . . . . . . . @ . . @ . . @ . . . . . . . . . . . @
@ . . . . @ . . . . . @ . . . . . @ @ . . @ . . . . . . . . . @ . . @ . . @ . . @ . . . . . @ . . . . @ . . . . @ @ . . . @ . @ . @ . . . . . . . @ . . . . @ . @ . . . . . . @ . . . . @ . @ . . . @ @
@ . . . . . . . . . @ . . . . . @ . @ . . . . . . . @ . . . . . . . . . . . @ . . . . . @ . . . . . . @ . . . . . . . @ . . . @ . . . . @ @ . @ @ . . . @ @ . . . . @ . . . . . . . . . . . . . . . . @
@ . . @ . . @ . . . . . @ . . . . @ . . . . . . . . . . @ . . . . . . . . @ . @ . . @ . . @ . @ . . @ . . @ . . . . . . . . @ . . @ . . . . . . . . @ . . . . . . . . . . . . . @ . . . @ . . . . @ . @
@ @ . . . . . @ @ . @ . . . . @ . . @ . . . @ . . @ . . . . . . . . . @ . . . @ . . . . . . . . . . . . . . . . . @ . . . . . . . @ . . @ . . . . . . . . . @ . . . . . . . @ . . @ . . . . . . . . . @
@ . . . @ . . . . . . . . . . . . . . . . . . . @ . . . . @ . . . . . . . @ @ . . . . @ . . . . . . . . . @ . . @ . @ . . . . . . . . . @ @ . @ . @ . . . @ . . . . . @ . . . . . . . . @ @ . @ . . . @
@ . . @ . . . . . @ @ . . . @ . . . . . . . . . . . . @ . . . . . . @ . . . . . . . . . . @ . . . . . @ . . . . @ . . @ . . . @ . . . @ . . . . @ . @ . . . . . . . . @ @ . @ . . @ . . . . . . . . . @
@ . @ @ @ @ . @ . @ . . @ . . . . . . . . . . . . . @ . @ @ . . . . . . . @ . . . . . . . . @ @ . @ . @ . . . . . . . . @ . @ . . @ @ . . @ . . . . . . . . . . @ . . . . . . . . @ @ . . @ . @ . @ . @
@ . @ . . @ . . . . . @ . . . . @ @ . . . . . . . @ . . . . . . @ . . . @ . . @ . . @ . . . . @ . . . . . . . @ . . . . . . . @ . . . . . . . . . @ . . . . @ . . . . . . @ . . @ . . . . . . . . . . @
@ . . . . . . . . . . . @ . . . . . . . . @ . . @ . @ . . . @ . . . . . . . . . @ @ . . . . @ . . . . . @ . . . . . @ . @ . . . . . . . . @ . . . . . . . . . . @ . . . . . . . . . . . . @ . @ . . . @
@ . . . . . @ . @ . @ . . @ . . @ . @ . . . . @ . . . . . . . . . . . . . . . . . . . @ . . . . . @ . . . . @ . . @ . . . . . . . @ . . @ . . @ . . . . . @ . . . @ . . . . . . . . @ @ . . . . @ . @ @
@ . . . . . . . . . . . . . . . . @ . . . @ @ . . @ . . . . @ @ . . . . . @ . . . . . . @ . . @ . . . . . . . . . . . . . @ . . . . . . . . . . . . . @ . @ @ @ @ . . . @ . . . . . . . . . . @ @ . . @
@ . @ . . . @ . . . . . . . . @ . . . . @ . . . . . . @ @ . . . . . . . . . @ . . . @ . . . . @ . @ . @ @ . @ . . . @ . . . . @ . . . @ @ . . . . . . . . . . . . . . . . . . . . . . . . @ . @ . . . @
@ . . . . . . . . . . @ . . . . . . . . . . . . . . @ . @ . . . . . . . @ . . @ . . . @ . . @ . . @ . . @ . . . . @ . . . . . . . . . . . . . . @ . . . . @ . . . @ @ . @ . . . . . . . . . . . . . . @
@ . . . . @ . . . @ . @ . . . @ . . @ @ . . @ . @ . . @ . . . . . @ @ . @ . . . . . . @ . . . . . . . . . . @ . . . . . @ . . @ . . . . @ . . . . . @ @ @ . . . @ @ . . . . . . . . . . . . . . @ . @ @
@ . . . @ . @ . . . . . @ . . . . . . . . . @ . . . . . . . @ @ . @ . . . . . . . . @ . . . . . . . . @ @ . . . @ . @ @ . @ . . . . . @ @ . . . . . @ . @ . . . @ . . @ . @ . . . . . . @ . . . . . . @
@ . . . . . . . . . . . . . . . . . . . . @ . . . . . . . . @ . . . @ @ . . @ @ . . . . @ . . . . . . @ . . . . . . . . . . . . @ . . . . . . . . . . . . . . . . . . . @ . . @ . . . @ . @ @ . . . . @
@ @ @ . . . . . . . . . . @ @ . . . . . . . . . @ . @ . @ @ @ @ . @ . . @ @ . . . . @ . . . . . @ @ . . . . @ . . . . . . . . @ . . . @ . . . . . @ . . . @ . . . . . . . . . . . . . @ . . . @ . @ . @
@ . . . . . . . . . @ @ . . @ @ . . . . . . . . . . @ . . . . @ . . . . . . . @ @ . . . . . @ . . . . . . @ @ . @ . @ @ . . . . . . . . . @ . . . . . @ @ . . . . . @ . @ @ . . . @ . . . . @ . . . . @
@ @ . . . @ . . . . . . . @ . . . . . . . @ @ . . @ . . . . . @ @ . . . @ . . . . @ . . . . @ . . . . @ . . @ . . @ . . . . @ . @ . . . . . . . . . @ . . . . . . @ . . . . . . @ . . . . . . . . @ . @
@ . . @ @ . . . . . . @ . . . . . . @ @ . . . . . @ @ . . . . . . . . . . . . . . . . . . . . . . . . . . . . . @ . . . . @ . . . @ @ . . @ . . @ . . . . . . . . . . . . . . @ . . . . @ @ . . . . @ @
@ . . . . @ . . . @ . @ . @ . @ . . @ . . . . . . . . @ . . . . . . . . . . . . . . . . @ . . . . . . @ . . . @ . @ . . @ @ . . . @ . . . . . . . . . . . . . . . . @ . . . . @ . @ . . . . @ . . . . @
@ @ . . . . . . . . . . . . . . . . . . . . . @ . . . @ . . . . . . . . . . . . @ . . @ . . . . . . . . @ @ . @ . . . . . . . . . @ . . . . . . @ . . . . . @ . . @ . . . . . . . . . . . . @ . @ @ . @
@ . . . . . @ . . . . @ . . @ @ . . . @ . . @ . . . . . . . . . . . @ . . . . . . . . . . @ @ . . . . . . . . @ . . . . . . . . . . . . . . . . . . . . . . @ . . . . . . . . . . @ . . . . . @ @ . @ @
@ . . . . @ . . . . . . . . . . . . . . @ . . . . . . . . . . . @ . . . . . @ . @ . . . . . . . . @ @ . . . . @ . . . @ . . . . . . . . @ . . . . . . @ . . . @ . . . . @ . . . . @ @ @ . . . . . . . @
@ . . . . . @ . @ . . . . . . @ . . . @ @ . . . . @ @ . . . . @ @ . . . . @ . @ @ . @ . . @ . . . . . . . @ . . . @ . . . @ @ . . . . . @ . . . . . @ . @ @ . . . . @ . @ . . . . . . . . . . . . . . @
@ . . . . . . . . @ . . . . . . @ . . . . . . . @ . . . . . @ . . . @ . . . . . @ . . . . . . . @ . @ . @ . . . @ . . . . . . . . . . @ @ . . @ . @ . . . . @ . . . . @ . @ . @ @ . @ . . . . . @ . . @
@ . . . . @ . . . . @ @ . . . . . . . . . @ . . . . . . . . . . . . . . . . @ . . . . . . . . . . . . . . @ . . . . . . . @ . @ . @ . . . . @ . @ . @ . . @ @ @ . . @ . . @ . . . . . . . . . . . . . @
@ . . . . . . . . . . . . . . . @ . . . . . . . . @ . . . . . @ . . . . . @ . . @ . . . . . . @ . . . @ . @ . . @ . @ . . @ . . . . . . . . @ . . . @ . @ . . . . . . . . . @ . @ . @ . . . . . . @ . @
@ . . . . . . . . . @ . . . @ . @ . . . . . . @ . . . . . . @ . . . . . @ . . . . @ @ . @ . @ . . . . . . . . @ . . . . @ . @ . . . . @ @ . . . . . @ . . . . . . . . . . . @ . . . . . . . . @ . . . @
@ . . . . . . @ . . . @ . . . . @ . @ . . . . . . . . . . . . . . . . . . . . @ . . @ . . . . . . . @ . . @ @ . . . . . . . . @ . . . . . . . . . . . @ @ . . @ . . . . . . . . . . . @ . . . . . @ . @
@ . . . . @ @ . . . . . . . . . . . . . . . @ . @ . . . . . @ . . . @ . @ . . . . . . @ . . . . . @ . . . . @ @ . . . . . @ . . @ . . . . . @ . @ . . . @ . . . . . . . . . . @ @ . . . @ . . . . . @ @
@ . . . . . . . . . . . . @ . . @ . . . . @ . . . . . . . @ . . . . . . . . . . @ . . . . . . @ . . . . . @ . @ . . . . . . @ . . . . . . . . . . . . . . . . . . . @ . . . . @ . . @ . . . . . . . . @
@ . . . . . . @ . . . . . . @ . . . . @ . @ . . . . . . @ . . . . @ . . . @ . . . . . @ . . . @ . @ . . . . @ . @ . . @ . . . . . @ . . . . @ . . . . . . @ . @ . @ . . . . . . . . . . . . . . @ @ . @
@ @ . @ @ @ . . . . @ . . . . . . . . . . . . . @ @ . . . @ @ . . . @ . . . . . . @ . . . . . . . . @ . . . @ . . . . @ . @ . . . . @ @ . . . . . . @ . . @ . . . . . . . @ . . . . @ . . . . . . . @ @
@ . . . . . @ . . . @ . @ . . . @ . @ . . @ . . @ . . . . . . . . @ . . . . . . . . . . . . . . @ . . @ . . . . . . @ . . . . . . . . . . . . @ . . . . . . . . @ . . @ . . . . . @ . @ . . @ . . . . @
@ . . . . . . . . . . @ . . @ . . . . . . @ . . . . . . . . . . . . @ . . . . . . . @ . . . @ . . . @ . . . . @ @ . . @ . . . . . . . . . . . . @ . . . . @ . . . . . . @ . . . . @ . . . . . . . . . @
@ @ . . . . @ . . . . . . . . . . . . . . . @ @ . . . . . . . . . . . @ . . . . @ @ . . . . . . @ . . . . . . . . . . @ @ . . . . . @ . @ . . . . . . . . . @ . . . @ . . . . @ . . . . . . . . @ @ . @
@ . . . . @ . . . @ @ . @ . . . . . @ . . @ . . . @ . . . . . . . . . @ . . @ @ . @ . . . . . . . . . . . @ . . . . . . @ . . . @ @ . @ . . @ . @ . . . . . . . . @ @ . . @ . . @ . @ . . . @ @ . . . @
@ . . @ . . . . . . . . . . . . . . . . @ . . . . . @ . . @ . . . @ . . . . . . . . . . . . . . . . @ . @ . @ . . . . @ . . . . . . . . . . . . . . . . . @ . @ . . . . . . . . . . . . . . . . . . @ @
@ . @ . . . . @ @ . @ . . . . @ . . @ @ . . . . . . . @ . . . . @ . . . . . . . . . . . . . @ . . . . . . . . . . . . . . . . . . . . . . . . . @ . . . . . . . . . . . . . @ @ . . . . . . . . . . . @
@ . . @ . . . . @ @ . . . . @ . . @ @ . . @ . . . . @ . . @ . . . . . . . . . . . . @ . . . . . . . @ . . . @ @ @ . . . . . . . . . . . . . . . @ @ @ . . . . @ . . @ . . . @ . . @ . . . . . . @ @ . @
@ . . . . . . . . @ . . @ . . @ . . . . . . . . . @ . . . . . . . . . @ . . . . . . . . . . . @ . . @ . @ . . . . @ . . . . . . . @ . . . . @ @ . . . . @ . . . . . @ . . @ . @ . . . . @ . . . . . . @
@ . . . . . . . . @ @ . . . . . . @ . . @ . . . . @ . . . . . . . . . . . . . . @ . . . . . . . @ . . . . . . . . . . . . @ . @ . . . @ . . @ . @ . . . . . . . . @ . . @ . . . . . . . . . . . . . . @
@ . . . . . @ . @ . . @ . @ . . . . @ . . . . . . . @ . . @ . . . . . . . . . . . . @ . . @ . . . . . @ . . . . . . @ . . . . . @ . @ @ @ @ . . . . . . @ . @ . . . . . . @ . @ . @ . . . . . @ @ . @ @
@ . @ . . . . . . . . . . @ . . . . @ . . . . @ . . . . . . . @ @ . . . . . . . . . . . . . @ . . . @ . . . . . . . . . . . . . . . . . @ . . . @ . . . . . . @ . @ . . @ . . . @ @ . . @ . . @ . . . @
@ . @ . . . . . . . . . . . . . @ . @ @ . . . . @ @ . . . @ @ . . @ . . . . @ @ . . . @ . . . . . . . @ @ . . . . . . . . @ . . . . . . . @ . . . . . . @ . @ . . . . . . . . @ . . . . . . . . @ . . @
@ . . . . . . @ . . . . . @ . . @ . . @ . . . . . . . . @ . . . . @ . . . . . . . . . . . . . . . . . . . . . . . . . . @ . . @ . . . . . . . . . . . . . . . . @ . . . @ . . . . . . . . @ . @ . . . @
@ @ . @ . @ . . . . . . . . . . . . . . . . . @ . . . . . . . . . . @ . . . . @ . @ . . . . . . . @ @ . . . . @ . . . . . . . . . @ . @ . . . . . . @ . . . . . . . . . . . . . . . @ . . . . @ @ . . @
@ . . . . . @ @ . . . @ @ . . . . . . @ . @ . . . . @ . . . . . @ . . . . . . . . @ @ @ . . . . . . . . . . . @ . . @ . . . . . . . . . . . . . . @ . @ . @ . . @ . @ @ . @ . . . @ . @ . . . . @ . . @
@ . . . . @ . . . . . . . . . . . . @ . @ . . . @ . . . @ . . @ . @ @ . . . . . . . . . @ . @ . . @ . . @ . . . @ . . . @ @ . . . . . . . . . . . . . . . . . . @ . . @ . . @ . . @ . . . . . . . @ . @
@ . . @ . . . . . . . . . . @ . . . . . . . . @ @ . . . . . . . . . . . @ . . . . . . . @ @ . . . @ . . . . @ . . . . @ . @ . . . . . @ . . . . . . @ . . @ . @ . @ . . @ . . . @ . . . . @ . . . . . @
@ . . . . @ . . . @ . . . . . . . . . @ . . . . . . . . . @ . . . . . . . . . @ . . . @ . . . . . @ . . @ . . . . @ . . . @ . . . . . . . . . . . @ . . . . . . . . . . . . . @ . . @ . . . . . . . . @
@ . . . @ . . . @ . . @ @ . . . . . . . . . . . @ . . . @ @ @ . . . . . @ . . . . @ . . . . . . . . . . . . . @ . . . . . . . . . . @ . . @ . . @ . @ @ . . . . . . . . . . . . . . . @ . . . . . . . @
@ . . . . . . @ . . @ . . . . . . . . . . @ . @ . . . . . . . . . @ . . . . . @ . . . . . . . . . . . . . . . . . . . . . . . . @ . . . . @ . @ . . . @ . @ . @ . . @ . . . @ @ . . . . @ . . . . @ @ @
@ @ . . . @ . . . @ . . . . . . . . . . . . @ . . . . . . . . . . @ . . . . . @ . . . . . . @ . . . . . . . . @ . @ . . . . . . @ . . @ . . . . . @ . . . @ . . . . @ @ . . . . @ . . @ . @ . . @ @ . @
@ . . . . . . . @ @ . . @ @ . @ . . . . @ . . . @ . @ . @ . . . . . . . . . . . @ . . @ . . @ . . . . . @ . . @ . . . . @ @ . . . . . . . @ . . . . . . . . . . . . . . . . . . . . @ . . . . . . . . @
@ @ . @ . . @ @ . @ . @ . @ . @ . . @ . @ @ . . . . . . . . . . . . . . @ . . @ . . . . . . . . . @ . . . . . . @ . . . . . . . . . . . . . . . . . . . . . . . . @ . . . . . . . . . . . . . . . . . @
@ . . . . . . . . . . . . @ . . . . @ @ . . . . . . . . @ . . . . . . . . . . . . @ . . . . . @ . . . . . @ . . . . . . . . @ . . @ . . . . . . . @ . . . . . @ . . @ . @ . . . . @ @ . @ . . . . @ . @
@ . . @ . . . . . . . @ . @ . @ . @ . . @ . @ . . . . . @ @ . . . . . . . . . . @ . . @ . . . @ @ . . . . . . . . @ . . . @ . . @ . . . . . @ . . . . @ . . . . . . . . . . . . . . . @ . . . . @ . @ @
@ . @ . . . . . @ . . . @ . . . . . @ . @ . . . . . . . . . . . . . . . . @ . . . . . . . @ . . . . . . @ . . . @ . @ . . . . . . . . . . . . @ . @ . . . . . . . . . . . @ @ . . . . . . @ . . . . @ @
@ . . . . . . @ . @ @ @ . . . . . . . . . @ . . . . . . . . . @ @ . . . . . . @ . . . @ @ . . . . . . . . @ . @ . . . . . . @ @ . @ . @ . . . . . . . . . . . . . . . . . . . . @ . . @ . . . . @ . . @
@ . . @ . . . . . @ @ . @ . @ . . . . @ . . @ @ . . . . . @ @ @ . . . . . . . . @ . . . . . . . . . @ . . . . . . . . . . . . . @ @ . . . @ . @ . . . . @ . @ . . . . @ . . . @ . . @ @ . @ . . . @ . @
@ . @ . . @ . @ @ . . . . @ @ @ . . . . . @ . . @ @ . . . . . . . @ @ . . . . . . . @ . . . . . @ . . @ . . . . . . . . . @ . @ . @ . . . . . . . . . . . @ . . . @ . @ . @ . . . @ . . @ @ . . . . . @
@ . @ . . . . . . . . . . . . . . . . . . @ @ . . @ . . . @ . . . . . @ . . . . . . . . . @ . . . . . . . . . . . . . . @ . . . . @ . . . . . . . @ . . . @ . . @ . . . . @ . @ . @ . . @ . . @ . . . @
@ . . . . . . . . @ . . . . . . . . . . . @ . . . . @ . . . . . @ . . . . . . @ . . . . . . @ . . . . . @ . . . . . . . . @ . . . . . . . . . . . . . . . . . . . . . . @ . . . . . . . . . . . @ . @ @
@ . . . . @ . . . . @ @ . . @ . @ . . . . . . . . @ . . . . . . . . . . . @ . . . . . . . . . @ . . . . . . @ @ . @ . . @ . . @ . @ . . . @ . . . . . . @ . . . . . . . . . . @ . . @ . . . @ . . . . @
@ . . . . . . . . . . . . @ . . . . . . . . . . . . . . . . . . @ . . . @ . . @ . . . @ . . . . . . . . . . . . . . . . . . . . . . . . . @ . . . . . . . . . . . . . . . . @ @ . @ . . . . . . . @ . @
@ . . . . @ . . . . . . . . . . . . . . @ . . . @ . . . @ . . . . . . @ . . . . . . . . . . . . @ . . @ . . . @ . . @ @ @ . @ . @ . . . . . . . . . @ . . . . . @ . . . . . . . . . . . . . . @ . . . @
@ . . . . . . . . . . @ . . . . @ . . . @ . @ @ . . . . . @ . . . . . . @ . . . . . . @ . @ . . . . . . . . . . . . . @ . . . @ . . . . . . . @ . @ . @ . @ @ . . . @ . @ @ . @ . . . @ . . . . . @ @ @
@ . . . . . . . @ . . . . . . . . . . . @ . . . @ . . @ . . . . @ . @ . . . . . . @ . . @ . @ . . . . . . . . . . . @ . . . @ . . @ . @ @ . . . . . . . . . . . . . . . . . . . . . . . . . . . . . . @
@ . . . . @ . . . . . . . . . @ . . . . @ . @ . . . . . . . . @ . . . . . . . . . . . . @ @ . . . . . . . . . . . . . . @ . . . . . . @ . . @ @ . . @ . . . . @ . @ @ . . . . . . . . . . @ . . . . . @
@ @ . . . . . . . @ . @ . . . . . . . . . . . @ . . . . @ . . . @ . @ . . . . @ . @ . . . . . . . . . @ . . . . . @ . . @ . @ . @ @ . . @ . @ . . . . @ . . . . . . . . . @ . . . . . . @ . @ . . . . @
@ . . @ . . @ @ . . . . . . . . . . . . @ . . . . . . . @ . . . . . . . @ . . . . @ . . . . . @ @ . . @ . @ . . @ . @ . . . . . . . @ . . . . . . . . . @ . @ . . . . @ . . . @ @ . . . @ . . @ . . . @
@ . . . @ . @ . . @ . . . @ . . . . . @ . @ . . . . . @ . @ . . . . . @ . . @ . . . . . . . . . @ . . . . . . . . . . . . . @ . . @ . . . . . . . . . . . . @ @ . . . . . . . @ . . . @ . . . . . @ . @
@ . . . . @ . @ . . . . @ . . . . . . . . @ . . @ . . @ . @ . @ . @ . . . @ . . . @ . . . @ . . @ . . . . @ . . @ . . . . . . @ . . @ . . @ @ . . . . . . . . . @ . @ . @ . . @ . . . . . . . . @ . . @
@ @ @ . @ . . . . . @ @ . . . . . . . . @ . . @ . . . . . . . . . @ @ . . . @ @ . . . . @ . . @ . @ . . . . . . . . . . . @ . . . . . . . . . @ . . . . . @ . . @ . . . @ . . . . . . . @ @ . . . . . @
@ . . . . . . . . . . . . . @ . . . . @ . @ . . . . @ @ @ . . @ . . . . . . . . . . . . . @ @ . . . . @ . . . @ . . . . . @ @ . . . @ . . . . . @ . . . . . . . . . . . . . . @ . . @ . . . . . . . @ @
@ . . . . . . . . . . @ . . . . . . @ . . . . @ . . . . . . . @ . @ . . . . . . @ . . . . . . . . . . @ . . . @ . @ . . . . . . . . . @ . . @ . . @ . @ . . . . @ . . . @ . . . . . . . . . @ . . . . @
@ @ . . . . @ . . . . . . . . . . . . . . @ . . @ . @ . . . . . @ . . @ @ . . . @ . . . @ . . . . . . . @ . . . . . . @ @ . . . . . . . @ . . . . . . . . . . . . . @ . . . @ . . . . @ . @ . . . @ . @
@ . . . . . . . . . @ . . . . . @ . . . @ . @ @ . . . . . . . . . . . . . . . . . . . @ . . . . . . . @ . . . . . . @ @ . . . . . . . . . @ . . @ @ . @ . . . . . . . . . . . . . . . . . . @ @ . . . @
@ . . . . . . . . @ @ . . @ . . . . . . . . . @ @ @ . @ . . . . . . . @ . @ . @ @ . . @ @ . . . . @ . . . . . . @ . . . . . . . @ . . @ . . @ . . . . @ . . . @ . . @ . . . . . . . . @ . @ . . @ . . @
@ @ . . . . @ . . . . . . @ @ . . . . . . @ . . . . . . . . . . . . @ . @ . . . . . . . . @ . . . . . . . . . . . . @ . . . . . . @ . . . . . . . . . . @ . . @ . . @ . . . @ . . . . @ . @ . @ . . . @
@ . . . . . @ . . @ . . . . . . @ . . . . @ . . @ . . . . . . . . . . . . . . . @ . @ . . @ . . @ . . . . . . . . . . @ . . . . @ . . . . . @ . @ . . @ . . . . . . . . @ . @ . . . . . . . . . . @ . @
@ . . . @ . @ . . . . . @ . . @ . @ . . @ . . . . . . . . . . . @ . . @ . . @ . . . . . . . @ . . . . . . . . @ . . . @ . @ . . . . . . @ . . . . . . . @ . . . . . @ . . . . . . . . . @ . . . . . . @
@ @ . . . . . . . . . . . . . . . . . @ . . @ . . . . . @ . . . . . . . . @ . . . . . . . . . . . @ . @ . @ . . . . @ . . . . @ . . @ . . . @ @ . . . . @ @ . . . . . . . . . . . . . . . @ @ @ . . . @
@ . . . . @ . . . @ . . . . . . . . . . . @ . . . . . . . . . . . . @ . . . . @ . . . @ . @ . @ . . @ . @ . . . @ . . . . . . . . . . . . . . . . . . . . . . . . . . @ . @ . . . . . . . . . . . . . @
@ . . . . . . @ . . . @ . . . . . . . . . . . . . . . . @ . . . . . . . @ . . . . . . . @ . . . . . @ @ . . . @ @ . @ . . . . . @ @ . . @ . . . . . . . . . . . . . . . @ . . . . . . @ . . . . @ . . @
@ @ @ @ @ @ @ @ @ @ @ @ @ @ @ @ @ @ @ @ @ @ @ @ @ @ @ @ @ @ @ @ @ @ @ @ @ @ @ @ @ @ @ @ @ @ @ @ @ @ @ @ @ @ @ @ @ @ @ @ @ @ @ @ @ @ @ @ @ @ @ @ @ @ @ @ @ @ @ @ @ @ @ @ @ @ @ @ @ @ @ @ @ @ @ @ @ @ @ @
3
32 30 46 14
89 64 19 27
6 64 73 8
