50 50
@ @ @ @ @ @ @ @ @ @ @ @ @ @ @ @ @ @ @ @ @ @ @ @ @ @ @ @ @ @ @ @ @ @ @ @ @ @ @ @ @ @ @ @ @ @ @ @ @ @
@ . . . . . . @ . @ . . . . . . . . . . . @ @ @ . . @ . . @ @ . . . . @ . @ . . @ . . . . @ . . . @
@ . . . . . . . . . . . . . . . @ . . . . . . . . . . . . . . . . . . . @ . . . . . @ . . . . . . @
@ . . . @ . . . . . . . . . . . . @ . . . . . . . . . . . . . . . . . . . . . @ . . . . @ . . @ . @
@ @ . . . . . . @ . . . . . . . @ . . @ . . @ . . @ . . . @ . . . . . . . . @ . @ . . @ . . . . . @
@ . @ . . . @ . . . . . @ . . . . @ . . @ . . @ @ . . . . . . . . . . . . . . . . . . . . . . . . @
@ . . @ . @ . . . . . . . . . . @ . . . . @ . . . . . . . . . . @ . . . . . . . . . @ . . . . @ . @
@ . . . . . . @ . . . . . @ . . . . . @ . . . . . . . . . . @ . . @ . . . . . . . . . . . . . . . @
@ . . . . . . . @ . . @ . . @ @ . . . . . . @ . . @ . @ . . . . . . . . . . . . . . @ . @ . . . . @
@ . . . . . . . @ @ . . . . @ @ . @ . . . . @ . . @ . . @ . . . @ . . . . . . . . . . @ @ . . . . @
@ . . @ . . . . . . . @ . . . . . . . . . @ . . . . . . . . . . @ . . . . . @ . . @ . . @ . . @ . @
@ . . . . . . . . @ . . . . . . . @ . . . . . . . . @ . . . . @ . . . @ . . . . @ . @ . @ . . . @ @
@ . . . . . . . . . . . . . @ . . . @ . @ @ . . @ . . . . . @ . @ . . @ . . . . . . . @ . . . . . @
@ @ . . . . . @ . . . . @ @ . @ . . @ . . . . . . . . . . . . @ . @ . . . . . @ . . . . @ . . . . @
@ . . @ . . . . . @ . @ . . . . . @ . . . . . . . @ . @ . . . . . . . . . @ . . . @ . @ . . . . . @
@ . . . . @ . . . @ . . . . @ . @ . . . @ . . . . . . . . @ . . . . . . . . @ . . . . . . . . . . @
@ . . . . . @ . @ . . . . . @ . . . . . . . @ . . . . . . . . @ . . . . @ @ . . . . . @ @ . @ @ . @
@ . . . . @ . @ @ . . @ . @ . . @ @ . . . . . . . . . @ @ . . . . . . @ . . . . @ . @ @ . . . . . @
@ @ . . . @ . . @ . . . . . . . . @ . . . @ @ . . @ @ @ . . @ @ . . . @ . . . . @ . . . . . @ @ . @
@ . . . . . . . . . . . . @ . . . . . . . . . . . . . . @ . . @ . . . . . @ . . . . . . @ . @ . . @
@ . @ . . . @ @ . . . @ . . . . . . . . . . . . . . . @ . @ . @ @ . . . . . @ . . @ . . . . . . . @
@ . . . @ . . . . . @ . . . . . @ . . . . . . @ . . @ . . @ . . . @ . . . . . . . . . . @ . . . . @
@ . @ . . . . . . . . @ @ . . . . @ @ . . @ . . . . . . . . . . . . . . . @ . . . . . . . . . . . @
@ . @ . . . . . . @ . . . . @ . . . @ . . . . . . . . . @ . @ . . @ . . . . . . . . . @ . . . @ @ @
@ . . . . . . . @ . . . . . . . @ . . . . . . . . . . . @ . . . . . @ @ . @ . @ . . . . . . . . . @
@ . . . . . . . . @ . . . . @ @ . . . @ . . . . @ . . . . . . . @ . . . . . @ @ . . @ . . . . . . @
@ . . . @ . . . . . . . @ @ @ . . . . @ @ . . @ . . . . . . . @ . . . . @ . . . . . . @ . . . . . @
@ . . @ . . . . . . . . . . . . @ @ . . . . . @ . . . @ . . . . @ . . . . . . . . @ . @ @ . . . . @
@ @ . . . . . . @ . . . . @ @ . . . . . . . . . @ @ . . . @ . . . . . . @ @ @ . . . . @ . . . . . @
@ . . . . . . @ . . . @ . @ . . . . @ . . . . . @ . . . . . . . . . . . . . . @ . @ . . . . . . . @
@ . . . . @ @ . . . . @ . . . . @ . . . . . . . . . . . . . . . . . . @ @ . . . . . . . . . . . . @
@ @ . . @ . @ . . @ @ . . . @ . . . . @ . . . @ . . . . . . . @ @ . @ . . . . . . . . . @ . . @ . @
@ . . . . . . . . . . . @ . @ @ . . . . . . . . . . . . . . . @ @ . . . @ . . . . . . . . . @ . @ @
@ . @ . . . @ . @ . @ . . . . . . . . . . . . . . @ . . . . . . . . . . . . . . . @ . . . . . . . @
@ . . . . . . . . . . @ . . . . . . . . . . @ @ @ . . . . @ . . . . . . . . @ . . . . @ . . . @ . @
@ . @ @ . @ . . . . . . . . . . . . . . . @ . . . @ . . . . . . . @ . . . . . . @ . . . . . . . @ @
@ . . @ . . . . . . . . . . . . . @ . @ . . . . @ . . @ . . . . @ . . @ . . . . . @ @ . @ @ . . @ @
@ . . . @ . . . . . . . @ . . . . . . . . . . . . @ . . . . . . . . . . . . . . . . . . . . . @ . @
@ @ @ @ @ . . . @ @ . . . @ . . . . @ . . . . . . . . . . . . . @ . . @ @ . . . . @ . . . . @ . . @
@ . . . . . @ . @ . . . . . . . . . . . . . . . . @ . @ @ @ . . . . . . . . . . @ . . . . . . . . @
@ . . . . @ . . . . . . @ . . @ . . . . . . . . . @ . . . @ . . @ . . @ . . . . @ . . . . . @ . . @
@ . . . . . . . . . . @ . . . . . @ . . . . . . @ . . . . . . . @ . . . @ . . . . . . . . . @ . . @
@ . . . . . @ . . . . @ @ . . . . . . . . @ . . . . @ . . . . . . . . . . . @ . . . . . . . . . @ @
@ . @ . . . @ . . . @ . . @ . . @ . . . . . . . . . @ . @ . . . . . . . @ . . . . . . . . . . . . @
@ @ . . @ @ . . . . . . . . @ . . . . . . . . @ . . . . @ . @ @ . . . . . . . . @ . . . . . . . @ @
@ . . . . . . . . . @ . @ . . . . . . . . . . . . . . @ . . . . @ . . . . . . . . @ . . . . . . @ @
@ . . . . . . . . . . . . @ . . . . . . . . . . . . . . . @ . @ @ . . . . @ . @ . . . . . . . . . @
@ . . . . . . . @ . . . . . . @ . @ . @ @ . . . . . @ . @ . . . . . . @ . . . . . . . @ . @ . . . @
@ . . . @ . . . . . . . . . . . . . @ . . . . . . . . . . . . @ . . . . . . . . . . @ . . . . . . @
@ @ @ @ @ @ @ @ @ @ @ @ @ @ @ @ @ @ @ @ @ @ @ @ @ @ @ @ @ @ @ @ @ @ @ @ @ @ @ @ @ @ @ @ @ @ @ @ @ @
3
25 3 13 47
4 32 29 30
28 26 6 18
