100 100
@ @ @ @ @ @ @ @ @ @ @ @ @ @ @ @ @ @ @ @ @ @ @ @ @ @ @ @ @ @ @ @ @ @ @ @ @ @ @ @ @ @ @ @ @ @ @ @ @ @ @ @ @ @ @ @ @ @ @ @ @ @ @ @ @ @ @ @ @ @ @ @ @ @ @ @ @ @ @ @ @ @ @ @ @ @ @ @ @ @ @ @ @ @ @ @ @ @ @ @
@ . . . @ . . . . . . . . . . . . . . . . @ . . @ . . @ . . . . . . . . . . . . . . . . @ . @ . . . . @ @ . . @ . . . . . . . . . . . . . . . . . . . . . . . . @ . . . . . . @ . @ . . . . . . . . @ @
@ @ . . . . . . . @ . . . . . . @ . . . @ . . . . . @ . @ . . . . . . . . . . @ @ . . @ . . . . . . . . . . . . . . . . . . @ @ . @ . @ @ . . . @ . @ . @ . . . . . . . . . . . . . @ @ . . . . . @ . @
@ . @ . @ . . . . . . . . @ . . . . @ . @ . . @ . . . . . . . . . . . . . . . . . . . . . . . @ . . . . . . @ . . . . . . . @ . . . . @ . . . . . @ . . . . . . . @ . . . . . @ . . . . . . . . . . @ @
@ . @ . @ . . . . . . . . . . . . . . . @ @ @ . . . @ . @ . @ . . . . . @ @ . . @ . @ . . . @ . . @ . @ . . . . . . . . . . . . . . . . @ . . . . . . . . . @ @ @ . . . . @ . . . . . . . . . . . . . @
@ . . . . @ . . . . . . . . . @ . . . . . . . . . . . . @ @ . . . . . . . . . . . . . . . . . . @ . . . @ . . . . . . @ @ . . @ . . . . . . . @ . . . @ . . . . . . @ . @ . . . . . . . . . . @ . . . @
@ @ . . @ . . . . . . . . . . . . . . . . . . . . . . . . . . . . @ . . . . . . . . @ . . . . @ . @ . . . @ . @ . . . . . . . . @ . @ . . . . . . @ . . . @ . . . @ . . . . . . . . . . . . . . . . . @
@ . . . . . . . . . @ . . . . . . . . . @ . @ . . @ . . . . . . . . . . @ . . @ . . . . . . . . @ . . . . . . . . . @ . . . @ . . . . . @ . @ . . @ . . . . . . . . . . . . . . . . . . . . . . . . . @
@ . . . . . . . @ . . . . . . @ . . . . . . . . . . . @ . . . . @ . . @ . . . . . . . @ @ . . . @ @ . . @ . . @ . . . @ . @ . @ @ . @ . . @ . . . . . . . . . @ @ . . . . . . . @ . . . . . . @ . . . @
@ @ . . . . . . @ . . @ @ @ . @ . @ . . . . . . . . . . . . . @ . . . . @ . @ . @ . . . . @ . @ . @ . @ . @ . . . . . . . . . . . . . . . . . @ . @ . @ . . . . . . . . . . @ . . . . @ . . . @ . . . @
@ . . . . . . . . @ . . . . . . . . . . @ . . . . @ . @ @ . . . . . . . . . @ @ . . @ . . @ . . @ . . . . . . @ . @ . . . . . . . . . @ . . . @ . . @ . . @ . . . . . @ . . . . . . . . . . . @ . . . @
@ . . . . . @ @ . . . . . . @ . . @ . . @ . . @ . @ @ . . . . . . . . @ . @ . . @ . . . . . @ . . . . . . . . . . . . . . . . . . . . @ . . . . @ . . @ . @ . . . . . . . . . . . . . . @ . . . . . . @
@ . . . @ @ . . . . . . @ . . . @ . . . @ . . @ . . . . . . . . . . . . . . . . . @ @ . . . @ . . . @ . . . @ . . . . . . . . . . @ . . . . . . . . . @ . . @ . . @ . . @ . . . . . . . . . . @ @ . . @
@ . . . . . @ @ . @ . . . . . . . . . . . . . . @ . . . . . . . . @ . . @ . . . . . . @ . . . . . . . . . . . . . . . . @ . . . @ . . @ . . @ . . . . . . . . @ . . . @ . . . . . . . @ @ . . . @ . . @
@ . . . . . . . . . @ @ . . . . . . . . @ . . @ . . . . @ . . . @ . . . @ . . @ @ . @ . . . . . . . . @ . . . . . @ . . . . . . . . . . . . . . . . @ . . @ . . @ . . . . . . . . . . . . . . . . . . @
@ @ . . . . @ . . . . @ . @ . @ . . . . . @ . . . @ . . . @ . . . . . . . . . @ . . @ . . . @ . . . . . . . @ . . . . . . . . . . . . @ . . . . . . . . . . . . . @ . @ . . . . . . . . . . . . . . @ @
@ . @ . . @ . . @ . . . . . . . . . @ . . . . . @ . . . @ . @ @ . @ . . . . @ @ . @ . . . @ . @ . . @ . . . @ . . . . . . . . . . . @ . . @ . . . . . @ . @ . . . . . . . @ . @ . . . . . @ . . . . . @
@ . . . . . . . . @ . @ . . . . @ @ . . @ @ . . . . . . . . . @ . . . . @ @ . . . @ . . . . . . . . @ @ @ . @ . . . . . . @ . . . . . @ . @ . . . . @ . . . @ . . . . . . . . . . . . . . . @ . . . . @
@ . . . . . @ . . @ . . . . . @ . . . . . . @ . . . . . . . . . . . . . . @ . @ . . @ . . . . . . . . . . @ @ . @ . . . . . @ @ . . . . @ . @ . . . . @ . @ . @ . @ . . @ . . . . @ @ . . . . @ . . . @
@ . @ @ . . @ . . . . . . . . . . @ . @ . . . . . . . . . . . . . . . . . . @ @ . . . . . @ . @ . . . . . . . . . . . . . @ . . @ . . . . @ . . . @ . . @ . . . . . . . . . . . @ @ . . @ . @ . @ . . @
@ . . . @ . . @ . . . . . @ . . . @ . . . . . . . . . . . . @ . . . . . . . . . @ @ . . @ . . . . . @ . . . . . . . . . . . . . . . @ . . . @ @ . . . @ . . . . . @ @ . @ . . . . . . . . . . @ . @ . @
@ . . @ . . . . . . . . . . . . . @ . . . . . . . @ @ . @ . . . . . . . . @ . . . @ . . . . . @ . . . . . . . . . @ @ . @ . . . . @ . . @ . @ . . . @ . . . @ . . . . . . @ @ @ . . . . . . . . . . . @
@ . . . @ . . . . . . . . . @ . . . . . @ . . . . . . @ . @ . . . . . @ . . . . . . @ . @ . . . . . . @ . . . @ @ . . @ . . . @ . . . . . . . . . . . . . . . @ . . . . . . . . . . . . . . . . . . . @
@ . @ . . . . . @ . . @ . . . @ . @ . @ . . . @ . . . . . . @ . . . . . . . . @ . . @ . . . . . @ @ . @ . . . . . . . . . . . . . @ . . . . . . @ . . . . . @ @ . . @ @ . . . . . . . . . . . . . . . @
@ . @ . . . @ . . . . . . . @ . . @ . . @ @ . . . . @ @ . @ . . . @ . @ @ . . . . @ . . . . . @ @ . . . . . . . . @ @ . . @ . @ @ . . . @ . . . . . . . @ . . @ . . . . . . @ . . . . . . . . . . . . @
@ . . . . @ . . @ . @ @ . . . . . . . . . . @ . . . . . @ . @ . . . . . . @ . . . . . @ . . . @ . . . . . @ . . . . . . . @ . . . @ . . . . . . . . . @ . . . . . . @ . . . . . . . . . . . . . . . . @
@ . . @ . . . . . @ . . . . . . . . . @ . . @ . . . . . @ . . @ . @ . . . . . . . . . . . . . . . @ . . . . . . . . @ . . . . @ . . @ @ . . . . . . . . . . . . . . . @ . . @ . . . @ . . . . . @ . . @
@ @ @ . . @ . @ . . @ . . . . . @ . @ . . @ . . . . @ . . . @ . . . . . . . . . . . . . @ . . . @ @ @ . @ . @ . . . . . . . @ . . . . . . . @ @ . . @ . . . @ . . @ . @ . . @ . . . @ . . . . . . . . @
@ . . . . @ . . . . . . . . . . . @ . . . . . . @ . . . @ . . @ . . . . . @ . @ . @ . @ . . @ . . . . . . @ . . . . @ . . . @ . . @ . . . . . . . @ . @ . . . @ . . @ . @ . . . . . . . . . . @ @ . . @
@ . . . . . . . . @ . . . @ . . . . . . @ . @ . . . . . . . @ . . @ . . @ . . . . . . . . @ . @ . . . . . . . @ . . . . . . @ . @ . @ . . . . . @ . . . . @ . . . . @ @ . . . . . . . . @ . . . @ @ . @
@ @ . @ . . @ . . . . @ @ @ . . . @ . . . @ . . . . . @ . . . . . . . @ . . . . . . . @ . . . @ . . . . . . . . @ . . . . . . . . . . . . . . @ . . . . @ @ @ @ . . @ . . . . . . @ . . . @ . . . . . @
@ @ @ . @ . @ . . . . . . . . . @ . @ . . . . . . . . . . @ . . . . . . . . . @ @ . . . . @ . . @ @ . . . . . . . . . . . . . . . . . . @ . @ . . @ . . . @ . @ @ . . @ . . @ . @ . . . @ . . @ . . . @
@ . @ . @ . . . . . @ . . . . @ . . . @ . . . . . @ . . . @ . @ . . . . @ @ . @ @ . . @ . . . . . . . @ @ . @ . . . . . . . . @ . @ . . . . . . . . @ . . . . @ . . . . @ . . . . . . . . . @ @ . . . @
@ . . . @ . @ . @ . . @ . @ . . . . @ . @ . . @ . . . . . . . . . @ . . @ . . @ . @ . . . . . . . . @ . . . . . . . . . . . . . @ . . . @ . . @ . . . . . @ . . . . . . . @ . . . @ @ . . . . . . . . @
@ . . . . . . @ . . . . @ . . . . . . . . @ . @ . . . . . . . . . . . @ . . . . . @ . . . . . . @ . . @ . . . . . . . . . . . . . . . . . . . . . . . . . . . . . . . . . . . . . . . @ . @ . . . @ . @
@ . . . . @ . . . . . . . . . . @ . . . . . @ . . . @ . . @ @ . @ @ . . . . . . . . @ @ . . . . . . . . . @ . . . @ . . . @ . @ . . @ . . . . . . @ . . . . . @ @ . . . . . . . @ . . . . @ . . . . . @
@ . . . . . . . . . . . . . . . . . . . @ . . . . . . @ . . . @ . . . . @ . . . . . . . . . . . . . . @ . . . . . . . . . . . . . . . . @ . . . . . @ @ . . @ . . . . . . . @ . . . . . . . . @ @ . . @
@ @ . . . . . @ @ @ . . . @ . . . . . . . @ . . . . . . @ . . . . @ @ . @ . . @ . @ . . . @ . . . . . @ . . . @ . . . . . @ . . @ . . @ . @ @ . @ @ . . . . . . . . . . . . . . . . . . @ . . . . . . @
@ . . @ @ . . . . @ . @ @ . @ @ @ . . @ . @ . . . . . . . . . . @ . . . @ . . . . . . . . . . @ . @ . . @ @ . . @ . . . . . . . @ . . @ . . . . . . @ . . . @ @ . . . . . @ . . . . . . . . . @ . @ . @
@ . @ . . . . . . . . . @ @ . . . @ . @ . . . @ . . . . . . . . . @ . . . . . . . . . @ . . . @ . . . @ . . . . . . . . @ . . . . @ . . @ . @ . . . . @ @ @ . . . @ . . . . . . @ . . . . . . . @ . . @
@ . . . . @ . . . @ . . . . . . . . . . . . @ . . . . @ . . . . . . . . . . . . . . . . . . . . . . . . . @ . . . . . . . . . . . . . . . @ . . . @ . . @ @ @ . . @ . . @ . . . . . . . . . . . . . @ @
@ . @ . @ . . @ . . . . . . . . . . . @ . @ . . . @ . . . . @ . . . . . . . . . . @ . @ . . @ @ . . . . . . @ . . . @ @ . . . @ . . . . . . . @ @ . @ . @ . . @ . . . . . . . . . . @ . . . . . . . . @
@ @ . . . . . . @ . . . . . . . . . . . . . . . . @ . . @ . @ . . . . @ . . @ . . . . . . . @ . . . . . . . . . . . . . . . . . . . . . . . . . . . . . . . . @ . @ . . . . . @ . . . . @ . . . . @ @ @
@ . . . . . @ . . . . . . . @ . . . . . . . . @ @ . . . . . . . . . . . @ . . . . @ @ . . . . @ @ @ . . . . . @ . . @ . @ . . . . @ . @ @ . . . . . . . . . . . . . @ . . @ @ . . . . . . . . . @ . . @
@ . . . . . . . . . . . @ . . . . . . . . @ @ . @ . . @ . . . . . . . . . . . @ . . @ . . . @ @ . . . . @ . . @ . @ . . . . . . . . . . . @ . . . . . . . . . . . . . . . . . @ @ . . . @ . . . . . . @
@ . . . . . . @ . . . . . @ . . . . . . . . . . . . @ . . @ . . @ @ . . . . @ . @ . . @ . . @ . . @ . @ . . . . . . . @ . . @ . . . . . . . . . . . . . . @ . . @ @ . . . . . . . . @ . @ . . . . . . @
@ . . . @ . . . . . . . @ . . . . @ . . . . . @ @ . . @ . . . . @ . . . . . . . . . . . . . . . . . @ . @ . . . . @ . . . . . @ . . . . . @ . . @ . . . @ . . . . @ . . @ . @ . . @ . . . . . @ . . . @
@ . . . . . . . . . . . . . . . . . . . . . . . . . . . . . . @ . @ . . @ . @ . . . . . . @ @ . . . . . . . . . . . . . . . @ . . . . @ . . . . . . . . . @ . . @ . . @ @ . . @ . . . . . . . . . . . @
@ . . . . . . . . . . . @ . . . . . . . @ . @ . . @ @ . . . . . . . . . . @ . . . . . . . @ . . . . . . . . . @ . . @ . . @ . . @ . . . . . . . . . . . . . . . @ . @ . . . @ . @ . . . . . . . @ . . @
@ . . . . . . . . @ . @ . . . . @ . @ . . . . . . . . . . . . @ @ @ . . . @ . . @ . . . @ . . . . @ . . . @ . . . . . . . . . . . . . . . . . @ . . . . . @ . . . . . @ . . @ . . . . . . . . . . . . @
@ . . . . . @ . @ . . @ . . . . . . . . . . @ . . . @ . @ . . . . . . . . . . @ @ . . . @ . . @ . . . @ . . . . . . @ . . . . . @ . . . . . . @ . . . . . @ @ @ . . . . . @ . . . . . @ . . @ . . . @ @
@ . @ . . . . . . . . . . @ . . @ @ . . @ . . . . @ . . @ . . . . . . @ . . . @ . @ @ . @ . . @ . . . . . @ . . . . . . . . @ . . . . @ . . . . . . . . . . . . . . . . . @ . . . . @ . . . . @ . . . @
@ . @ @ . . . . . . . . . . . . . @ . . . @ . @ . . . . . . . . @ @ . @ @ . . . . . . @ . . . . @ . . @ . . . . . . . . . . . . . . @ @ . . . . . . . . . @ . @ @ . . . @ . . . . . . @ . . . . . . . @
@ . . . @ . . @ . . @ . . . . . @ . . . . . . . @ . @ . . . . . . . @ . . . @ @ @ . . . . . . . . . . . . @ @ @ @ . . . @ . . . . . . . @ . . . . . . . . @ @ . . . . . @ . . . . . @ . @ . . @ . . @ @
@ . . @ . . @ . . @ . @ . . . . . . @ . @ @ . . . . . . . . . @ . . . . . @ . . . . @ . . . . . . . . @ . . . . . . . . . . . @ . . . . . . . . . . . . . . . @ . @ . @ . @ . . . . @ . @ . . . @ . . @
@ . . . . @ . @ . @ . . . @ . . . . . @ . . . . . . . . . . . . . @ . . . @ @ . . . . . . . . . . . . . . . . . @ . . . . . . . . . . @ . . . . @ . @ @ . . . . . . @ . @ . . . @ . . @ . @ . . @ . . @
@ . . . . . . @ . . . . . @ . . @ . . . @ . . . . . . @ @ . . . . . @ @ . . . . . . . . . . @ @ . . . . . . . @ . @ @ . . . . . @ . . . . . . . . . . . @ . . . . . . @ @ . . @ . . . . . . @ . . @ . @
@ . . @ . . @ . @ . . . . . @ . . . @ @ . . @ . . @ . . . . . . @ @ . . . . . . . . . . . . @ . . @ @ @ . . . . . . . . . . @ . . . . @ . @ . @ . . . . . . . . . @ . . . . . . . . . . . . . . . . . @
@ . . . @ . . . . . . @ . . . . @ @ @ . . . @ @ . . . . . . . . @ @ . . . . @ . . . . . @ @ . @ . . . @ . . @ . . . @ @ . . . . . . @ . . . . . @ . @ . . . . . . . @ . . @ . @ . . . @ . @ . . . . . @
@ . . . . . . . . @ . @ . . . @ . @ . . @ @ @ @ . . . . @ . @ @ . . . . . . . . . . @ . . . . . . . . . . . . . . @ . . @ . @ . . . . . @ . @ . . . . . . . . . . . . . . . . . . . . . . . . . . . @ @
@ . . . . . . . . @ . . . . . . . . . . @ @ @ . . . . . . . . @ @ @ . . @ . . . @ . . . . . . . @ . . @ . . . . . . . @ . . . . . . . . . . . . . . @ . . . . . @ @ . @ @ . @ @ . . . . . . . . @ . . @
@ . . @ . . . . @ . . . . . . . @ . @ @ . . . @ . . @ . . . . . . . . . . . . . . . . . . . . . . . . . . . . . @ . . . @ . . . . . . . @ . . . @ . . . . . @ . . . . @ . @ . . . . . . @ . . @ . . . @
@ . . . . @ . . . @ . . @ . . . @ @ . . . . . . . . . . . @ . . . . @ . @ . . . . @ . . . @ . . . . . . . @ @ . @ . . . . . . . . @ @ . . . . . . . @ . @ . . . . . @ . . @ . . . . . . . . . . . @ . @
@ . . . . . . . . . . . . @ . . . @ . . . . . . . . . . . . . @ . . . . . . @ @ . . . . . . . @ . . . @ . . . @ . . @ . . . . . . @ . @ . . . @ @ . @ . . . . . . . @ @ . . . . @ . . . . . @ @ . . . @
@ . @ . . . . @ . . @ . . @ . @ . . . @ . @ . . . . . . . @ . . . @ . . . @ . @ . . . . . . . . . . . . . . @ . . . . @ . . . . @ @ @ . @ . . . @ . . . . . . . @ . . . . . . . . @ . . . . . . @ . . @
@ . . . . . @ . . . . . . . . @ . . . . . . . . . . . @ . . . . . . @ . . . . . . . @ . . @ @ . @ . . . . . . . @ @ . . . . @ . @ . . @ . . . . . @ . . . @ . . . . . @ . @ . . . . . . . @ . @ . . . @
@ . @ . . @ . @ . . @ . . . . . . . @ . . . . . . . . . . . . @ . @ . . . . . . . . . @ . . . . . . . @ . . . . . . @ . . . . . @ @ . . . . . . . . . . . @ . . . . . . . . . @ . @ . . . . . . @ . . @
@ . . @ @ . . . . . . . @ . . . . @ . . . @ . . . @ . . . . @ @ . . . . . . . . . . @ . . . . . . . . . . @ . . @ . . . @ . . . . . . . . . @ . . . . . . . @ . . @ . . @ . @ . . . @ @ . . . . . . @ @
@ . . . . @ . . . . . . . @ . . . . @ . . . . . . . . . . . . . . . . . . @ . . @ @ . . . . . . . . . . . . . @ . . . . . . . . . @ . . . . . . @ . . . . . . . @ . . @ . . . . . . . . . . . @ . . . @
@ . . . . . . . @ . @ . @ . . @ . . . . . . @ . . @ . . . . . . . . . . . . @ . @ . @ . . . . . . . @ . . @ . . . @ . . . . . . . . . @ . . . . . . @ . . . . @ @ . @ . . . . @ . @ . . . @ . . @ . . @
@ . @ . . . . . . . . . . . . . @ @ . . . @ . . . . @ @ . . . @ . . . @ . . . . . . . @ . . . @ . @ . . @ . @ . . . . @ . . . . @ . . @ . . . . . . . . @ @ . . . . . . . @ @ . @ . @ . . . . @ . @ . @
@ . . . . . @ . @ . . . @ @ . . . . . . . . . . . . . . . . . . . . . . . . . @ . @ . . . . . . . . . . . . @ . . . . @ . . . . . . . . @ . . @ . @ . . @ . @ . . . . @ . . . @ . . . . @ . . . @ . @ @
@ @ . . . . . . . . . . . @ . . @ . . . . . . . . . . . @ . . @ . . . @ . . @ . . @ . . . . @ . . . . . . . . . . . . . @ . . @ . . . . @ . . . . . . @ . . . . . . . . . . . . @ @ . @ . . . . . . . @
@ . . @ . . . . . . @ . . . . . . . . . . . . . . . . . . . . . @ @ . @ . . . @ . . . . . . . . . . . . . . @ . . . @ . . @ @ . . . . . . . . @ . . . @ @ . . . . . . . . . . @ . @ . . @ @ . . @ . . @
@ . @ . . @ . . . . @ . . . . . . . . . @ . . @ . . . . . . . @ . . . @ . . . @ . @ . . @ . . . . . . . . . . . @ . . . . @ . . . . . @ . . @ . . . . . . @ . . @ . . @ . . . @ . @ . . . . @ . . . . @
@ . . . . . . . @ . . @ . . . . . . . . @ . @ @ . . . . . . . . . @ . . . . . . @ . . . @ . . . . . @ @ . . @ @ . . . @ . . @ @ @ . @ . . . . @ . . . . . . . . @ . . . . @ . . . . . . . . @ . . . @ @
@ . . @ . . . @ @ . . . . @ @ @ . . . . . . . . . . . @ . . . . . . . . . . . . @ . . . @ @ . . . . . . . @ . . . . . . . @ . . . . . @ . . . . . @ . . . @ . . . . . . @ . . . . . @ . . . . . . @ . @
@ . . . . @ . . . . . . @ . . . . . @ . . . @ . . . . . @ . . . @ . . . . . @ . . @ . . . . . . @ . . @ . . . . . . . . @ . . @ . . . . . @ . @ . . . . . . @ . . . . . . . . @ . @ . . @ . @ . . . . @
@ . @ . . . @ . . . . . . . . . . . . . @ . . . . . . . . @ . . @ . . . . . . . . . . . . . . . . . . . . . @ . . . @ . . . . . . . . . . . . @ . . . @ . . . . . @ . . . . . . . . @ . . @ . . @ . . @
@ . . . @ . @ . @ . . @ . . . . . . . . . . . . . . . . . . @ @ . @ . . . . @ . . . . . @ . @ . @ . . . . @ . . . . . . . . . . . @ . . . . . . @ @ . . . . . . . . . . @ . . . . @ . . @ . . . . @ . @
@ . . . . . . . @ . @ . . . . . . . @ . . . . @ . @ . . . @ . @ . @ . . . . . . . . . . . @ . . @ . . . . . . . . . . . . . . . @ . @ . . . . . . @ . . @ @ . . . . . @ . . . @ . . @ . @ @ . . . . . @
@ . . . @ @ @ . . @ @ . . @ @ . . . . . . . @ @ . . . @ . . @ . . . . . . . . @ . . . . @ . @ . @ . . . . . . @ . @ . . @ . . . @ . . . . @ . . . @ . . @ . . . . . @ . . . @ . @ . . . . @ . . . @ @ @
@ . . . . . . . . . . @ @ . . . . . . . @ . . . . . . . . . . . . . . . . @ . . . @ @ . . @ . . . @ . . . . . . . . . . . . @ @ . . . . . . . . @ . . . . . @ @ . . . @ . . . . . . . . . . . . . @ . @
@ @ . @ . . . @ . @ . @ @ . @ . . . . . @ . . . . . . . . @ @ . @ . . @ . @ . . . . . . @ . @ . . . @ . . . . . . . . . . . . . . . . . . @ . . . . . . . @ . . . . . . . . . . @ . . . . . . . @ @ . @
@ . . . . . . . . . . . . . . . . . . . . @ . . . @ . . . . @ . . @ @ @ . . . . . @ . . @ . . . . . . . @ . . . @ . @ . . . . . . . . @ . . @ . @ @ . @ . @ @ @ . @ . . @ . . . @ . . . @ . . . . . @ @
@ . @ . . @ . . . . @ @ . . . @ @ . . @ . . . . . . @ . @ . @ . . . . . . . . @ . . . . @ @ @ . @ . @ . @ @ @ . . . . @ @ . . @ . . . . . . . . . . . @ . . . . . . . . . . @ . @ . . . . . @ . . @ . @
@ . . . . . @ . . . . . @ @ @ . . . . . . . . . . . . . . . @ . . @ . . . . . . . . @ . . . . @ . @ . . . . . . . . . . . @ . . . @ . @ . . . . . . . . . . . @ . . @ @ . . . . . . . @ . @ . . . . @ @
@ . . @ . . @ . @ @ . . @ @ . . . @ @ . . . . . @ @ . . . . . @ @ . . . . . . . . @ . . . . . @ . . . . . @ . . . . . . . . . . . . . . . @ . . . . . @ @ . . . . . . . . . . . . . . @ . . @ . . @ . @
@ . . @ . . . . . . . . . . . . . @ . . . . . @ . . . . @ @ . . . . @ . . . @ . . . . . . . . . . @ @ . @ . . . . . @ . @ @ . . . . . . . . . . . . . . . . . . . @ . . @ . . . . . . . @ . . . . . . @
@ . . . . . . @ @ . . . @ . @ @ . @ @ . . . . . . . . @ . . . . . . . . . . @ @ . . . @ . . . . . @ . . . . . . . . . . . . . . . . . . . . . . . . . . . @ @ . . . . . . . . . . . . . . . . . . . . @
@ @ @ . . . . . @ . . @ . . . . . . . . . . @ . @ . . @ . . @ . @ . . . . @ . . @ @ . . @ . . . . @ . . . . @ . . @ . . . . . @ . @ . @ . . @ . . . . . . . . . . . @ . @ . @ . . . @ @ . . . . . . . @
@ . . . . . . . . . . @ . . @ . . . @ @ . . . . @ . . . . . . . . . @ . . @ . . . @ . . . . . . . . . . . @ . . . . . . . . . . . . . . . . . @ . . @ . . . . @ . . @ @ . . . . . . . . . @ . @ . . . @
@ . . @ . @ . . . . . . @ . . . . . . . . . . . . . @ . . @ . @ . . . . . . @ . . . @ . . . . . . . @ . . @ . . . . . . . . . . @ . . . . . . . . . . . . . @ . . . . . . @ . . @ . . . . . . . . . . @
@ @ . . . . . . . . . . . . . . @ . . . . @ . . . @ @ . . . . . . @ . . . @ . . . . . . . . . . . . . . . . @ . . . . . @ . . @ @ . . . . . . . . . . . @ . . . @ . . @ . . . . @ . . . . . . . @ . . @
@ . @ . @ . . . @ . . . . . . . . . . . . . . . . . . @ . . . . . . . . . . . . . . . @ . . . . . . . . . . . . . . @ . . . . . . . . . @ . . . . . . @ . . . . . . . . . @ . . . . . . . @ . . . . . @
@ . @ @ . @ . . . . . . . . . . . . . @ . . . @ . @ . . . @ . . @ . . @ . . . . . . . . . . @ . . @ @ . . @ . . . . . . . @ . @ . . . . . . @ . . @ . . @ . . @ . . . . . . . . . . . . @ . . @ . . . @
@ . . . @ . . . @ . . @ . . . . . . @ . . . . . . . . . . . . @ . . . . . . @ . @ @ . @ . @ @ . . . . . . . . . . . . . . . @ . . @ @ . . . @ . . . . . . . . . . . . . @ . . . . . @ . @ . . . . . @ @
@ @ . . . . . . . @ . . . . . . . . . . . . . . . @ @ . . . . . @ . . . . @ . . . . . . @ . . . . . . . @ . @ . . . . . . . . . . . . . . . . . . . . . . . @ . . . @ . . . . . @ . . . . . . @ . . @ @
@ . . . . . . @ . . . . . @ . . . . . . @ . . @ . . . @ . . . . . . . . @ @ . @ . @ . . . . . . @ . . . . . . . @ . . . . . . . . . @ . . . . . . @ . . . . . . . @ @ . . . . . . . . @ . . . . . @ . @
@ @ @ @ @ @ @ @ @ @ @ @ @ @ @ @ @ @ @ @ @ @ @ @ @ @ @ @ @ @ @ @ @ @ @ @ @ @ @ @ @ @ @ @ @ @ @ @ @ @ @ @ @ @ @ @ @ @ @ @ @ @ @ @ @ @ @ @ @ @ @ @ @ @ @ @ @ @ @ @ @ @ @ @ @ @ @ @ @ @ @ @ @ @ @ @ @ @ @ @
3
97 12 7 23
6 82 69 9
90 10 16 32
