25 25
@ @ @ @ @ @ @ @ @ @ @ @ @ @ @ @ @ @ @ @ @ @ @ @ @
@ . . . . . @ . @ @ @ . . . . . @ . . @ . . @ . @
@ . . . . . . . . . . . . . . @ @ . . . . . @ . @
@ . @ . @ . . @ . . . . . . . . . . @ . . . . . @
@ . . . . . . . . @ . . . . @ . . . . . . . . . @
@ . . @ . . . . . . @ . . . . . . . . @ . . . . @
@ @ . . . . . . . . . . . . . @ . @ . . @ @ . . @
@ . . . . . . . . @ . @ . . . . . @ . . . . . . @
@ . @ . . . @ . . . @ . . . . @ . . . . . . . @ @
@ . @ . @ . . . . . . . . . . . . . . . @ . . . @
@ . @ . . . @ @ @ . . . @ . . . . . @ . . . . . @
@ . . . . . @ . . . . . . @ @ . . @ . . . @ . . @
@ . . . . . . . . @ @ @ . . @ . . @ . . . . . . @
@ @ . . @ . . . . . . . . . . . . . @ . . . . . @
@ . . @ . . @ . . . . . @ . . @ . . . . . . . . @
@ . . . . . . . . . @ . . @ . @ . . @ . . . . @ @
@ . . . . @ . . @ . . . . @ . @ . . @ . @ . . . @
@ @ . @ @ @ . . . . @ . . . @ . . @ . . . . . . @
@ . . . . @ . . . . . . @ . . . . @ . @ . . . . @
@ . . . . . @ . . . . . @ . . . . . . @ . . . . @
@ . . . . . . . . . . . . . . . . . . . . . . . @
@ . . . . @ @ . . . @ . . . . . . . . . . . . . @
@ . . . @ @ . . . . . . . . @ . . . . . . . . . @
@ . . . . . . . . . . . . . . . @ . . . . . . . @
@ @ @ @ @ @ @ @ @ @ @ @ @ @ @ @ @ @ @ @ @ @ @ @ @
3
13 5 23 7
3 22 20 18
4 13 4 18
