25 25
@ @ @ @ @ @ @ @ @ @ @ @ @ @ @ @ @ @ @ @ @ @ @ @ @
@ . . . . . . . . . . . . . . . @ @ . @ . . . . @
@ . . . . . . . . . @ . @ . . @ . . . . . . . . @
@ . . @ . . . . . . . . @ . . . . . @ . . . . @ @
@ . . . . . . . . . . @ . @ . @ . . @ . . . @ . @
@ . . . . . . . . . . @ . . . . @ . . . . . . . @
@ @ . . @ . . . . . . . @ . . . . . @ . . . @ . @
@ . . . . . . . . . . . . . @ . . . @ . . . . . @
@ @ . . @ . . . . . . @ . . . . . . . . @ . . . @
@ @ . . . . . . . . . . @ . . @ . . . . . @ . . @
@ . . . @ . . @ . . . . @ . . . . @ . . . @ . . @
@ . . . . . . . . . . . . . . @ . . . . . . @ . @
@ . . @ . . @ . . . @ . . . @ . . . @ . @ . . . @
@ @ . . . . @ . . . . . @ . . . . @ . . . @ . . @
@ . . . . . . . . . . . . . . . . @ . . . . . . @
@ @ . . . . @ @ . . @ . @ . . . @ . . . . . . . @
@ . @ . @ . . . . . . @ . . . @ . . @ . . . . . @
@ . . . . . . . . . . @ . . . @ @ @ . @ . . . . @
@ . . . . @ . . . . . . . . . @ . . . . @ . . @ @
@ . . @ . . . . . . . . . @ . . @ . @ . . @ . . @
@ . . @ . . . . . . . @ . . . @ . . . . . . . . @
@ . . . . . . . . . . . . . . . . . . . . . @ . @
@ . . @ . . . . . @ . @ . . . . . . . @ . . . . @
@ . . . . . . . . . @ . . @ . . . @ . . . . . . @
@ @ @ @ @ @ @ @ @ @ @ @ @ @ @ @ @ @ @ @ @ @ @ @ @
3
3 1 8 6
6 3 10 20
13 8 12 16
