12 12
@ @ @ @ @ @ @ @ @ @ @ @
@ . . . . @ . . . . . @
@ @ . . . . . @ . . . @
@ @ . . . @ . . . @ . @
@ . . . . @ . . . . . @
@ . @ . @ . . . . . . @
@ . . . . . . . . . . @
@ . . . @ . . @ . . . @
@ . . . @ . . . . . . @
@ . . @ . . . @ . . . @
@ . . . @ . . . . @ . @
@ @ @ @ @ @ @ @ @ @ @ @
3
4 2 10 5
5 7 6 2
6 6 6 8
