12 12
@ @ @ @ @ @ @ @ @ @ @ @
@ . @ . . @ . . . . . @
@ . @ @ . . . . . . . @
@ @ . @ . . . . . . . @
@ @ . . . . . . . . . @
@ . @ . . @ . . . . . @
@ . . @ . . . . . . . @
@ . . . . @ . . . . . @
@ . . @ . . . . . . @ @
@ . . . . . . @ . . . @
@ . . . . . . . . . . @
@ @ @ @ @ @ @ @ @ @ @ @
3
10 1 4 8
9 4 9 9
10 4 6 9
