25 25
@ @ @ @ @ @ @ @ @ @ @ @ @ @ @ @ @ @ @ @ @ @ @ @ @
@ . . . . . @ . @ . . . @ . @ @ . @ . . @ . . . @
@ @ . . . . . . . . . @ . . . . . . @ . @ . . . @
@ . . . . . . . . . . @ . . . . . . . . . . . . @
@ @ . @ . . @ @ @ . . . . . . @ . . . . . . . . @
@ . . . . . . . . . @ . . @ . . @ . . @ . . . . @
@ . . @ . . . . @ . . @ . . . . . . . . . . . . @
@ . . @ . . @ @ . . . @ . . . @ . . . @ . @ . . @
@ . . . . @ . . . @ . . . @ @ . . . @ . . . . . @
@ . . . @ . . . @ . @ . . . . . @ . . . . . . @ @
@ . . . . . . . . . . @ . . . . . @ . . . . @ . @
@ . . . . . . . @ @ . . . . @ . @ @ . . . . . . @
@ . . . . . . @ @ . . . . . . . . . . . . @ @ . @
@ @ . . . . . . . . . . . . . . . . . . . . . . @
@ . . . . . . . . . . . . . . . . . . @ @ . . . @
@ . @ . . . . . @ . . . . . . . . . . . @ . . . @
@ . . . . . @ . . . . . . . @ . . . . . . @ @ @ @
@ . . . . . . . . . . . @ . . @ . . . @ . . . . @
@ . . . . . @ @ . . . . @ . . @ . @ . . . . . . @
@ @ . . . . . . @ . . . @ . @ @ . . . . . . @ . @
@ . . @ . . . . . . . . . . . . . @ . . . . . . @
@ . @ . . . . . @ . . @ . . . . . . @ . . . @ . @
@ . . . . @ . . . . . . . @ . . . . . @ . . @ @ @
@ . . . @ . . . . . . . @ . . @ . @ . . @ @ . . @
@ @ @ @ @ @ @ @ @ @ @ @ @ @ @ @ @ @ @ @ @ @ @ @ @
3
16 4 7 12
5 23 22 10
16 3 14 7
