50 50
@ @ @ @ @ @ @ @ @ @ @ @ @ @ @ @ @ @ @ @ @ @ @ @ @ @ @ @ @ @ @ @ @ @ @ @ @ @ @ @ @ @ @ @ @ @ @ @ @ @
@ . . . @ . . . @ . . . . . . . . . . . . . . . . . @ . . @ . . . . . . . . . . . . . . . . . . . @
@ . . . . @ . . . . . . . @ . . . . . . . @ . . . . . . . . . . . @ . @ . . . . . . . . . . . . @ @
@ . . . . . . . @ . . . . . . . . @ . . @ . @ @ . . . . . . . @ . . . @ . . . @ . . . . . . . . . @
@ . . . . . @ . . . . . . . . . . @ . . @ . . . @ . . . . . . . . @ @ . . . . . . . @ . . . @ . . @
@ . . . @ . . . . . . . . . . . . . . . . . . . . . . @ @ . . . @ . . . . . . . . @ . . . @ . @ . @
@ . @ . . . . . . . . . . . . . . . . . . . . @ . @ . . @ . . . . . . . . . . . . . . . . . . . . @
@ . @ . . . . . . . . @ . . . @ . . @ . @ . . . . . . . . . . . . @ . . . . . . . . . @ . . . . . @
@ . . . . @ . . . . . . . . . @ @ @ . . . . . . . . . @ @ . . @ . . . . . . . @ . . . . @ . @ . @ @
@ @ . . . . . . . . . . . . . . . . . . . @ . . . . . . . @ . . . @ . . @ @ . @ . . . . . @ @ . . @
@ . . . . . . . . . . . . @ . @ @ @ . @ . . . . @ . . . @ . @ . . . @ . . @ . . . . . @ . . . . . @
@ . @ . . . @ . . . . . . . . @ . . . . . . . . . . . @ . . . . . . . . . . . . . . @ . . @ @ . @ @
@ . . . . . . . . . . @ . . @ . @ . . . . . . . @ . @ . @ . . . . . . . . . @ . . . . . . . . . . @
@ @ @ . . . . . . . . . . . . . . . . . . . . . . . @ . . . @ . . . @ . @ . . . @ . . . . . . . . @
@ . . . . . . @ . . . . @ . . . . . . @ . @ . @ . . . . . . @ @ . . . . . . . . . @ @ . . . . . . @
@ . . @ @ @ . . @ . @ . @ . . . . . . . . . @ . . . . . . . . . . @ . . . . . . . . . @ @ . . . @ @
@ . . . . . . . . @ . . . @ . . . . . . . . . . @ . @ . . @ @ . . . . . . . . . . . . @ . . . . . @
@ @ . . . . @ . . @ . @ . . . . @ . . . . . . . . @ . . . . . @ . . . . . . . . @ . . . . . . . . @
@ . @ @ . . @ . . . . . . . . . . @ @ . . . . . . . . . . . . . . @ . @ . . . . @ . . @ . . . . . @
@ . @ . . @ . . . . . @ @ . . . . . . . @ @ . . . . . . . . @ . . . . . @ . . . . @ . . . . . . . @
@ . . . . . . . . . . . @ . @ . . . . . . . . . . . . @ . . . @ . . . . . . . . @ . . @ . . @ . . @
@ . @ . . . . @ . . . . . . . . . . . . . . . . . . . . . . @ . . . . . . . . . @ . . . . . . . . @
@ . . . . @ . . . . @ . . . . . @ . . . . . . . . . . . @ . . . @ . . . . @ @ . . @ . . . . . . @ @
@ . . . . . . @ . . . . . . . . . . . @ @ . . . . . . . . . . . . . . . @ . . @ . @ . . @ . . . . @
@ . . . . . . . . . . . . . @ . @ . . @ . . . . @ . . . @ . . @ @ . . . . . . @ . . . . . . . . . @
@ . . . @ . . . . . . . . . . @ . . . @ . . @ . . . . . . @ . . . . . . . @ . . @ . . . . . . . . @
@ . . . . . . . . . . . . . . @ . . . . . . . . . @ . @ . . . . . . @ @ . . . . . . . . . . @ . @ @
@ @ . . . @ . @ . . @ . . . . @ . . . @ . . . . . . @ . . . . . @ @ . . . . . @ . . . . @ @ . . . @
@ . . @ . . . . . . . . @ . . @ @ . @ . @ @ . . @ . . . . . . . @ . . . . . . . . . @ . . . . . . @
@ @ . . . . . . . . @ . @ . . @ . . . @ . . . . . . . @ . . . . . . . @ . . . @ . . . . . . . @ . @
@ . . @ . . . . @ . . @ @ . . . . . . . . . . @ . . . . . @ . . @ . . . . . . . . . . @ @ . @ . @ @
@ @ . . . . . @ . . . . @ . . . . @ . . . . . . . . . . . . . . . @ . . . . . . @ @ . . . . . . @ @
@ . . @ . . . . . . . . . . @ . . . . . . . . . . . . . . . . . . . . @ . . . . . @ . . @ . . . . @
@ . @ . . . . . . @ . . . @ @ . @ . . . . . . . @ @ . . . . . @ . . . . . . . . @ . . . . . @ . . @
@ . . . . . . . . . . . . @ . @ . . @ . @ . . . . . @ . . . @ . . . . @ . . @ . . @ . . . . . . . @
@ . @ . @ @ @ @ . . . . . . . . @ . @ . @ . . . . . . . @ . . . . @ . . @ @ . . . . . . @ . . . . @
@ . @ . . . . . @ . . . . @ . . . . . . @ . . . . . @ . @ . . . . @ @ . . . . . . . . . . . . . @ @
@ . . . . @ . . . . . . . . . . @ . @ . . . . . . . . @ . @ . . @ . . . . . . . @ . . . . . . . . @
@ @ . . @ . . . . . . . . @ . . @ . . . . . @ . @ @ . @ . . . . . @ . . . . @ @ . . . @ @ . . . @ @
@ . . . . @ @ . . . @ . . . . . . @ . . . . . @ . . . . . . . . . . . . . . @ . . . @ . @ . . . . @
@ @ . @ . . . . . @ @ @ . . @ . . . . . . . . . . . @ . @ . . . @ . . . . @ @ . . . . . . . . . . @
@ . . . . . . @ . . . @ . . . . @ . . . . . . . . . . . . @ @ . . . . . @ . . . . . . @ @ @ . . . @
@ . . @ . . . . . . . . . . @ . . . . . @ . @ . . . . . . . . . @ @ . @ . . . . . @ @ . . . . . . @
@ . . . . . . . . @ . . . . . . . . . . . @ . . . . . . . . . . . . . . . @ . @ . . . @ . . . . . @
@ . @ @ . . . . . . . . @ . . @ @ @ . . . . . . . @ . . . . . . . @ @ . . . . @ . @ . . . . . . . @
@ @ . . . . . @ . . . @ . . @ . @ . . . . . . . . . . . @ . . . . . . . . . . . . . . . . . . . . @
@ . @ . . . @ . . . . . . @ . @ . . . . . . . . @ . @ @ . . . . @ @ . . . . . . . . . @ . . . . . @
@ . . . . . . . @ . . . @ . . . . . . @ . . . . . . @ . . . @ . . . . . . . . . . . . . . . @ @ . @
@ . . . . . . . . . @ . . . . . . . . . @ . . . . . . . . . . . . . . @ . . . . @ . . @ . @ . . @ @
@ @ @ @ @ @ @ @ @ @ @ @ @ @ @ @ @ @ @ @ @ @ @ @ @ @ @ @ @ @ @ @ @ @ @ @ @ @ @ @ @ @ @ @ @ @ @ @ @ @
3
34 4 1 20
19 42 27 30
17 15 30 20
