100 100
@ @ @ @ @ @ @ @ @ @ @ @ @ @ @ @ @ @ @ @ @ @ @ @ @ @ @ @ @ @ @ @ @ @ @ @ @ @ @ @ @ @ @ @ @ @ @ @ @ @ @ @ @ @ @ @ @ @ @ @ @ @ @ @ @ @ @ @ @ @ @ @ @ @ @ @ @ @ @ @ @ @ @ @ @ @ @ @ @ @ @ @ @ @ @ @ @ @ @ @
@ @ . . @ . . @ . @ . . @ . . . . . . . . . . . . . @ . . . @ . . . . . . . @ . . . . . . @ . . . . . . . . . . . . . . . @ . . . . . . . @ . . . . @ . . . . . . . . @ . . . . . . . . . . . . . . . @
@ . . . . @ . . . . . . . . @ . . . . . . . . . . . . . . . . . . . @ . . . . . @ . . . @ @ . . . . . @ . . @ . . @ . . . . @ @ . . . . . . . . @ . . . @ . . . . @ . . . . . . . . @ . . . . . . . . @
@ . . . . . . . . . . . . @ . . . @ . . . @ . . . . . . . . . . . . . . . . . . . . @ . . . . . . . . . . . . . . . @ . @ . . . . . @ . . . . . . @ . . . . . . . . . @ . @ . @ . @ . . . @ . @ . @ . @
@ . . . . @ . @ . . . . . . @ . . . . . . . . @ @ . . . . . . @ . . @ . . @ . . . . . . . . . . . @ . . . . . . . @ . @ . . . @ . . . . . @ . . @ . . . . . . @ . . . @ . . . . . . . . . . . . . . . @
@ . @ . @ . . . . . @ . . . . . . . . . . . . @ . . . . @ . . . . . . . . . @ . . . . . @ . . . . @ . @ . . . . . . . . . @ . @ @ . . . . . . . @ @ . . . . . . . @ . . @ . . . . . @ . @ . . . . . . @
@ . . @ . . @ @ . . . . . . . . @ . . . . . . . . . @ . . . . . . . . . . . . . @ . . . . @ . @ @ . . . . @ @ . . . @ . . . . . . @ . @ . @ . . . . . . . . . . . @ . . . . @ . . @ . . . @ . . . . . @
@ . @ . . @ . @ @ . . @ @ . . @ @ . . . . . . . @ . . @ @ . . . . @ . . . . . . . . . . . . . . @ . . . @ . @ . . . . @ . . . @ . @ . . . . @ @ . . . @ @ @ . . . . . . @ . . . . . . . . . @ . . . . @
@ . @ . . @ . . @ . . . . @ @ . . @ . . . @ . . . . . . . . . . . . . @ . . . . . . . . . . @ . @ . . . . . . @ . . . . . . . . @ . . . . . . . . @ . @ . @ . . . . . . @ . . . . . . . . . @ @ . . @ @
@ . . . . . . . @ . . @ . . @ . . . @ . @ . . @ @ . . . . @ . . . . . . . . . . @ . . . . . . @ . . . . . @ . @ @ . . . . @ . . @ . . @ . . . . . . @ . . @ . . . . . . @ . . . . @ . @ . . . . . . . @
@ . . @ . . . @ @ . . . . @ . @ . . . . . @ . . . . . @ @ . . . . . @ . . . . . . . . . . . . . . . . . . . . . . . . . @ . . @ . . . . @ . . @ @ . . . . . . . . . . . . . @ . . . . . . . . . . . . @
@ . . . . @ . . . . . . . @ . @ . . . . . @ . . . . . . . . . @ . . @ . . . . . . . . @ . @ . . @ . . . @ . . . . . . . . . . . @ @ . . . @ @ @ . . . @ . . . @ . . . . . . . @ . . . . . . . . . . . @
@ @ @ . . . . . . . . . . . . . @ . . . @ . . . . . . . . @ @ . . . . . . . . . . . . . @ . . . . . . . . . . @ . @ . . . . . @ . . . . . . . . @ . . @ . @ . . . . . . . . @ . . . . . . . @ . . . . @
@ @ . . . . @ @ . @ . . . @ . . . . . @ . . @ . . . . . . . . @ . . . . . . . . . . . . . . @ . . . . . . @ @ . . . . . . @ . @ . . . . @ . . . . @ . . . . . . . . . . . @ . . . @ . . . . @ . @ @ . @
@ . . . . . . . . . . . . . . . . . . @ . . . . . @ . @ . . @ . . . . . . . . . . @ @ . @ . . @ @ . @ . @ . . @ . . . . . . @ . . @ . . . . . . . . . @ . @ . @ . @ . . . . @ . . . . . . . . @ . . @ @
@ @ . . . . @ . . . . . . . . . . . . @ . . @ . . . . . . . . . @ . . . . . @ @ . . @ @ . @ . . . . @ . @ . . . @ . @ . . . . . @ . @ . . @ . . . . . . . . . . @ . . . . . . . @ . . . . . @ . . . @ @
@ . . . @ . . . . @ . . . . . . . . . @ . . . . . . . . . . . . . . @ . . @ @ . . @ . . . @ @ . . . . . @ . . . @ . @ . . @ . . @ . . . . . . @ . @ . . . . @ . . @ . @ . . @ @ . . . . . . . . . . . @
@ @ . . . . . . . . . . @ . . . . . . . @ . . . @ . . . @ @ . . . @ . . . . . @ @ . . . @ . . . . . @ . . . . . @ . . . . @ . . . . . . . . . . . . . . @ . . . . . . . . . . . . . @ . @ . . . . . . @
@ . . . . . @ . @ . . @ . . . @ . . @ . . . . . . . @ . . . . . @ . . @ . . . . . . . . . @ @ . @ @ . @ @ . . @ . . . . @ . @ . . . @ . . . . . . . . . . @ . . . . @ . . . . . . . . @ . . . . . . . @
@ @ . . . . . . @ @ . . . . . . . . . . . . . . . . . . @ . . . . @ . . . . . . . . . . @ . . @ @ . @ . . . . . . . . . . . . @ . @ @ @ . . . . . . . . @ . . . . . @ . . . . . . . . . . @ . . . . @ @
@ . . . @ @ . . . . . . . . . . . . . . @ . . . . @ @ . . @ @ . . . @ . . . . . . . @ . . . @ . . . . . . . . . . . . . . . . . . . . . . @ . . @ . . . . . . . . @ . . @ @ . . . @ . @ . . . . . . . @
@ . . . . @ . . . . . . . @ . . . . @ . . . . . @ . @ . . . . @ . . . @ . . . @ . . . . @ . . @ . . . . @ . @ . . @ . . . @ @ . . @ . . . . . . . . . . . . @ @ . . . . @ . . . @ . . . . @ . @ @ . . @
@ . . @ . @ @ . . . . . . @ . . . . @ . . @ . . . . . . @ . . . . @ . . . . . . . @ . @ . . . . . @ . @ . . @ . . . . @ @ . . . . . @ . . . . . . . . . . . . . . . . . . . . @ . . . . . @ . . . . . @
@ . . . . . . . . . . @ . . @ . . . . . . . . @ . @ . . . . . . @ . . . . . . . . . . . . . . @ . @ . @ . . . . . . . . . . . @ . . . @ . . @ . . @ . @ . . . . @ . . . . @ . @ @ . @ . . . @ . . . . @
@ . @ . . . . @ . . . . . . . . . . . . . . @ . . @ . . . . @ . . . . @ . @ . . . . . . . . . . @ . . . @ . . . @ . . @ . . @ . @ . . . . @ . . . @ . @ . . . . @ . . . . . @ . . . . . @ . . . . . . @
@ . . . @ . . . . . . . . @ . . . @ . . . . . . @ . . @ . @ . @ . @ . . . . @ . . . @ @ . . @ . . . . . . . . . . . @ . . @ . . . . . . . . . . . . . . . . . . . . . . . . . . . . . . . @ . . . . . @
@ . . . . . . . . . . . . . . @ . . . . . @ @ . @ @ . . . . . @ . . . . . . . . . . . . . . . . . . . . . . . . @ . @ . . . @ . . . . . . @ . . . @ . . . . . . . . . . @ . . @ @ . . @ . . @ @ . . . @
@ . . . . . @ . @ . . @ . @ . . . . . . @ . . . . . . . . . . . . . @ . . . . @ . . @ . . . . . . . @ . . . @ . . @ . @ . @ @ . . @ . @ . @ @ . . . . @ @ . . @ @ . . . . @ . . . . @ . . @ . . . . . @
@ . @ @ . . . . . . . . . . @ . . . @ . @ . . . . . . . . . . . @ @ . . @ . . @ . @ @ . . . . @ . . @ @ @ . . . . . . . . . . . . . . . . . @ . . . . . @ . . . . . . . . . . . . . . @ . @ . . . . @ @
@ . . @ . . . . . . . . . . . . . . . . . . . . . . @ . @ . . . @ . . . . . . . . . @ . . . . . @ . @ . . . . . . @ . . . . . . . . . . . . . @ @ . . . . . . . . . . . . . . . . @ . @ . . . . . . . @
@ . . . . . . . . . . @ . . . @ @ . . @ . . . . . . . . @ @ . . . @ . . . . . . @ . . . . . @ . . . . @ . . . . . . . . @ . . @ . . . @ . . . . . . . . . . . . . . . . . . . . . @ . @ . . . . @ . . @
@ . @ . . . @ . . @ . . . . . @ . . . . . . . . . . . . @ . . . . . . . . . . . . . @ . . . . . . . . . @ . . . @ . . . . . @ . . . . . . . . . . . . @ . @ . . . @ @ . @ . . . . . . . . . . . . . . @
@ @ . . . . . . @ . . . . . . @ . . . . . . . . . . . . . @ . . . @ . . @ . . . . . . . @ . . . . . . . . . . . . . . @ . . . . . @ . . . . @ . . . . . . . . . . @ . . . @ . . . @ . . . @ . . . . . @
@ . . . . . @ . . . . . . . . . . @ . @ . . . . . . . . . . . . . . . . . . . . . . . . @ . . . . . . . @ . . . . . . . . . @ @ @ . . . . . . . @ . @ . @ . . . . @ . . . @ . . . . . . @ . . . . . @ @
@ . . . . . . @ @ . . . @ . . . @ . @ . . @ . . . . . @ . . . . @ . @ . . . . . . . . . . . . @ . . . . . . . . . . . . . . . @ . . . . . . @ . . . . . . . . @ . . . . . . . . @ . @ . . . . . . . . @
@ @ . . . . @ . . . . . . . . . . . . . . . . @ . . @ . . . . . . . . @ . @ . . . . . . . . @ . . . @ . . . . @ . . . . . . . . @ . @ . . @ . . . . . . . . @ . @ . @ . . . . @ . . . . . . @ @ . . . @
@ . @ . . . . . . . . . @ . . . @ . . . @ . @ . . . . . @ . . . . @ . . . . . @ @ . @ . @ . . @ . . . . . @ . . . . . . @ . @ . @ . . . . @ . . . . . . . @ . @ @ . . . . . . . . . . @ . . . . . . . @
@ @ . . . @ . . . . @ . . . . @ @ . @ . . @ . . . . . . . @ . . . @ . . . . @ . . . . @ . . . @ . . . . . . . . @ . @ . . . @ . . . @ . . . @ . . @ . . . . @ . . . . . . . @ @ . . . . . . . . . . . @
@ @ @ . . . . . . . . . . . . . . . . . @ . . @ . . . . . . . . . @ . @ @ . . . @ . . @ . @ . . . . . . . . @ . . @ . @ . . . . . . . . . @ . . . . . . @ . . @ . . . . . . . . . . @ . . . . . . . . @
@ . . @ . . . . . . . @ . . . @ . . . . @ . . . . @ . . @ . . . . . @ . . @ . . . . . . . @ . . . . @ . . . . . . . . . . @ @ . @ @ . . . . . . . . . @ . . . . . . @ . @ . . @ . . . . . . . . @ . . @
@ @ @ . @ . . . . . . @ . . @ . . . . . . . . . . . . @ . . . . . . . @ . . @ . . @ . . . . . @ . . . . . @ . . @ . . . . @ . @ . . . . . . . @ . . @ . @ . @ @ . . . . . @ @ . . . . . . . . . . . . @
@ @ . . . . . . . @ . . @ . . . . . . @ . @ . . . . . . @ . @ . . . @ . @ . . . . . . . . @ . . . @ . . @ . @ . . @ @ . . . . . . . . . . @ . . . . . . . @ . @ . . . @ @ . @ . . . @ . . @ . . @ . @ @
@ . . . . . @ . . @ . @ . . . . . @ . . . . . . . . @ . @ . . . . . . . @ . . . . . . . . . . . . . . . . @ . @ . . . . . @ . . . . @ @ @ . . . @ . . . . . @ . . . . . . . @ @ . . . . . . . . . @ . @
@ . @ . @ . @ . . . . . @ . . . . . . . . . . . . . . . . . @ . @ @ . . . . . . . . . . . . . . . . . . . . . . . . . . . . . . . . . . . @ . . . . . . @ . @ . @ . . . @ . . . . @ . . . . . . . @ . @
@ @ @ . . . . . @ . . . . . . . . . . . . . . . . . . . . . . . . . . . . . @ . . . . . . @ . . . . @ . . . . . . . . . @ @ . . @ . . . . @ . . . . . @ . @ . @ . . . . . . . @ . . . . . . . . . @ . @
@ . . . . . @ @ . . . . @ . . @ . . . . . @ . . . @ . . . . . @ . @ . @ . . . . . @ . . . . . . . . . . . . . . . . . . . . @ . . . @ . . . . . . @ . . . . . . . @ . @ . . @ . @ . . . . . . @ . . . @
@ . @ . . . . . . . . . . . . . . . . @ @ . . @ . . . . . . . @ @ . . @ @ . . . . . . . . @ @ . . . . . . @ . . . . @ . . . . @ @ @ . . . . . @ . . . . . . @ . . . . @ . . . . . . . @ . @ @ . . . @ @
@ . . . . . . . . . . . . . @ . . . . . . @ . @ @ . . . . . . . . @ . . @ . @ . @ . . . . . . @ . . . . . @ . . . . . . . . . . . . . . . @ @ @ . . . . . . . . . . . @ . . . @ @ . . @ . . . @ . . @ @
@ . . . . . . @ . . . . . . . . . . . . . . @ . . . . . . . . . . . . . . @ . . . . . . . @ . . . . . @ . . . . . . @ . . . . . . . . . . . @ . @ . . . . . . . @ . . . . . . . . . @ . . . . @ . @ . @
@ . . . . . @ . @ . . . . . . . . . . . . @ . . . . . . . @ . @ . @ . . . . . @ . . . @ . . . . . . . . @ @ . . . . . . . . . . . . . @ . @ . . . . . . @ . . . . . . . . @ . . . @ . . . @ . . @ . . @
@ . @ . @ . . @ . . . . . . . . . . . . . . @ . . . . . . . . . . . . @ . . . . . @ . . . . @ . @ @ . @ . . @ . . . . . . @ . . . . . . @ . . . @ . . @ . . . . . . . . @ . @ @ @ . . . . . . . . . . @
@ . . . . . . . @ . . . . . . . @ . . . . @ . @ @ . . @ . . . . . . . @ . . @ . . . . . . . . . . . . . @ . . . @ . . . . . . . . @ . . @ @ . . . . . . . . . . . . . @ . . . . . . . . . @ . . . . . @
@ . . . . . @ . . @ . @ . . . . . . . . . . . . . . . . . @ . @ . . @ . . @ . . . . . . . . . @ . . . @ . . . @ . . . . . . . . . . @ . . . . @ . . . @ . . @ . @ @ . . . . . . . @ . . . . @ . . . . @
@ @ . . . . . . . . @ . . . . @ . @ . @ . . . . . . . . . . @ . . . @ . . . . . . @ . @ . . . . . . . . . . . . . . . . . . . . @ @ . . . . . . . . @ . . . . @ . @ @ @ . @ . @ @ @ . . . @ . @ . @ . @
@ . . . . . . . . . . @ . . . . . . @ . . . @ . . . @ @ . @ . . . . . @ . . . . . . . . . . . . @ @ . . . . . . . . . @ . . . @ . . . . @ . . . . . @ . . . . . . . . . . . @ . @ . . @ . . @ . . . . @
@ . . . . . . . @ . . . . . . . . . @ . . . . @ @ . . . . . @ . . . . . . . . . . . @ @ . . @ . . @ . @ @ @ . . . . . . . . . @ . . . . . . . . . . . . . . . . . . . . . . @ @ @ . . . @ . . . . . @ @
@ @ . . . . . . . . . . . @ . @ . . . . . . @ . . . . . @ . . . @ . . . . . . . . @ . . . . . . . @ . . . @ @ @ . . . @ . @ @ . . . . . . . @ . . . . . . . . . @ . @ . . @ . . . @ . . . . . . . @ . @
@ @ . . . @ . . . @ . . . @ @ . @ . . . . @ @ @ . . . @ . . . . . . . . . . . @ . @ . . . . . . . @ . @ @ . . @ . @ . . . . . . . @ . . . . . . . . @ @ . . . . . . . . . . . . @ @ . @ . . . . . @ . @
@ . . . . . . @ @ @ . . . @ . . . . . . . . . @ . . . . @ . @ @ . . . . . . @ . . . . . . @ . . . . . . . . . . . . . . . . @ . @ . . . . . @ . . . @ . . . . . . . . . . @ . . . . . . . . . . . . . @
@ . . . @ . @ . . . . . . . . . . @ . . . . . . . . @ . . . . . . . . @ @ . @ @ . @ . . . . . . . @ . . @ @ . . . @ . . @ . @ . @ . . . . @ . . @ . . . . . . @ @ @ . . . . @ . . . . . . @ . @ . @ . @
@ . . @ . . . . . . . . @ . . . . . . . . @ . . . @ . . . . @ . @ . . . . @ @ . . . . . . . . . . . . @ . . . . . . . . . . . . . . . . . @ . . . . . . . @ . . . . . . . . . . . . . @ . . . . @ . . @
@ . . @ . . . . . @ @ . . @ . . @ . . . . . @ . . . . . . . . . . . . . . @ . . . . . . @ . . . . . @ . . . @ . . . . . . . . . . . @ . . . . . . @ . @ . . @ . . . . . . . . . @ . . @ . . . . . . . @
@ . . . . . . . . . . @ . . . @ . . . . @ . . . . . . . . . . . @ . . . . . . . . . . . . @ . . @ . . @ . . . . . . . . . . . . . . . . . . @ . @ . . @ . . @ . . @ . . @ . . @ . . . . . . . @ . . . @
@ . . . . . . . . . . . . @ @ . . . @ . @ . . . . . . . . . . . . . . . . . . . . . @ . . . . . . . . @ . . . @ . . . . . @ . . . . . . . . . @ . . @ . . @ . . . . . . @ . . . . . . . . . . . . . . @
@ . . @ . @ . . . @ . . . . . . . . @ . . . @ . . . . . . @ . @ @ @ . . . @ @ . . . . . . . . . . . . . @ . . . . . . @ . . . . . . . . . . . . . . . . @ . . @ . . . . . . . @ . . . . . . . @ . . @ @
@ . . . . . . . @ @ . . . . . . . @ . . . . . . @ . . @ @ . @ . . . . . @ . . @ . . . . @ . @ . . . . . . . . @ . . . @ . . @ @ . . . . . . @ . @ . . . . . . . . . . @ . . . @ . @ @ . @ . . . . @ . @
@ . . . . . . . . . . . . @ . . . . . . . @ . @ . . . . . . . . . . . . . @ . @ . . . . . . . . . . . . . . . . @ . . . . @ . . @ . . . . . . . . . @ . . . . . @ . . . . . . @ . . . @ . . . . . . . @
@ . . . . @ @ . . . . . . . . . . . . . . . . . @ . . . . . @ @ @ . . . . . . . . . . . @ . . . . . . . . . . . @ . . . . . . . . . . @ . . . . @ . . . . . . . . . . . . . @ . . . . . . . . @ . . . @
@ @ . @ . @ . . . . . . . @ . . . . . . . @ . . . . . @ . . . . . @ . . . . . . . . . . . . @ . . . . . . . . . . . . . . . . . . . . . . @ @ . . . @ . . . . . . . . . @ . . . @ . . . @ . . . @ . . @
@ . . . . . . @ @ . . . . . @ . . . . . . . @ . @ . . . . . . . . . . . . @ . . . @ . @ . . . . . . . . . . . . @ . . . . @ . . @ . . . . . . @ . . . @ . . . . @ . . . . . . . . . . . . . @ . . . . @
@ . . @ @ @ . @ . . . @ . . . @ . @ . . @ . . @ . @ . . . . . . . . . . . . . . . @ . . . @ . . . . @ . . @ . @ . . . . . . . . . . . . . . @ . @ . . . . . @ . @ . . @ . . . @ . . . . @ @ @ @ . . . @
@ @ . . . . . . @ @ . . . . . . . . . . . . . . . . . . . . @ . @ @ . @ . . . . . . . . @ . . . . . . . . . . . @ . . . @ . . . . . @ . . . . . . . . . . @ @ . . . . @ . . . . @ @ . . . . . . @ . . @
@ . . . @ . . . . . . . . @ . . . . @ . . . . . . . . . . . . . . . . . . @ . . . @ . . . @ . @ . @ . . . @ . . . @ . . . . . . @ @ . . . . . @ . . . . . . . . . . @ . @ . . . @ . . @ . @ . . @ @ . @
@ @ . . . @ . . @ . . . @ . . @ . . @ . . . . @ . . . . . . . . . . . . . . . . @ . . . . . . . @ . . . @ . . . . . . . @ . . . @ . . . @ . . . . . . . . . @ . . . @ . . @ . . . . . . . . . . . . @ @
@ . . @ @ . . @ . . . . . . . . @ @ . @ . . . . @ . . . . . . . . . . . . . . . . . . . . . . . @ . . . . . . . . . @ . . . @ . . @ . . . @ . . . . . . @ . @ . . . . . @ . . @ . . . . . . . . . . . @
@ . . @ . @ . . . @ . . . @ . . . . . . . @ . . . . . . . . . . @ . . . . . . . . . . . . . . . . . . . . . . . . @ . . . . @ . @ . @ . @ . @ . . . . . . . . . . @ . . @ . . @ . . . @ . . . . . @ . @
@ . . . @ . @ . @ . . . . . . . . . . . . . . . . . @ . @ . . @ . . @ . . . . . . . . . . . . . . . @ . . . . . . . . . . @ @ . . . . . . @ . . . . . . . @ . . . . . . . . . @ . . . . . @ @ @ . @ . @
@ . @ . . @ . . . . . . . . . @ . . . . . @ . . . . . @ . . . . . . . . @ . @ . . . @ . @ . . . . . . . @ . . . . @ . @ . . . . . @ . @ @ . . . @ . . . . . . @ . . . . @ . . . @ . @ . . . . . . . . @
@ . . . . . . . . @ . @ . . . . . . @ . . . . . @ . @ . . . . . . . @ . @ . . . . . . . . . . . . @ . . . . . . . . . . . . . . . . . . . . . @ . . @ . @ . . . @ . . . . . . . @ @ . . . . . . . . . @
@ . . . . . . . . @ . . . . . . @ . . . . . @ @ . @ . . @ . . . @ @ . . . . . . . . . . @ . . . . . . . . . . . . . . . . . . . . . . . @ @ . . . @ . . . @ . . . . . . . . . . . . . . . . . . . . . @
@ . . @ . . . . @ . . . @ . . @ . . . . . . . . . . . @ . . . . . . . . . @ . . . . @ . . . @ . . . @ . . . @ . @ . . . . . . . @ @ . . . . @ . . . . . @ . @ . . @ . . . . @ . . . . . . . . @ . . . @
@ . @ . . . . . . . @ @ . @ . . @ . . . . . . @ . . . . . . . . @ @ . . @ @ . . . . @ . . . @ . . . . . . @ . . . . . . . . . . . . . . . . . . . . . . . . . @ . . . . . . . . . . . . . . . . . . . @
@ . @ . . . . @ . . . . . . . . . . . . . . . . @ . . . . . @ . . . . . . . . . . @ . . . . . @ @ . . . @ . . @ . . . . @ . . . @ . . . @ . . . . . . . . . . . . . . . . . . . . . . . . . . . . . . @
@ . . . @ . . . . . @ . . . @ . . . @ . . . . . . . . . . . . @ . . @ @ . . . . @ . . @ @ . . . . . . . @ . @ . @ @ @ @ @ . . . . . . . . . . @ . @ @ . . @ . . @ . @ . @ @ . @ . . @ . @ . . . . . . @
@ . . @ . . . . . . @ . . . . . . . . . . @ . @ . @ . . @ @ @ . . @ . . @ . . . . @ . @ . . . . . @ . . . @ . . . . . . . @ . @ . . . . @ . . . . . @ . . . . @ . . @ . . . . @ . . . . . . @ . . @ . @
@ . @ . . . . . . . . @ @ . . . . . @ . . . . . . @ . . . . . . . . . . . . . . . . @ . . . . . . . . . . . . . . . . . @ . . . . . . . . . @ @ . . . . . . . . . . . . @ . . . . . . . @ . . . . . . @
@ . . . . . @ . . @ . . . . . . . . . . @ . @ . . . . . . . . . . . . @ @ . . @ . . . . . . . @ . . . @ . . @ . . . . . . @ @ @ . . . . @ . @ . . . . . . . . . . . @ @ . . @ . . @ . . . . . @ . @ . @
@ . @ . . . . @ . . . @ . @ . @ . . . @ . . . . . . @ @ . . . . . . . . . @ . . . . . . . @ . . . . . . . . @ . . . @ . . . . . . . . @ . . . . . . . . . @ . . . . . @ . . . . . @ . . . . . . . . . @
@ . @ @ . . . . . . @ . . . . . . . . . . . . . . @ . . . @ . . . . . . @ . . . . . @ . . . . @ . @ . . . . . @ . @ . @ . . @ . . . . . @ . . . . @ . . @ @ . @ . @ @ . . . @ . . . . @ . . . . @ . @ @
@ . . @ . @ . @ . . . @ . . . . . . @ . . . . . . . . . . . @ . . @ . . . . . . . . . . . . . . . . . . . . . @ @ . . . . . . @ . . . . . . . . @ . . . . . @ . . . . @ . . . . @ . . . . . . @ @ . . @
@ . . . . @ @ . @ . @ . . . . . . . . . . @ . . . . . . . . . . . . . @ . . . . . . . . . . . . @ . . @ . @ . . . . . . @ . . . . . . @ . . @ . . . . @ . . . . . . . . . @ . @ . . . @ . . . . . . . @
@ @ . . . . . . . . . @ . . . . @ . . . @ . . . @ . . . . . . . . . @ @ . . . . . . . . @ . @ . . @ . . . @ . . . . @ @ . @ @ . @ . @ . . @ . . . @ . . . . . . . . . . . . . . @ . @ @ . . . . . . . @
@ . . . . . . . . . @ . . . . . @ . . . . @ . . . . @ . @ . . . . . . . . @ . . . . . . . . . . . @ . . . . . @ . . . . . . . . . . . @ . . . . . . @ . @ . . . . . . . . . . . . . . . . . @ . @ . . @
@ . @ . . . . . . . . . . . . @ . @ . . . . . . @ @ . @ . . . . . . . @ . . . @ . . . . . . . . . . . . @ @ . . . . . @ . @ . @ . . . . @ @ . . . . . @ . . . . @ . . @ . @ . @ . . . . @ . . . . . . @
@ . . . . . . @ . @ . . . @ . . @ . . . @ @ . . @ . . . @ . . @ . . . @ . . . . . . . . . . . . @ . @ @ . . . . . . . . . . . . . . . . . . . @ . @ . . . @ . @ @ . @ . . . . . . . @ @ . @ . @ . . . @
@ . . @ . . . @ . @ @ . . . . . . . . . . . @ @ . . . . . . . . @ . . . . . @ . @ . . . . . @ . . . @ . @ . . . . . . . . . . . . @ . . . . @ . . . . . @ . . . . @ . . . . . . @ . . . . . . @ . . . @
@ . . . . . . . @ . . . . . @ . . . @ . @ @ . . . . . . . . . . . . @ . . . . @ . . . . @ . . . . @ . . . . . @ . . . . . . . . . . . . . . @ . . @ . . @ . . . @ . @ . @ . . . . . . . @ . . . . . . @
@ . . . . @ . . @ . @ . . . . . . . . . . . @ . . . . . . @ . . . @ . . @ . . . @ . . . . . . . . @ @ . . @ . @ . . . . @ . . . . @ . @ . . . . . . . . . . @ @ . . . . . @ . . . . . @ . @ . . . . . @
@ . . . . . . . . . . . . . . . . . . . . . . . . . . . . . . . . @ . . . . . @ . . . . . . . . . . . . . . . @ . . . . . . . . . . . . . . . . . . @ . . . . . . . . . . . . . . . . @ . . . . @ . . @
@ @ @ @ @ @ @ @ @ @ @ @ @ @ @ @ @ @ @ @ @ @ @ @ @ @ @ @ @ @ @ @ @ @ @ @ @ @ @ @ @ @ @ @ @ @ @ @ @ @ @ @ @ @ @ @ @ @ @ @ @ @ @ @ @ @ @ @ @ @ @ @ @ @ @ @ @ @ @ @ @ @ @ @ @ @ @ @ @ @ @ @ @ @ @ @ @ @ @ @
3
5 1 6 20
31 23 42 8
93 45 29 22
