100 100
@ @ @ @ @ @ @ @ @ @ @ @ @ @ @ @ @ @ @ @ @ @ @ @ @ @ @ @ @ @ @ @ @ @ @ @ @ @ @ @ @ @ @ @ @ @ @ @ @ @ @ @ @ @ @ @ @ @ @ @ @ @ @ @ @ @ @ @ @ @ @ @ @ @ @ @ @ @ @ @ @ @ @ @ @ @ @ @ @ @ @ @ @ @ @ @ @ @ @ @
@ . . . . . . . . . . . . . . . . @ . . @ . . . . . . . . . . . . @ . . . . . . @ @ . . . . . . . . . . @ . . . . @ . . @ . . . . . . . . . @ . . . . @ @ . . . . . . . . . . . . . . . . . . . . . . @
@ . . @ . . . . . . . @ . . . . . @ . . . @ . @ . . . . . . @ @ . . . . . . . . . @ . . . @ . @ . . . . . . . . . . . . . . . . . @ . . @ . . . . @ . @ . @ . . . @ . . @ . @ . . . . @ . . @ . . . . @
@ . . @ . . . . @ . . . . . . . . . . @ . . . . . . . . . @ . . . . . @ . @ @ . . . . . . . . . @ . . . . @ . . . @ . . . . @ . . . . @ . . . @ . . @ . . . @ . @ . . . . . . . @ @ . @ . . . @ . . . @
@ . @ . . . . @ . . @ . . @ . . . @ . . @ . @ . . . . . . . . . . . @ . . . . . . . @ @ . . . @ . . . . . . @ . @ . . . @ . @ . . . . . . . . . . . . . @ . @ . . . . . . . @ . . . . . . . . . @ . . @
@ . . . . @ . . @ @ . @ . @ . . . @ . @ @ . . . . . @ . . . . . . . . . . . . . . . . . . . . . . . . . . . . . . @ . @ . . @ . @ . . @ . . . @ . . . . @ . . . @ . . . . . . . . . . . . . . @ . . . @
@ . . . @ . . . . . . . @ . . . . . . @ . . @ . @ . . . . . . @ . @ . @ . . . . . @ . . . . . . . . . . @ . . @ . . . . @ . . . . . . . . @ . . . . . . @ . . . . @ . . . . . . . @ . . . @ . . @ @ . @
@ . . . @ . @ . . . @ . . . . . . . . . @ . . . . . . . . . . . . . . . . . . . . . . . . . . @ . . . @ . . @ . . . . . . . . . . . . . . . . . . @ @ . . . . @ . . . . . . . . @ . . . . . . . . . . @
@ @ . . . . . @ . @ . . @ @ . . . . . . . . . . . . . . . . . . . . . . . . . . . . . . @ . @ . . . . . . . . . . @ . . . . . . . . . . @ . . . . . . @ . @ . . . @ . . . . . . . @ . . @ . . @ . . . @
@ . . . . @ . . @ . . @ . . @ @ . . . . . . @ . . . . . . . . . . . . . . @ . . . . . . . . . . . . @ . . . @ . @ . . @ . . . @ . . @ . . . . . . . . . . @ . . . . . @ . . . . . . . . . @ . . . . . @
@ . . . . . . @ @ . . . . @ . . . @ . . . . . . . . . . @ @ . . . . . . . . @ . @ . . @ . . . @ @ . . . @ . . . . . . @ . . @ . . . . @ . . . . @ @ . . @ . @ . @ . @ . . . . . . . @ . @ . . . . . . @
@ . . . . . . . . . . . . . . . . . . . . . . @ . . @ . . . . . . . . . . . @ . . @ . . . @ . . . @ . . @ . . . . . . . @ . . @ . . . @ . . . . . . . . . . . . . . . . . . . . . @ . . @ . . . . . . @
@ . . . . . . . . . . . . . . . . @ . . @ . @ . . . . . @ @ . . . . @ . . @ . @ . . . . . . . . . . . @ . . . @ . . . . . @ . . . . @ @ . . . . . . . . . . . . @ . . . . . . . . . . . . @ . . . . . @
@ . . @ . . . . . . . . . @ . . . . . . . . . . . . @ . . @ . . . . . . . . @ . . . . . . @ . @ @ . . @ . . . . . . @ @ . . . @ . . . @ @ @ . . . . . . . . . . . . . . . . . . @ . . @ @ . @ . . . . @
@ @ . @ . . . . . . . . . . . . . @ . . . @ . . . . . . . . . . . . . . @ . . . . . @ . . . . @ . . . . . . . . @ . . . @ . . . @ . @ . . . . . @ . . @ . . . . . @ . . . . . . . @ . . . . . . . @ . @
@ . . @ . @ @ . . . @ . . . . . . . . . . . @ . . . . . . . . . . @ . @ . . @ . . . . @ . . . . . . . . @ @ . . . @ . . . . . . . . . @ . @ . . . . . . . . . . . . . . . . . . . . @ . . . . . @ @ . @
@ . . . @ . . . . @ . @ . . . . . . @ . . . . . . . . . . . . . @ . @ . . . . . . . . . . . . . @ @ @ . . @ . . . . . . . . @ . @ . . @ @ . . . @ @ . . . . . . @ . . @ @ . . . . . . . @ . . . @ . . @
@ . @ . . . @ . @ . . . . . . @ . . . . . . . . @ @ . . . . . . . @ . @ @ . . . @ @ @ . . . . . . . . . . . . . . . . . . . @ @ . . . . . . . @ . . . . . @ . @ . . . . . . . . @ . . . . . . . . . . @
@ . . . . . . @ . . @ . . @ . . . @ . . . @ . . . @ @ . . . . @ . . . . . . @ . @ @ @ @ . . . . . @ . . . . . @ @ . . . . . . . . . . . @ . . . @ @ . . . . @ . @ . . @ . @ . . . . . . . . . . . . @ @
@ . @ . . . . . @ . . . . . . . . @ . . @ . . . . . . . @ . . . . . @ . @ . . . . . . . . . . . . . @ . . . . . . @ . . @ . . @ . . @ @ . . . . . . . . . . . @ . @ . . @ . . . . . . . . @ . . . . . @
@ . . . . . @ . . @ . . @ . . . . @ . . . . . @ . @ . . . . @ . . . . . . . . . @ . . . . @ . . . . . . . . . . . . . @ . @ . . . . . . @ . . @ . . . . @ . . . . . . . . . . . . @ . . . @ @ . . @ . @
@ . . . . . . . . . . . . . . @ @ . . . @ . . . . . @ . . . @ . . . . . @ . . . . . . @ . . . . . . . . . @ . . . . . . . . . . . . . . . . . . . . @ . . @ . . . . . . . . . . . @ . . . . . . @ . . @
@ . . . @ . . . . @ . . . . . . . . . . . . . @ . . . . . . . . @ . . . . . . . . . . . @ . @ . . . . . . @ . . . . . . . . . . . . . @ . . @ . . . . @ . . . @ . . . @ @ . @ @ . @ . @ . . . @ . . . @
@ . . @ @ . @ . . . . . . @ . @ . . . . . . @ . . . . . @ . . . . @ . . . @ . . . @ . . . . . . . . . . . . @ . . . . . . . @ . . . @ . @ . . . @ . . . @ . @ . . . . . . . . . . . . . @ . . . . . . @
@ . . . . . . @ . . . . . . @ . . . . . @ . . @ @ . . . . . @ . . @ @ . . . . . . . @ . . . @ @ . @ @ . . . . @ . . @ . . . @ . . . . @ . @ . . . . . . . . . . . . . . @ . . . . . . . . @ . . . @ . @
@ . @ @ . . @ . . @ . . . . . . @ . . . . . . . . . . . . . @ . . @ . . . . . . . . . . . . . . . . . . @ . . . @ @ . . . . . . . . . @ @ . . . . . @ . . . . . . . . @ . . . . . @ . . . . . . . . . @
@ . . . . . . . . . . . . . . . . . . . . . . . @ . . . . @ . . . . . . . . . . @ . . . . . . . . . @ @ . @ @ . . . . . @ . . . . . . @ . . @ @ . . . . @ . . . . @ . . . @ . @ . . @ . . . @ . . . @ @
@ . . . . . . . . . . @ . . . @ . . . . . . . . . . . . . . . . @ . . . . @ . . . @ . . . . . . @ . . . . . . . . . . @ . . . . . . . . @ @ . . . . . . . . . . . . . . . . . . . @ . @ . . @ . . . . @
@ . . . . . . . . . @ . . . . @ @ . . @ . . . . . @ . . . . @ . . @ @ . . . . . . @ @ @ . @ . . . . . . . . . . . @ . . . . . . @ . . . @ . . . . . @ . @ . . . . . . @ @ . . . . . . @ . . . . . . . @
@ . . . . @ . . . . . @ . @ . . . @ . . . . . . . . . . . . . . . . . . @ . . . . . . . . . @ . . . . . @ . . . . . @ . @ . . . . @ . @ . @ . @ . . . . @ . . . @ . . . . @ . . . . . . @ . . @ . . . @
@ . . . . @ . . @ @ . . . . . @ . . . @ . . . . . . . @ @ @ . . . . . . . . . . . . . . . . @ . . . @ . . . . . @ . . . . . . . . . . . @ . . . . . . @ . . . . . . . . . . . . . @ . . . . . . @ . . @
@ . . . . . . . . . . . . . . . . . . . . . . @ . @ . . . . . @ . . . @ . . . . . . . . . @ . . . . @ @ . @ . . . . . . . . . . . . . . . . @ . . @ . . . . . . . . . . . . . . . . . . . . . . . @ . @
@ . @ . . . . @ . . @ . . . . . . . . . @ @ . . . . . . @ . . . . . . . . . . . . . . . . . . . . . . . @ . . @ . . @ @ . . . . . . . @ . . @ . . . . . . . . @ . . . . . . . . @ . . @ . . . . . @ . @
@ . . . @ @ . . . . . . @ . . . . . . @ . . . . . . . . . . . . @ . . . . @ @ . . . . . . @ . . . @ . . @ . . . @ . @ . . . . . . . . . . @ . . @ . @ . @ . . . @ . @ . . . . . . . @ @ @ . @ . @ . . @
@ . . @ . . . . @ @ . . . @ . . . . @ . . . . . . . . . . @ . . . . . . @ @ . . . . . @ @ . . . . @ . . . . @ . . @ . . . . @ @ . @ . . @ @ . . . . . . @ . . . . . . . @ . . @ . @ . . . . . . . . . @
@ . @ . . . . @ . @ . . . . . @ @ . . . . . . . . @ . . . @ . . @ . . . . . . . . . @ @ . . @ . . @ . . . . . . . . . . . . . . . . . . . . . . . . . . . . @ . . . . @ . . @ . . . . . . @ . . @ . @ @
@ @ . . . . . . @ . . . . . . . @ . . . . @ . @ . @ . . @ . . . . . @ . . . . . . . @ . . . . @ . . . . . . . . . . . . . . . . @ . . . . . . . . @ . . . . . @ . . @ @ . @ . @ @ . . . . . @ . . . . @
@ . @ @ . . . @ . @ . . . . . . . . . . . . . . . . . . . . . . . . . . @ . @ @ @ @ @ . . @ . . . . . . . . . . . . @ . . @ . . . . . . . . @ @ . . . . . . . . . . . . @ . . . @ . . . . . . . . . . @
@ . @ . . @ . . . . . @ . @ . . . . . . . . @ . @ . . . . @ . . . . . . . . . . . . . . . . @ . . . . @ . . . . . . . . @ . . @ @ . . . . . . @ @ . . . . . . . . . . . . . @ @ . @ . . . . . . . . . @
@ . . . . . . . . . . . . . . . @ . . . . . @ . . . . . . @ . . @ . @ . @ . @ . @ . . . @ . . . . @ @ . . . @ . . . . . . . . @ . . . . . @ . @ . . . . . . . . . . @ . . @ . . . . . . . . . . @ . . @
@ . . @ . . @ . . @ . @ . . . . . . . . . . . . @ . . . . . @ . . . . . . . . . @ @ . . . . . . . @ . . . . . . . . . . . . . . . . . . . . . . . . @ @ @ . . @ @ . . . . . . @ . . . . . . @ . . . . @
@ @ . . . . @ . . . . . . . . . @ . @ . . . . . . @ . . . . . . . . . @ . . . @ . . . . . . . . . . . . @ . . . @ . . . . . . . . . . @ . . . @ @ . . @ . . . . . . . @ . . . . . . . @ . . . @ . . . @
@ . . @ . @ . . . . . . . . . . . @ . . . @ . . @ . . . . . . . . . . . . . . . . . . . . . . . . . . @ . . @ @ . . . . . . @ . . . @ . . . . . @ @ @ . . . . . . @ . . . . . @ . . @ @ . @ . . . . . @
@ . . . . . . . @ . . @ . . . @ . . . . . . . . . @ . . . @ . . . @ . . . . . . . . . . . . . . @ . . . . . . . . . @ . . . . . @ . . . . . . . . . . . . . @ . . . . . . . @ @ @ @ . . . . . . . . . @
@ . . @ . . . . . . . . . . . @ . . @ . @ . . @ . . . . @ . . . . . . . . @ . . . . . . . . . . @ . . . . . . . . . . @ . . @ @ . . . @ . . @ . . @ . . . . @ @ . @ . @ @ . . . . . @ . @ . . @ . . . @
@ . . @ . . . . . . . . . @ . . . . . . . . . @ . . . . @ @ . . . . . @ . @ @ . . @ . @ . . . . @ . @ . . @ . . . . . . . @ . . @ . . . . . @ . @ . . @ . . . . . . . . . . . . @ . @ . . @ . . . . . @
@ . @ . . . . . . . . @ . . @ . . . . @ . . @ . . . . . . . . . . . . . . . . @ . . . . . . . . . . . @ @ @ . . . . . . @ . . @ . . . . . @ . . . @ . . . . . @ . . . . . . . . . . . . . . @ @ @ . . @
@ . . . . . @ . . . . . . @ . . . . . . . @ @ . . . . . . . . . . . . . . . . . . . . . @ . . . . @ . @ . . @ . . @ . . . @ . @ . @ . . . . . . @ . . . @ . . . @ . @ . @ . . . . . @ . . . . . . . @ @
@ . . . . . . . . . . . @ . . . @ . . . . . . @ . @ @ . . @ . . . @ . @ . @ . @ . . @ . . . @ . . . . . . . . . . . @ @ . . . . . @ . . @ . @ @ . @ @ . . . . . . @ . . . @ @ . . . . . . . . . . . . @
@ @ @ . @ . . . . . . @ . @ . . . . . @ . . . . . . @ . . . @ . . . . . @ . . . . . . . @ . . . . . . . . . . . . . . @ . . . @ @ . . @ . . . . . . . . . . . . . . . . . . . @ . . . . . . . . . @ . @
@ . @ . . . @ . . @ . . . . . @ . @ . . . . . . . . . . . . . @ . . . . . . . . . . . . @ @ . . . @ . . . . . . . . . . @ . . . . . . . @ @ . . . . . . . . . . . . . . . . . . @ @ @ . @ . . . . . . @
@ @ . . . . @ . . . . . . . . . . . . . . . . . . . . @ . . . . . . . . . @ . . . . . . . . . . . . . @ . . . . . . . @ . . . . . . . @ . . . . @ . . . . @ . . . . . . . . . . . . . . . . . . @ . . @
@ . . . @ . @ . . @ @ @ . . @ . . @ @ . . . . . . @ . @ . . . . . . @ . @ . . . . . . @ . . . . . . . . . . . . . @ @ . . . @ . . @ @ . . . . . . . . . @ . . . . . . @ . . @ . @ . . . . . . . . @ . @
@ @ . . @ . @ . . . . . . . . . . . . @ . . . . . . . . . . @ . . . . . . . . . @ . . . . @ . . @ . . @ . . . . . . . . . @ . @ . . . @ @ . @ . . @ . . . . . . . @ . . @ . . . . @ @ . . . . . @ . @ @
@ @ . . . . . . . . . . @ . . . . . . . . . . . . . . . @ @ . . . . @ . @ . . . . . @ . . . . . . . . . . @ . . . . . . @ . . . . . . . . . . . . . @ . . . . . . . . . . . . . @ . . @ @ . @ . . . . @
@ . . . . . . . @ . . . . @ . . . . . @ @ . @ . . . . @ . . . @ . . . @ . . . . . . . @ . . . . . . . . . . @ . . . . . . . . . @ . @ . . . . . @ . . . . . . . . . . . . . . @ . . . . . . . . . . . @
@ . . . @ . . . . . @ . . . . . . . . . . . . . @ . . . . @ @ . . . . @ . @ . . . . . . . . . . @ @ . . . . . . @ . . . @ . . . . . . . . . . . . . @ . @ . @ . . . . @ . @ . . . . . . . @ . . . . @ @
@ . . . . . . @ . . @ @ . . @ @ . . . . @ . . . . . . @ . @ . . . . . . . @ . . . . . . . . . . . . . . @ . . . . . . . . . @ . . @ . . . @ . . . . . . . . . @ . . . . . . @ . . . . . . . . . . . . @
@ . @ . . . . @ @ . . . . . @ @ . . . . . . @ . . . . . . @ . . @ . . . . . . . . . @ . @ . @ . . . . . . @ @ . @ . . . . . @ . . . . . . . . @ . . . @ @ . . . . @ . . . . . . . . . . . . . @ . . . @
@ @ . . . . . . @ . . . . @ @ . . . . . . @ . . . . . . . . . . . @ @ . @ . . @ . @ . . . . . . . . . . . . . @ . . . . . . . . . . @ . @ @ . . . . . . . @ . . . . . . @ . . . . . . @ . @ . . . . . @
@ . . . . . . . . . @ . @ . . . . . @ . @ . . @ . . . . . . @ . . . . . . . . . . . . . . @ . . . . . . . . . . . . . . . . . . @ . . . . . . . . . @ . @ . . @ . . . . . . . . @ . . . . . . . @ . @ @
@ . @ . @ . . . . . @ . . . . . . . . @ . . . . . . . . . . . . . . . @ . . @ . . . . . . . . . . @ . . @ . . . . . . . @ . . . . . . . . . . . . . . . . @ @ . . . . . . . . @ . . @ . . . @ . . . . @
@ . . . @ . @ . . . . . . . . . . . . . . . . @ @ . . . . @ . . @ @ . . . . . . . @ . . . . . . . . . . @ . . @ . . . . . . . @ . . @ . . . . . . . . . . . . . . . . @ . . @ . @ @ . . . . . . . . . @
@ . . . @ . @ . . @ . . . @ @ . . . . . . @ . . . @ . . . . . . @ . @ . . @ . @ @ . . . . @ . . . . . @ . . . . @ . . . . @ . . . . . . . . . . . . . . . @ . @ . . . . @ . . . . . . . @ . . . . @ . @
@ . . @ . . . . . . . . . . . . . . . . . . . . . . . . . . . . . . . . @ . . . @ . @ . . @ . . @ . . . . . . @ . . . @ @ . @ . @ @ . . . . . . . . . . . . @ . . . . . . . . . . . @ . . . . . . . . @
@ . . . . . . @ . . . . . @ . . . . @ . . . . . . . . . . . . @ . . @ @ . . @ . . . . . . . @ . . . . @ . . . @ . . . @ . . . @ . . @ . . . . . . @ . . . . . . . @ . . . . . . . . . . @ . . . @ . . @
@ . . . . @ . . . . . . . . . @ . @ . . . . . . . . @ . . . . . . . . @ . . @ . . . . @ . . . @ . . @ . . . . @ . . . @ . @ @ . . @ . . . . @ . @ @ . . . . @ . . . . . @ @ . . @ . @ . . . . . . . . @
@ . . . . . . . @ . @ . @ . @ . . . . . . . @ . . . . @ . . . . . @ . . . . . . . @ . . . . . . . . . . @ . @ . @ . . . . . . . . . . . . . @ . . @ . . . . . @ @ @ . . @ . . . . . . . @ . . . . . . @
@ . . . . . @ . . @ . . . . @ . . . @ . . . . . . . . . @ . @ . . . . @ . @ . . . @ . . @ . . . . . @ . . . . . . . @ . . @ . @ @ @ . @ . @ . @ . . . @ . . . . . . . . . . . . @ . . @ . @ . . . . . @
@ . . . . . . . . . . . . . . . . . . @ . . . . . . . . . . @ . . . . @ . . . . @ . . @ . . . @ . . . . . @ . . . . . @ . . . . . . . . . . . . @ @ @ . . . . . . . . . . . @ . . . . . . . @ . . . . @
@ . . . . . . . @ . . . . . . . . . . @ . . . @ . . . @ . @ . . . . . . @ . . . . . . . . . . . @ @ . . @ . . . . . . . . . . . @ . . . @ . . . @ . . . @ . . @ . . . @ @ . @ . . . . @ . . . . . . . @
@ . . . @ . @ @ . . @ . @ . . . . . . @ . . . . @ . . . . . @ @ @ @ . @ . . . @ . . . . . . . . . . @ . @ . . . @ . . . . . . . . . @ . . . @ . . . . . @ . . . . @ @ . . . . . @ . . . . . . . . . . @
@ . . . . . . . . . . . . . . . . . . . . . . . . . @ . . . . @ . . . . . @ @ . . . @ . . . @ @ . @ . . . . . . . @ . . . . . . . . . . . . . @ . . @ . @ . @ . @ . . . . @ . . . . @ . . . . . . . . @
@ . . . . . . . . . . . . . . . @ . @ . @ . . . . . . . . . . . . . . . . . . . . . . @ . . @ . . @ . . @ . @ @ . . . . @ . . @ . . . . . @ . @ . . @ . . . . . @ . . @ . . . . . . . . . . . . @ . . @
@ . . . . . . . . . . . . . @ . . . . @ . . . . . . . . . @ . . . . . . @ . . . . @ . . . . @ . . @ @ . @ @ . . . . . . . . @ . . @ . . . @ . @ @ . . . . . @ . . . . . @ . . . . . @ . . @ . . . . . @
@ . . . . . . @ . . . . . @ . . . . . . . . . @ . . @ . . . . . @ . . . . . . . . . . @ . . @ . . @ . . @ . @ . . @ . @ . . @ . @ . . . . . . . . . . . . . . . . @ . . . . . . @ . . . @ . . @ . . . @
@ @ . . @ . . . @ . . . . . . . . @ . . . . . . . . @ . . . . . . @ . . . . @ . . @ . . . @ . . . . . . . . . . . . @ . . @ . . . . . @ . . . . . @ . . @ . . . @ . . . . @ . . . . . . . . @ . . . . @
@ . . . . . . . . . @ . . @ . . . . @ . . . @ . . . . @ @ @ . @ @ @ @ . . . . @ . . . . @ . . . . . . @ . . . @ . . . . . . . @ . . @ . . . . . . . . . . @ . . . . @ . . . @ . . @ @ . . . . . . . . @
@ @ . . . . . @ . @ @ . . . . . . . . . . . . . . . . . . . . . . . . @ . . . . . . . @ . @ . . . @ . . . @ . . @ . . . . . . . . . . . . . . . . . . . @ . . . . . . @ . @ . . . . . . @ . . . . @ . @
@ . . . . . @ . . . . . . . @ . . . . . . . @ . . . . . . . . . . @ @ . . . . @ . . . . . @ . . . . @ . . . @ . . . @ . . . . . . . . . . . . . . . . . @ . . . . . . . @ . @ . . . . @ . . . @ @ . . @
@ . @ . @ . . @ . . @ . @ . . @ . . . . . @ . . @ @ . . . . . @ . . . . . . . . . . . . . . . . . @ @ . @ . . . . @ . . . . . . . . . . . . . @ . @ @ . . . @ . @ . . . . . . @ . @ @ . . . @ . @ . @ @
@ @ . . . @ . . . @ . . . @ . . @ . . . . @ . . . . . . . @ . . . . . . . . . . . . . @ . . . . . . @ . . . @ . . . . . . . . @ . . . . @ @ . . . . . @ . . . . . . . @ . . . . . . . @ @ . . . . . @ @
@ . . . . . . . . @ . @ . . @ @ . . @ @ . . . . . . @ @ . . @ . . . . . . . . . . . . . . . . . . @ . . . . . . . . . . . @ . . . @ . @ . . . . . . . @ @ . . . . . . . . . . @ . . . . . @ . . . . . @
@ . . . @ . . . . @ . . . . . . . . . . . . . . . . . . . . . . . . . . . @ . . . . . . . . @ . . . . . . . . . . @ @ . . . . . . . . . . . . . . . . . . . . . . . @ . @ . . . . . . . @ . . . . @ . @
@ . . . . . . @ . . . . @ . . . @ . @ . . . . . . @ . . . . . . . . . . . . . . . . @ . . . @ . . @ . . . . . . . . . . . . . @ . . . . . . @ @ . @ . . @ . . . . . . . . . . . . @ . . . @ . . . . . @
@ . . . . . . . . . . . . . . . . . . @ . @ . @ @ . . . . @ . . . . . . . . . . . . . . . . . . . @ . @ . . . @ . @ . . @ . . . . . @ @ . . @ . @ . . @ . . @ . @ . . . . . . . . . @ . . . . . @ @ . @
@ . @ . . . . @ . . . @ . . . . . . . . . . . . . . . @ . @ . . . @ . . . . . . . . . . . @ . . . . . @ . . . . . . @ . @ . . . . . . . . . . . @ . @ . @ . . . . . . @ . . . . . . . . . . . . @ . . @
@ . @ . . . . . . . . . . . . . . @ . . . . . @ . @ . . @ . . . . . @ . . . . . . . @ . . . . @ . . . @ . . . . . . . . . . . . . @ . . . . @ . . . . . . . . @ . . . . . . . . . . @ @ . @ . . @ . . @
@ . . . . . . @ . . @ @ @ . . . . . . @ . . . . @ . . @ @ . . . . . . . . . . @ @ . . . . . . . @ . @ . . @ . @ . @ @ . . . . . @ . . . . . . . . . @ . @ . . @ . . . . . . . . . . . . . . . . . @ . @
@ @ . . . . . @ . . . . @ . . . . . @ . . . . . . . @ . . . . . @ . @ . . . . @ . . @ . . . @ . . . . . @ . @ . @ . @ . . @ . . . . . . . . . . . . . . . . @ . . . . . . . . @ . @ @ @ . . . . . . @ @
@ . . . . . . . . . . . . . . . @ @ . . . . . @ . . . . @ . @ . @ . @ . . . . @ . . . @ . . . @ . . . . . . . . @ . . . . . @ . . . . . . @ @ . . @ . . . . @ . . . . . . @ . . . . . . @ . @ . . . . @
@ . . @ . @ . . . . . . . @ . . . . . . . . . . . @ . . . @ . . @ . @ . @ . . . @ . . . . . . . . . . . . . . . @ . . . . . . . . @ @ @ . . @ . . . . . @ @ . . . . . . . . . . . . . . . . . . . . . @
@ . . @ . @ . . . . . . . . . . . . . @ . @ . . . @ . . . . . . . . . . @ . @ . . . . @ . . @ . @ . . @ . @ . . . . @ @ . . . . . . . . . . . . . . . . @ . @ . . . . . . . . @ . . . . . . . . . @ @ @
@ . . @ . @ . @ . . . @ . . . . . . . @ . . @ . . . . . . . . . . @ . . @ @ . . . @ . . . . . . @ @ . . . . . . @ . @ . . . . . . . . . . . . . . . . . . . . . . . . . . . . . . @ . . . . . @ . . . @
@ @ @ . . . . . @ @ . . . . . @ . @ . . . . . . . . . . . @ . . . . . . . . . . @ . . . . . . . @ @ . @ . . @ @ . . . . . . @ . . . @ . @ . . . . @ . . . @ . . . . . . . . . . . . . @ @ @ . . . . . @
@ . . . . . . . . @ . . @ . . . @ . . . . . . . . @ . . . . . . @ . . . @ . . @ . @ @ . . . @ @ . . . . . . . . @ . . . . . @ . . . . . . . . @ . . . . . . @ . @ @ @ . . . . . . . . . . @ . . . @ . @
@ @ . . . . . . . . @ . . @ . @ . . . . . . . @ . . . . . . . . . . . . . . . . . @ . . . . . . . . . . . . . . . . @ . . . . . . . . . . . . . . @ . . . . @ . @ . . . . . . . . @ . . . . . . . . . @
@ . @ . . . . . @ @ . @ . @ . . . . . . . . . . . . . . . . . . . . . . . @ . . . . . @ @ . . @ . . . @ . . . @ . . . . . . . . . . . . . @ @ . . . . . . . . . . . . . . . . . . . . . . . . . . . . @
@ . . . . . . . @ . . @ . . . @ . . . . . @ @ . . . . . . . @ . . . . . . @ @ . . . . @ . . . . . . . . @ . . . @ . . . . . . . . . . . . . . . . . . . . . . . @ . . . . . . . . . . . . @ . @ . . . @
@ @ @ @ @ @ @ @ @ @ @ @ @ @ @ @ @ @ @ @ @ @ @ @ @ @ @ @ @ @ @ @ @ @ @ @ @ @ @ @ @ @ @ @ @ @ @ @ @ @ @ @ @ @ @ @ @ @ @ @ @ @ @ @ @ @ @ @ @ @ @ @ @ @ @ @ @ @ @ @ @ @ @ @ @ @ @ @ @ @ @ @ @ @ @ @ @ @ @ @
3
13 23 72 98
57 95 39 21
40 81 39 10
