50 50
@ @ @ @ @ @ @ @ @ @ @ @ @ @ @ @ @ @ @ @ @ @ @ @ @ @ @ @ @ @ @ @ @ @ @ @ @ @ @ @ @ @ @ @ @ @ @ @ @ @
@ . . . . @ . . . . . . @ @ . @ . . . . . . . . . . . . . . @ . . . . @ . @ . . . . @ . . . . . . @
@ . @ . . . . @ . . . . . . . . . . . . . . . @ . . . . . . @ . . . @ . . . @ . @ . . . . . . . . @
@ . @ . . . . . . . @ . . . . . . . . . . @ . . . . . . @ . . . . . . @ . . . @ . . . . . . . . . @
@ . . . . . . . . . . . . . . . . . . . . . . . @ . . . . . . @ . . . . . . . . . . . . @ . . @ . @
@ . . . . . . . @ @ . . . @ . @ . . . . . . . . . . . . . . . @ . @ . . . @ . . . . . . . . . . . @
@ . . . @ . . @ . . @ . . . . @ . . . @ . . . . . . . @ . @ . . . . . . @ . . @ . . . . . . . . . @
@ @ . . . . . . . . . . @ . . . . @ . . . . @ . . . . . . @ . . . @ . . . . . . . . . @ @ . . . . @
@ . @ @ . . . . . @ . @ @ . . . . . . . . . . . . . . . . @ . . @ . . . @ . . @ @ . . . . . . . . @
@ . . . . . . . @ . . . . . @ . . . . . . . . . . @ . . @ . @ . . . . . . . . . . . . . . @ . . . @
@ . @ . . . . . @ . . . . . . . . . . . @ . . . @ . . @ . . . . @ . . . . @ . . . . @ @ . . . . . @
@ @ . . @ . @ . . . . . . . @ . . . . . . . @ . . . . . . . . @ . @ . . @ @ @ . . . . . . . . . . @
@ . . . @ . . . . . . . . . . . . . . . . @ . . . . . . @ . . . . . . . . @ . . . . . . . . . . . @
@ . . . @ . . . . . . . . . . . . . . . . . . . . . . . . . . . . . . . . . . . @ . . . . . . . . @
@ . . . . . @ . @ . @ . . . . . . . . . @ . . @ . . . . . @ . . . . . . . . . . . . . . . . . @ . @
@ . @ . . . . . . . . . . . . @ . . . @ . . . @ . @ . . . . . . @ . @ . . . . . . . . . . . . . . @
@ @ . . . . . . . . . @ . . . . . . . . . @ . . @ . . . . . . . . @ . . . . @ . . . . . . . . @ @ @
@ . . . @ @ . . . . . . . . . . @ . . @ . @ . @ . . . . . . @ @ . . . . . . . . . . @ . . . . . @ @
@ . . . . . . . . . . . . @ . . . @ @ . . . . . . . . @ . . . . . . . . . . . . . @ . . . @ . . . @
@ . . . . . . . . . . . . . . . . . . . . . . . @ . @ . @ . . . . . . . . . . @ . . . . . @ . . . @
@ . . . @ . . . . @ . . @ . @ . . . . @ . @ @ . . @ . . @ . . @ @ . . . @ . @ . @ . @ . . . . @ . @
@ . . . . @ . . . . . . . . . . . . . . @ . . . . @ . . . . . . . @ . . @ . . @ @ . @ . . . . . . @
@ . . @ . . . @ . . . @ . . @ . @ . . . @ . . . @ . . . . . . . . . . . . . . . . . . . @ . . @ . @
@ . . . . . @ . . . . . . . . . . @ . . . . . . . @ . @ . . @ . . . . . @ . . . . @ . @ . . . . . @
@ . . . . . . . . . @ @ . . . . . . . . . . . . . . . . . . . . . . @ . . @ . . @ @ @ . . . . @ @ @
@ . . . @ . . . . . . @ . . . . . @ . @ . @ . . . . . . . . . . . . . . @ . . . . . . . . . . @ . @
@ . . . @ . . . . . . . . . . . . . . . . @ @ . @ . . . . . . . . @ @ . . @ . . @ . . . @ . . . . @
@ . . . . . . . . . . . . . . . @ . . @ . . . . . . . @ . . @ . . . . @ . . . . . @ . @ . @ . . . @
@ . @ . . @ . . . . @ . . . @ . . . . . . @ @ . . . . . . @ . @ . . . @ . . . . . . . . . . . . . @
@ @ . . . . @ . . . . . @ . @ @ . . . . . . . . . . . . . . @ . . . . . . @ . . . . . . . . @ . @ @
@ . . . . . . . @ . . . . @ . . . . . . . . . @ . . @ @ . . . . . . . @ . . . . . . . . . . . . . @
@ . . @ . . @ @ . @ . . . . . @ . . . . . . @ . . . . . . . . . @ . . . . . . . . . . . . @ . @ . @
@ . . . . . . . . . . . . . . . @ . . . . . @ . . . . . . @ . . @ . . . . . @ . @ . . @ . . . @ . @
@ . . . . . . . . . . . . . . . . . . . . . . . . . . . . . . . . . . . . @ @ . . . . . . . . . . @
@ . . . @ . . . . . @ . . . . . . . . . @ . . . . . . . . . . . @ . @ . . @ @ . . . . @ . . . . . @
@ . . . . . @ . . @ . . @ . . . @ . . . . . . . . . . . . @ . . @ . @ @ . . . . . . . . . . . @ . @
@ . . . . . . . . @ . . . @ @ . . . @ . . . . . @ . . @ @ . . . . . . . . @ . . @ . . . . . . . . @
@ . . . . . . . . . . . . . . . . . . . . . . . . . . . . . . . . . . . . . @ . . @ . . . . . . . @
@ . . @ . @ . . . . . . . . . . @ . . . . . . . . @ . . . . . @ . . @ . . . . . @ . . . . . @ . . @
@ . . . . . . . @ . . . . . @ . . . . @ . . . @ . . . . @ . . . . . . . . . . . . . . . @ @ . . . @
@ @ . . . . . . @ . @ . . . . . @ . . @ . . . @ . . . . @ . . . . . . . . . . . . . . @ . . . . . @
@ . . @ . . . . . . . . . . . . . @ . @ . . @ . . @ . . . . . . . . @ . . . . . . . . . . . . . @ @
@ . . . @ . . . @ . . . . . . . . . . @ . @ @ . . . @ @ . @ . . . . . . . . . . . @ . . @ . . @ . @
@ . . . @ . . @ . . . @ @ . . . @ . . . @ . @ . . . . @ . . . . . . . @ . . . . . . @ . . . . . . @
@ . @ . . . @ . . . @ . . . @ . @ . . . . @ . . . @ . @ . . . . @ . . . . @ . . . . . . . . . @ @ @
@ . . @ . . . @ . . . . . . . . @ @ . @ @ . . . . . . . . . @ . . . . . . . . @ . . . . @ . . @ . @
@ . . . . @ . . . . . . . . @ . . . . @ . . @ . @ . . . . @ . . . . . @ . . . . @ . . @ . @ . . . @
@ @ . @ . . . @ . . . . . . . . . . @ . . @ . . . . @ . @ . . . . @ . . . . . . . . . . . . @ . . @
@ . . . @ . . . . @ @ . . . . . . . . . . . @ . . . . . . . . . . . . . . @ . . . . . . . . . . . @
@ @ @ @ @ @ @ @ @ @ @ @ @ @ @ @ @ @ @ @ @ @ @ @ @ @ @ @ @ @ @ @ @ @ @ @ @ @ @ @ @ @ @ @ @ @ @ @ @ @
3
29 21 26 2
13 44 7 13
19 30 18 36
