12 12
@ @ @ @ @ @ @ @ @ @ @ @
@ . . @ . @ . . . . . @
@ . . . . . @ . . . . @
@ . . @ . . . . . . @ @
@ . . . @ . @ . . . @ @
@ @ @ . . . . . @ . . @
@ . . @ @ . . . . . . @
@ . . . . . . . . . . @
@ . . . . @ . @ . @ @ @
@ . . . . . . . @ . . @
@ . . @ . . . . . . . @
@ @ @ @ @ @ @ @ @ @ @ @
3
5 6 2 4
1 4 8 6
7 1 4 8
