25 25
@ @ @ @ @ @ @ @ @ @ @ @ @ @ @ @ @ @ @ @ @ @ @ @ @
@ . . . . . . . . . . . . . @ . @ . . @ @ . . . @
@ . . @ . @ . @ . . @ . . @ . . . . . . . . . . @
@ . . . . . . . . . . . . @ . . . . . . . . @ . @
@ . . . @ . @ . . . . . . . . . . . . . . @ . . @
@ . . . . . . . . . . @ . . . . @ . @ @ . . . @ @
@ . . . . . . . . . . @ . . . . . . . . . . @ . @
@ . . . . @ . . . . . . . . . . . @ . @ . . @ . @
@ . . @ . . . . @ . @ @ @ . . @ . . . @ . . . . @
@ . . . . . . . . . . . . @ . . . . . @ . . . . @
@ . @ . @ . . . . . @ . . . . . . . . . . . . . @
@ . . . . . . . . . . . @ . . . . @ . . . . . . @
@ . . . @ . . @ . . . . . . . . . . . @ . @ . @ @
@ . @ . . . . . . . . @ . . . . . . . . . . @ . @
@ . . . @ . . . . . @ . . . . . . . . @ . . . . @
@ @ . . . @ . . . . . . . . @ . . . . . . . @ . @
@ . . . . . . . . . . @ @ @ . . . . . . @ . . . @
@ . . . . . . @ @ . . . . . . . . @ . . . . . . @
@ . . . . . . . . . @ . @ . . . @ @ @ . . . . . @
@ . @ . @ @ @ . . . . . . . . . . . . . . . . . @
@ . . @ . . . . @ . . @ . . @ . . . @ . . . . . @
@ . . . @ . @ . @ . . . . @ . . . . . . . . . . @
@ . @ . . . @ . . @ . @ . @ . . @ . . . . @ . @ @
@ . . . @ . . . . . . . . . @ . . . . . . . . . @
@ @ @ @ @ @ @ @ @ @ @ @ @ @ @ @ @ @ @ @ @ @ @ @ @
3
9 14 3 16
7 10 8 9
7 14 8 18
