100 100
@ @ @ @ @ @ @ @ @ @ @ @ @ @ @ @ @ @ @ @ @ @ @ @ @ @ @ @ @ @ @ @ @ @ @ @ @ @ @ @ @ @ @ @ @ @ @ @ @ @ @ @ @ @ @ @ @ @ @ @ @ @ @ @ @ @ @ @ @ @ @ @ @ @ @ @ @ @ @ @ @ @ @ @ @ @ @ @ @ @ @ @ @ @ @ @ @ @ @ @
@ . @ . . . . . . . . . . . . . . . . . . @ . . . @ . @ . . . . . @ . . . . @ . @ @ . . . . . . @ . . . . . @ . @ . . . @ @ . . @ . . . . . . . . . . . . . . . . . . . . . @ . . . @ @ . . . . . . . @
@ . . . . . . @ . @ . . . . . . @ . . . . . @ . . . . . @ . . @ . @ . . . . . @ . @ . . . @ @ . . @ . . . @ @ . . @ . . . . . . @ . @ . . . . @ . @ . . . . @ . @ . . @ . . @ . . @ . . @ . . . . . . @
@ @ . . . . . . . . . @ @ . @ . . . . . . . @ . . . . . . . . . . . @ @ . . . . . . . . . . . . . . . @ . . . . . . . . . . . . . @ . . . . @ . . . @ . . @ . . . @ @ . . . @ . . @ . . . . . . . . . @
@ . . . @ . . @ . . . @ . @ . . . . . . . @ . @ . . . @ . . . . . @ . . . . . . @ . . . @ @ . . @ . . @ . . . . . . . . @ . . . . @ . . @ . . . . . . . . @ . . . . . @ . . . . . . . @ . . . . @ . . @
@ . . . . . . . @ . . @ . . @ . . . . . . @ @ . . . . . . . . . . . . . @ . . . . . . . . . @ . @ . . . . . . . . . . @ . . . @ . . . @ . . . . . . . . . . . @ @ . . . . @ . . . . . @ . @ . . . . . @
@ . . . @ . . . . . . @ @ @ . @ . . . @ . . @ . . @ @ . . @ . . . @ . . . . . . . . . . . . . . . . . . . . . . . . @ . . . . @ @ . . . . . . . . . @ . . . . . . . . . . @ . . . . . . . . . . . @ . @
@ . . . . . . . . . . . @ . . . . @ . . @ . . . @ . . . . . @ . . . . . . . . . . . . . . . . . @ . . . . @ . @ . @ . . . @ @ . @ . @ @ . . . . . . . @ . . @ . . . @ . . . @ . . . @ . . @ . . . . @ @
@ . . @ . . . . . . . @ . @ . . . @ . . . . @ . . @ . @ . . @ . . . . @ . @ . . . . . . . . . . . . @ . . . . . . . . . . . . . . . . . . . @ . @ . . . @ . . . @ . . @ . . . @ . . . @ . . . . @ @ . @
@ . . . @ . . . . . . . @ . . . . . . @ @ @ . . . @ . @ @ . . . . . @ . . . . . @ . . . @ @ . . . . . . . . . . . . . . . . . . . . . . . @ . @ @ . @ . . . . . . . . . . . @ . . @ . . . @ @ . . . . @
@ . @ . . . . . . . @ @ . . . @ . . . . . . @ . . . . . . . . . . @ . . . . . . . . @ . . . . . . . . @ . @ . . @ . @ . . @ . . . . @ . . . @ . . . . @ @ . @ . . . . @ @ . . @ . . . @ . . @ . . @ . @
@ . . . @ . . . . . . . . . . . @ . . . . . . . @ . . @ @ . . . . . . @ @ . . @ . . . . @ . @ . . . . . . @ . . . . . . @ . . . . . . @ . . . @ . . . . . . . @ . @ @ . . @ . @ . . . . . . . . @ @ . @
@ . . . . @ . . . . . . . @ . . . . . . @ . @ . @ . . . . . . . . . . . . . . . @ . . . . @ . . . @ . . @ . @ . . . @ . @ . . . . . . . . @ . . . . . . . . . @ . . . . @ . . . . . . . @ . . @ . . . @
@ @ . @ @ @ . . . . . . @ . . @ . . . @ . . . . . . . @ @ . . . . . . . . . . . . . . . . . . . . . . @ . . . . . . @ . . @ . @ . . . . @ . @ . @ . . @ . . . . @ @ . @ . . @ . @ . . @ . . . . @ . @ @
@ . . . . . . @ . . . . . . . . . @ . . . . @ . . @ . . . . . . . . . @ . @ . . . @ . . . . @ . @ . . . . . . . . @ . . . . . . @ . . . . @ . . . @ @ . @ . @ . . . . . . @ . @ . . . . . . . @ @ . . @
@ . . . @ . . . . @ . . . . @ . . . . . . . . . . . . . . . . @ . . . . . . . @ . . . . . . . . @ . . . . . @ . . . . @ . @ . @ . . @ . . . . . @ . @ . . . @ . . . . . . @ . . . . . @ . @ . . @ . @ @
@ . . . . . . @ . . . @ . @ . . . . . . . . @ . . . . . . . . . @ @ . . . . . . . . @ . . . . @ . . . . . . . . . . . . . @ @ . @ . @ @ . . . . . @ . @ . . . @ . @ @ . @ . . . . . . . . . . . . . . @
@ . . . . . . . @ @ . . . . . @ @ . @ . . . . @ . . @ . . . . @ . . @ . . . . . . @ . . @ . . . . @ . @ . . . . . @ @ . . . . . @ . . . . . . . @ . . . . . . . . . . . . @ . . @ . . . @ . . . . . @ @
@ . . @ . . . . @ @ @ . @ . . . . . . @ . . . . . . @ . . . . . . . . . . . @ . . . . . . . @ . . . . . . . @ . . @ . . . . . . @ . @ . @ . . . . @ . . . . . . . . . . . . @ @ . . . . . . . . . . . @
@ . . . . . . @ . @ . . . . @ @ . . @ . . . . @ . @ . . @ . . . @ . . . . @ . . . . . . . @ . . . . . . . . . . . @ . . @ . . . . . . . . . . @ . . . . @ . . . . . . . . . . . @ . . . . @ . . . @ . @
@ . . . @ . . . . . . @ . . . . . . . @ . . . . . . . @ . . . . . . . . . . . . . . . . . . . . . . . . . . . . . . @ . @ @ . . . @ . . . @ . . . @ . @ . . . . . . . . . . . @ . . . . . . . . @ . . @
@ . . @ . . @ . . . @ . . . . . . . . . @ . . . . . . . . . . . . . . . . . @ . . @ . . . . . . @ @ . . . @ . . . . . . . . . . . . @ . . . @ . . . . . . . @ . . . . . . . . . . . @ @ . . . @ . . . @
@ . . . . . . . . . @ . . . . . . . . . @ @ . . @ . . . . . . . . . @ . . . . @ . . . . . . @ @ @ . . . . . . . @ . . . @ . . @ @ @ @ . . . . . . @ . @ . @ . @ @ @ . @ . . . . . . . . . . . @ . . @ @
@ . @ . . . . . . . . @ @ . . . . @ . . . . . @ . . . . . . . . . . . @ . . . . . @ . . . @ . . . . @ . @ . @ . . . . . . . . . . . @ . . . . . . . . . . @ . . . . @ . . @ @ . . . . . @ . . . . . . @
@ . . @ . @ @ . @ . . . @ . . @ . . . . . @ . . . . . . @ . @ . . . . . @ @ . . . . . . . @ . . @ . @ . . . @ . . . @ . . . . . @ . @ . @ . . . @ @ . . . . . @ . @ . @ . . . . @ . @ . . . . . @ . . @
@ . . . . . . . . @ . . . @ . . . . . . . . @ . . @ . @ . . . . . . . . . . . . . . @ . . . . . . . . @ . . . . . . . . . . . . @ . . . @ . . . . . . . . @ . . . . @ . . . . . . . @ . . . . @ . . . @
@ . . . @ . . . . . . . . . . @ . . . . . . . . . . @ . . @ . @ . . . . @ @ @ . . . . . . . . . . . . . . @ @ . . @ . . . @ @ . . . . @ @ . . . . @ . . . . . @ @ . . . @ . . . . @ . @ . . . . . . @ @
@ . @ . . . . @ . @ . . . @ . . @ . . @ @ @ . . @ . . . . . . @ . . . @ . . . . . . . . . . . . . . . @ . . . . . . . . . . . . . . . . . . . . . . . . . @ . . . . . . . . @ . . . . @ . @ . @ . @ . @
@ . . . . . @ . @ . . . @ . @ . . . . . . . . . . @ . . . . . . . . . . . . . . . . . . . . @ . . . . @ . . . . . . . . . @ . . . . . . . . @ @ . . . . @ . . . . . . @ @ . @ . . . . . . . @ . . . @ @
@ @ . @ . . . . . . . . . . . @ . . . . . . . . @ @ . . . . @ . . . . @ . . . . . @ @ . @ . . . . . . . . . . @ @ . . @ . . . . . . . . . . @ . . @ . @ . . . . . . . . . . . . . . . @ . . . . . . . @
@ . . . . @ @ @ . . @ . . . . . . . . @ . . @ . . . @ . . . . . . . . @ . . . . . . . . . @ . . . . . . @ . . . . . . . . . . . . @ @ . . @ . . . . . @ @ . . . . . . . . . . . . . . . . @ . . . . . @
@ @ . . . . . . @ . @ @ . . @ @ . . . . . . . . . . . . . . . . @ . . . . . . . . . . . . . @ @ . @ . . @ . . . . . . . . . . . @ . . . . . . . . @ . . . @ . . . @ . . @ @ . . . . . @ . . . . . . . @
@ . . . . . . @ . . @ @ . @ . . . . . . . . . . . . . . . . . . . . . . . . . . @ . @ @ . . @ . . . . @ . . . . . . . . @ . @ . . . . . . . . . . . . . @ . . @ . . . . @ . . . . . . . . @ . . . . . @
@ . . . . @ . . . . . . @ . . . @ . . . . . . . @ . @ @ . . . . @ . . @ . . . . . @ . . . @ . . . . . . . . . . . . . . . . . @ . . . @ . @ . . . . . . @ @ . . @ . . @ . . . . . . . @ . . . . . . . @
@ . . @ . . . . @ . . @ . . . . . . . @ . . . . @ . . . . . . . . . . . . . . . . @ @ . . . . @ . . . @ . . . . . . @ . . @ . . @ . . @ . . . @ . . @ @ . . . @ . @ . . . . @ . . . . @ . . . . . @ . @
@ @ . . @ . . . . @ . . . @ @ @ . . @ . @ . . @ . . . . . . . @ . . . . . @ . . @ . . . . . . . . . @ . . . @ . . . @ . @ . @ . . . . . . @ . . @ . . @ . . . . . . . . . . . . @ @ . . . . @ . . . . @
@ . . . . @ . . . . . @ . . . . . . . . . . @ . . @ . . . @ . . @ . @ . . . . @ @ . @ . . . @ @ . . . @ . . . . . @ . . . . @ . . @ . @ . . . @ . . . @ . . @ . . . @ . . . . . . . . @ . . . . @ . @ @
@ . . . . @ . . . . @ . . . . . . . @ . . . . @ . @ . . . . @ . . @ . . @ . . . . . @ @ . @ . . . . . . . . . . . . @ . @ . @ . . . . . @ . . . @ . . @ . . @ . . @ . . . . . . . . . . . . @ . . . . @
@ . . @ . . . . . . . . . . @ . . . . @ . . . . . . @ . . @ . . @ . . . @ . @ . @ @ . . @ . . . . . . . @ . . . @ @ @ . . . . . @ . @ . . . . . . . . . . . . . @ . . . . . . @ . . . . . . . @ . . . @
@ . . @ . @ . . @ . . . . . . . . . . . . . . . . . . . . . . . @ . . . . . . . @ . @ . @ . . @ . . . . . . . . . . . @ . . . @ @ . . . . . . . . . . . @ . . . . . . @ @ . . . . . . . @ . . . . . . @
@ . . . . . . . . @ . @ @ . . . . @ . @ . . . . . . . . . . . . . . . . . . . . . . . . . @ . . . . . . . @ . . . . @ . . . @ . . . . @ . . @ . . @ . . . . . . . . . @ . . . . . . . . . . . . . . . @
@ . . . @ @ . . . . . . . . . . . . . . . @ . . . . . @ . . . . . @ . . . . . . . @ . . . . . . @ . @ . . . . . . @ . . . . @ . @ @ . . . . . . . . @ . . . . . . . . . . . @ . . . @ @ . . . . . . . @
@ @ . . . . @ . @ . . . . . . @ . @ . . @ . . . . . . . . @ . . . @ . @ @ @ . . @ @ @ . . . @ . @ . . . . @ @ . . @ . . . . . . . . . . @ . . . . . . . . . . . . . @ . . . . . . . . . . . . . @ . . @
@ . . . . @ . . . . . . . @ . . . @ . @ . . @ . . . @ @ . . . @ . . @ . . . . . . @ . . @ . . . . . . . . . . . . . . . . . . . . . . . @ . . @ . . . . . . . . . . . . . . @ . @ . . . . . . @ . . . @
@ . . . . . . @ . . @ . @ . . . . . . . @ . . . @ . . . . . . . . . . . . . @ . . . . . . . . @ . @ . @ @ . . . . . . . . . @ . @ . . . . . @ . . . . @ . . . . @ . . . . @ . . . . . . @ . . . . . . @
@ @ @ @ . . . @ . . . . . . . . . . . . . @ . . . . . . . . @ . . @ @ @ . . . . . @ . . @ @ . . . . @ @ . . . @ . . . . . . . @ . . . . @ . . . . . @ . @ @ . . . @ . . . . @ @ @ @ . @ . . . . . . . @
@ @ . . . . . . . @ @ . @ . . @ . . . @ @ . . . . . @ . . . @ . . @ . . . . . . . @ . . . . . . . @ . . . @ . . . @ . . . @ . . @ . . . . . . @ . . @ @ . . . @ . . . . . . . @ . . . . . . . . @ @ @ @
@ . . @ . . . . @ . . @ . . . . . . . . . . . @ . . . . . . . @ . . . . . . @ . . @ . . . . @ . . . . . @ . . . . . . . . . . . . . . @ . . . . . @ . . . . . . @ . . . @ . @ . . . . . . @ . . . . . @
@ . . . @ . . . . . . . . . . . . . . . . @ . . . . @ @ . . . . . . . @ . @ . . . . . . @ . @ . . @ . . @ @ . @ @ @ . . . @ . . . . . . . . @ . . @ . . . . . . @ . . . . @ . . @ . @ . . . @ . . . @ @
@ . @ . . . . . . . . . @ . . . . . . . @ . . . @ . . . @ . . . . . . . @ @ . . @ . . . . . . . . . @ . . . . . @ . . . . . . . . @ @ . . @ . . . . . . . . . . . . @ @ . . . . . . . . . @ . @ . . . @
@ . . . . . . . . . . @ . . @ . . @ . . . . . . . . @ @ @ . . @ . . . @ @ . . . . . @ . . . . @ @ . . . . . . . . . . . . . . . . . . . . . . . @ . . . . . @ . . . . . . @ . . . @ @ . . @ . @ . . . @
@ . . @ . . @ . . . . . . . . . . . . @ . . @ @ . . . . . . @ . . . @ . . . . . . . . . @ @ . . . . . . @ . . . @ . . . . . @ . . @ . . . @ @ . . . . . @ @ . . . . @ @ @ . . . . @ . . @ . . . . . . @
@ . @ . . @ . @ @ . . . . @ . . . @ . . . . . . . @ . . . . . @ . . . . . . . . . . @ . . . . . . . . . . . @ . . . . . . . . . @ . . @ . . . . . @ . . . . . . . . . . . . . @ . . . . . . . . @ . . @
@ . @ . @ . . . . . . . . @ . . @ . . . . @ . @ . @ . @ . . . . . . . . @ . @ @ . . . . @ . @ . . . . . . . . . . . . . @ . . . . . . @ . . . . . . . . . . . . . @ . . . . . . . . . @ . @ . . . @ . @
@ . . @ . . @ . . @ . . . . . . . . . . . . . . @ @ . . . . . . . @ . . . . . @ . . . @ . . . . . . . @ . . @ . . . . . . @ . . . . . @ . @ . . . @ . . @ . . . . . . @ @ . . @ . . @ . . . . . . . . @
@ . . . . . . . . @ . . . . @ . . . . . . @ . . @ . . . . . . . @ . . . @ . . . . . @ . . . . . . @ . . . . . . . @ . . . @ @ . . . . . . . @ . @ . . . . @ . . . . @ . @ . @ . . . . . . . @ . . . @ @
@ . . . @ . . @ . . . . . @ . . . @ . . . @ . . . . . . @ . . . . . @ . . . @ . . . @ . . . . . . . . . @ . . . . . . @ . . . . . . . @ . . . . . . . . . . . . . . @ . @ @ . . . . . . @ @ . . . @ @ @
@ . @ . . . . . . . . . . . . @ . . . . . . @ @ . . . . . . . . . . . . . . . . . @ . . @ . . @ @ . . . . @ . . @ . . . . . . . . . . . . . . @ . @ @ @ . . . . . . . . . . . . . . . . @ . . . . . . @
@ . . . . . . . . . . . @ @ . . . . . . @ . . . . @ . . . @ . . . . . . . . . . . . . . . . . @ . . . . . . . . . . . @ . . . @ . . . . . . . @ . . . . . . . . . . . . . . . . . . . @ . . . . . @ . @
@ . . . @ @ . @ . . @ @ . . . . . . @ @ . . . . . . . . . . @ . . . . . . @ . . @ . . . . . @ . . @ . @ . . @ . . . @ @ . . . . . @ . . . . @ . . . . @ @ . @ . @ . . . . @ . . @ . @ . . @ . . @ . . @
@ . . . . . . . . . . . . . . . . . . . . . . @ @ . @ @ . . @ @ . . . . . . . @ . . . . . @ . @ . . @ @ @ . @ . . . . . . . . . @ @ . @ . . . . . . @ . . @ . @ . . @ . . @ @ . . . . . . @ . . @ . . @
@ . . . @ . . . . . . . . @ . . . . . . @ @ . . @ @ . @ . . . . . @ . . @ @ @ . . . . @ @ . . . . . . . . . . . . @ . @ . . @ . . . . . . . . . . . . @ . . . . . @ . @ . . . @ . . . . . @ . . . . . @
@ . . . . . @ . . . . . . . @ . @ . . @ . . . . @ . . . . . . . . . . . . . . . . @ @ . . . @ @ . . @ @ . . . @ @ . @ . . @ . . . . @ . @ . . . . . . @ . . . . . @ @ . . @ @ . @ . . @ . . . . . . . @
@ . . . @ . . . . . . . . . . . . . . . . . @ . . . . . . . . @ . . . . . . . @ . . . . . . . . . . . . . . . . . @ . . . . . @ . . . @ . . . . . . . . . . @ . @ . . . . . . @ . . @ . . . . . . . . @
@ . . . . @ . . @ . . . . . . . . . . . . . . @ @ . . . . . . . . . . . @ . . @ . . . . . . . @ . . . . @ . . . . . @ . @ . . . . . @ . @ . . . . . . . . @ . . . . . . @ . @ . . . . @ . . . @ . . @ @
@ . . . . . @ . . . . @ . . @ . . . . . . . . . . . . . . . . . . @ . . . . . . . . . . . . . . @ . . . . . . . . . . . @ . . @ . . . . . . . . . . . . @ . . . . . . @ . . . . . . . . . . . . . @ . @
@ . . . . . . . . @ . . . . . . @ @ . . . . . @ . @ @ . @ @ . . . . . . . @ . . @ @ . . @ @ . @ . . . . . . @ @ . . . . @ @ . . . . @ . . . . . . . . @ . @ . . . . . . . . . @ @ @ . @ . . . . . . . @
@ . . @ . . . . . . . . . . @ @ @ . @ . @ . . . . . . . . @ . . @ . . . . . . . . . . . . . . . . . . . . . . . . . . . . . @ @ . . . . . . . . . . @ . . . . . . . . @ @ . . . . . . . . @ . . . . . @
@ @ . . . . . . @ . . @ . . . . . . . . . . @ . @ . @ . . @ . . . . . . . @ . @ . . . . . . @ . . . . . . . . . . . . . . . . . . . @ . @ . . . . . . . . . . . @ . . . @ . . . . . . . . . . . . @ . @
@ . . . . . . . . . . . . . . . . . . . . @ . . . . . . . . . . . . . . . . . . . . . . . . . . . . . . . . . . . @ . . . . . . @ . . . . . . . . . . . . . . . . . . . . . . . . . . . . . . . . @ . @
@ . . @ . . . . . . . @ . . @ . . . . . . . . . @ . @ . @ . @ @ . . . @ . . @ . . . . . . . @ @ . . . . . @ . . . . . . . @ . @ . . @ . . . . . . . @ . . . . . . . . . . . @ . . . . . . . . . . . . @
@ . @ . @ . . . @ . . . . . . @ @ . . . . @ . . @ . . . . . @ . . . . . . . . @ @ . . . . . . . . . . . . . @ . . @ . . . . . @ . . @ . @ . @ . . . @ . . . . . @ . @ @ . . . . . . . . . . . . . . . @
@ . @ . . . . . . @ . @ @ . @ . . . @ . . . @ . . . . . . @ . . . . @ . . . . . . . . . . . . @ @ . . . . @ . . . . @ . . . . . . . . . . . . . . . @ . . . . . . @ . @ . . @ . . . . @ . @ . . . . . @
@ . @ . . . @ . . . . . . @ . . . @ @ @ . . . . . . . . @ . . . . . @ @ . . . . @ @ . . . . @ . . . @ . @ . . . . @ . @ . . . . . @ . . . . . @ . . . . . @ . . . . . . . . . . . . @ . . . . . . @ . @
@ . . @ . @ . . . . . . @ @ . . . . . . . . @ . . . . . @ . . . . . . . . . . . . . . . . . . . . . @ . . . . . . . . @ . . @ . . . . . . . . . . . . . . . . . @ . @ . . . @ . . . @ . . . . . . . . @
@ @ . . . . . @ . . @ @ . . @ @ . . . . . . . . . . . . . @ . @ . @ . @ . . . @ @ . . . . . . . . . . @ . @ . . . . . . @ . . . @ . . @ . . @ . . . . @ . . @ . @ . . @ . . . . . . . . . . . . . . . @
@ . . @ . @ . . . . @ . . . . . . . . . . @ . . . . . . . . . . . @ . @ . @ . . . @ . . . . . . . . @ . @ . . @ . . . . . . . @ . . . . . . . . @ @ . . @ . . . . . . . . . . . . @ . @ . . . . . . . @
@ . . . . @ . . . . . . . . . . . @ . . . @ . . . @ . @ . . . . . @ . . . . . . . . . . . . . . . . . @ . . . . . . . . . . @ . . . . . @ . @ . . . . . . . . @ @ . @ . . . . . @ . . . . . . . . . . @
@ . . . . . . . . . . . . . . . @ . . . . . . . @ @ . . . . . . . . . . @ . . @ . @ . . . . . . . . . @ . @ . . . . . @ . . . . . . . . . @ . . . . @ . . . . . . . . . @ . . . @ @ . . . . . . . . . @
@ . @ . . . @ . . . . . @ @ @ . . . @ . . @ . . . . @ . . . . . . . . . . . @ . . . . . . . . . . . . . . . . . . @ . @ . . @ . . @ . @ @ . . @ . . . . @ . . . . @ . @ @ . . . . . . . @ . . . . @ . @
@ @ . @ . . @ . . . . @ @ . . . . @ . . . . . . . . . . . . . @ . . @ @ . . . . @ . . . . . . . . . . . @ @ . . . @ . . . . . @ @ . . . . . . . . . . . . . . . @ @ . . . . . . . . . . . . . . . @ . @
@ . . . . . . . . . . . . . @ @ . . @ . . @ . . . . . . . . . . . @ . . . . @ @ @ . . @ . . . @ . @ @ . . . . . . . . . . . . . . . @ @ @ . @ . . . . . . . . . . . . . . . . . . . . . . . . . . . . @
@ . . . . . . @ . . . . . . . . . . . . . . . . @ . . . @ . . . . @ . . . . . . . . . . . . . . . @ . . . . . . . @ . . . . . . . . . . . . . @ . @ . . @ . . . . . . . . . . . . @ . . . @ . . @ @ . @
@ . . @ @ . . . . . @ . . @ . . @ . . . @ . . . . . . . . . . . . . . . @ . . . . . . @ . . @ . . . . . @ . . @ . . . @ . . . . @ . . @ . . @ . @ . . . . . . . . . . @ . . . @ . . . @ . . . . @ . . @
@ . . @ . . @ . . . . @ . . . . . . . . . . . . @ . . . . . . . . . . . . . . @ . @ . . @ . . @ . . . @ . . . . . . . @ . . @ . @ . . . . . . . @ . . . . . . . . . . . . . @ . . . . . @ . . . @ . @ @
@ . . . . @ . . @ . . . . @ . . . @ . @ . @ . . . . . . . . . . @ @ . . @ . . . . . . @ . @ . @ . . . . . . . . . @ . . @ . . . . . . . . . . . . . . . . @ @ @ . @ . @ . . . @ . . . . . . . . . . @ @
@ . @ @ . . . @ . . . . . @ . . . . . . @ . . @ . . . @ . . . . . . . @ . . @ . . . . . . . . . . . . . . . . @ @ @ . . . @ . @ . @ @ . @ . . . . . . . . . . . @ . . . . . . . @ . . . @ . . . . . . @
@ . . . @ . @ . @ . . . . . . @ . . @ . . @ . . . . . . . . . @ . . . @ . . . . . . . @ . @ . @ . . . @ . . . . . . @ . . . . @ . . . . . . . . . @ . . . @ . . . @ . . . . . @ . . . . . . . . . . . @
@ . . . @ . . @ . . . . . . . . . @ . . @ . @ . . @ @ . @ . . . . . . . @ . . . . @ @ . . . . . . . . . . . . @ . @ . . . . . . . . . . . . . . . . . . . . @ . . . . . . . . . @ . @ . @ @ @ . . @ . @
@ . . . . . . . . . . . . . . . . . . . . . . . . . . . . . . . . . . . . . . . . . . . . . @ . . @ . @ . @ . . . . . . @ @ . . . . . . . . . . . . @ . . . . . . . . . @ . . @ . . @ . . . . . . @ . @
@ . . @ . . . . . @ @ @ . . . @ @ . . . . . . . . . @ . . . . . . @ @ . . . @ . . . @ . . . . . . . . . @ . . . . . . . . @ . @ . @ . . @ . @ . @ . . . . . @ . . . . . . @ . . @ . . . @ . . . . . . @
@ @ . . . . . . . . @ . . . @ . . @ @ . . . . . @ . . . . . . . @ . . . . . . . . . @ . . @ @ @ @ @ @ . . . . . . . . . . . . . . . . . . . @ . @ . . . . . . . @ . . @ @ . . . . . @ . @ . . . . . . @
@ . . @ . . . . . . . . . . . @ . . . . . . . @ . . . . . @ . @ . . . . . . . . . . . @ . . @ . . . @ . . . @ . . . . . . @ . . . . . . @ . . . @ . . . . @ . @ . . @ . . . . . . . . @ . . @ . @ . . @
@ . . . . @ . . . . . . . @ . @ . . . . . @ . . . @ . . . . . . . . . . . . . . . . . . . . @ . . . @ . . . . . @ . . @ @ . . . @ . @ @ @ . . . . . . . . . . . . . . . . @ . . . @ . . . @ . . . . . @
@ . . . . . . . @ . . . @ . . . . . . @ @ . . . . . @ . . @ . . . . . . . . . . . . . @ . . . . . . . . . . . . . . . . . . . . . . . @ . . . . . . . @ . . . . . . . @ . . . . . . @ . @ . . . . . . @
@ . . @ @ . . @ . . . . . @ . . . @ . . @ . . . . . . . . . @ @ @ . . . . @ . @ . @ @ @ . . . . . . . . . . . . . . . @ @ . . . . @ . @ . . . . . . . @ . . . . . . . @ . . . . . . . @ . @ . . . . @ @
@ . . . . . . . . . . . . . . @ . . . . . . . . . @ @ . . @ . . @ . @ . . . . . . . @ . . . . . @ . . @ . . . . . @ . @ . @ . . . . . . @ . . . . @ . . . . . . . . . . . . . @ . . . . . . @ . . . . @
@ . . . . . . . . . . . . . . . . @ . . . . . . . . . . . . . . . . . . @ . @ . . . . @ . . . . . . . . . . @ . @ . . . . . @ . . . . . . . . @ . . . . . . . . . @ . . . @ . . . . . . . . . . . @ @ @
@ . . . . . @ . . . . . . . . . @ . . . . . . . . . . . . . @ . . . . @ . . . . . @ . . . . . . . . . . . . . . . . . @ . . . . . . . . . . . . . . . . . . . @ . . . @ . @ . @ . . . . @ @ . . . . . @
@ @ @ @ @ @ @ @ @ @ @ @ @ @ @ @ @ @ @ @ @ @ @ @ @ @ @ @ @ @ @ @ @ @ @ @ @ @ @ @ @ @ @ @ @ @ @ @ @ @ @ @ @ @ @ @ @ @ @ @ @ @ @ @ @ @ @ @ @ @ @ @ @ @ @ @ @ @ @ @ @ @ @ @ @ @ @ @ @ @ @ @ @ @ @ @ @ @ @ @
3
68 4 96 72
60 46 15 80
54 82 52 91
