25 25
@ @ @ @ @ @ @ @ @ @ @ @ @ @ @ @ @ @ @ @ @ @ @ @ @
@ . @ . . . . . . . . . @ . . . . . . . . . . @ @
@ . . . . . @ . . @ . . . @ @ . . . . . . . @ . @
@ . . . . . . . . . @ @ . . . . . @ . . . . . . @
@ . . . . . . . . . . . . . . @ . . @ . . . . . @
@ @ . . . . . . @ . . @ @ . . . . @ . . . . . . @
@ . . @ . . . . . . @ . . . . . . @ . @ . . . . @
@ . . . @ . . @ . . . . @ . @ @ . . . . . . . . @
@ . . . @ @ . . . . @ . . @ . . . . @ . . @ . . @
@ . . . . . . . . @ . . . . . . @ . . . . @ . . @
@ . @ . . @ . . . . . . . @ . . . . . . . . @ . @
@ . @ . . @ . . . . . . @ . @ . . @ . . @ @ . @ @
@ . . . . . . . . . . . . @ . . . . . . @ . . . @
@ . . . . @ . . . . . . @ . . @ . . @ . . . . . @
@ . . . @ . . . . . . . . . @ . . . . @ . @ . . @
@ . . . . . . . . . . . . . . . @ . @ . . . . . @
@ . . @ . . . @ . . . @ . . @ . . @ . . @ . . . @
@ . . . . . @ @ . . . . . . . . . . . . . @ @ @ @
@ . . . . . . . . . . . @ . @ . . . . . . . @ . @
@ . . . . @ . . @ . . . @ . . . . . . . . . . . @
@ . . . . . . @ . . . . . . . @ @ . @ . . . . . @
@ . @ @ . . . . @ . . . @ . . . . @ . . . @ . . @
@ . @ . @ . . . @ . . . @ . . . @ . @ @ . . . . @
@ . . . . @ . . . . . @ . . . @ . . . . . . . . @
@ @ @ @ @ @ @ @ @ @ @ @ @ @ @ @ @ @ @ @ @ @ @ @ @
3
4 1 3 12
1 6 3 14
8 7 12 22
