25 25
@ @ @ @ @ @ @ @ @ @ @ @ @ @ @ @ @ @ @ @ @ @ @ @ @
@ . . . . . . . . . . . . . @ . @ . . . . . . . @
@ . . . . @ . @ . @ . . . @ . . . . . . . . @ . @
@ . . . . @ @ . . . . . . . . . . @ . . . . . @ @
@ @ . . @ . @ . . . . . . . . . @ . . . . @ . . @
@ . . . @ . . . . . . . . . . @ . . . . @ . . . @
@ . . . . . . . . . . . . . . @ . . . . @ . @ . @
@ . . . . . . . . . . . . . . . . . @ . . . . . @
@ . @ . . . . @ . . . . . . . . . . . . @ . . . @
@ . . @ . . . . . . . . . . . . . . @ . . . . . @
@ @ . . @ . . . @ . . . . . . @ . . . . . . . . @
@ . @ . @ . . . . . . . @ . @ . . . . . . . . . @
@ . . . . . . . . . . . . . . . . @ . . . @ . . @
@ . . . . . . . . . @ . @ @ . @ . @ . . . . @ . @
@ . . . . . . . . . . . . . @ . . . @ . . @ . @ @
@ . . . . . . . . @ . . @ . @ . @ . . . . . . . @
@ . . . . . @ . . . . . . @ . . @ . . . . . . . @
@ . . . @ . . . . @ . . . . . . . . . . . . . . @
@ . . . . . @ @ . . . @ . . . . . . . . . . . . @
@ . . . . . . . . . . . @ @ . . . . . . . . . . @
@ . . . . . . . . @ . . . . . . . @ . . . . . . @
@ . @ @ . . . . . @ @ . . . . . . . @ . . @ . . @
@ . . . . . . @ . . . . . . . @ @ . . @ . . . . @
@ . . . . . . . . . . . . . @ . @ . . . . . . . @
@ @ @ @ @ @ @ @ @ @ @ @ @ @ @ @ @ @ @ @ @ @ @ @ @
3
6 6 9 12
1 20 12 18
20 6 8 13
