100 100
@ @ @ @ @ @ @ @ @ @ @ @ @ @ @ @ @ @ @ @ @ @ @ @ @ @ @ @ @ @ @ @ @ @ @ @ @ @ @ @ @ @ @ @ @ @ @ @ @ @ @ @ @ @ @ @ @ @ @ @ @ @ @ @ @ @ @ @ @ @ @ @ @ @ @ @ @ @ @ @ @ @ @ @ @ @ @ @ @ @ @ @ @ @ @ @ @ @ @ @
@ . . . . . . . . . . . . . . . . . @ . . . . . . . . . . @ . . . . . . . . . . . . . . @ . . . @ . . @ . . . . . . . . . @ . @ . . @ . . . . . . . . . @ . . . . . . . . @ . . . . . @ . @ . . . @ @ @
@ @ . @ @ . . . @ @ . . . . . . . . . . . . @ . . @ . . @ . . @ . @ . . . . . . . . . @ . . . . . . . . . . . . . . . . @ @ . @ . . . . @ . . . . . . @ . . . . @ . . . . . . . . @ @ . @ @ . . . . @ @
@ . @ . . @ . . @ . . . @ . . . . . @ @ . . . . @ . . . . . . . . . . . . @ . . . . . . . . @ . . . . . . @ @ . . . . . . . . . . . @ . . . . . . . . . . @ . . . . . . @ . . . @ . . . @ . . . . . . @
@ @ . . . . . . @ . @ . . . . . . . . . . . . . . . @ . . @ . . . . . . . . . . @ . . . . . . . @ @ . @ . . @ . . . . . . . . . . . . @ . @ . . . . . . . . . . . . . . @ . . . . . . . . . . @ . . . @
@ . . . . . . . . . . @ . . . . @ . . . . . . . . @ . @ . . . . @ . . . . . . @ . @ . . . . . . . . . . . . . @ . @ . . . . . . . . . . @ . . . . . . @ @ @ . . @ . . . . @ . @ . @ . . . . . . . . . @
@ . . . . @ . . . . @ . . . . . . . . . . . @ . . . . . . . . @ . . . @ . . . . . . . . . . . . . @ @ . . . . . . @ . . . @ . . @ @ . @ . . . . . . @ . @ . . . . . . . @ . @ . . . @ . . . @ @ . @ @ @
@ . . . . . . @ . @ @ . . . . . . @ . . @ . . . . . . @ @ . . . . . . . . . . @ @ . . . @ . . . @ . @ . . . @ . . . @ . . . . . . . @ @ . . . . . . . . . . . . . . . . . . @ . . . . . . . . . @ . . @
@ . @ . . . . . . . . . . @ . . . . . . . @ . . @ . @ . . . @ . . . . @ . . . @ @ . . . . . . . . . @ . . @ @ @ . . . . . . . @ . . . @ . . . . . @ . . . . . . . @ . . . . @ . . . . @ . . . @ . . . @
@ . . . . @ . . . . . . . . @ . @ . . . . @ . . . . . . . . @ . . . . . . . . @ . . . . . . . . . . . @ . . @ . . . @ . . . . . @ . . . . . . . . . . . @ . . . @ . . . @ . @ . . . . . @ @ @ . @ . . @
@ . . . @ . . . . . . . . . . @ . . @ . . . @ . . . @ . . @ . . . . . . . . . . . . . . . . . @ . . @ . . . . @ . @ . @ . . . . . . @ . . . . . @ . . @ . @ . . . . . . @ . @ . @ . . . . . . . . . . @
@ . . . @ . . . . . . . @ . . . . . . . . . . . @ . . . . . . . . . . @ @ . . . . . . . . . . . @ @ . @ . . . . . . . . . . . . . @ . . . @ . . @ @ . . . . . . . @ @ . . @ . . @ @ . @ . . . . @ . . @
@ . . . . . . . . . . . . . @ @ @ . @ . . . . . @ . @ @ . . @ . @ . @ . . . . . . . @ . . @ . . . . . . . @ @ . . . . . @ . . . . . @ . . . . . . . . . . @ . . . . . . . . . @ . . @ . . . . . . @ . @
@ @ . . . . . . . . . . . . . . . . . @ . @ . @ . @ . . . @ . . . . . @ @ . . . @ . . . @ . @ . . . . . @ . . . . . . . . . . @ . . . . . @ . @ . . . . . . . . . . . @ . . . . @ . . . . . . . . @ . @
@ . @ . . . . . . . . . . . @ @ . . . . . . . . . . . . . . . . . . . . . . . @ . . . . . . . . . @ . . . @ . . @ . . . . . @ . . . . . . . . . . . . . . . @ . . . . . . . . @ . . @ . @ . . . . . . @
@ . . . @ . . . @ . . . . @ . . . . . @ . . . . @ . @ . @ . @ . @ . . . @ @ . . . . . . . . . @ . . . @ . @ . . . . . . . . . . . @ @ . . . . . . . @ . . . . . . . . . . @ . . . . @ . . @ . @ . . . @
@ . @ . @ @ @ @ . . . . . . . . . . . @ @ . . . . . . . @ @ . . @ . . . . . @ . . . . . . . . . . . . . . @ . . . . . . @ . . . . . . . . . . . @ . . . @ @ @ . . . . . . . . @ . . . . . . . @ . . . @
@ . @ @ @ . . . . . . @ @ . . . . . . . . . . @ . @ . . . . . . . . . @ @ . . . . @ . . . . . . @ . @ . . . . @ . . @ . . . . @ . . . . . . @ . . . . . . . . . . . . . @ . . . @ . . . @ . . . . @ . @
@ @ . . @ . @ . . . . . . . @ @ . . @ . . . . . @ . @ . . . . . . . . . @ . . @ . @ . . . . . . . . . . . @ . . . . . @ . @ . . . . . . . . . @ @ . . . . . @ . . . @ . . . . . . . . @ . . . @ @ . . @
@ . . . . @ @ . . . . . . . . . . . . . . . . . . . . @ . . . . . . . . . . . . . . . . . . @ . . @ . . @ @ . . . . . . . . . . . . . . . @ . . . . . @ . . . . . . @ @ . @ @ . . . . . . . @ . @ @ @ @
@ @ . . . @ . . @ . . . @ . . . . @ . . . @ . @ . @ @ @ . . . @ @ . . . . . @ . @ @ . . . . @ . . . . . . . . @ @ . . . @ . . @ . . @ . . @ . . . . . . . . . @ . . . . @ . @ . @ @ . . . . . . . . . @
@ @ . . . @ @ . . . . . . . . . . . @ . . . . . . . . . . . . . . @ @ . . . . @ . . @ . . . . . . . @ . . . @ @ @ . . @ . . . . . @ . . . @ @ . . . @ . . . @ . . . . . . . . . @ . . . @ . . @ . . @ @
@ . @ . . @ . . . . . . . . . . . . . @ . . . . . . . . . @ . . . @ . @ . @ . . . . . . @ . . . @ . . . . . . . @ . . . . . . . @ . . @ . . . . . @ . . @ . . . @ . . @ . . . . . . . . . . . . @ . . @
@ . . . . . . . . . @ . . . . . . . . . . . . @ @ . . . . . . . . @ . . . . @ . . . @ . . @ @ . . . . . . . . . . . . @ . . . . . . @ . . . . @ . @ . . . @ . . . @ . . @ @ . . . @ . . . @ . @ . . . @
@ @ . . . . @ . . . . . @ @ . . @ . . . . . @ @ . @ . . . . @ @ . . . . . . . . . . . @ . . . . . . . . . @ . . . . . . @ @ . . . . . . . @ . . @ . @ . . @ . . . . . . . @ . . . . . . . . . . @ @ . @
@ . . . . @ @ . . . . . . @ . @ . . @ . . . . . . . @ . . . . . . @ @ . . @ . . . . . . @ . @ @ . . . @ . . . . . . . . @ . . @ @ . . @ . . @ . . . @ . @ . . @ . . @ @ . . . . @ . . . @ . . . @ . . @
@ . . . . . . @ . . . . . @ . . . . . . . . . . . . . . @ @ . @ @ . . . @ . @ . . . @ . . . @ . . . @ . . @ . . . . . . . . . . . . @ . . . . . . . . . . . . . @ . . . . . @ . . . . @ . . . @ . . . @
@ . . . . @ . @ @ . @ . @ . . . . . . . . . . . . . . . . . . . . . . . . . . @ @ . @ . . . . . . . . . . . . . @ @ . . . . . . . . . . . . @ . . . . . . . . @ . . @ . @ @ . @ . . @ . . . @ . . . . @
@ . . . @ . . @ . . . . . . . . @ . @ . . . @ . @ . . . . . . . . . . . @ @ @ . . . . . . . . . . . . . @ . . . . . . . . . . . . @ . . . . . . . . . . . . . . @ . . . . . . . @ . @ . . . . . . @ . @
@ . . . . . . . @ . . . . . . . @ . . . . . . . . . . . @ @ @ . . . . . @ . . . . . . . . . . . @ @ . . @ . . . . @ . . @ @ . . . . @ . . @ . . . . . @ . . . . . @ . . . . . @ . . . . . . . . . . . @
@ . . . . @ . . . @ . . . @ . . . @ . @ . . . . . @ . @ . . . . . @ . . . . . . . @ . . . @ . . . . . @ . . . . . . . . . @ . . . . . . @ . . . . . . . @ @ . . . . . . . . . . . . . @ @ . . . @ . . @
@ . @ . . @ @ . . . @ . . . . @ . @ . . @ . . . . . @ . . . @ . . . . . . @ @ . . @ . . . . . . . . . . . @ . . . . . . . . . . . . . @ . . @ . @ . . . . . . . . . . . @ . @ @ . . . . . . . . . . . @
@ . @ . @ . @ @ . . . . . . . . . . . . . . . @ @ . . . . . @ . . . . . . . . . . . @ . . @ @ . . . . . . . @ . . . . . @ . . @ . . . . . @ . @ . . . @ . . . . . . . . @ . . . . . . . . . . . . @ . @
@ . . . . . @ . . . . . . @ @ @ . . @ . . . . . . . . @ . . . . @ . @ . . . . . . . . . . . . . . . . @ . . . @ . . @ @ . . . . . @ . . . . . . @ . . . . . . . . @ . @ . . @ . . . @ . . . . . . . . @
@ . @ . . . . . @ . . . . @ . @ @ . . . . . . . . . . . . @ . @ . . . . @ . . . @ @ @ . @ . . . @ . . . . @ . . . . . . . . . @ @ . . . . @ . . . . . . . . @ . . . . . @ . @ . . . . . @ . . . . @ . @
@ . @ . . @ . . @ . . . . . . . . . @ . . . . . . . . . . . @ @ @ . . . . . . @ . . . . . . . @ . . . . . . . . . . . . @ . . . @ . . @ . @ . . @ . . . . . . . @ . . @ . . . . . @ . . . . . . . . . @
@ . @ . . . . . . @ . . @ . . . . @ . . . @ . @ . . . . . . . . . . @ . . . @ . . . @ . . . @ . . . . . . . . @ . . @ . . @ @ . . . . . . . . . . . . . @ . . . . . . . . @ . . . . . . @ . . . . . . @
@ . . . . . . . . . . . . . . . . . . . @ . @ . @ . . . . . . . @ . . . . . . . . . . . . . . . . . @ . . . . . . . . . . . . . . . . . @ . . . . . . . . . . . . . . . @ . @ . . . . . . . . . @ . . @
@ . . . . . @ . . . . . . . . . . . @ . . . . . . . . . . @ . . . . . @ . . . . @ . . . @ . . . . . . . . . @ @ . . . . @ . . . . . . @ . . @ . . . . @ . . . . . @ . . . . . . . . . . . @ . @ @ . @ @
@ . . . . . . . . . . . . . . . . @ . . . . . @ . @ @ . . . . . @ @ . . . . . . . . . . . @ . . . . . @ . . . . . @ . . . . . . . . . @ . . . . @ . . . . @ . . . . . . . . . . . @ . . . . . @ . . . @
@ . . . . . . . . . . @ . . . . . . @ . . . . . @ . @ . . . . . @ . @ . . . . . . . @ . . . . . @ . @ @ . . . @ . . @ . . @ . . . @ . . . . . @ . . . . . . . @ . @ . . . @ . . . . @ . . @ . @ @ . . @
@ . . . @ . . . . . @ @ . . . @ . . . . . . . . @ @ . . . @ . . . . @ . @ . . . @ . @ . . . . . . . @ . . . . . . . . . . . . . . . @ . . . @ . @ @ . . . . . @ . . . @ . . . @ . @ . @ . . . . @ . . @
@ . . . . . . . . . . . . @ . . . . . . . . @ . . . . . . . @ . . @ . . . . . . @ . . @ @ . . . . . . . . @ . . . . @ . . . . . . @ . . . . . . . . . . . @ . . . . . . . @ . . @ . . . . . . . . @ . @
@ . . @ @ . . . @ . . . . . . . . . . . . . . @ . @ . . . @ @ . @ . . @ @ . . . . . . . . . . . . . @ . . . . @ . @ . @ . . . @ . . . . @ . @ . . . @ . . . . . . @ . . . . . . . . . @ @ . @ @ . . . @
@ . . . . . . @ . . @ . . . . . @ . . @ . . . . @ . . . @ . . . . . . . @ @ @ @ . . . . . . . . . . . . . . . . . . . . . @ . . @ . @ . . . . . . . . . . . . . @ @ @ @ . . @ . @ . . . . @ . . . . @ @
@ . @ . @ @ . @ . . @ . . . . . . . . . . . . . . @ . . @ @ . . . @ . . . . . . @ . . . . . . . . . . @ @ @ . @ . . . . . . . . . . . . . . . . . . . . . @ . . . . @ @ . . . @ . . . @ . . . . @ . . @
@ @ . . @ . . . . . . . . . . . . . . . . @ . . . . . . . . @ . . . . . . . @ . . . . . @ . . . @ @ @ . . . @ . . @ @ . . . . . . . . . . . @ . . . @ . . @ . @ . . . . @ . . . . . @ . @ . . . . . . @
@ @ . . . . @ . . . @ . . @ . @ . . . . . . . . . . . @ @ . . . . . . @ . . . . . . . . @ . . . . . . @ . @ . . . . . @ . . . . @ . @ . . . . . . . . . @ . . . . . . . . @ . . . . . . . . @ . . . . @
@ . . . . . @ . . . . . . . . . . . @ . . . @ @ @ . . . . . . . . . . . . . . . . . . . . @ . @ . . @ . . . . . . @ @ . . . . . . . . . @ . . . . . . . . . . . . . @ . . . . . . . . . . . . @ . . . @
@ . . . @ . . . @ . . . . . . @ . @ . . . . . @ . . . . . . . . . . . . . . . . . . . @ . . . . . @ . @ . . . . . . . . . . . @ . . @ . . . . @ . . . . . @ . . . @ . . . @ . . . . @ . . . . . . . . @
@ . . . . . . . . . @ . . . . . . . . . . @ . . . . . . . . . . . . @ . . . . . @ . . . . @ @ . . . . . . . @ . . . @ . @ @ . . . . . . . . . . . . . . . . . . . . @ . . . . . . . . . . @ @ @ . @ . @
@ . . . . . . . . . . . . . . . . . . @ . . . @ . . @ @ . @ . . . . @ . @ . . . . . . . @ . . @ . . . . . . . @ . @ . . . . . . . . . . @ . . . . . . . . . . @ . . . . . . . . . . . @ . . . . . . . @
@ @ . . . . . @ . . . . . . . . . . . @ . . . @ . . . . . @ . @ . . . . . . . @ . . . . . . . . . . . . @ . . . . . . @ . . . @ @ . . . . @ @ . . . . . . . . . . . . . . . @ . . . . . . . . . . @ . @
@ @ . . . . . . @ . . @ @ . . . . . . @ . . @ . . @ . . . . . . . . . . . . . . @ . . @ . . . @ . . . . . @ . . . . . . . @ . . . . . . @ . . . @ . @ . . . @ @ . . . . @ . . . . . . . @ @ . . . . . @
@ . @ . @ . . . . @ @ . . . . . . . . . . @ . . . . . . . . . . . . . @ . . . . . . . . . . @ . @ @ . . . . @ . . . @ . @ . . . . . . . . . . . . . . . . . . . @ . . . @ . @ . . . . . . . . . . @ . @
@ @ . . . . . @ . . @ . . . @ . . . . . . . . . . . @ @ @ . @ . . . . . . . . . . . @ . . . . . . @ . . . . . . . . . . . . . . @ @ @ @ @ . . . @ . . . . @ . . . @ . . . . . . . @ @ . . . @ . . . @ @
@ . . . . . . . . . . @ . . . . . . . @ @ . . . . . . . . . . . . . . . . . . @ . . . . @ . . . . . . . @ . @ . . . . . . . . . . . . . . . . . . . . . . @ . . . . . @ . @ . . . . . . @ . . . . . . @
@ . @ . . . . . . @ . . . @ . . @ . @ . . . . . . @ . . . . . . . . . . @ . . . . . @ . . @ @ . . . . . . . . . . @ . @ . @ . . . . @ . . . . . . . . . . . . @ . . . . . @ . . . @ . @ . . . . . . @ @
@ . . @ . . . . . . @ . . . . . . . . . . @ . . . . . . . . . . . . @ . . . @ @ . . . . . . . . . . . . . . . . . . . . . . @ . @ . . . @ @ . @ . . . @ . . . @ . . . . . . . @ . . . . . . . . . . . @
@ . . . . . . . . . . . . . . . . . . . . . . @ . @ @ . . @ . . . . @ . . . . . . . . @ . . . . . . . . . @ @ . @ . . . . @ @ . . @ . . . . . . @ . . @ . . . . . . . . . . . . . . . . . . . . . . . @
@ . . . . . @ . @ . @ . . . . . @ @ . . . . . . . . . @ . . . . . . . @ . @ @ . @ . . . . @ . . . . . . . @ . @ . @ . @ @ . . . . . . . . . . . . . . . . . . . . @ . . . . . . . . . . . . @ . . . . @
@ . . . . . . . . . @ . . . . . . . . . . @ . . @ . . . @ . . . . @ @ @ . . @ . @ . . @ . . . . . . @ . . . . . . . . @ . @ . . @ @ @ . . . . @ . . . . . . . . . . . . . . . . . . . . @ . @ . . . . @
@ . . . . . . . . @ . . . . . . . . . . . . . . . . . . . . . . . . @ . . @ . . . @ . . . @ . @ . @ . . . . . @ . @ . . . . @ . . . . @ . . . @ . @ . . . @ . . . . . . . . . . . . . . . . . @ . . . @
@ . . @ . . . . . . . . . . . @ . . @ . @ . @ . . . @ . . @ . @ . . . . . . . . . @ . . . . . . . . . . . . . . . . . . @ . . @ . @ . . . . . . . . . @ . . . @ . . . . . . . @ . . . @ . @ . @ . . . @
@ . . . . . . @ . . . @ . . . . . . . . . . @ @ @ . . . . . . . . . . . @ . . . . . @ . . . . @ . . . . . . . . . @ . @ . . . . . . . . . . . . . . @ . @ @ . . . . . . . . . . . . . . . @ . . . @ . @
@ . . . @ . . . . @ . . . . . . @ . @ @ . @ . . @ . . . . @ . @ . . . . . . . . . . . . . . . . @ . . . . . @ . . . . . . . . . . . . . . @ . @ . . . . . . . . @ . . @ . . . . . . . . @ @ . . . . . @
@ . . . . @ . @ . . . . @ . . . . @ . @ @ . . . . . @ . @ . . . . . . @ . . . . . . . . . @ . . . . . . . . @ . . @ . . . . . . . . @ . . . @ . . . . . @ @ . . . . . @ . . . . . . . . @ . . . . . . @
@ . . . . . . . . . . . . . . . @ . @ . . . . . . . . . . . @ . @ . . @ . . . . . . . . . . . . . @ . . . . . . . . . . . . . @ . . . . . @ . . . . @ . . . . . . @ . . . . . . @ . . @ . . . . . . . @
@ . . @ . @ . @ . . . . . . . . @ @ . . . . . . . . . . . @ . . . . . . @ . . . . . . . @ . . . . . . . . . . . @ . . @ @ . . @ . . @ @ . . . . . . . . . . . . . @ . @ @ . . . @ . . . @ @ . . . . . @
@ . @ . . @ . . . . . . . @ @ . . . . @ . . . @ . . . . @ . . . @ . . . . . . . . . @ . . . . . @ . . . . . . @ . @ . . . . @ . . . . . . . . . . . . . . @ . . . . . . . . @ . . . @ . @ . . . . @ . @
@ . . . @ . . . . . . . . . . . . . . . . . @ . . . @ . @ . . . . . @ . . . @ . . . . @ . . . . @ . . . . . @ @ . . . . @ . . . . @ @ @ . . . . . . . @ . . . . . . . . . @ . . . . . . . . @ @ @ . . @
@ . . @ . . . . . . . @ . . @ . . @ . @ . @ . @ . . . @ . . . . . @ . @ . . . . . . . @ . . . @ . @ @ . . . @ . . . . . . . . . . . @ . . @ . . . . . . . . . . . . . . . . @ . . . @ . . . . . . . . @
@ . . . . @ . . @ . . . . . . . . . . . . . . . @ . . . @ . . . . . @ . . . . . . . . . @ . . . @ . . . . . . . @ . . @ . @ @ . @ . . . . . @ . . . . . . . . . @ . . . . . . . . @ . . . . . . . @ . @
@ . . . . . . . . . . . . @ . @ @ . @ . . . . . . . . . . . . . @ . . . @ . . @ @ . . @ . . . . . . . . . . @ . . @ . @ . . . . . . @ . @ . . . . . . . . . @ . . @ . . . @ . . . @ . . @ . . . . . @ @
@ . . . . . . . . . @ . . . . . . . . . . . . @ . . @ . . . . . . . @ . . . @ . . . @ . . . @ @ . @ . . . . . . . . . . @ . . . . @ . . . . . . . . . . . . @ . . . @ @ . . . . . . . . . . . . . . . @
@ . . . . . . . . @ . @ . . @ @ . @ @ . @ . . . . . . . . @ @ @ . . . . . @ . . . . . . . . . . . . . . . . . . @ . @ . . . @ . @ . @ . . @ . . . . . . . . . . . . . . @ . @ . . @ @ . . . . @ . @ . @
@ . . . . @ . @ . . . . . . @ . . . . @ . @ . @ . @ . . . . . . . . . . @ . . . . . @ . . . . @ . . . . . . @ . . . . . . . . @ . . . . . . . . . . . . . . . . . . . . @ . . . . . . . . . . . . . . @
@ @ . . @ . . . . . . . . . @ . . . . . . @ . . . . . . . . . @ . . . . . . @ . @ @ . . . . @ . @ . . . @ @ . . . . . . . . . . . . . . . . . . . . . . . . . . . . . . . . . . . . @ . . . . . . @ . @
@ . . @ . @ . . @ . . . @ . . . . @ . . . . . . . . . . . . . . @ . . . . . . . . . . . . @ . @ . @ . @ . . . @ . . . . . @ . . . . . . @ . . . . . . . . . . . . . . . . . . . . . . . . . . @ . . . @
@ . . . . . . . . @ . . . @ . . . . . . . . . . . @ . . . . @ . . . . . . . . @ . . . . @ @ . @ . . . . . . . @ . . . . @ @ . . . . . . . @ @ . . . . . . . . . . . . . @ @ . . . . @ . . @ . . . . . @
@ . @ . . . . @ . @ . . . . . . . . . . @ . . @ . . . . . . . . . @ . . . . . @ . . @ . . . @ . @ . . @ . @ . . @ . . @ . . . @ . . . . @ . . . @ . . . . . . @ . . . . . . @ . . . . . . . . . @ . @ @
@ @ . @ @ . . . . . @ . . . . . . @ @ @ . . . . . @ . . . . . . . . . @ . . . . . . . . . . @ . . . . @ . . . . . . . . . . @ . @ . @ . @ . @ . . . . . . @ . . . . . @ . . . . @ . @ . . @ . . @ . . @
@ . . . @ . . . @ . . . @ . . . . . . . . . . @ . . @ @ . . . @ . . @ . . . . . . . . . . . . @ . . @ . . @ . . . . . . . . @ . @ . . . . . . . . . . @ . . . . . . . @ . @ . @ . @ . @ . . . @ @ @ . @
@ . . . . @ . . . . . . . . . . . . @ . . @ @ . . @ . @ . . . . . . . @ . . . . . @ . . . . @ . . . . @ . . @ . . . @ . . @ . . . . . . . @ . . . . . . . . . . . . @ . . . . @ . . . . . . . . . . . @
@ . . . . . . . . . . . . . . @ . @ . @ . . . . . . . . . @ . . @ . . . . . @ . @ . . @ . . . . . . . . @ . . . . @ . . . @ . . . . . . . . . . . @ @ . . . . . . . . . @ . . @ . . . . . . . @ . . . @
@ . . . . . . . . . . . . . . @ . . . . . @ . . . . . @ . . @ @ . . . . . . . @ . . . . . . . . . @ @ . . . . . . . @ . . @ . . . . . . . . @ . . . . . . . . . . . . . . . . . . @ . . . . . @ . @ . @
@ . . @ . @ . . @ . . . . @ . . . . . . @ . . @ . . . . . @ . . . . . . @ @ . . @ . . @ . . @ . . . . . . @ . . . . . @ . @ . . . @ . @ . . . @ . . . . . . . @ @ @ . @ . . @ @ . . . . @ . . . . @ @ @
@ . . . @ . . . . @ . . @ . . . . . . . . . @ . . . . . . @ . . . . . . . . . @ . . . . . @ . . . . . . . @ @ @ . . . . @ . . @ . . . @ @ . . . . . . @ . @ . . . @ . . @ . . . @ @ . . @ . . . . @ . @
@ . . . . . . . @ . . . . @ . @ . . . . . . . @ . . . . @ . . @ . . . . . . . . . . . . . . @ . . . . . . . . @ . . . . . @ . . . @ . . . @ . . . . . . @ . . . . . @ . . . . . . . . . . . . . . @ . @
@ . @ . . @ . . . . . . @ . . . . @ . . . . @ . @ . @ . . . @ . . . . . . @ . @ . . . . . . @ . . . @ . . . . . . . . . . @ . . . . . . . . . . @ @ . . . . . . @ @ . . @ . . . . . . . . . . @ . . . @
@ . @ @ . . @ . . . . @ . . @ . @ . . . . . @ . . . . . . . . . @ . @ . . . . . . . @ . . . . . . . . . . . . . . . . . . . @ . . . . . . . . . @ . . . . . . . . . . @ . . . @ . . . @ . . . @ @ @ . @
@ . . . . . . @ . . . . . . . . . . . . . . . . @ . @ @ . @ @ . . . @ @ . @ @ . . . . @ . . . @ . @ . @ . . . . . . . . . . @ . . @ . @ @ . . . . . . . . . @ . . @ . . . . @ @ . . . . @ . . . . . . @
@ . . . . . . . . . . . . @ . . . @ . . @ . . . . . . . . . . . . @ . @ . @ @ . . . . . . . . . . @ @ . @ . . . . . . . . . . . . . . . . . . @ . . . . @ . @ . . @ . @ . . . . . . . . @ . . . . . . @
@ @ . . . . . @ . . . . . . . . . @ @ . . . . . . . . . . . . . . . . . @ . @ . @ . @ . . @ . @ . . . . @ . . . . . . . . . . . . . . . . @ . . . . . . . . . . . . . . . . . . . . . . . . @ . . . . @
@ . . @ . @ @ . @ . . . . @ . . . . . . . . . . . . @ . . . . . @ . @ . . . . . @ . . . . . . . . . . . . . . . . . . @ . @ . . . . . . . . . . . . . . . . . @ . . . . . . . . . . @ . . . . . . . . @
@ . . . . . . @ . . . . . . . @ . . . @ @ . . @ . @ . @ @ . . . . . . @ . . . . . . @ . . . @ . . . . . . @ . . . . . . . . . . . . . . . . . . . . . . . @ . . . . @ . . . @ @ . @ . . . @ . @ . . . @
@ @ . @ . . . . @ @ . @ . . . . . . . . @ . @ . . . . . . . . . . . . . . @ . @ @ . . . . . . . . . . . . . . @ . @ . . . . . . @ . . . @ . . @ . . @ . . . . . . . . . @ . . @ . @ . . . @ @ . . . . @
@ . @ . . @ . . . . . . . @ . . . @ . . . . @ . . . . . . @ . . . . . . @ . . . . @ @ . . . . . . @ . . . . . . . . . . . @ . . . . . . . . . . . . @ . . @ . . @ . . . . . . . . . . . . . . . . . . @
@ . . . . @ . . . . . . . . @ @ . . @ . . . . . . . . . . . . . . . @ . . . . . . . @ . @ . . . . . . . . . . . . . . . @ . . . . . . . . . . . . . . . . . . . . . . . . . . . . . . @ . . . . . . . @
@ @ @ @ @ @ @ @ @ @ @ @ @ @ @ @ @ @ @ @ @ @ @ @ @ @ @ @ @ @ @ @ @ @ @ @ @ @ @ @ @ @ @ @ @ @ @ @ @ @ @ @ @ @ @ @ @ @ @ @ @ @ @ @ @ @ @ @ @ @ @ @ @ @ @ @ @ @ @ @ @ @ @ @ @ @ @ @ @ @ @ @ @ @ @ @ @ @ @ @
3
17 77 35 79
30 82 75 92
26 92 19 39
