25 25
@ @ @ @ @ @ @ @ @ @ @ @ @ @ @ @ @ @ @ @ @ @ @ @ @
@ . . . . @ . . . . . . . . . . . . . . . . . . @
@ . . @ . . @ . . . . . . . . @ . . . . . @ . @ @
@ . . . . @ . . . @ @ . . . . . . . . @ . . . . @
@ . . . . . . . @ . . . . . @ @ . . . . . . @ . @
@ . . . . . . @ . . . . . @ . . . @ @ . . . . . @
@ . . . . . . . . . @ . . @ @ . . . @ . @ @ . . @
@ . . . . . . . . . . @ . . . . @ . . . @ . . . @
@ . . . . . . . . . . . @ . . . . @ . . . . . . @
@ . . . . . @ . . . . . . . . @ . . . . . . . . @
@ . @ . . . . . . @ @ . . . . . . @ . . . . @ . @
@ . . . . @ . . @ . @ . . . @ . . @ . . . . . . @
@ . . . . @ . @ . . . . . . . . @ . @ @ . @ . . @
@ . . . . . @ . . @ . . . . . . . . @ . . . @ . @
@ . . . . @ . . . . @ . . . . . . . . . @ . . . @
@ . @ . @ . . . . . . . . . . . . @ . . . . . . @
@ . @ . . @ . @ . . . . @ . . . @ . . . . . @ . @
@ . . . . . @ @ . . . . . . . . . . . . . . . @ @
@ . . . . . . . . . . . . . . . @ . . . . . @ . @
@ . . . @ . . . . . . . . . @ . @ . . . . . . . @
@ . . . @ . @ . . @ @ @ . . . . . . . @ . @ . . @
@ . @ . . . . . . . . . . . . . . . . . . . . . @
@ . . . . . . . @ . . . . @ . . . . . . . . . @ @
@ . . . @ . . . . . . @ . . . . . . . . . . . . @
@ @ @ @ @ @ @ @ @ @ @ @ @ @ @ @ @ @ @ @ @ @ @ @ @
3
2 13 11 19
20 2 3 21
9 8 17 1
