100 100
@ @ @ @ @ @ @ @ @ @ @ @ @ @ @ @ @ @ @ @ @ @ @ @ @ @ @ @ @ @ @ @ @ @ @ @ @ @ @ @ @ @ @ @ @ @ @ @ @ @ @ @ @ @ @ @ @ @ @ @ @ @ @ @ @ @ @ @ @ @ @ @ @ @ @ @ @ @ @ @ @ @ @ @ @ @ @ @ @ @ @ @ @ @ @ @ @ @ @ @
@ . . . . . . . . . . . . . . . . @ @ . . . . . . . . . @ . . . @ . . @ . . . @ . @ . . . . . . . . . . . . . . @ . @ . . . . . . . . . . @ . . . . . @ . . . . . . . @ @ . . . . . . . . . . @ @ . . @
@ . . @ . . . . . @ . . . . . @ . . @ . . . . . . . . . . . . @ . . . @ @ . . . . . @ . . @ . . . @ . . . @ @ . . . . . . . . . . . . @ . . . . . . @ . . . . . . . . . @ . . . . . . . @ @ . . . . . @
@ . . . . . . . . . . @ . . . @ . . . . . . @ . . . . @ . . @ . . . @ . . . . . . @ . . . . . . . @ . . . . . . @ . . . . @ . . @ . . . . . @ . . @ . . . . . . . @ . . . . . . . . . . . . . . @ . . @
@ . . . . @ . . @ @ . . . . @ . @ . . . . . . . . . . . . . . @ . . @ . . . . . . . . . . . . . . @ . @ . . . . . . . . . . . . @ . . @ . . . . . . . . . . @ . . . . . . . . . . . . . . . . . . . . @
@ . . . @ . . . . . . . @ . . . . . . . . . . . @ . . . . @ . . . . @ . . . . @ @ @ . @ . . . . . . . . . . @ . . . . . . . . . . . @ . . . . @ . . . . . . @ . @ . . . . . . . . @ . . . . . . . . @ @
@ . . . . . @ . . @ @ . . . . @ . . . @ . . . . @ . . . . . . . . . . . . . . . @ . . . @ . . . . . . . @ @ . . . . @ . . @ . . @ @ . . @ @ . . . . . . . . . . . . . . . . . . . . . . . . . . . . . @
@ . . . . @ . @ . . . . @ . @ . . . . . @ . . . . . . . . . . . . . . . . @ . . @ . . . @ . . . . . . @ . . . @ . . . @ . . . . @ . . @ . . . . @ . @ @ . . . @ . . . . . . . . . . . @ . . . @ . . . @
@ . . . @ . . . . . @ . . . @ . . @ . . @ . . . @ . . . . @ @ . . . . . @ . . . . . . . . . . . . . . . . . . @ . @ . . . . . . . . . . @ . @ . . . . . . . . . . . . @ . . . . . . . @ . . . . . . . @
@ . . . . @ . . . . . . . . . @ . . . . . . . . @ . . . . . @ . . . @ . @ . . . @ . . . @ @ . . . @ . . @ . . . @ . . . . . . . @ @ . . . . @ @ . . @ @ . @ . . @ . . @ @ . . . @ . . . . . @ . . . . @
@ . . @ . . . . . . . @ . . . . . @ . . . @ . . . . . . . . @ . . . . @ . . . . . . . @ . @ . . . . @ . @ . @ . . . . . . . . @ . . . . @ . . . . @ . . . . . . . . @ . . @ . . @ . . @ . . . . . . . @
@ @ . @ . . . . . . . . . . @ . . . @ @ . . . . . . . . @ @ . . . . @ . . . . . . . . @ . . . . . . @ . . . . . . . . . . . . . . . . . . . . . . . . . . @ . . . . @ . . . @ @ . . . . . . @ . @ . . @
@ . . . . @ @ . . . . . @ . . . . @ . . . . @ . . . . . . . . . . . . . . . . . . @ . @ . . . . . @ . . . . . @ . @ @ @ . . . . . . @ . . . . . . . . @ . . . . . . . . @ @ . . @ . . . . . . . . @ . @
@ . . . @ . . . . . . . . . . . . . . . . . . . . . . . @ . @ @ @ . . . @ . . . @ . @ . @ . . @ . . . . . . . . . @ . . . . . . @ @ . . . @ . . . @ . . @ . . . . . . . . . @ . . . @ . . . @ . . . @ @
@ . . . . . @ . . . . . . . . . . @ . . . . . @ . . @ . . @ . . . . @ . . . . . . . . . . . . . . . . . . . . @ . . . @ . . @ . . . . @ . . . . . . . . . . . . . . . @ @ . @ . . . . . @ . . . . . . @
@ . . . . . . . . . . @ . . @ . @ . . . . . . . . . . . . . . @ . . . . . @ . . . . . . . . . . . . . . . . . . . . . @ . . . . . . . . . . . . @ . . . @ . . . . . . . . . . . . @ . . @ @ . . . . . @
@ . . . . . . . . . @ . . . . . . . . . . @ . @ . . . . . . . . @ . . . . . @ @ . . . . . . @ . . . . @ @ . . . . . . . . @ . @ . . . . . . . . . . . . . . . . . . . . . . . . @ . @ . . . . @ . . . @
@ . . . . @ . . @ . . . . . . . . . . . @ . . . . . . . @ . . . . . . . . . @ . . . . . . . . @ @ @ . @ . . . . . . . @ . @ . . . @ . . . . . . @ . @ . . . @ . . . . . . . . . . . . . . . . . . . . @
@ . . @ . . . @ . . . . . . @ . . . @ . . . . . . . . . . @ @ . . . @ . . . . . . . . . . . . . @ . . . @ @ . . . . . . . . . . . . . . . @ . . . . . . . . . . . . . . . @ . . . . . . . . . @ . . . @
@ . . . @ . . . . . . . . . @ @ . . @ @ . . @ . . @ . . . . . . . . . . @ . . . . . . . . . . . @ @ . . . . @ @ . @ . . . . . . . . . . . . . @ . . . . . . @ . . . . . @ @ . . . . . . @ . . . . . . @
@ . . . . . . . . @ . . . . . . . . . . . . @ . @ . . @ . @ . @ . . @ . . . . . . . . . . . . . . . . . . . . . . . . . . . . . . . . . . . . . . . . . . . @ . . . . . . . . . . . . . . . . . @ . . @
@ . . @ . . . . . . . . . . . @ @ . . . . . @ . @ . @ . . . . . @ . . . @ . . @ . . . . . . . . @ @ . @ . . . . . . . . @ . . @ . . . . @ . @ . . @ . . . @ . . . . . . . @ . . . . . . . @ . . . @ . @
@ @ . . . . . @ . . . . . @ . . . . . @ . . . . . . . . . . . . . . . . @ @ . . . . . . . . . . . . . . . . . @ . . @ . . . . . @ @ . @ . . . . . . . . @ . . . . . . . . . . . . . . . . . . . . @ . @
@ @ . . @ . . . . . . . . . . . . . . . . . . . . . @ . . . . . . . @ @ . @ . @ . . . . . . . . . . . . @ . . . . . . . . . . . . @ . @ . . . . . @ . . . . . . . @ . . @ . . . . . . . . . . . . . . @
@ . @ . @ . . . . @ . . . @ . @ @ . @ . . . . @ . . . . . . . . @ @ . . . . . @ . . . . . . . . . . . . . . . . . @ . . . . . . @ . . . . . @ . . . @ . @ . . . . . @ . . @ . . . . . . . @ . . . . . @
@ . . . . . . . . . . . . . . . . . . . @ . . . @ . . . . @ . @ . . . . . . . @ . . . @ . . . . . . . . . . . . . . . . . @ . . . . @ . . . . @ . . @ @ . . . . . . . . . . . . @ . @ . . . . . . . . @
@ . @ @ . . . . . . . @ @ . @ . . . . @ . @ . . . . . . . . . . . . . . . . @ @ . @ . . @ @ . @ . . . . . @ @ . . . . @ . . . . . . . . . . . . @ . @ . . . . . . . . . . . @ . . . . . @ . . . . . . @
@ . . @ . . @ . . . . @ . . . . . . @ . . . . . . @ . . . . . . @ . . . . . . . @ . @ . . . . . . . @ . . . . . . . . . @ . . . . . . @ @ . . . @ @ . . . . . . . . . . . . . . . . . . @ . . . . . @ @
@ . @ . . . . @ . . . . . . . . @ . . . . . . . @ . . . @ @ . @ . . . . . . . @ . . . . . . . . . . . . . . . . . @ . . . . . . . . . . . @ . . . . . . . @ . . . . . . . . @ . . . . . . . . . @ . . @
@ . . . . . . . @ @ . @ . . . . . @ . . . . @ @ . @ . . @ . . . @ @ . . . @ . . . . . . @ . . @ . @ . . . . . . . . @ . . @ . . . . . @ . . . . @ . . . . . . @ . . . . . . . @ . . . . . . . . . . . @
@ . @ . . . . . @ . . . . @ . . . @ . . . . . . . . . . . . . . @ . @ . @ . @ . . . @ . . . . . . . @ . . @ . . . . . . @ . . @ @ . . . @ . . . . . . . . . . . . . . . . . . . . . . . @ . . . . @ . @
@ . . . . . . . . . . @ . . . . @ . . . @ . @ . . . . @ . . . @ . @ . . @ @ . . @ . . @ . @ @ . . @ . . @ . . . . @ @ . @ . . @ . . . . . . . . . . @ . . @ @ @ . . . . . . . . . @ . @ . . @ . . . . @
@ . . @ . . . . . . @ @ . . . . . . . @ . @ . . . @ @ . . . . . @ . . @ @ . . . . . . . . . . . . . . . . . . . @ . . . . . . @ . . . . . @ . . . @ . @ . . . @ . . . . . . . . . . . . . . @ @ . . . @
@ . . . . @ . @ . . @ . . . . . . . . . . . @ . . . . . . @ . @ @ . . . . . . . @ @ @ . . @ . . . . . . . . . . . . . . @ . @ . @ . . . . . . . . . . . @ @ . . @ . . . . . . @ @ . . . . . . . @ . . @
@ . @ . . . . . . @ . . . . @ . . . . . @ . . . . . . @ . . . . . . . . . . . . @ . . . . . . . . . . @ . . . . . . @ . . . . @ . . . . . @ @ @ . . . . . @ . . . . . @ . . . . . . . . @ . @ . . . . @
@ @ . . @ . . . @ . . @ . . . . . . . . . . . . . . . . @ . . @ . . . @ . . . @ . . . . . @ @ . . . . . . . . . . . @ . . . . . . . . . . @ . . . . . . . . . . @ . . . . . . . . . . . . . . . @ . . @
@ . . . . . . . @ . . . @ . . . . @ . @ . . . . @ . . . @ . . @ . . . . . . . @ . @ . . . . . . . @ . . @ . . . . . @ . @ . . . @ . . . @ . . @ . . . . . @ . . @ . . . . . . . . @ . . . . . . . . . @
@ @ . . . . . . . . . @ . @ @ . . . . . . . . @ . @ . . . @ @ . @ . . . . . . . @ @ @ . @ . . . . @ . . . . @ @ . . . @ @ @ . @ . . . . @ . @ . @ . . . . @ . . . @ . . . @ . . . . @ . @ . . . . . . @
@ . @ . @ . @ . . @ . . . . . . . . . . @ . @ . @ . . . . . . . . @ @ . . . . @ . @ . . . . . . @ . . . . . . . . . . . . . . . @ @ . . . . @ . . . . . . . . . . . @ . . . @ @ . . . . . . . . . . . @
@ . . . . . . @ . . . . . . . . . . . . . . . . . . . . . @ . . . . . . . . . . @ . . @ . . . . @ . . . . . @ . . . @ . . . . . . . . . . . . . . . . . . . . . . @ . @ . . . . . @ . . @ . . . . . @ @
@ . @ . . . . @ . . @ . @ @ . . @ . @ . . @ . . . @ . . @ . . . . . . . . @ . @ . . . @ . . . @ . . . . @ . . . . . . @ . @ . . . @ @ . . . . . . @ . . . @ . . . . . . . . @ . . . . . . . . @ . . . @
@ . . . . . . . . . . @ . . . . . . . . . . @ . . @ . . . . . . . . . . . . . @ . . . . . . . . . . . . . . . . . . . @ . . @ . @ . . . . . @ . . @ @ . . . . . . . . . . . . . @ . . . . @ . @ . . . @
@ . . . . @ . . . . . . . . @ . . . . . @ . . @ @ . . . . . . . . . . . . . @ . . . . . . . . . @ . . . . . . . . . . . . @ . . . . . @ . . . . . . . @ . @ . . . . . . . . @ . @ . @ @ . @ . @ . . . @
@ . @ @ . . . . . . @ . . . . . . . . . . . . . . . . . . . . . . . . . . . . . . . . . . . . @ . . @ . @ @ . . . . . . . . . . . . . @ . . . @ . . @ . . @ . . . . . . . . . @ . . . . . . . . . . . @
@ . . . . . . @ @ . . . . @ . . . @ . . . @ . . . . . @ . @ . . . . . . . . @ . . @ . . . . . . . . . . . . . . . @ . . . . . . . . . . . @ . @ . . . @ . . . . . . . @ . . . . . @ . . . . . . . . . @
@ . . . @ . . . @ . . . . . . . @ . . . . . . @ . @ . . @ . @ . . . . . . . @ . . . . . . . . . . . . . @ . . . . . @ . . @ . . . @ . . . . . . . . . . @ . . . @ . . . . . . . . . . @ . . . @ . . . @
@ . . . . . . . . . . @ . . @ . . . . @ . . . @ . . @ . . @ . . . @ . . @ . . . . @ . . @ . @ @ . . . . . . . . . . . . . . . . . . . . . . . . @ . . @ . . . . . . . @ . @ @ . . . . . . . . . . . . @
@ . @ @ . . @ . . . @ . @ @ . . . . . @ . . . . . . . . . . . @ . . . . @ @ . . . @ . . . . . . . . . . . . @ . . @ . . @ @ . . . @ . . . @ . . . . . . @ . @ . . . . . . . . . @ . . @ . . . @ . . . @
@ . . . . . @ . . . . . . . . . . . . @ . . . . @ . . @ . . . @ . . . . . @ . . . . . . . . . . @ @ . . . . . . . . . . . . @ . @ . . . . . . . . @ . @ . . . . . @ . @ . . . . . . . . . . . . . . . @
@ . . . . @ . @ @ . @ . . @ . . . . . . . . . . . . . . . . . @ . . . . . . . . . . . . @ . . @ . . . . . . . . @ . @ . . . . . . . . @ . . @ . . . @ . . @ . . . . . . . . @ . . @ . @ . . . . @ @ . @
@ . @ @ . . . . . . . . . @ . @ . . . @ . . . @ . . @ . @ . . @ . . . . . . . . @ . . . . . . . . . . . . . . . . . . . . . . . . . @ . @ . . @ . . . . . . @ . . @ . @ . . . . . . @ . . . . @ . . . @
@ . . . @ . . . . . . . @ . . . @ . . . @ . . . . . @ . @ . . . . . . @ . . . . . . . @ . . . . @ @ . . . . . . @ . @ . @ . . . . . . . . @ @ . . . . . . @ . @ . @ . . . . . . . . . . . @ @ . @ . . @
@ . . . . @ . . . . . . . . . . . . . @ . . . . @ . . @ @ . . . . . . . . . . . . . . @ . . . . . . . . . . . . . . . . . . . . . . @ . . . . . . @ . . . . . . . . . . . . . . . @ . . . . . . . @ . @
@ . . @ . . . . . . . @ . . . . . . . . . . @ @ . . . . . . . . . . . . @ . @ . @ . . . . @ . . . @ . . . . @ . . . . . . . . @ . . . @ . . @ @ . . . . . . . . @ . . @ . . . . . . @ . . @ . . . . . @
@ . . . . . . @ . . . . . . . @ @ . @ . . @ . . @ . @ . . . . @ . . . . . @ @ . . @ . . . . . . . . . . . . . . . . @ . . . . . . . . . . . . . . . . . . . . . . . . . . . . . . . . . . . . . @ . . @
@ . . . . @ . . . . . . . . . @ @ . . . . @ . . . . . . . . . . . . . . . . @ . . . . . . . @ . . . . . . . @ . @ @ . . . . . . . . . . . @ . @ . . . @ . . . . . . @ @ @ . . . @ . . . @ @ . . . . @ @
@ . . @ . @ . . . . . . . . . . . @ @ @ . @ @ . . . . . . . . . . . . . . . . . . . . . . . . . . . . . . . . . . . . . . @ . . . . . . . . . . . . . . . . . @ . . . . . . . @ . @ . . @ . . . @ . . @
@ @ . . @ @ . . . . . . . . . . @ @ . . @ . . . @ @ . @ . . . . . @ . . @ . . . @ . . . . . @ . . . . . . . . . . . . . . . . @ . . . . . . . . @ . . . . @ @ . @ @ . . . . . . . . . @ . . . . . . @ @
@ . . . . . . . . @ . . @ . . . . . . . . . . . @ . . . . . . . . . . @ . . . . . . @ @ @ . . . . . . . . . . . . . . . . . . . . . . @ . . @ . . . @ . . . . . . @ . @ . . . . . . . @ . . @ . . . . @
@ . . . . . . . . . . . . . . @ . . . . @ . . . @ . @ . . . . . . . . . . @ . . . . . . . . @ . @ . . . . . . . @ . . @ . . . @ @ @ . . . . . @ @ . . . . . . @ @ . . . @ . . @ . @ . @ . @ . . . . @ @
@ . . @ . . . . @ . . . . . . . @ . . . . . . . @ @ @ . . . . . . . . . . . . . . . . . . . . @ . . . . @ . . . . . @ . . . . . . . @ @ . . . . . . . . . . . . . . . . . . . . @ . @ @ . . . . . @ . @
@ . @ . @ . @ . . @ . . . @ @ @ . . . . @ . . . . . . @ . @ . . . . . . . . . . . . . . . . . . . . . . . . . . . . . @ . . . . . . . . . . . . @ . . @ . . . @ . . . @ . . . . . . . . . . . . . . . @
@ . . . . . @ . . . . . @ . . . . . . . . . . . . . . . @ . @ . . . . . . . @ . . . . @ . . . . . . . . @ . . . . . . @ . @ . @ . @ . . . . . . . . @ . . . . @ @ . . . . . . . . @ . . . . . . . @ . @
@ . . . . . . . . @ . . @ . . . . . . . . . @ . . . . . . . @ . . . @ . @ . . . . . @ . . . @ . . . @ . . @ . . . . . . @ . . . . . . . . . . . . . . . . . . . . . . . @ @ . . @ . . . . . . @ . @ . @
@ . @ @ . @ . @ . . @ . . . . . . . . . @ . @ . @ . . . . . . @ . . . . . . . . @ . . . . . . . . @ . . . . . . . . . . . . . . . @ . . @ . . . . . . . . . . . . @ . @ @ . . . . . . . . . . . . . . @
@ . . . . . . . . . . . . . . @ . . . . . @ @ . . . . . . . . . . . . . . . @ . . . . . . . . . . . . . . @ @ . . . . @ . . . . @ @ . . . . @ . . . @ @ @ . @ @ . @ . @ . @ . . . . . . . @ . . @ @ . @
@ . . @ . . . . . . . . . @ @ . @ . . . . . . . . . . . . . . . . . . . @ @ @ . . @ @ . . . @ . . . @ . . . . . . . @ . . . . . . . @ . . . @ . . . . . @ . . . . . . . . . . @ . . @ . . . . . . . . @
@ . . . . . . @ . . . . @ . . . . . . . . . @ @ . . . . . . @ . . . . . . . . . . . . . @ @ . . . . @ @ . . . . @ . @ @ @ . . @ . @ . . . . . @ . . . . . . . . . . . . . @ . . . . . . . . . . @ . . @
@ . @ . @ . @ . @ @ . . . . . . . @ . . . @ . . . . . . . . . . . . . . . @ . . . . . @ . . @ . . @ @ . . @ . . . @ . . . . . . . . . @ . . . . . . . . @ . @ . @ . . . @ . @ . . . . @ . . . @ @ . . @
@ . . @ . . . . . @ . . . . . . @ . @ . . . . . . . . . . @ . @ . . . @ . . @ . . @ . . . . . @ . . @ . . . . . . . . . . . . . . . . . . @ . . @ . . . . . . . . . . . . . @ . . . . . . . . . . . . @
@ . . . . . . @ . . . . . . @ . . @ . @ . . . . . . . . . . . . . . . . @ . . . . . @ . . . . . . . . @ . . . . . . . . . . . . . . . . . . @ . @ . . . . . . . . . @ . @ . . . . . . @ . . . . @ . . @
@ @ . . @ . . . . . . . @ . . . . . . . . . . @ . . . . . . . . . . @ @ . . . @ . . . . . @ . . @ . @ @ . @ . . @ . . . @ . . . . . @ . . . @ . . . @ . . @ . @ . @ . . . @ . . @ . . @ . . @ . @ . . @
@ . @ . . . @ . . . . . . . . . @ . @ . @ . . . . @ . . . @ . . . @ . . . . . . . . . @ . . . . . . . . . . . . . . . . . . . . @ . @ . @ . . . . . . . @ . . . @ . @ . . . @ @ . . . @ @ . . . . . . @
@ . . . @ . . @ . . . . . . . . @ . . . . . . . . . @ . . . . . . . . @ @ @ . @ . . . @ . . @ . @ . . . . . . . @ . @ . . @ . . . @ . . . . . . @ . . . . . . . . . . . . . . . . . . . . . . . . . . @
@ . . . . . . . . . . . . @ . . . @ @ . . . @ @ . . . . . . . . . @ . . . . @ . . @ . . . . . @ . . . @ . . . . @ . . . . . @ @ . . . . . @ . @ . . . . . . . . . . . . . . @ @ . . . . . . . . . . . @
@ . . . . . . . . @ @ . . . . . . . . . @ . . . . @ @ . . . . . @ . . . . @ . . . . . . . . . . . . . @ . . . . . . . . @ . . . . . . . . . . . . @ . . . . . @ . . . . @ . . . . @ . . . . @ @ . . . @
@ @ . . . @ . . @ . . . . . . . . . . . . . @ . . . @ . . . . . . . . . . . . . . @ . . . @ . . @ . @ . . @ . . . . @ @ . @ @ . . . . . . @ @ . . @ . @ . @ . . . . @ @ . . . . . . . . . . . . . . . @
@ . . . . . . . @ . . @ . . . . . @ . . . . @ . @ . . . . . . @ . . . . . . @ . @ @ . . . . . @ . . . . . @ . . . @ . . . @ . @ . . . . . . @ . . . . . . . . . . . . . @ . @ . . . . . . @ . @ . . @ @
@ . . . . @ . . . . @ @ . . . . . . . . . @ . . . . . . @ . . . . . . @ @ . . @ . . . @ . . @ . . @ . . . . . . @ . . . . . . . . . @ @ . . . . . . . . . . . . . . . . . . . . . @ @ . @ . @ . . . . @
@ . . @ . . . @ . . . @ . . . . . . . . . . . . . . @ . . . . . . . . . . . . @ . @ . @ . . . . . . . @ . . . . . . . . @ . . . . . . . . . . @ . . . . . . . . . @ . . @ . . @ . . . . . . . . . . . @
@ . . . . @ . . @ . . . . @ . . @ . @ . . . . . . @ . . . . @ . . . . . . . . . . . . . . . . @ . . . . @ . @ . . . . . @ . . . . @ . . . . @ . . . @ . @ @ . . . . . @ . . . . . @ . . . @ . @ . . . @
@ . . . . @ . @ . . . . . . . . @ . . . . . @ . . . . . . . . . @ . . . . . . . . . @ . . . @ . . @ @ . . . . @ . . . @ . . . @ . . . . . @ . . @ . . . . . . . @ . . . @ @ . . . . . @ @ @ . . @ . . @
@ . . @ . . . . . . . . . @ . . @ . @ . . . . . @ . . . . . . . . . . . . @ . . . @ . . . . . . . . . . . @ . . . . . . . @ . @ . . . . @ . . . . . . . @ . . . . . @ . . @ . . . . . . @ @ . . @ @ . @
@ . . . . . . . . . . . @ @ @ . @ . . . . . @ . @ @ . @ . . . @ @ . . . @ . . . . . . . . . @ @ . @ . . . . . . . . . . . . . . . . . . . . . @ . . . . . . @ . . . . . . @ . . . . . . . . . @ . . . @
@ . @ @ . . . . . . . . @ . . . . . . . . . . . . . . . . . . . @ . . . . @ @ . @ @ . @ . . @ . . . . . @ . . @ . @ . . . . . . . . . . . . . . . . . . . @ . . . . . . . . . . . . . . @ . @ . . . . @
@ . . @ . . . . . @ . @ . . . @ . . . . . . . . . . . . . . . . . . @ . . . . . . @ . . @ . @ . . . @ . . . . . . . . . . . . . . . . @ . . . @ . . . . . @ . . . . . . . . @ . . . . . . . @ . . . . @
@ . . . @ . @ . . . . . . @ . . . . . . . . . . . . . . . . @ . . . . @ . . . . . . . . . @ . @ . . . . . . @ . . . . . . @ . . @ . . @ . . @ . . . . . . . . . . . . . . . . . @ . . . . . @ . . @ . @
@ . . . . . . . @ . . @ @ . . . . . . . . @ . @ . . . . . @ . . . @ @ . . . . . . . . @ . @ . . . . . @ . . . @ . . . . @ @ . . . . . . . . . . . . . @ @ . . . @ . . . . . . . @ . . @ @ . @ . . . . @
@ . . . . . . . . . . @ . . . @ . . . . . . @ . @ . @ @ . . . . . . . . . . . . . . . @ . . . . . . . . . . . . @ . . @ . . . . @ . . . . . . . . . . . . . . . . . . . . . . . . . . . . @ . . . . . @
@ . . . . . . @ . . @ . . . . . . . . @ . . . @ . . . . . . . . @ @ . . . . . @ @ . . . . @ . . . . . . . . @ @ . . . . . @ @ @ . @ . . . . @ . . . . . . . . . . . . . . @ @ . . . . . . . @ . . . . @
@ . . . . . @ . . . . . . . . @ . . . . . . . @ . . @ . . @ . . . . . @ . . . . . . . . . . . . . @ . . . @ . @ . . . . . . . . . . . . @ . . . @ @ . . . . . . @ . . . @ . . . . . . . . @ . @ . . @ @
@ @ . . . . . . . @ . @ . @ . . . . . . . . . . . . . @ @ . @ . . . . @ . @ . . . . . . . . @ . . @ . . . @ . . . . @ . . . . . . @ @ . @ . . . . . . . . . . . . @ . @ . . . . . @ . . @ . . . @ . . @
@ . @ . . . . @ @ . . . @ . . @ . . . . . . . . @ . . @ . . . . . . @ . . . . . . . . . . . . . . @ . @ . . @ . . . . . . . . @ @ . @ . . . . @ @ @ . @ . . . . . . . . @ . . . . . . @ . . . . @ . . @
@ . . @ . . . . . . @ . . . @ . . . . . . . . . . . @ @ . . . . . . . . . . . . . . . . . . . . . . . . . @ . . . @ . @ . . . . . . . . @ . . . . . . . . . . . . @ @ . . . . @ . . . . . . . . . . . @
@ @ . . . . @ . . . . . . . . . @ @ . . . . @ . . . . . . . . . @ @ . . . . . @ @ . @ . . @ . . @ . . . . . . . . . @ . . . . . . . @ @ . . . . . @ . . . . @ . . . @ . . . . . . . . @ @ . . @ . . . @
@ . . . . . . . . . . . . . . . . . . . . @ . . . @ . . . @ . @ @ . . @ . . . . . . @ . . . @ . . . . . . @ . @ . @ . . @ . . . @ @ . . . . . . . . @ . . . @ . . @ . . . . . . . @ . . . . . . . . . @
@ . . . @ @ . . . . . . . . . @ @ . . @ . . . . . . . . . @ . . . . . . @ . . @ @ . . . . . . . @ . . . . . . . . . . . . . . . . . . . . . . . . . @ . . . . . . . . . . . . . . . . . . . . . @ . . @
@ . . . . . . . . . . . . @ . . . . . . . . . . @ . @ . . . . . . @ . . . . . . . . @ . . @ . . . @ @ . @ . @ @ @ . . @ . . . . . @ @ . . . . . . . . . . . @ . . @ . . . . @ . . . @ . . . . @ . @ . @
@ . . . . . . . . . . @ . . . . . . . . . . @ . . . . . . @ . . . . . . . . . @ . . . @ . . . . . . . . . . . . . . . . . . . @ . . . . . . . . . . . . . . . . . . . @ . . . . . @ . . . . @ . . . . @
@ @ @ @ @ @ @ @ @ @ @ @ @ @ @ @ @ @ @ @ @ @ @ @ @ @ @ @ @ @ @ @ @ @ @ @ @ @ @ @ @ @ @ @ @ @ @ @ @ @ @ @ @ @ @ @ @ @ @ @ @ @ @ @ @ @ @ @ @ @ @ @ @ @ @ @ @ @ @ @ @ @ @ @ @ @ @ @ @ @ @ @ @ @ @ @ @ @ @ @
3
52 75 69 8
58 1 79 8
42 46 23 94
