25 25
@ @ @ @ @ @ @ @ @ @ @ @ @ @ @ @ @ @ @ @ @ @ @ @ @
@ . . . @ . . . . @ . . . . . . . . @ . . . . . @
@ . @ . . . . . . . . . . @ @ . . . . . . . . . @
@ . . @ . @ . . . . . . . . . . . . . . . . @ . @
@ . . . . . . . @ . . . . . @ . . . . . . . @ . @
@ @ @ . @ . . . . . . . . . . . . . @ . . . . . @
@ . . . . . . . . @ . @ . . . . @ . . . . . . @ @
@ . . @ . . . . @ . . . . . @ @ . . @ . . . . . @
@ . . . . . @ . . . . . . . . . . . . . . . . . @
@ . @ @ . . . . @ . . . . . . @ . . . . . . . . @
@ . . . @ . . . . . @ . @ . . . . . . . . . . . @
@ . . . . . . . . . . . @ @ @ . . . . . . . . . @
@ . . . @ . @ . . . . . . . @ . . . @ . . . @ . @
@ . @ . . . @ @ . . @ . . @ @ @ . @ . . . . . @ @
@ . . . . . . . . . . . . @ . . @ . . . . . . . @
@ . @ . @ . . . . . @ . . . . . . . . . . . . . @
@ . . . . . @ @ . . . . . . . . . @ . . . . . . @
@ . . . . . . @ . . . . . . . . . . . . . @ . . @
@ . . . @ . . . . . . . . . . . . . . . . . . . @
@ . . . . @ . . . . . . . . . @ . . . . @ @ . . @
@ . @ . . . @ . . . @ . . . . . . . . @ . . . . @
@ . . . . @ . @ . . . . @ . . . . . @ . . @ . . @
@ @ . @ . @ . . @ . . . . . @ . . . . . . . . @ @
@ . . . . . @ . . . . . . . . @ @ . . . . . . . @
@ @ @ @ @ @ @ @ @ @ @ @ @ @ @ @ @ @ @ @ @ @ @ @ @
3
2 6 7 7
2 1 10 13
10 3 12 13
