50 50
@ @ @ @ @ @ @ @ @ @ @ @ @ @ @ @ @ @ @ @ @ @ @ @ @ @ @ @ @ @ @ @ @ @ @ @ @ @ @ @ @ @ @ @ @ @ @ @ @ @
@ . . . . . . . . . . . . . @ . . . . . . . . . . . . . . . . . . . . . @ . @ . . . . . . . . @ . @
@ . . . . @ . . . . . . . . . @ @ . . . @ @ . . . . . . . @ . . . . . . . . . . . . @ . . . . . . @
@ . . . . . . . . . . @ . . . . @ . @ @ . . . . @ @ . . . . . . . . @ . @ . . . . . . . . . . . . @
@ . . . . . . . . . . . . . @ . . @ . @ . . . @ @ . . . . . . . . . . . @ . . . . . . . . . . . . @
@ . . . . . . . . @ . . @ . . . . . . . . . . . . @ . @ . . . . . . . . . @ . . . @ . . . . . @ . @
@ . @ . . . . . . . . . . @ . @ . @ . . . . . . . . . . . @ . . . . . . . . . . . . . . . . . . @ @
@ @ . . . @ . . . . @ . . . . @ . . . . . . . . . . . . . . . @ . . . . . @ @ . @ . @ . @ . . @ @ @
@ . . . . . . . . . . . . . @ . . @ . @ . . . . . @ @ @ . @ @ . . . @ . . @ . . . . . . . . . . @ @
@ . . . . @ . @ . . . . . . . @ @ . . . . @ . . . . . . . . . @ . . . . . . @ . . . . . . . @ . . @
@ @ . . . . . . . . . . . . . . @ . . . . @ @ . . . . . . . . . . . . . . . . . . . . . . . . . . @
@ . . . . . . . . . . @ . . . . . @ . . . . . @ @ @ . . . . @ . . . . . . @ . . . @ . @ @ . . @ . @
@ . . . @ . . @ . @ . . . . . . . . . . . . @ . @ . @ . . . . . . . . . @ @ . . . . . . . . @ . . @
@ . . . . . @ . . . . . @ . . . . . . . . . . . @ . . @ . . . @ . . . . . . . . . . . @ . . . @ . @
@ . @ . . . . . @ . . . @ . @ . . . @ . . . . @ . @ . . . . @ . . . . @ . . . . . . . . . @ . . . @
@ . . . . . . . . . . . . . @ . . . . . . . . @ . . . . . . . @ . . . . . @ @ @ . . . . . . @ @ . @
@ . . . . . @ . . . . . . . . . . . @ . . . @ . . . @ . . . . . . . . . . . . @ @ . . . @ . . @ . @
@ @ . . . . . . . @ . @ . . . . . . . . @ . @ . . . . . . . @ . . @ . @ . . . . . @ . . . @ . . @ @
@ . . @ @ . @ . . . . . . . . @ . @ . . . . . . . @ . . . @ . . @ . @ . . . @ . @ . . @ . . . . . @
@ . . . . . . . . . . . . . . . . @ . . @ . . @ . . . @ @ . @ . . . . @ . . . . . . . . . . . . . @
@ . . . . . . @ . . . @ . . . . . . @ . . . . . . @ @ . . . @ . . . . . . . . . . @ . . . . . . . @
@ . . . . @ . . . . . . . . . . . . . . . . . @ . . @ . @ . . . @ . @ . @ . @ . . . . . . . @ . . @
@ . @ . . . . . . . . @ . @ . . . . @ . . . . @ . @ . . . . . . . . . . . . @ . . . . . . . . . . @
@ @ . . . @ . @ . . . . . . . . . . @ . . @ . . @ @ . . @ . . . . . . . . . . . . . . . . @ . . @ @
@ . . . @ . . @ . . @ . @ . . @ . @ . . @ . . . @ . . . @ . . . . . . . @ . . . @ . . . . . . . . @
@ . . . . . . @ . @ . . . . . @ . . . . . . . . . . . . @ . @ . . @ . @ . . @ @ . . . . . @ . . @ @
@ @ . . . . . . . . . . . . . . . . . . . . . . @ . . @ . . . @ . . . . . . . . . . . . . . . . @ @
@ . . . . . . . . . @ . @ @ . . . . . . . . . . . . . . . @ . @ . @ . . . . @ . . @ . . @ @ . . . @
@ . . @ . . . . . . . . . . . . . @ . . @ . . . . . . . . . . @ . . . @ . . . . . . . . . . . @ . @
@ . . . . . . . . . . @ . . @ . . @ @ . . . . . @ @ . @ . @ . . . . . . . . . . . @ . . . . . . . @
@ . @ . . . . . . . @ . . . . . . . . . @ . . . . . . . . . . . . . . . . . . . @ . . . @ . . . @ @
@ . . . . @ . @ . . . . . . . . . . . . @ . . . . . @ . . @ . . . . @ . . . @ @ . @ . . . @ . . . @
@ . . . @ . . . @ . . . . . . . . . @ . . . . . . . . . . . . . . @ . @ . . . . . . . . . . . . . @
@ . . . . . . . . @ @ . @ . . . . . . . . @ . . @ . . . @ @ . @ . @ @ . . @ . @ . . . . . . . @ . @
@ . . . . . . . . @ . . . @ . . . @ . . . . . . . . . @ . . . @ . . . . . . . @ . @ . . . . @ . . @
@ . . . . . @ . . @ @ . . . . . . . . . @ . . . . . . . @ . . . . . @ . . . @ . @ . . . . @ . . . @
@ . . . . @ . . . . . . . . . . . . . . . . . . . @ . . @ . . . @ . . @ . . . . @ . . . . . . . . @
@ . . . @ . @ . @ . . . . @ @ . . . @ . . . . @ . . . . . . @ . . @ . . . . . . @ @ . . @ . @ . . @
@ . . . . . . . . . . . . @ . . . . . . . . . . . . . . @ . . @ . @ . @ . . . @ . @ . . . . . @ . @
@ . . @ . @ . . . @ . . . . . . . @ . . . @ . . . . . . . . . . . . @ . @ . . . . . @ . . @ @ . @ @
@ . . . . . @ . . . @ @ . . . . . . . . . . . . . . . . . . . . . @ . . . . . @ . @ . . @ . . . . @
@ . . . . . @ . @ @ . . @ . . . . . @ . . . . . . . . @ @ . @ . . . @ . . . . . . . . @ . . . . . @
@ . @ . . . . . . . . . . . @ . @ . . . . . . . . . . @ . . . . . . . . . . . . . . . . . . @ . . @
@ . @ . @ . . . . . . @ . . . . . . . @ . . @ . . . . . @ . . . . . . . . . . . . @ . . . . . . . @
@ @ @ . . . . . @ @ . @ . . . @ @ @ . . . @ . . . . . @ . . . . . . . . . @ . . @ . . . . . @ . . @
@ . . . . . @ . . @ . . . @ . . . . . @ . . . . @ @ . . . @ . . @ . . . @ . @ . @ . . @ . . . . . @
@ . . . . @ . . . . . . . . @ . . . @ . @ . . . . . @ . . . @ . @ . . . . . . . . @ . . . @ @ . . @
@ . . . . . @ . . . . . @ . . @ . . . . . @ . . @ . @ . . . . . . . @ @ @ . . . . . . . . . . @ . @
@ . . . . . . . . . . . . . . . @ . . . . . @ . . . . . . . . @ . @ . . . . @ . . . . @ . . . . . @
@ @ @ @ @ @ @ @ @ @ @ @ @ @ @ @ @ @ @ @ @ @ @ @ @ @ @ @ @ @ @ @ @ @ @ @ @ @ @ @ @ @ @ @ @ @ @ @ @ @
3
33 6 32 7
43 3 2 13
20 22 42 11
