12 12
@ @ @ @ @ @ @ @ @ @ @ @
@ . . . . . . @ @ . . @
@ @ . . . . . . . . . @
@ . . . . . . @ . . @ @
@ . . . . . . . . . . @
@ . . . . . . . . @ . @
@ @ . . . @ . . @ @ . @
@ . . @ @ . . . . . . @
@ @ . . . @ . . @ . . @
@ . @ @ . @ @ . . @ . @
@ . . @ . . . . . . . @
@ @ @ @ @ @ @ @ @ @ @ @
3
6 7 10 10
9 10 3 1
3 4 2 9
