100 100
@ @ @ @ @ @ @ @ @ @ @ @ @ @ @ @ @ @ @ @ @ @ @ @ @ @ @ @ @ @ @ @ @ @ @ @ @ @ @ @ @ @ @ @ @ @ @ @ @ @ @ @ @ @ @ @ @ @ @ @ @ @ @ @ @ @ @ @ @ @ @ @ @ @ @ @ @ @ @ @ @ @ @ @ @ @ @ @ @ @ @ @ @ @ @ @ @ @ @ @
@ . . . . @ . . . . . . . @ . . @ . . . . . @ . . . . . . . . . . . . @ . . . . @ . . . . . . . . @ . . . @ . . . . . . . . . . . . . @ . @ @ . . . . . . @ . . . . . . . . . . . . . . . . . . . . . @
@ . . . @ . . . . . . . . . @ . . . . . . . @ @ . . . @ . . . . . . . . . . . . @ . . . . @ . . . . . . . @ . . . . . . . . . . . . . . . . @ . . . . . @ @ @ . . . . . @ . @ . @ . . @ . @ . . . . . @
@ . . . @ . . . . . . @ . . . . . . . . . . . @ . . . . . @ . . @ . . @ . . . . . . . . . . . . . . . . . @ . . . . . @ . . @ @ . @ @ . . . . . . @ . . @ . . . @ . . . . @ . . @ @ . . . . . . . . . @
@ . . . @ @ . . . . . . . . . . . . @ . . @ . . . . . . . . . . @ @ @ . . . . . @ . . . . @ . . . . . . . . . . . @ @ @ . . . . . . . . . . . @ @ . . @ @ . . . . . . @ @ @ . . . . . . . @ . @ . @ . @
@ . . @ @ . @ . . . . . . . . . . @ . . . . . @ @ @ . . @ @ . . . . . @ @ . @ . @ . . . @ @ . @ . . . . @ @ . . . . . . . . . @ . . . . . . . . . . . . . @ . @ . . . . . . @ . . . @ . . . . . . . . @
@ . . . . . . . @ . . . @ . . . . . . . . . . . . . . . . . . . . . . . . @ . . . . . . @ . . . . . . . @ . . @ @ . . @ . . . . . . . . . . . . . @ . . . . . . @ . . . @ . . @ . . . . . . . . . @ . @
@ . . . . . @ . . @ . . . . . @ @ . . . @ . . @ @ . @ . . @ . . . . @ . . . . @ . . . . @ . . @ . . . . @ . . . . . . . . . . . . . . . . . . . . . . . . . . . . @ . @ . . . . . . . @ . . . . @ . . @
@ . . . . . . @ . . . . . . . . . @ . . . . . . . . . . . . . . . @ . . . @ . . . @ . @ . . @ . . . . . . . . @ . . @ . @ . @ . @ @ . . @ @ . . . . . . . . @ @ . . . . . . . . . . . . . . . @ @ . . @
@ . . . . @ . . . . . . . @ . . . . . . . . . . . @ @ . . . . . . @ . @ . . . . . . @ . @ . . . . . . @ . @ . . . @ . . . . . . . . @ . . . . . . @ . @ . . . . . . . . @ . . . . . . @ . . . . . . . @
@ . . . . @ . . @ . . . . @ . @ . @ . . @ @ . . . @ . @ . @ . @ . . . @ . . @ . @ . . . . . . . @ . @ . . @ . @ . @ . @ . . . @ . . . @ . . . . . . . . . . . @ @ . @ . @ @ @ . . . @ . . . @ @ . . . @
@ . . . . . . . . . @ . . . @ . . . . . . @ . . . @ . . . . . . . . @ . . @ . @ . . . . @ . . @ . . @ . . . @ . . . . . . . . . . . . @ . . . . . . . . @ . . . @ . . . . . . . @ @ . @ . . . . . . . @
@ . @ . . . . . @ . . . @ . . . . . . . . . . . . . . @ @ . . . . . . . . @ . . . . . . . . . . . . . . . . . . . . . . . . . . . . . . . . @ . @ . . . @ . . @ . . . . . . . . . . . . . . @ @ . @ . @
@ @ . . . @ @ . . . @ . @ . . . . . . @ . . . . . . . . @ . . . . . . . . . . . @ . . . @ . @ . . . . . . @ @ . . . @ . . @ . . . . . . . . . . . . . . . . . @ . . . . . . @ . . . . . . . . . . . . @
@ . . @ . . . . . @ . . . @ . @ . . . . . . . . . . . . . . . . . . . . . . . . @ . . . . . . . @ . . . . . . . @ . . . . . . @ @ . . . . @ . @ . . . . @ . @ . @ . . . . . . . @ . . . . . . @ . . . @
@ . . . . @ . . . @ . @ . . . . . . . . . . . . . . . . . . . . . . @ . . . . @ . . . . . . . @ @ . . . . . @ . . . . . . . @ . . . . . . . . . @ . . . . . . @ . . . @ . . . @ . @ . . . @ . @ . @ . @
@ . . @ . . . . . . . @ . . @ @ . . . . . . . . . . . . . . . @ . . . . . @ . . . . . . . . . @ . . . . . . . . . . . . . . . . . . . . . @ . . . . . . . . . . @ . . @ . . @ . . . . . . . @ @ . . @ @
@ . . . . . @ . . . . @ . . . . @ . . . . . . . @ . . . . . . @ . . . . . . . . @ . . . . . . . @ . . . . . @ . @ . . @ . . . @ . . . . . . . . @ . . . @ . . . . . @ . . . . . . . . . . . @ . . . . @
@ . . @ . . . . . . @ . @ . . . . . . . . . @ . . @ @ @ @ . . . @ . . . . . . . . @ . @ . @ . @ . . . . . @ . . . . . . . . . . . . . @ @ . . . @ @ . . . @ . . . . @ . . @ . . . . . . . . . . . . . @
@ . . . . @ . . . @ . . @ . @ . . . . . @ . . . @ . @ . . @ . . . . . @ . . @ . . . . @ @ . . . . @ . . . . @ . . . @ . @ . . . . . . @ @ . . . . . . . . @ . . . . . . . . . . . . @ . . @ . . . . . @
@ . @ . @ . . . . . . . . @ . . . @ . . . . . . . . . . . @ . . . . . . . . @ . @ . . @ . . . . . . . @ . @ . . . . @ . . . . . . . . @ . . . . . . @ . . . @ . . @ . . . . . @ . @ . . . . . . . @ . @
@ . . @ @ . . . . . @ @ . . . . . . @ . @ @ @ . . . . . . @ . @ . . . . . . . . . @ . . . @ . . . . . . . @ . . . @ . . . . . . . . @ . . . . . . . . . @ . . @ . . . . @ . . . . . . . . . @ . . . . @
@ . . . . . . . . . . . . @ . @ @ . . . . . . . . @ @ . . . @ . . @ . . . . @ . . . @ . . . . . . . . . . . . . . . . @ . @ @ . . . . . . . . . @ . @ . . @ . . @ . . . . . . . . . . @ . . . . . . . @
@ . @ . @ . . @ . . . . . . . . . . . . . . . . @ . . . . @ . . . . . . . . . @ . . . . . @ . . . . @ . . . . . @ . . . . @ . @ . @ . . . . . . . @ . . . . . @ . @ . . . . . . @ . . . @ . . . . . . @
@ @ . . . . . . @ . . . . . @ . . . . . . . . @ . @ @ . . . . . . . . . . . . . . . . . . . . @ @ . . . . @ . . . . . . . . @ @ . . . . . . . . . . . . . . . . . . . . . . . . @ . . . @ . . . . . . @
@ . . . @ . @ . . . . . . . . . . . @ . . . . . . . . . . . . . @ . . . . . . . . . @ . . . . . . . . . . . . . . . @ @ . . . . . . . . . . . @ . . . . . . . . . . . @ . @ . @ . @ . . . . . . . . . @
@ . . . . @ . . . . @ . . . . . @ . @ . . . @ . @ . . . @ . . . . @ @ . . . . . . . . . . . @ . @ . . . @ . . . . . . . . @ . . . @ . . . . . @ . . . . . . . . . . . @ . . . . . @ . . . . . . . . . @
@ . . . . . . . . . . . . . @ @ . . . . . . @ . . . . . . . @ . . . . @ @ . . . . . @ @ @ . . @ . . . . . . . . . . @ @ . . . . . @ @ . . . . . . . @ . @ . . . . . . . . . . . . . @ . . . @ @ @ . . @
@ . . . . . . . . . @ . . . . . . . . . . @ . . . . . . . . @ . . . @ . @ @ . . . . . . . . . . . . @ . . @ . . . . . . . . . @ @ . . . . @ . . . . . . . @ . @ @ . . @ . . . . . @ . . . @ . . . @ . @
@ @ . @ . @ . @ . @ . . . . . @ . . . . . . . . . . . . @ . . . . @ . . . . . . @ . . @ @ . @ @ . . . . . . . . . @ . . . . @ . . . . . . @ . . . . . @ . . . . @ . . . . . . . . . . . . @ @ . . . @ @
@ @ . . @ . . . . . . . . . . . @ . . . . @ . . . . . . . . . . . . . @ . @ . . @ . . . @ . . . @ . . . . @ . . . @ . @ . . . . . . . . @ . . . . . @ . . . @ . . . . @ . . . . . . . . . . . . . . . @
@ . . . . . . . @ . @ . . . @ . @ . . . . . @ . . . . . . . . . . . . . . . . . . . @ . . . . @ . . @ . . . . . @ @ . . @ . . . . . @ . . . . . @ @ . @ . . . . . . . @ . . . . . . . . . . . @ . . . @
@ . . . . . . . . @ . . . . . . @ . @ . . . . . . @ . . . . @ . @ @ . . . . . . . @ . . . . @ . . @ . @ . . . . . @ . . . . . . . . . . . @ . . . . @ . . . . . @ . @ . . . . . . . . . . . @ . . @ . @
@ . @ . . . . . @ . . . @ . . . . . . . @ . . . . . @ . . . @ . . . . . . . @ @ . . . . . @ . . @ . @ @ . . . . . . . @ . . . . . . . . . . @ . . . . . . . . . . . . . . @ . . . . . . . . . @ . @ . @
@ . @ . . @ . . . . . . . . . @ . @ . . . . . @ . @ . @ . @ @ . . @ . . . . . . . . . . . . . . . . . . @ @ . . . @ . @ @ @ . . . . . . . . . . . @ @ . . @ @ . . . @ . . @ . @ . . . @ @ @ @ . . @ @ @
@ . @ . . . @ . . . . . . @ . . . . . . . . . . @ . . @ . . . . . . . . . . . . . . @ . . . . . . . . . . . @ @ . @ . . . . . . . . @ . . . @ . @ . @ . . . . . . . . . @ @ . @ . . . . . . @ . . . . @
@ . . @ . . . . . @ . @ . . . . . . @ . . . . . . . . . @ . . . @ . @ . . . @ . . . . . . . . . . . . . . . @ . . @ . . . . . . . . . . @ . . @ . . . . . . . @ . . . . @ . . . @ . . . . @ . . . . . @
@ . @ . @ . . . . @ . . . . . . . . . . . . . @ . @ . @ . . @ . @ . . . @ . @ . . . . . @ . @ @ . . . . . . . . . . . @ . . . @ . @ . @ . . . . . . . . . . . . . @ . . . . . @ . . . @ . . @ . . . . @
@ . . . . @ . @ . . . . . . . . . . . . . . . . @ . . . @ . . . . . . @ . . . . @ . . . . . . . . . . . @ . . @ . @ . . @ . . . . . . . . . . . @ @ @ . . . @ . @ . . . . . . . @ @ . . @ . . @ . . . @
@ . . . . . @ . . . @ . . . . . . @ . @ . @ . . . . @ . . . . . . . @ . . . . . @ . . . . . . . . . . . . . . . . . @ . . . . . . . . . . . . . @ . . . . @ . @ . . . . . . @ . . . . . . . . . . . . @
@ . @ . . . . . @ @ . @ . . @ . . . . . . . @ . . @ . @ . . . . . @ . . . . . . . . . . . . @ . . . . . . @ . @ . . . . . @ . . . . . . . . . @ . . . @ . . . . . . @ . . . . . @ @ . . . @ . @ . @ . @
@ . . . . . . . . . @ . . @ . . . @ . . . . . . . . . . . . . . @ . @ . @ . @ . . . @ . . . . . . . . . . . . . . . . @ . . . @ @ . . . . . . @ @ . . . @ . . . . . @ . . . . . . . @ . . @ . . . . . @
@ . . . . . . . . . @ . . . @ . @ . . . . . . . . . . . @ . . @ . . . . . . . . @ . . . . . @ . . @ . . . . . . . . . . . . . . . . . . . @ @ . . . . . . . @ . . . . @ . . . @ . . . . . . . @ . . @ @
@ . . . . . @ . . . @ . @ . . . . . . @ @ . . @ . . . @ @ . . . @ . . . . . . . . . . . . . . . . . . . . . . @ . . . . @ . @ . . . . @ . . . . . . . . . . . . . . . . . . . . . . . . . . . . . @ @ @
@ . @ . @ . . . . . . . . . @ . . . . . . . . . . . . @ . . . . . . @ . @ . . . . . @ . @ . . . @ . . . . . . . . . . . . @ . . . . . . @ . @ . . . @ . @ . . @ . @ @ . . . . @ . . . . @ . . . . . @ @
@ . @ . . @ @ . @ . . . @ @ . @ . . . . . . @ . . @ @ . . . . . . . . . . . . . . . . . . . . . . . . . . . . . . . @ . . . @ . . . . . . @ . . . . . @ . . . . . . . . . @ . . . . . . . . . . . . . @
@ . . . . . . . . . . @ . . . . . @ . . . . . . . . @ . @ . . . . . . . . . . @ . . . . . . @ . . @ . . @ . @ . @ . . . . . . . . . . . . . . . . . . . . . . . . . . . . . . . @ . @ . . . . . . . . @
@ . @ . . . . . . . . . . . . . . . . . . @ . . . . . . . @ . @ . . . . @ . . . . . . . . @ @ @ . . @ . . . . . @ @ . . . . @ . . @ . . @ @ . . . . . . . . @ . . . @ @ @ . @ . . . . . . . . . @ . . @
@ . . . . . . @ . . . . @ . . . . . @ . . . . . @ @ . . . . . . . . . . . @ . . . . . . . . . . . . . @ . . @ . . . . . . . @ . . . . @ @ . @ . . . . @ . . @ @ . . . . . . . . . @ . @ . . @ . . @ . @
@ . . . . . . . @ . @ . @ . . . . . . . . . . . . . . . . . . . . . . . . . . @ . . . . . @ . . . . . . . . . . . . . . . . . . . . @ . . . . . . . . . . . . @ . . . @ . . . . . . . . . . . . . @ . @
@ . . . . . . . . . . . . @ . . . . . . . . . . @ . . . . . . . . @ . . . @ . . . . . . . . . . . . . . @ . . @ . . . . @ . . . . . @ @ . . . . . . . . @ . . . . . . . . . . . . . @ . . . @ @ . . . @
@ . . . . . . . . . . . @ . . . . . @ . . . . . . . . @ @ . . . . . @ . @ @ @ @ . . @ . @ @ . . @ . . . . . . @ . . . . . . . . . . . . . @ . . . . @ . . . . @ . . @ . @ . @ . @ . . . . . . . . @ . @
@ @ . . @ . . . . . . . . . @ . @ . . . . . . . . . . . . @ . . . . . . . @ . . . . . @ . . . @ . . . . . . @ . . . . . . @ . @ . . . . . . @ . . . . . . @ . @ . . . @ . . . . . . . . . . . . @ . . @
@ . @ . . . . . . . @ . . @ . . . @ . . @ . . . . . . . . . . . @ . . . . . . . . . . . . . @ . . @ . @ . . . . . . . . @ . . @ @ . . . . . . . @ . . . . . . . . . . . . @ . . . @ . . @ . . @ . . . @
@ . . . . . . . . . . . @ . . . . . . . . . . . . . . . . . . . . . . . . . . . @ . . . . . . . @ . . . . . . . . . . . . . . @ . . @ @ @ . @ @ . . @ . . . . @ . @ . . . . . . . . . . . . @ . . . . @
@ . . . . . . @ . @ . . . @ . @ . @ . . . @ . . @ @ . . . @ @ @ . . . . . . . . . . . . . . @ . . . . . . . . . . . @ . @ . . . . . @ . . . . @ . . . . . . . . . . . . . . @ . . @ . . @ . . . . . . @
@ . . . . . . . . . . . . . . . . . . . @ . . . . . . . . . . . . . . . . . @ . . . @ . . . . . . . . . @ . . . . @ @ . . @ . . . . @ . . . . . . . . . @ . . . . . . @ . . . . @ @ . . . . . . @ . . @
@ . . . . . @ . . . . . @ . . . . . . . . . . @ . . . . . @ . . . . . @ . . . . . . . . @ . . . . . . . . . . . . . . . . @ . . @ @ . . . . @ . . . . . . . @ @ . . . . @ . . . . . @ . @ . . . . . . @
@ . . @ . @ @ . . . . . . . . . . . . . . . . . . . . . . . . . . . @ . . . . . . . . . . . . @ . @ . . . . . @ . . . . . @ . . . . . . . . . @ . . . . @ . . . . . . . . @ @ . . . . . . . . . . . . @
@ . . . . . . . . . . . . . . . . . . . . . . . . . @ . @ . @ @ . @ . . @ . . @ . . . . . . . @ . . . . . . . . . @ . @ . . . . @ . . @ . . . . . . . . @ . . @ . . . @ . . . . . . . . . . . @ @ . @ @
@ . . . . @ @ . . . . . . . . . . . . . . . @ @ . @ . . . . . . . . . . . @ . @ . . . . . @ . . . . . . @ . . . . . @ . @ . @ @ . @ . . @ . . . . . . . . . . . . . . @ . . . . . . . @ . . . . . . @ @
@ . . . . . . . @ . . . . . . . . . . . . @ . . . @ . . . . . . . . . . . . . . . @ . . . @ . @ . . . . . @ . . . @ . . . @ . . . . . . . . . . . . @ . @ @ . . . . @ @ . @ . . . . . @ . . . . . @ . @
@ . @ @ . . . . . . . @ . . . . . . . . . . . . . @ @ . @ @ . @ . . . . . . . . . . . . . . . . . . . . . @ . . . . . @ . . . . . . . @ . . . @ . . . . . . . @ . @ . . . . @ @ . . . . . . . @ . . . @
@ . . . . . . . @ . @ . . . . . . . . . @ . . . . . . . . . . . . . . . . . . . . @ . . . . . . . . . . . . . . @ . . . . . . . . . . . . . . . . . . @ . . @ . . . . . . . . . . . . . @ . . . . . . @
@ @ . . . . . . . . . . . . . . . . . . . . . @ . . @ . @ . . . . . . @ . . . . . . . . . . @ . . @ . . . . @ . . . . . . @ . . . @ . . . . . . @ @ . . @ . . . . . . @ . . . . . . . . . . . . . . . @
@ . . . @ @ @ . . . . . . . @ . @ . . . . . . . @ . . @ . . . . . @ . . . . . . . @ . . . . . . . @ . . . . . . . . . . . . . . . . . . . . . . . @ . . . . . . @ @ . . . . . . @ . . @ @ @ . @ . @ . @
@ @ . . . . . . . . . . . . . @ . . @ @ @ . . . . . @ . @ . . @ . . . . . . . . . . . . @ @ . . . . . . . . @ . . . . @ . . . . @ . . . . . . . . . . . . @ . . . . . . . @ . . . @ . . . . . @ . . . @
@ . . . . . . . . . . . . . @ . . . . . @ . . . . @ . . @ . . . @ . . @ . . . @ @ . . . . . . . . . @ . . @ . @ . . @ . . @ . . . . . . @ . . . . . . . @ . @ @ . @ . . . . . @ . . @ . @ . @ @ . . @ @
@ . . . . . . . . @ . @ . . . . . . @ @ . . @ . . . @ . . . @ . . . . . . . . . . . @ . . . . . . @ . @ . . . . . @ . . . . . . . . . . . . . . . . . . . . . @ @ . . . . . . . . . . . . . . . . @ . @
@ . . . . . . . @ . . . @ @ . @ @ . . . . . . . . . @ @ . @ . . @ . . . @ @ . . . . . . . @ @ @ . . . @ . . @ . . . @ . . . . @ . . . . . @ @ . . . @ . . . . . . . . @ . @ . . @ . . . @ . . . . @ . @
@ . . . . . . . . @ . @ . . . . . . . . . . . @ . . . . . . @ . . . . @ . . . . @ . @ . . . @ . @ . . . . . . . . . . . . . . . . . . . @ . . . @ . . . . . @ . . . . . . @ . . @ @ @ . . . . . . . . @
@ . @ . . . . . . . . . @ . . . . . . @ . . . . . . . . . . . . . . . @ . . . . . @ . . . . . @ . . @ . . @ . . . . . . . . . . . @ . @ . . . @ . . . @ @ . . . @ . . . @ . @ . . . . @ . . . . . . . @
@ . . . . . . . . . . . . @ . . @ . . . . @ . @ . . . . @ . . . . @ . . . @ . . . . . @ . . . . . . . . . @ . . . . . . . . @ . . . . . . . . @ . . . . . . . . . . . . . . . . . . @ @ . . @ . . . . @
@ . . . . @ @ . . . . . @ . . @ . . . . . . @ . . . . . . . . . @ . @ . . . . . . . . . . . . . . . . . . . @ . . . . . . @ . . . . . . . . @ . . . . . . . @ . . . . @ . @ . . . . . . . . . . @ @ . @
@ @ @ @ . . . . . @ . . . . . . . . . . @ . . @ . . . @ . . . . . . . @ . @ . . . . . . . . @ . @ . . . . @ . . . @ . . . . . . . @ . . . . . . @ @ . . @ . @ . @ . . . . . . . @ . . @ . . @ . . @ . @
@ . . . @ @ . . @ . . . . @ . @ . . @ . . . . . @ . . . . . . @ . . . . . . . . . . . . . . . @ . . . @ . . . . @ . @ . . @ @ . @ . @ . @ . @ . . . . . . . . @ . . . . @ @ . . . . . @ . . . . . . . @
@ . . . . . @ @ @ . . . . @ @ . . . . . . . . @ . . @ @ @ @ . . . @ . . . . . . . . . . . . @ . . @ . . . . . @ . . . . . @ . . . . . @ . @ . . . . . . . . . . . . @ . . . . . . . . . . . . . . . . @
@ . . @ . . @ @ . . . @ . . . . @ . @ . . . . @ @ @ . . . @ . . . . . . . @ . . . . . . . . @ @ . @ . . . @ @ . . @ . . . . . . . @ . . @ . . . . . @ . @ . . . . . . . . . . . . @ . @ . . . . . . . @
@ . . . . . . . . @ . . . . . . . . . . . . . . . @ . . . . . . . . @ . . . . . @ . . . . . @ . . . @ . . . . . . . . . . . . . . @ . . . @ . . . . . . . @ . . . . . . . @ . . . . . . . . . @ . . . @
@ . . . . @ . . . . . . @ . . @ . . . . . . . . . . . . . . . . . . . . . . . . . . . . . @ . . . . @ . @ @ @ . . . . @ . . . . . . . @ . . . . . . . . . . @ . @ @ . @ . @ . . . . . . . . . . . . . @
@ . . . . . . . . . @ @ . . @ . . @ . @ . . . . . . . . . . . . . . @ . . . . @ . . . @ . . . . . @ . . . . . @ . . . . @ @ . . . . . . . . . . . . . @ . . . . . . . . @ . @ . . . @ . . @ . . . @ . @
@ . . . . . . . . . . . @ . . . . . @ . . . . . . . . . . @ @ @ @ . @ @ . @ . . . . @ . . . @ . . . . . . . . @ . @ . @ . . . . . . @ . . @ . . . . . . @ . @ . . . . @ @ . . . . . . . . @ . . @ . . @
@ . . . . . . . . . . @ . @ . @ @ . . . . . . . . @ . . . . . @ . . . . . . @ . @ . . @ . @ . . . . . . . . . . . . . . . . . . @ . . . . . @ . @ . @ . . . . . . . . . . @ . . . . . @ @ . . . . . . @
@ . . . . . . . . . . . @ . . . . . . . . . . . . . @ . . . @ . . . . @ @ . . . @ . . . . . . . @ . . . . . @ . . . . . . . . . . @ . . . . @ . . . . . . . . . @ . . . @ . @ . @ . . . . . . . . . . @
@ . . . . . . . @ . . . @ . . . . . . . . . . . . . . . . @ . . . . . . . . . . . . . @ . . . . @ @ . . . . . . @ @ @ . . . @ . . . . . . . . . . . @ . . @ . . . . @ . . . . . . . . . . . . . . . . @
@ . . . @ . . . . . . . . . . @ @ . . . . . . . @ . . @ . @ . . . . . . . . . . . . @ . . . . . @ . . . @ . . . . . . @ . . . . . . . . . . . . . @ . . . . @ . . @ . . . . . . . . @ . @ . @ . @ . . @
@ . @ . . . @ . . . . @ . . @ @ . @ . . . . @ . . . . . @ . . . @ @ . . . . . . . . . . . . . @ . . . . . @ . . . @ . @ . . . . . @ . . . . . . . . . . . . . . . . @ . . . . . . . . . . . . . @ . . @
@ . . . . . @ . . . . . @ @ . . . . . . . . . . @ . . @ . . . . . . . . . . @ . . . . . . @ . . . . . . . . @ . @ . . . . . . . . @ . . . . . . @ . . . @ . . @ @ @ . . . . . @ . . . . . . . @ . . . @
@ . @ . . . @ . @ . . . @ . . . . . @ . . . . @ . . . . @ . . @ . . . . . . . . @ . @ . @ . @ . @ . @ . . @ . . . . . @ . . . . @ . @ . . . . . . @ . . . . @ . . . . . . . . . . @ . . . . . . . . . @
@ . . . . . . @ . . . @ . . @ . . . . . . . . @ . . @ . . @ . . . . . . @ . . @ . @ @ @ . . . . . . . . . . . . . . . . . . @ . . . . . . . @ . . @ . . . . . @ . . . . @ . . . . . @ @ . . . . . . . @
@ . . . . . . . @ . @ . . . . . . . . . . . . . . . . @ . . @ . . @ . @ . . . . @ . . . . . . . @ @ . . @ . @ . . . . . . . . . . . . . . . . . . . . . . @ @ . . . . . . . . . . @ . . @ . . . . . @ @
@ @ . @ . . . . . @ . . @ . . . @ . . @ . . . . @ @ . . @ . . @ . . . . . . . . . . . @ . . . . . . . . . . . . . . . . . @ . . @ . @ . @ . @ . @ . @ . . . . . . . . @ @ . . @ . . . . . . . @ . . . @
@ . @ . . . . @ . . . . . . . . . . . . . @ . . . . . . @ . . . . @ . . @ . @ . . . . . . . . @ . @ . . . . . . . . . . . . . . . . . @ . . . . . . . @ . . . . . . . . . . . . . . . @ . . . . @ . . @
@ @ . . @ . . . . @ . . @ . @ . . . @ . . . . . . . . . . @ . @ @ @ . . @ . . . . . @ . @ . . . . . @ @ . . . . . . @ . . . . . . . . . @ . . . . . . . @ . @ . . . @ . @ . . . . @ . . . @ @ . @ . . @
@ . . @ . @ . @ . . @ . . . . . . . . . . . . . . . . . . @ . . . @ . . @ . @ . . @ . @ . @ . . . . . . . @ . @ . . . . . . @ @ . . . . . . . . . @ . . . . . . @ . . . . @ @ . @ . . . @ . . @ . @ . @
@ . . . @ . . . @ . . @ @ . . . @ . @ . . @ . . . . . . . . . . . . . . . . . . . . . @ @ . @ . . @ . @ . . . . @ . . @ . . @ . . . . . . . . . . . . @ . . @ . . . @ . @ . . . . . . . . . . . . . @ @
@ . . . . . . . @ . . . . . . @ . @ . . . . . . @ . . . @ . . . . . @ @ @ . . . . . . . . . @ . . . . . . @ . . . . . . . . . . . . @ @ . . . . @ . . @ . . . . @ . . . . . . . . . @ . . . . . . . . @
@ . @ @ . . . . . . . . @ . . . . . . @ . . . . . . . . . . . . . . . . . @ . . . . . . . . . @ @ . . @ . . . . . . . . . . . . @ . @ . @ . . . . . . @ @ @ . @ . . . . . . . @ . . . . . . . @ @ . . @
@ . . . . . . @ . . . . . . . . . . . . . . . . . . . . . . . @ . . . . . . . . . @ @ . . @ . . . . @ . . . . . @ . . . . . . . . . @ . . . @ . . . . @ . @ . . . . . . . . . . . . . . . . . @ . . . @
@ @ @ @ @ @ @ @ @ @ @ @ @ @ @ @ @ @ @ @ @ @ @ @ @ @ @ @ @ @ @ @ @ @ @ @ @ @ @ @ @ @ @ @ @ @ @ @ @ @ @ @ @ @ @ @ @ @ @ @ @ @ @ @ @ @ @ @ @ @ @ @ @ @ @ @ @ @ @ @ @ @ @ @ @ @ @ @ @ @ @ @ @ @ @ @ @ @ @ @
3
46 82 40 83
22 28 63 26
68 52 63 37
