12 12
@ @ @ @ @ @ @ @ @ @ @ @
@ . . . . @ . . . @ . @
@ . . . . . . . @ . . @
@ . . . . . . . . . . @
@ . . . . . . . . . . @
@ . . . @ . . . . . . @
@ . @ . . . . . . @ . @
@ . . . @ @ . . . . . @
@ . . . @ . @ . . . . @
@ . . . . . . . @ . . @
@ . . . . . . . . . . @
@ @ @ @ @ @ @ @ @ @ @ @
3
1 6 9 9
7 10 2 3
8 5 6 7
