50 50
@ @ @ @ @ @ @ @ @ @ @ @ @ @ @ @ @ @ @ @ @ @ @ @ @ @ @ @ @ @ @ @ @ @ @ @ @ @ @ @ @ @ @ @ @ @ @ @ @ @
@ . @ . . . . . . . . . . . . . . . . . @ . . . . . . . . . @ . . . . . . @ . . . . @ . . . . . . @
@ . . @ . . @ . . . . . @ . . . . . . . . . . . . . . . . . . . . @ . . . . . . . . . . @ . . @ . @
@ @ . . . . . . . . . . . @ @ . . . @ . . . . . . . @ . . . @ @ . . . . . @ @ . . . @ . . . . . . @
@ . . . . . . @ . . . . . . . @ . . @ . . . . @ . . . @ . . . . . . . . @ . @ . . . . . @ . @ . @ @
@ . . . . . . . @ . @ @ . . . @ . @ . . . . . . . . . . . . . . . @ . . . . . . . . . . . . . . . @
@ . . . . . @ . . . . . @ . . . . . @ . . . @ . . . . . . . . . @ . . . @ . . . . . . . @ . . . . @
@ . . . . . @ . . . @ . . . . . . @ . . . @ . . . . . . . . . . . . @ . . @ . @ . . . @ . . . . . @
@ . @ . @ @ . @ . . . . . . . @ . . . . . . @ . . . . . @ . . . . . . . . . . . . . . . . . . . . @
@ @ . . . . . . . . . . . . . . @ . . @ . . . . . . . . . . . . . . . . . @ . . . @ . @ . . . . . @
@ . . . . . . . . . . . @ . . . . . . . . . . . @ . . . . . . . . . . @ . . @ . @ . . @ @ . @ . . @
@ . @ . . @ . . @ @ @ @ . . . . . . @ . . . . . . . @ . @ . . . . . . . . . . . . . . . . . . . . @
@ . . . . @ @ . . @ . . . . @ . . @ @ . . . . . . . . . . @ @ . . . . @ . . . . @ . . @ . . . . . @
@ @ . . . . . . @ . . @ . . . . . . . @ . . . . . . . . . . . . . . @ . . . . . . @ . . . . @ . . @
@ . . . . . . . . @ @ . @ . . . . . . . . . @ @ . @ . . @ . . @ . . . . . . . . . @ . . . @ . @ . @
@ @ . . . . . @ @ . . . . @ . . . . . . . @ . @ . . . . @ . . . @ . . @ . . . @ . . . @ . . . . . @
@ . . . . . . . . . . @ . @ . . . . . @ . . . . . . @ . . @ . . . . . . . @ @ . . @ . . . @ . . . @
@ . . . . . . @ . @ . . . . @ @ . . . . . . . . . . . @ . . . . . . . . . . . . @ . . @ . . @ . . @
@ . @ . . . . @ . . . . . @ . . . . . . . . . . . @ . @ . . . . . . . @ . @ . . . . . . @ @ . . @ @
@ . . . . . . . . . . . . . @ . . . . . . . . . . . . . . . . . . . . @ . . @ . . . @ . . . . . . @
@ . @ . @ . . . . @ . . . . . . . . . . . . @ . . @ . . @ @ . . . . @ . . @ . . . . . . . @ . @ . @
@ . . . . . . . . . . . . . . . @ @ @ @ . . . . @ . . . @ . . . . @ . . . . . @ @ @ . . . . . . . @
@ . . . . . . @ . @ . . @ . @ . . . . . . . . . . . @ @ . . @ @ @ . . . . . . . . . . @ . . . . . @
@ @ . . . . . . . . @ . . . . @ . . . . . . . . @ . . . . . . . . . . @ . . @ . . . . . . . . . . @
@ . . @ . . . . @ . . @ . . . . @ . . . . . . . . . . . . @ . . . . . . @ . . . . . @ @ @ @ . @ . @
@ . . . . . @ . . . @ . @ @ @ . . . . . . . @ . . . . . . . @ . . . @ @ . . . . . . . @ @ . . . . @
@ . @ . @ . . . @ @ . . . @ . . . . . . . . . . . . . . . . . @ . . . . @ . . @ . @ . . @ @ . . @ @
@ @ . . . . @ . . . @ . . . . . . @ . . . . . @ . . . . . @ . . @ . . @ . . . . @ . @ . . @ @ @ . @
@ . . . . . . . . . . . . . . . . . @ . . @ . . . . . @ . . . . . . . . . . . . . . @ @ . . . . . @
@ . . . . . . . . . . . . . . . . . . . . . . . . . . . @ . . . @ . @ . @ . . . . . . . . @ . . . @
@ . . . . . . . . . . @ . . . . . @ . . . . . . . . . . . . . @ . . . @ . @ @ . . . . . . . . . . @
@ . . . @ @ . . . @ . . @ @ . . @ . . . @ . . . . @ . . . . . . @ . . . . . @ . . . . . @ . . . . @
@ . @ . . . . . . . . . . . . . . @ . . . . . . . . . . . @ . . . . . @ . . . @ . @ . . . . . . . @
@ . . . . . . . . . . . . . @ . . . . . @ . . . . . @ . . . . . @ . . @ . . @ @ . . . . . . @ @ @ @
@ . . @ @ . . . . . . . . . . . . . @ @ . . . . . . . . @ . . . @ . @ . . . . @ @ . . . @ . . . . @
@ . . . . . . . @ . . . . . . . . . . @ . @ . @ . . . @ . . . . . @ . . . . . . . @ . . @ . . . . @
@ @ . . . . . . . . . @ . @ . . . @ @ . . . . . . . @ . . . . . . . . . . . . . @ . . . @ . . . . @
@ . @ . . . @ @ . @ . . @ . . . . . . . . @ . . . . . . . . . . . . . . . . . . . . . . . @ . @ . @
@ . . . . . . @ . . @ @ . . . . . . . . . . . . . . . . . . . . . . . . . . . . . . . . . . . . . @
@ . @ @ . @ . . . . . . . . . . . @ . @ @ . @ @ . @ . . . @ . @ . . @ . . . @ . @ . . . . . . . . @
@ . . . . . . . . . . . . . . . . . . . @ . @ . . . . . @ . . @ . . . . . @ . . . . . . @ . @ . . @
@ . @ . . . @ . . @ @ . @ . . . @ . @ @ . @ . . . . . . . . . @ . . . . @ . @ . . . . . . . . . . @
@ . . . . @ . . . @ . @ . . @ . @ . . . . . . . . . . . @ . . . . . @ . . . . . . . . . . . . . . @
@ @ . . . . @ . . . . . @ . . . . . . . . . . . @ . . . . . . @ . . . . @ . . . @ @ @ . . . . . . @
@ @ . . . @ . . . . @ . @ . @ . . . . @ @ . . . . . . . @ . . @ . @ . . . . . . . . . . . . . . . @
@ . . . . . . . . . @ . . . . . . . . . . . . . . . @ . . . . . . . . . . . @ . . @ . @ . @ . . . @
@ . . . . @ . . . . . . @ . . . @ . . . . . . . . . . . . . . . . . . . . . . . . . . @ . . @ @ . @
@ . . . . . . @ . . . . . . . . . . . . . @ . @ . . . . . . . . . @ . . . @ . . . . @ . . . . . . @
@ @ . @ . . @ . . . . . . @ . @ . . . . . . . . . . . . . . . . . . . @ . . . . . . . . . . . @ . @
@ @ @ @ @ @ @ @ @ @ @ @ @ @ @ @ @ @ @ @ @ @ @ @ @ @ @ @ @ @ @ @ @ @ @ @ @ @ @ @ @ @ @ @ @ @ @ @ @ @
3
23 29 29 23
10 23 22 19
3 16 17 28
