100 100
@ @ @ @ @ @ @ @ @ @ @ @ @ @ @ @ @ @ @ @ @ @ @ @ @ @ @ @ @ @ @ @ @ @ @ @ @ @ @ @ @ @ @ @ @ @ @ @ @ @ @ @ @ @ @ @ @ @ @ @ @ @ @ @ @ @ @ @ @ @ @ @ @ @ @ @ @ @ @ @ @ @ @ @ @ @ @ @ @ @ @ @ @ @ @ @ @ @ @ @
@ . . @ . . . . . @ . . . . . . . . . @ . @ . @ . @ . . . . . . . . . . . . . . . . . . . . . . . . . @ . . . . . . . . . . . . . . . . . . . . . . . @ . . . . @ . . . . . . @ . @ . . . . @ . . . @ @
@ @ . . . . . . . @ @ . . . . . . @ . . . @ @ . . . . . . . @ . @ . . . @ . . @ @ . . @ . . . . @ . . . . . @ . . @ . . @ . @ . . . . . . @ @ @ @ . . . . . . . . . @ . . . . . . @ . . . . . . . @ . @
@ . . . . . @ . @ . . @ . . . . @ . . . . . . @ . . . . . . . . . @ . . @ . @ . . . . . . @ @ . . . @ . . . . . . . . . . @ . . . . . . @ . @ . . . . @ . . . . . @ . . . . @ . . @ . . . . . . . . . @
@ @ . . . @ . . . . . . . . . . @ . . . . . . . . . . . . . . . . @ . . . . . . @ . . . . . . . . . . @ . . @ . . . . . . . . . . . . . @ . . . . . . . @ . . @ . . . . . @ . . . @ . . @ . . @ . . . @
@ @ . . . . . . . @ . @ . @ . . . . . . @ . . . . . . . . . . . . @ . . . @ . . . . . . . . . . . . . . . . . @ . . . . . . . . . . . . . . @ . @ . . . . . . . . . . . . . . . . @ . . @ . . . . . . @
@ . . . . . . . . . . . . . . . @ . . . @ . . @ . . . @ . . @ . . . . @ . . . . @ . @ . . . . . . . @ . . . . . . . . @ . . @ @ . . . . . . . . . . @ . . . . . . @ . . @ . . . @ . . . @ @ . . . @ . @
@ . . . . . . . @ . . . . @ . @ @ . . . . . . . . @ . @ @ . @ . . . . . . . . . . @ . . . @ . . . . . . . . @ @ . . . @ . . . . @ @ . . . . . . @ . . . . . . @ @ . @ . . . . @ . . . . . . . @ . . . @
@ @ . @ . . . . @ . . . @ . . . . . . @ . . . @ . . @ . . . . . . . . . . . . . . . . . . . . . . . . . . . . @ . . . . @ . . . . . . . . . . . . @ . . . . @ @ . @ . . @ . . @ . @ . . . @ . @ . . . @
@ . . . . . . . . . . . . . @ . . . . . . @ . . @ @ . . . . . . @ . @ @ . . . . . . . . @ . . . . . . @ . . . . . . . @ @ . . . . @ . @ . . . . . . @ . @ . . . . . . . . . . . . . . . . . . . . . @ @
@ . . . . . . . . . . @ . . . . . . . . @ . . . . . . . . . . . . . . . . . . . @ . . . . . . . . . @ . . . . . . @ . . . . . . . . . . . . . . . @ . . . . . . @ . @ . @ . . . . . . @ . . . . @ @ . @
@ . . . . . . . . . . . . . . . . . @ . @ . @ . . . @ . @ . . . . . . . . @ . . . . . . . . . . . @ @ . . . . . . @ @ . . . . . . . . . . @ . . . . . . . . . @ . . . . . @ . . . . . @ . . . . . . @ @
@ . . . @ . . @ @ @ . . . @ . @ @ . . . . . . . . . . . . . . . . @ . . . . . @ . . @ . . . @ @ @ @ . . @ @ . @ @ . @ . . @ . . @ . . . . . . . . . . . @ . . . @ . . . . . . . @ . @ . . . . @ . @ . @
@ . @ . . . . . @ . . . @ @ . . . @ . . . . . . @ . . . . @ . . @ . . . . . . . . . . . @ @ . . . . @ . @ . @ . . . . . . . . . . . . @ . . . . . . . . . . . . . . @ . . @ . . . . . . . . @ . . . @ @
@ . . . . . . . . . @ . . . . @ . . . . . . . . @ . . . . . . . . . . . . . . . @ . . @ . @ . . . . . . . . . @ . . . . . @ . . @ . . . @ . . @ . . . . . . . . . . . . . . @ . . . . . . . @ . . . . @
@ . @ . . @ . . . @ . @ . . . @ . . . . . . . . @ . . @ . @ . . . . . @ . @ . . . . . . . . . @ . . . . . . @ . . . . . . . . . . . . . . . . . . . . . . . . @ @ . . . . . . . . @ . . @ . @ . . @ . @
@ @ . . @ . . @ @ . . . . . @ . @ @ @ . . . . . . . @ . . . . @ . . . . . . . . . . @ . . . . . . . . . . . . . @ . . . . . . . . . . . @ . . . @ . . . @ . . . . @ @ . . . . . @ . . . . @ . @ . . @ @
@ . . . . . @ @ . . @ . . @ @ . . . . @ @ . . . . . . . . . . @ . . . . . . . . @ . @ @ . @ . . @ @ . . . @ . . . . . . . @ . . . . . . . . . . . . . @ . @ . . . . @ . @ . @ . . . . . . . . . . @ . @
@ . @ @ @ @ . . . . . . @ . @ . . . . . . . . @ . @ . . . @ @ . . . . . . . . . . . . . . . . . . . @ . @ . . . @ @ . . @ . . . . . . . @ @ . . . . . . @ . . . . . . . @ . . @ @ . @ . . . . . . . . @
@ . . . . . . . . . . @ . . . . . . @ . @ . . . @ . @ . @ . . . . @ . . . . . @ . . . . . . . . @ . . @ . . @ . . . . . . @ . . @ . . . . . . . @ . . @ . @ @ @ . . @ . . . . @ . . . . . @ . . @ . . @
@ . @ . . . . . @ . . . . . @ . @ . . . . . @ . . @ . . . @ . . . . . @ . @ . . . @ . . . . @ . . . @ . @ . @ . . . . . . . . . . @ . @ . . . . . @ . . . . @ . @ @ . @ . . . . . . . . . . . . @ . . @
@ . . @ @ . . . . . . . . . . @ . . . . . . . @ . . . . @ . . . . . @ . . . @ . . . . . . . . . . . . . . . . @ . . . @ . . @ . . @ . . . . . . @ . . . . . . . . . . . . @ . . . @ . . @ . . @ . . . @
@ . . . . . . @ @ . . . . . . . . . . . @ . . . . . . . . @ . . @ . . . . . . . . . @ . . . . . . . . . . @ . . @ . . . . . . . . . @ @ . . . . . . @ . . . . . . @ . @ . . . . @ . . . . . @ . . . . @
@ @ . . . . @ . @ @ . . . . . . . . . . . . . . . @ @ . . . . . . @ . . . . . . @ . . . . @ . . . @ . . . . . . . . . . . . . @ . . . . @ . . . . . . . . @ . @ . . . . . @ @ @ @ . @ . . . . . @ . . @
@ . . . . . . . . . . . . . . . . . @ . @ . . . . . . . . . . . . . . . @ . . . . @ . @ . . . . . . . @ . . . . @ . . @ . . . . . . . . . . . . . . . . . @ . . . . . . . . . . . . . . . @ . . . @ . @
@ . @ . . . . . @ . . . . . . . @ . . @ @ . @ . @ . . . . @ . . . @ . . . @ . . . . . . . . . . . @ . . . . . . . . . . . @ . . @ . @ . . . . @ @ . . @ . . . @ . . . @ . . . . @ . @ . @ . . . . . . @
@ . . . . . . . . . . . . . . @ . . . . . . . . . . . . . . . . . @ . @ . . . . . . . @ . . @ . . . @ . . . . . . . . . @ . . . . . . . . . . . . . . . . . @ . . @ . . . . . . . . . . . . . . . . . @
@ . @ . @ . . . @ . . . . . @ . . . . . @ @ . . . . . . . . . . . . . . . @ . . . . . . . . . . . . @ . . . . . . @ . . . . . . . . . . @ . . . . . . . . . . . . . . . . . . . . . @ . . @ . . . . . @
@ . . . @ . @ . . . @ . @ . . . . . @ . . . . . . . . . . @ . . @ . . . . . . @ . . @ . @ . . . . . . . @ @ @ . . . . . . @ @ @ . . . @ . . . . . . . . . . @ . . . . . . . . . . . . @ . @ . . @ . . @
@ . . . . @ . . . . . . . . . . @ . . @ . . . . . . . . @ . . . . @ . . . . @ @ . . . . . . @ . . . . . . . . . @ . . . . . . . . . . . . . @ . @ . . . . . . . . @ . @ . . . @ . . . @ . . . . . . @ @
@ . . . . @ . . . . . . . . @ . . . . @ . . . . . . @ @ . . . . . . . . . @ . . @ . . . @ . . . @ . . . . . . . @ @ . . @ . . . . . . . @ . . . @ @ . . . . @ . . . . . . @ @ . . . . . . . . . . . . @
@ . . . . . . . @ . @ . . . . . . . . . . . . . . . . . . @ . . @ . . . . . @ @ . . . . . . . @ . . . . . . . . . . . . . . . . . @ . . . . . . . . . . @ . . . @ . . . . . . @ @ . . . . . . . @ . . @
@ . . . . . . . . . . . . . . . . . . . . @ . . @ . . . . . . . . @ . . . . @ . . . . . . . . . . . . . . . . . . . . . . . . . . . . . . @ . . . . . . @ . . . . . . @ . . . @ . @ . @ . . . . . @ . @
@ . . . @ . . @ . @ @ @ @ . @ . . @ . @ . . . @ . . . . . . . @ . . . . . @ . . . . . . @ . . . . . @ . . . . . . . . . . . . . . @ . . @ . @ . . @ . . . . . . . . . . . . . . @ . . . . . @ . . @ . @
@ . . . @ . . . . @ . . . @ . . . . . . @ . . . . @ . . . . . . . . . . . . @ . . @ . . . . @ . . @ . . . . . . . . . . . @ . . @ . . . . . . . . . . . . . . . @ @ @ . @ . . . @ . . . @ . . . . @ . @
@ @ . . . . @ . . . . . . . @ . . . @ . . @ @ . . . . . @ . . . @ . . . . @ . . @ . @ . @ . . . . . . . . . . . . . . . . . . . . . . . . @ . . . . . @ . . . . . @ . . . . . . . @ . . . . @ @ . . . @
@ . . . . . . . . . . . @ . . . . . . . . . . . . @ . . . . . . . . . @ . . . @ . . . . . . . . . . . . . . @ @ . . . . . . . . . . . . . . . @ . . @ . . . . . . . . . . . . . . . @ . . . . . @ . @ @
@ . . . . . . . @ . . . . . . . . @ . . . . . . . . . . @ . . . . @ . @ . . . . @ . . . . @ . @ . . . . . . . . . @ . . . . . . @ . @ . . . . . . . . . . . . . . . . . . @ . @ . . . @ . . . . @ . . @
@ . @ . @ . @ . . . . . . . @ . @ . . @ . @ . . . . . . . . . . . . . . . . . . . . . @ . . @ . . . . . . . @ . @ . . . @ . . . . @ @ . . @ . . . . . . . . . . . . . . @ . . . . . @ . . @ . . . . . @
@ @ . . . . . . . . . @ . . . . . . . . . . . @ . . . . . . . @ . . @ . . . . . @ @ . . . . . @ . . . @ . . . . . . . . . . . @ . . . . . @ . . . . . . . . @ @ . . . . . . . . . . . . . . . . . . . @
@ . . . . . . . . @ . @ . . . . . . . . . @ @ . @ . . @ . . . . . . @ . . . . @ . . @ @ . . . . . . . @ . . . . . @ . . . . . . . . . . @ @ . . @ @ . . . @ . . . . . @ . . . . . . . @ . . . . . . . @
@ . . @ . . @ . . @ . . . . . . . . . . . . @ . . . . . . . @ . . . . @ @ . . @ . @ . @ . . . . . @ . . . @ . . . . . . . @ . . @ . . @ @ . . . . . . . @ . . . . . . . . . . . . . . . @ . . . @ . @ @
@ . . . @ . . . . . . . . . @ . @ @ . . . @ . . . . @ @ . . . . . . . . . . . . . . . @ . . . . . . @ . . . @ . . @ . . . . . . @ . @ . @ . . @ @ . . . @ . . @ . . @ . . . . . . . . . . @ . @ . . . @
@ . . @ @ . @ . . . . . . . . . . . @ @ . . . @ . . . . . . . . . . . . . . . . . . . . . . . . . . . . @ . . @ . . . @ . . @ @ . . . @ @ . . . . . . . . . . . . . . . . @ . . @ @ . @ . . . . . . @ @
@ . . @ . @ . . . . . . . . . . . . @ . . . . . . . . . . . . . . . . . . @ . . @ . . . . . . @ . . . . . . . . . . . . . . . . . . . . . . . . . . . . @ . @ . . . . @ . . . . . . . . . . . . @ . . @
@ . . . . . @ . . . @ . . . . @ . . . . . @ @ . @ @ . . @ . . . . . . . . . @ . . @ @ @ @ . . . . . . @ . . . . @ . . @ . @ . . . . . @ . . . . @ . . @ . . . . . @ @ . . @ . . . . @ . . . . . . @ . @
@ . @ @ . . . . . . . . . . . . . . @ . . . . . . . . . . . @ . . . . . @ . @ @ @ @ . . . . . . . . . @ . . . . . @ . . . . . . . @ . @ . . @ . . . . @ . @ . @ . . . . . . @ . . . @ . . . . . @ @ . @
@ @ . . . . . . . . . . . @ . . . . . . @ . @ . . . . . . @ . . . . @ @ . . . . @ . . . . . . . @ . @ . @ . . . . . . @ . . . . . . . . . @ @ . . @ . . @ . . @ . . . . . . . @ @ @ . . @ . @ . . . . @
@ . . @ . . . . . @ . . . . . . . @ @ . . @ . . . . . @ . . . @ . . . . . . . . . . . . . . @ . . . . . . . . . @ @ . @ . . . . . . . . . . . . . @ . @ . @ . . . @ . . . . @ @ @ . . . . . . . . . . @
@ . . . . . . . . . . . . . . @ . . . . . . . @ . . @ . . . . . @ . . . . . . . . . . . . . @ . . . @ . . . . @ . . . . @ . @ @ @ . . . @ . . . . . . . . . . . . . . . . . @ . . . @ . @ . @ . @ . . @
@ . @ . . . . . . . @ . . @ . . . . . . . @ . . . . . . @ . . . . . . . . . @ @ . @ . . . . . . . . . . . . . . . @ . . . . . . . . . . . . @ . . . . . . . . . . @ . . . . . . . . . . . . . . . . . @
@ . . . . . . . . . . . @ . @ . . . . . . . @ . . @ . . . . . . . . . . @ . . . . . . . @ . . @ @ . . . @ . . @ . . . . . @ . . . . . @ . . . . . . . . . . . . @ . . . . . @ . . . . @ . @ @ @ . . . @
@ . . . . @ . @ . . . . . . . . . @ . . @ @ . . . . @ @ . . . . . . . . @ . . . . . @ . . . . . . . . . @ . @ . . . . @ . . . . . . . . . . . @ . . . . . @ @ @ . . . @ . . . . . . @ . . . . . . . . @
@ @ . . @ . . . . . . . . . . . @ . . . . . . . . @ . . . . . . . . . @ . . . @ . . . @ . . @ . . @ @ . . . . @ . . . . @ . @ . @ @ . . . . . . . . @ . . . . . . . . . . . . . . . . . . . . . @ . . @
@ . . . . . . @ . @ . . . @ . . . . . @ . @ . . . . . . . . . . . @ . . @ . . . . . @ . . . @ . . . @ . . @ . . . . . . . @ . . . . @ . . @ . . . @ @ . . . . . . @ @ . . @ . . . . . @ . @ . . . @ . @
@ @ . . . . . . . . . . . . . @ . @ @ . . . . @ . . . @ . @ . . . . . @ . . . . . . . . . @ . . . . . . . . @ . . . @ . . . . . . . . . . . . . . . . . @ . . . @ . . . @ . . . . . . . . @ . . . . . @
@ . . . @ . @ . @ . . @ @ . . . . . . . . . . . @ . . . . @ . . @ . . . . @ . . . . . . . . . . . . . . . . . @ . @ . . . @ . @ . . . @ . . . . . . . @ @ . . . . . . . . . . . . . @ . @ . @ . . . . @
@ . @ . . . . . . . @ . . . . . . . @ @ . . . . . . @ . @ . @ . . . @ . . @ . . . . . . . @ . . . . . . . . @ . . . . . . . . . @ . @ . . @ @ . . . . @ . . . @ . . . . . . . @ . . . . . . . . . . . @
@ . @ . . @ . @ . . . . . . . . . . . . @ . @ . . . . . . . . . . . . . . . . . . . @ . . . . . . . . . @ . . . . . . . . . @ . . . . . . . . . . . . . . @ @ . . . . . . @ . . . . @ . . @ . . . . . @
@ . . . @ . . . . . . @ . . . . . . . . @ . . . @ . @ . . . . . . . . . . . @ . @ . @ . . @ . @ . . . . . . . @ . . . . @ . . . @ . . @ . @ . @ . . . . @ . . . @ @ . . . . . @ . . . . @ @ . @ . . . @
@ . . . . . . . . . . . . @ . . . @ . . . . . . @ . . . . . . @ . . . @ . . . . . . . . . . . . . @ . . . . . @ . . . . . . @ . . @ . . @ @ . . . @ . @ . . . . . . @ . @ @ . . . . @ . . . . . @ @ @ @
@ . . . . . . . . . @ . . . . @ . . @ @ . . . . . . . . . @ . . . . @ . . . . . . . . . . . . . . . . . @ . @ . @ . @ . . . . . . . . . . . . . . . . . . . . . . . . . . . . . . . . . . . . . . . . @
@ . @ . @ . . . @ . . . . . @ . . . . @ @ . . . . @ . . . . . . . . . . . . . . . . . . . . . . . . . @ . . . . . . . @ . @ @ . @ . . . . . . . . . . . . . . . . . @ . . . . . . . . . @ . . . . @ . @
@ . . @ . . . @ . . . . @ @ . @ . . . . . . . . . @ . . . @ @ . . . . . @ @ . . . . . . . . . . . . . . @ . . . . . @ . . . . . . . . . . . . . . . . . . . . . . . . . . . @ . . . @ . . @ . . . . . @
@ . . . @ . . . . . . . @ . . . . . . . . . . . @ . . . @ . . @ . . . . . . . . @ . . . . . . . . . . . . . @ @ . . . @ . . . . . @ . @ . @ . . . . . . . @ @ . . . . . . . . . . . . . . . . @ . . . @
@ . . . @ . @ @ . . . @ . . . . . @ @ . @ . . @ . @ . . . . . . @ . . . @ . . . . . . . . . . @ . . . . @ @ . . . @ . . . @ . . . @ . @ . . . . @ . . . . @ . . . . . . . . . . . . . . . @ . . . . @ @
@ . . . . . . @ . . . . @ . @ . . . . . @ . @ @ . . @ . . @ . @ . . . . . @ . . . . . . . . . . @ . . @ . . . . . @ . @ . . . . @ . . . . . @ . . . . . . @ . @ . . @ @ . . . . . . . @ . . . . . . . @
@ @ . . . . . . . . . . . . . @ . . . @ . . . . @ . . . . @ . . @ @ . . @ . . . . . . . . . . . . . . . . @ . . @ . . . . @ . @ . @ . . . @ @ . . . . . @ . @ . . . . . . . @ . . @ . . . . . @ . . . @
@ . . . @ . . @ . . . . . . . . . . . . . . . . . . . . . . . . . . . . . @ . @ . . . . . . @ . . . @ . @ . . . @ . . . . . @ . . . . . @ . . . . . . . . . @ . @ . @ . . @ . . . . . . . @ @ . . . . @
@ . . . @ . . . . . @ . . . @ . . . @ . . @ . . . @ . . . . . . . @ . . @ . . . . . . . . . . @ . . . . . . . . @ . @ . . . . @ . . . . . . . . . . . . . . . @ . @ . . @ . . . @ . . . . . . @ . . . @
@ . . . . . . @ . . . . . . . . . . @ . . . . . . @ . . @ . . . . @ . . . . . . @ . @ . . . . @ . @ . . @ . @ . . @ . . . . . . . . . @ . @ . . . . . . . . . . . . . . . . . . . @ . @ . @ . . . . . @
@ . . . . . . . . . @ . . @ . . . . . . . . . . . . . . . . . . @ . . . . . . . . . @ . . . @ . . . . @ . . @ @ . @ . @ . @ . . . . @ . . @ . . . . . @ . . . . . . . . . @ . . . . @ . . . @ @ . . . @
@ . . . . . . . . . . @ . . @ @ . . @ @ . @ . @ . . . . . @ . . . . . @ . . . . @ . . . . . . . @ . . . . @ . . @ . @ . . . . . . @ . . @ . . @ . . . . . . . @ . @ . . . . . . . . . . @ @ . . . . . @
@ . . . . @ . . . . . . . . . . . . . . . . . . . @ . . . . . . . . . . @ @ . . . . . . . . . . . . . . . . . . . . . . . . . @ . . @ . . . . . . @ . . . . . @ . . @ . . . . @ . . . . . . . . . @ . @
@ . . . . . @ . @ . . . . . @ . @ . . . @ @ . . . . . @ . . . . . @ @ . . . . @ . . . . . . . @ . . . . . . . . . . . @ @ . @ . . . . . . . @ . @ . @ . . . @ . . @ . . . . . @ . . . . @ . @ . . . . @
@ . @ . . . . . . . . . @ . . . . . . @ . . . . . @ . . . . . @ . . . . @ . @ . . . . . . . . . . @ . @ . . . . . @ . . @ . @ . @ @ . . @ . . @ . . . . @ . . @ . . . @ . . . . . . @ . . . . @ . . . @
@ . . . . @ . . @ . . @ . @ . . . . . . . . . . . . . @ . . . . . . . . . . . . . . . . . . . . . @ . . . . @ . . . . . . @ . . @ . . . . . . . . @ . . @ . @ . @ . @ . . @ . @ . @ . . . @ @ . . . . @
@ . . @ . . . . . . . . @ . . . . . @ . . . . . . @ . @ . . @ . . . . . . . . . . . @ . . . . . . . . . . . . . @ . . . . . . . . @ . @ . . @ . . . . . . . . . . . . . . . . @ . . . . . . . . . . . @
@ . @ . . . . . . . . . . . . . . @ . . . . . . . . . . @ @ . . . . @ @ . @ . @ . @ . @ . . . . . @ . . . . @ . . @ . . . . . . . . . . . @ . @ . . @ . . @ . . @ . . . . . . . . @ . @ . . . . @ . . @
@ . . . . . . . @ . . . . @ . @ . . . . . . @ . . . . . . @ . . . . . . . . . . . @ . . . . . . . . . @ . . . . . . . . . . @ . . . . . . . . . . . . . . @ . @ . @ @ . . . @ @ . . . . . . @ . @ . . @
@ . . . @ . . . @ . . . @ . . . . @ . . . . @ . . @ . . . . . @ @ @ @ . . . . . . @ . . . . . . @ . . . . . . . . . . . @ . . . . @ . @ @ . . . . . . . . . . . . @ . . . . . . . . . @ . . . @ . @ . @
@ . @ . . . . . . . . . @ @ . @ . . . @ . . . @ . . . . . . @ . . . . . . @ . . . . . @ . . . . . . . @ . . . . . @ @ . . . . @ . . @ . . . . . . . . . @ @ @ . . . . . . . . . @ . . . . @ . @ . . . @
@ . . . . @ . @ . . . . . . . . @ . . . . . . . @ . . . . @ @ . . . . . . . . @ . @ . . . . . . . . . . . . . . . . @ . . . . . @ . . . . @ . . @ . @ @ . . . . @ . . @ . . . . . . @ . . . . . . . . @
@ . . @ @ . . @ . . . . . @ . . . . . . @ . . @ . . . . . . . . . . . . . @ . @ . . @ @ . @ @ . . . . . @ . . . . . . . . . . . @ @ . @ @ . . . . @ . . . . . . . . . . . . . . . . @ . . . . . @ . . @
@ . . . . . . . @ . . @ . . . . . . . . @ @ . . . . . . . . . @ . . @ . . . . @ . . . . . . . @ @ . . . . . @ . . @ . . . . . . . . . @ . . @ . . . . . . . . . . . . @ . @ . . . . . . @ . . . . . . @
@ @ @ . . . . @ . . . . . . . . . . . . . . @ @ . @ . . . . . . @ . . . . . . . @ . . . . . . . . . . . @ . . . . . @ . . @ @ . . . . . . @ . . . . . . @ . . . . . . . . . . . @ . . . @ . . . @ @ . @
@ . . . . @ . . . . . . . . . @ . . @ @ . . . . @ . . @ . . . . . @ @ @ . @ . . . . . . . . . @ . . @ . . @ . . . . . . @ . @ . @ . @ . @ . . . . @ . . @ . . . . . @ . . . . . . . . . . . @ @ . . . @
@ . . @ . . . . @ . . . . . @ @ . . . . . . . . . . . . . . . @ @ . . . . . . . . . @ . . . . . . . @ . @ . . @ . . . . . . . . . . . @ . . @ . . . . . . . . @ . . . . . . . . . . @ . @ . . . . . . @
@ . . . . . . . . . . @ . . . @ . @ . . . . . @ @ . . . . . . . . . . . @ . . @ . @ . . . . @ . . . . . . . . . . . . . . @ . . . . @ . @ . @ . . . . . . . . . . . . . . . . @ . . . @ . . @ . . . . @
@ . . . . . . . . . @ @ . . . . . @ . . . . . @ . . . . . . @ . . . . . . @ . . . . . . . . . @ @ . @ . . . @ . . . @ . . . . . . . . @ . . . . . . . . @ . . . . . @ . @ . . . @ . . . . . . . . . . @
@ . . @ . . . . @ . . . @ @ . . . . . . @ . . . . . @ @ . . . . . . @ . . . . . . . . . . @ . . @ . . . @ . . . . . @ . . . @ . @ @ . . . @ . @ . . . . . . . @ . @ . @ . . . . . . . . . . @ . . @ . @
@ . . . . . @ . . . . . @ . @ . . . . . @ . @ . . . @ . @ . . . . @ . . . . . @ . . . @ . . . . . @ @ . . . . . . . . . . . . . . . . . @ . . . . . . . . . . . . . . . . . @ . . . . . . . @ . . . . @
@ . . . . . . . . . @ . . . . @ . . . @ . . . . . . . @ . . . . . . . . . . . . @ . . . . . . . . . @ @ . @ . . . . . . . . . . . @ . . . . . . . . . . . . . . . . @ . @ . . . . @ . . @ . . . . . . @
@ . . @ . . . . . . . @ . @ . @ . . . @ . . . . . . . . . @ . . . . @ . . @ . . . @ . . . . . . . . . . @ . . . . . . . . . . . . . . . . . @ . . . . . @ @ . . . . . . . . @ . . @ . . . . . . @ @ . @
@ . . . . . . . @ . . . . . . . . . . . . . . . @ . . . @ . . . @ . . @ . . @ . . . . . . . . . . . . . . . . @ . . . @ . @ . . . . . @ @ . . . . . . . . . . . . . . . . . . . . . . . . . . @ . . . @
@ . . . . . . @ . . . @ @ . . . . . @ . @ . . @ . . . . . . . @ . . . . @ . . @ . . @ . . . . @ . . . . . . @ . . . . . . . . . . . . . . . . . @ . . . @ . @ . . . . . . . . @ @ . @ . @ . . . . . . @
@ @ @ @ . . @ . . . @ . . @ . . . @ . . . . . @ . . . . . @ @ . . . @ . . . . . . . . . . . . . . . @ . . . . @ @ . . . @ . . . . . . @ . . . . . . . . . . @ . . . . . . . . . . . . . . . . . . . . @
@ @ . . @ . @ . . . . @ . . . . @ . . . . . . . . @ . . . . @ . . . . @ . . . . . . . @ . . . @ . . . . @ . . . . . . . . . . . . . @ @ . . . @ @ . . . @ . . @ . . . @ @ . . . . @ . . . . . . @ . @ @
@ . . . . . @ . @ . . . . . . @ . . . . . @ . . . . . . @ . . . @ . @ . @ . @ . . . . . @ . . . . . . . . . . . . . . . . . . . . . . . . . . . . . . . . . . . . . . @ @ . @ . . . . . . . @ . . . . @
@ @ @ @ @ @ @ @ @ @ @ @ @ @ @ @ @ @ @ @ @ @ @ @ @ @ @ @ @ @ @ @ @ @ @ @ @ @ @ @ @ @ @ @ @ @ @ @ @ @ @ @ @ @ @ @ @ @ @ @ @ @ @ @ @ @ @ @ @ @ @ @ @ @ @ @ @ @ @ @ @ @ @ @ @ @ @ @ @ @ @ @ @ @ @ @ @ @ @ @
3
91 72 44 94
75 77 79 60
40 7 36 66
