12 12
@ @ @ @ @ @ @ @ @ @ @ @
@ . . . . . . . . . . @
@ . . . @ . . . . @ . @
@ . . . . . . . . . . @
@ . @ . . . . @ . . . @
@ . . @ . . . . . . @ @
@ . . @ . @ . . @ @ . @
@ . . . . @ . . . . . @
@ . . . . . . @ . . . @
@ . . . . @ . . @ . @ @
@ . . . . . . . . . . @
@ @ @ @ @ @ @ @ @ @ @ @
3
4 9 8 10
2 3 3 8
4 6 2 2
