100 100
@ @ @ @ @ @ @ @ @ @ @ @ @ @ @ @ @ @ @ @ @ @ @ @ @ @ @ @ @ @ @ @ @ @ @ @ @ @ @ @ @ @ @ @ @ @ @ @ @ @ @ @ @ @ @ @ @ @ @ @ @ @ @ @ @ @ @ @ @ @ @ @ @ @ @ @ @ @ @ @ @ @ @ @ @ @ @ @ @ @ @ @ @ @ @ @ @ @ @ @
@ . . . . . . @ . . . . . . . @ . @ . . . @ . . . . . . . . . . @ . . . . . @ . . @ . . . . . . . . . . . . . @ . . . . . . . . . . . @ . . @ . @ . . @ . @ . . . . @ . . . . . . . . . . @ . . . . . @
@ . . @ . . . . . . . @ . @ . . . . . . . . . @ . . . . . . @ . . . . @ . . . . . . @ . . . . @ . . . . . @ . . . . . . @ . @ . . . . . . . . . @ . . @ . . . . . @ @ . . . @ . . . . . . . . @ . . . @
@ . . @ . . . . @ . . . . . . @ . @ . . . @ . . . . @ . @ . . . . @ . @ . . . . . . . @ @ . . . . . . . . . . . @ . . . @ . . . . . . . . . . . . @ . . . @ . . . . . . . . . . . . . . . . . . . @ . @
@ . . @ . . . @ . . . . . . @ . . . . . . @ @ . . . . . . . . . . . . . . . . @ . . . @ . . . . . . . . . . @ . . . . . . . @ . . . . . . @ @ . . . . @ . . . @ . . . . . @ . @ . @ . . . . . . @ . . @
@ @ . . . . . @ . . . . . . . . @ . @ . . . . . . . . . . . . . . . @ . . @ @ . . . . . . . . . . . . . . @ . @ . . @ . . @ . . . @ @ . . . . . @ . . . . . . . . @ @ @ . . . . . . . . . @ . @ . . . @
@ . @ @ . . . . . . . . . . . . . @ @ . . . . @ . @ . . @ . . . . @ . . . . . . . . . . . . . . . . . . . . . . . . . . . . . @ . . . . . @ . . . . . . . . . . @ . . . . . . @ . . . . @ . . . . . . @
@ . . . . . . . @ . @ . . @ . . @ . @ . . @ @ . @ . . . . . . . . . . . . . . . . @ . @ . . . @ @ @ . . . . . @ @ . . . . . @ @ @ @ . . . . . . @ . @ . . . . . . @ . . . . @ . @ @ . . @ . . . . . . @
@ . . . . . . . @ . @ @ . . . . @ . . . . . . . . @ . . . . . . . . . . . . . . . . . . @ . . @ . . . . . . . @ . . . . . . . . . . @ . . . . @ . . @ @ . . . . . . . . . . . @ . . @ . @ . . @ @ . . @
@ . @ . . . . . . . . @ . . . . . . . . . . . . . . . . @ . . . . . . @ . . . . . @ . . . . . . . . @ @ . @ . @ . . . . . . . @ . . . . . . . . . . . @ . . @ . . . . @ . . . . . . . . . . . . @ . . @
@ . . . . @ . . . . . . . . . . . . . @ . . . . . . . . . @ . . . @ . . . . . . @ . @ . . . . . @ . . . . . . . . @ . . . @ . . @ . . . . . . @ . . . . . . . @ . . . . . . . @ @ . @ . . . @ . . . . @
@ . . . . . . . . @ . @ @ . @ . . . . . @ . . . @ . @ . . . . . . . . . @ @ . . . @ . . . . @ . . . @ @ . . . . . . . . . . . . . . . @ . @ . . . . . . @ @ . . . . . . @ @ @ . . . . . @ . . . @ . . @
@ . . . . . @ . @ . . . . . . . . . . . . @ . . . . . . @ @ . . @ . . . . . @ . @ @ . @ . @ . . . . @ . . . . . @ . . . . @ . . . . . . . . . @ . @ . . . . . . @ . . . . . . . @ . . . . . . . . . . @
@ . . . . . . . . . . . . @ . . @ . . . . . . . . . . . . . . . . @ . . @ . @ . . . . . @ . . . . . . . @ . . . . . @ . . . . . @ . @ . @ . . . . @ . . . @ . . . . . @ . @ @ . . . . . @ . . @ . . . @
@ @ . . . . . . . @ . @ @ @ . . . . @ . @ . . . . . @ . . . . @ . . . . . . . @ . . . @ . . @ . . . @ . @ . . @ . . . . @ @ . @ . . . @ . . . @ . . . @ . . . . . @ . . . . . @ @ . . . . . . . . . . @
@ . . . @ . . . . . . . . . . . . . . @ . . . . . @ . . . . . . . . @ . . . . . . . . . . . . . . . . . . . @ . . @ @ @ . . @ . . . . . . . @ . . . . . . . . . . . . . . . . @ . . . . . . . . @ . . @
@ @ . . . . @ . . @ @ . . . . . . @ @ . @ . . . . @ @ . @ . . @ . . . . . . @ . . . . . . @ . . . . @ . @ . . . . . . . . @ . . @ . . . @ . @ . . . . . . . . . . . @ . . . . . . @ . . . @ . . . @ . @
@ . . . . . @ . . . . . . . @ . . . . . @ . . @ . . @ . . . . . . . . . @ . . . . . @ . . . @ . . . . . . . . . . . . @ . . @ . . @ @ . . . . . . @ @ @ . . . @ . . @ . @ . . . . . . . . . . . . . . @
@ . . . . . . . . . . . . . . . . . @ . . . . . . . . . . @ @ . @ . . . . . . . . . . . . . . . @ . @ . . . . . . . . . . . @ . . . . . . . . . . @ . . . . . . . . . . . . . @ . . . @ . @ @ . . . . @
@ . . @ . @ @ . . . . @ . . @ . . . . . . @ . . . . . @ . . . @ . . . . . . . . . . . @ @ . . . . . . @ . . . . @ . @ . . . . . . . . . . . . . . @ . . . @ @ . . @ . . . . . . . . . @ . . . . . . . @
@ . @ . . . . . . . @ . . . . . @ . . . . . @ . @ . . . @ @ . @ . . . . . @ . . . . . . . @ @ @ . . . . . . . . . @ @ . . . . . . . @ @ . . @ . . @ . . . @ . @ . . @ . . . . . . . @ . . . . . . @ . @
@ . @ @ . . . @ . . . . . . . @ . . . @ . . . . . @ . . . . . @ . . @ . . @ . . . . . . . . . . . @ . . . . . . . . . . . @ @ . . @ . . . . . . . @ . . . . . . . . . @ . @ . . . . . @ . . . . . . . @
@ . . . . . . . . . . . . . . . @ @ . . . . . . @ @ . . . . . @ . . . @ . . . . @ . . . . . . . @ . . . . @ . . . . . . @ . . . @ . . . @ . . . . . . . @ . . . . . @ . . . . . . . . . @ . . . . . @ @
@ . @ . . . . @ . . . . . . . . . . @ . @ @ . @ . . . . . . . . . @ . . . @ . @ . . . @ . . . . @ . @ . . . . . . . . . . . . . . . @ . . . . @ @ . . . . @ . . . . . @ . . @ . . . . . . @ . . . . . @
@ . . . . . . . . . . . . . . . . . . . . . . @ . @ @ . . @ . . . . . @ @ . . . . @ . @ . . @ . . . . @ . . . . . . . . . . . @ . . . . . @ . @ . . . . . . . . . . . . . . . . . . . . . . . @ @ . . @
@ . @ . . @ . . . . . . . . . . . . @ . . . . @ . . . @ . . . @ . . . . @ @ . . . . . . . . . . . . @ . . @ . @ . . . . . . . . . . . . . . . . . . . . . @ . @ @ @ . . @ . . . . . . . . . . @ . . @ @
@ . . . @ . . . . @ . . . . . . @ . . . @ . @ . @ . . . . . . . @ . . . . . . . . @ . . . @ . @ . @ . . @ . . . . @ . . . . . . . . @ . . . . . . @ . . . . @ . . @ . @ . . . . . @ . . . . . . . . . @
@ . . . . . @ . . . . . . . . . . . @ . . . . . . @ . . . @ @ . . . . . . @ @ . . . . . . . @ . . . . . . . . . @ . . @ . . . . . . . @ . . @ . @ . . @ . . @ . . . . . . . . @ @ . . @ . . . . . . . @
@ @ . . . . . . . . @ . . @ . . . . . . . . . . @ . . . . . . @ . . . . . . @ . . . @ . . . . . . . . . @ . . . . @ . . . . . . @ @ . . . . . . . @ . . @ . @ . @ . @ . . . . . . . . . . @ . . . @ . @
@ . . . . . . . @ @ @ . . . . . . @ . . @ . . . . . . . . . . . . . . . . . . . @ . . @ . . . . . . . @ . . . . . . . . . . . . . . . . . . @ . . . . . . @ . . . . . . . @ . . @ . . . . . . . @ . . @
@ . . @ . . . . @ . . . . . . . @ . . @ @ . . . @ . . . . . . . . . . . . . . . . . . . . @ @ . . . @ . . . . @ . . . . . . . . . . @ . . . @ . . . . @ . @ . @ . . . . @ . . . . @ @ . . . . . . . . @
@ . . . . . . . . . @ . . . . . . . . . . . @ . . @ . . @ @ . . . @ . . @ . . . @ @ . . . . . . . . @ . . . . . . . . . . . . @ . . . . . @ @ . . @ . . . @ . . . . . . @ . . @ . . . . @ . . . . . . @
@ @ . . . @ . . @ . . . . . . . . . . . @ @ . @ . . . . . . . . . . @ . . . . @ . @ . . . . @ . . . . . @ . . . . . @ . . . . . . @ . . . . . . . . @ . . . . . . @ . . . . . . . @ @ . . . @ . . . @ @
@ . . . . . . . . . . . . . @ @ . @ . . . . . . . . . . . . . . @ @ @ . . . @ . . . @ . . . . @ . . . . . . @ . . . . . . @ . . . . . @ . . . . . . . @ . . . @ . . . . . . . . @ . . . . . . . . . . @
@ . . . @ @ . . . . . . . @ . . . . . . . @ . . @ . . . . . . . . . . @ . @ . . . . . . . @ . @ . . . . . . . . . . . . . . . @ . . . . @ . . . . . @ . . . @ . @ . . . . . . . . . . @ @ . @ . . . . @
@ . . . @ . . . . @ . . . . . . . . . . . . . . . . @ . . @ . . . . . . . . . . . . . . . @ @ . . @ @ @ @ . . . . . . . . . @ . . @ . . . . . . . @ . . . . . . . . . . . @ . . . @ . . . @ . . . . . @
@ . . @ . . . . @ . . . . . . @ @ . . . . . . @ . @ . . @ . . . . . . . . . . . . @ . @ . @ . . . @ . @ . . @ @ . . @ . @ @ . . @ . . @ @ . . . @ . . @ . . . @ . . . . . . . @ . . . . . . @ . . . . @
@ . @ . @ . . . @ @ . @ . . . . . . . . . . . . . . . . . @ . . . . . . @ @ . . . @ . . . . . . . . . . @ . . . @ . . . . . . . . . . . @ @ . @ . . . . . . . @ . . . . @ . . @ . @ . @ . . . . @ @ . @
@ . . @ . . . . @ . . . . . @ . . . @ . . . . . . . . . . . . @ . . . . . . . . . @ . . . . . @ . . . . . . . . . . . . . . . . . . . . . . . . . . . . . . . . . . . . . . @ . . . . . . . @ . @ . . @
@ . . . . . . . . . @ @ . . . . @ . . @ @ @ . . @ . . . . . @ . . . . @ . . . . . . . @ . @ . . @ . . . @ . . . . . . . @ . . . . @ . . . . . . . . @ . . @ @ . . . . . . . . @ . @ . @ . . . . . . . @
@ . . . . . . . @ . . . . . . . . . @ . . . . . . . . . . . . @ . . . . . . @ . . . . . . . . . . . . @ . @ . . . . . . . . . . . . . . . . . @ . . . . . . . @ . . . @ . . . . . . . . . . . @ . . @ @
@ . . . . . . . . . . . . . . . . . . @ @ . . . . . @ . . . . . . @ @ @ . . . . . . . . . . . . . . . . . . . . @ . @ . . . . . . . . . @ . @ . . @ . . . @ . . . @ . . . @ . . . . @ . @ . . . . @ . @
@ @ . . @ . . . . @ @ . . . @ @ . . . . . . . . @ . @ . @ . @ . @ . . . . . @ . @ . . . @ . . . @ . . . . . . . . . . . . . . @ . @ . . . . . @ . @ . @ . . . @ . . . . . . @ . @ . @ . . . . . . . . @
@ . . . . . . . . . . . . . . . @ . . . . . . . . . . . . . . @ . . . . . . . @ . . . . . @ . . . @ . . . . @ . . . . . . . . . . . . . . @ . . . . @ . . @ . . @ . . . . . . . . . . . . @ @ . . . . @
@ @ . . . . @ . . . . . @ . . . . . . . @ . . @ . . . @ . @ . . . . . . . . . @ . @ . . . . @ . . . . . @ . . . . @ . @ . @ @ . . . . . . . . . . . . . @ . . . . @ . . @ . . . @ @ . @ . . @ . . @ . @
@ . . . @ . . . . . . . @ . . . . . . . @ . @ . . . @ . . . . . . . . . . . @ . @ . . . . . @ @ @ . . . @ . . . . . . @ . . . . . . . . . . . . . . . . . . . . . . . @ . . @ . . . . . . . . . . . . @
@ . . . . @ . . . . . @ . . . . . . . . @ . @ . . . . . . @ @ . . . . @ @ . . . . . . . . . . . . @ . . . . . . . . @ . . . . . . . . @ . . . . . . . @ . . . . . . @ . . . . . . . @ . @ @ . . @ . . @
@ . . . @ . @ . . . . @ @ . . . @ . . . . @ . . @ @ . . @ . . . . . . . . @ . . . @ @ . . . . . . . . . . @ . . . @ . @ . . @ . . . . @ . . @ . @ . @ . . . . . . . . . . . . . . . . . . . . @ . . . @
@ . . . . . . . @ . . . . . . . @ @ . . @ . . . . . . . . @ @ . . . . . . . . @ @ . . . . . . . @ . @ . @ . . . . @ . . . . . . . . . . . @ . @ @ . . @ @ . . . . . . . . . . . . @ @ . . . . . . . @ @
@ . @ . . . . . . @ . @ . . . . . . . . @ . . . . . . . @ . . . . . . @ @ . . . . . @ . . . . @ . @ . @ . . . . . . . . . @ . . . . @ @ . . . . @ . . . @ . . . . @ . . . . . . . . . @ . . . . . . . @
@ . . @ . . . . @ . . . . . . . . . . . . . . @ . . . . . @ . . . @ . . . . . @ . . @ . . . . . . . . . @ . . @ . . . @ . . . @ . @ . . . . . . . . . @ . . . . . . . @ @ . . . . . . . @ . @ . . . . @
@ . . @ . . @ . . . . . . . . @ @ @ @ . . @ . @ @ . . . . . . . @ @ . . . . . . . . . . . @ . . . . . @ . . . . . @ . . . . @ . . . . . . . . . . . . . . . . . . @ . . . . . . . . . . . . . . . . . @
@ . . . . . . . . . . . . @ . . . . @ . . . . . . @ . @ @ . . . . . @ . @ . . @ . . . . . @ @ @ . @ . . . . . . . . . . . . @ . . @ . . @ . @ @ . . . @ . . . . . . . . . . . . . . . . . . . @ . . . @
@ . . . . . . . . . @ . . @ . . . . . @ . . . @ . . @ @ . . @ . . . . . . . . . . . . . . . . . . . @ . . . . . . . . @ . @ . @ . . . . . . . . . . . . . . . . @ . . . . . @ . . . . . . . . . . . . @
@ @ @ @ . @ . . . . . . @ . . . . . . . @ . . . . . . . . @ . . . . . . . . . @ . . . . . . . . @ @ . . . . . @ . @ . . . @ . @ . . . . . . . @ . . . . . . . . . . . . @ . . . . . @ @ . . . . . . @ @
@ . . @ . . . @ @ . . . . . . . . . . . . . . @ . . . . . . . . @ @ . . . . @ . . . . . . . . . . . . . . @ . . . . . @ . . . @ . . . . . . . . . . @ . . . . . @ . . . . . . . . . . . @ . . @ . . . @
@ . . . . . . . . . @ . . . . . . @ . . . . . @ @ . . . @ . @ . @ . @ . @ . @ . . . . @ @ . . . . . . . . . . @ . . . . . @ . . . . . . . . @ . @ . . . . . . @ . . . . . . . . . . @ . . . . @ @ . . @
@ . . . . . . . . . . @ . . . . @ @ . @ . . . . . . . . @ . . . . . @ @ . . . . @ @ . . . . . @ . @ @ . . . . . . . . @ . . @ . @ . . . @ . . . . . . . @ . . . . @ . . . @ . . . . . . @ . . . . . . @
@ . . . . @ . @ . . @ . . . . @ . . . . @ . . . . . @ @ @ . @ . @ @ . . . @ . . . . . . . @ . . . . @ . . . . . . . @ . @ . . . . @ . . @ . @ . . . . . . . . . . . . . . . @ . . @ @ . . @ @ . . . . @
@ . @ . . . @ . @ . . . @ . . @ . . . . @ . . @ . . . . . @ . . . . . . . . . . . . . . . . @ @ . . . . . . . . . . . . . . . . . @ . . . @ . . . . @ . . @ @ . . . . . @ . . . . . . . . . . . . . @ @
@ . . @ @ . . . @ . . . . . . @ . . . . . . . . @ . @ . . . @ . . . . . @ @ . . . . . @ . . . . . . . . . @ @ @ . . . @ . . . . . . . . @ . . @ . . @ . . @ . . . . . . . . . @ @ . . . . . . . . . . @
@ . . . . . . . . @ . . . . @ . . . @ . . . . . . @ @ @ . @ . . . . @ . . . . . . . . . . @ . . . . . . . . . . . @ . . . . . @ . @ @ . . . . . @ . . . . . . . . . . . . . . . . . . . . . . @ . @ . @
@ . . @ @ @ . . @ . . . . @ . . . . . @ @ . @ . . @ . . . @ . . . . . . . @ @ . . . @ @ . . . . . . . . . . . @ . . . . . . . . . . . . @ . . . . . . . . . . @ . . @ . . @ . . . . . . . @ . . @ . . @
@ @ . . . . . . . . . . . . @ . . . . . @ . . @ . . . . @ . @ . . . . . @ . . @ . . . . . . . . . . . @ . . @ . . . . . . . . . . . . . . . . . . . . @ . . . . . . . . . . . . . . @ . . . . . . . . @
@ @ . . . . . . . . . . . . . . . . . . . . . . . . . . @ . . . . . . @ . . . . . . . @ . @ . . . . . . . . . . . . . @ . . @ @ . . . . . . @ . . @ @ . . @ . . . . . . . @ . . . . . . . . . . @ . . @
@ . . . . . . . . . . . @ . . . . . . . @ . . . . @ . . . . . . . . @ . . . . . @ @ . @ . . . . . . . @ . . . . . . @ . . . . . . . @ . . . . . . . . . . @ . @ . . . . . @ . . . . @ . . . . . . . . @
@ . . . . . . . . . . . . . . . @ . . . . . . . . . @ . . . . . . . . . . @ . . . . @ . . . @ . . . . . . @ . . . @ . . @ . . . . . @ . . @ . . . . . . @ . @ . @ . . . . . . . @ . . . . . . . . . . @
@ . . . . @ . . . . . @ @ . . . @ @ . @ . . . . . . . . . . . . . . . @ . . . . @ . . . . . . . . . @ @ . . . @ . . . @ @ . . . . . . . . . . . . . . . . . . . . . . . . . . . . . . . @ . . . @ . . @
@ . . @ . . . . @ . . . . @ . . . . . . . . . . . . . . . . . . . . . . . . . @ . . . . . . . . . @ @ . . . @ @ . . . . @ . . . . . . . . @ . . . @ . @ . . . . . . . . . . . @ . . @ . . . . . . . . @
@ . @ . . . . . @ . . . . . . . . . . . . . @ . . . . . . . . . . . . . @ . . . . . @ . . . @ . . . . . . . . . . . . . . . . @ . . @ . . . . @ . . . . . . . . . @ . @ . @ . . . . . . . . . . . . @ @
@ . . . @ . @ . @ . . . . . . @ . . . . . . @ @ . . . . . . . . . . . . . . . . @ . . . . . . . . . . . @ . . @ . @ . . . . . . @ . . @ . @ . . . @ . . . . . . . . . . . . @ . . . . . . . . . . . @ @
@ . . . . @ . @ . . . . @ . . . . @ . @ . . . . . . . @ @ @ @ . . . . . . . . @ . . . . @ @ . . . @ . . . @ . @ . . . . . . @ . . . . . . . . . . . @ @ . . . . . . . . @ . . @ . . . . . . . . @ . . @
@ . . @ . . . . @ . @ . . . @ . . @ . @ . . . . @ @ @ . . . . . . . . . . . . . . . . . . . . @ . . @ @ . . . . . . . . . . . . . . . @ . . . . . . . . . . . . . . . . @ . . . @ . @ . . . . . . . @ @
@ @ . . . . @ . . . . . . . . . . @ . . . . @ . . . . . . . . . . . . . . . . . . . . . . . . . . @ . . . . . . . . @ . . . . @ @ . . . . . . . . . . @ . @ . . . . @ . . @ . . . . . . . . . . . . . @
@ . . . @ . @ . . . . . . . . . . . @ @ . . . . @ . . . . . . @ . . @ . . . . . . . @ . . @ . . . . @ . . . . . . @ @ @ . @ . . . . . . @ . . . . . . . . . @ . @ . . . @ . . . . . @ @ . . . . . . . @
@ . . @ . @ . . . @ @ . . . . . . . @ . . @ . . @ . . @ . . . . . @ . . . . . . . . . . . . . @ . . . . . @ . @ . . . . @ . . @ . . . . . @ . @ @ . . . . . @ . . . @ @ . . . . @ . . @ . @ @ . @ . . @
@ @ . @ . . @ @ . . . . . @ . . . . . . . @ . . . . @ . @ . . . . . . . . . . . . @ . . @ . . . . . . . . . . . . . . . . . . . . . . . . . . @ . . . . . . @ . . . . @ . . . @ . @ @ @ . . . . . . . @
@ . @ . . . . . . . . . . . @ . . . . . . . . . . @ @ @ . . . . . . . . @ . . @ . . . . . @ . . . . . . . . . @ @ . . . @ . . . . . @ . . . . @ . . . . @ . . . @ @ . @ . . . . @ . . . . . . . . . . @
@ . . . . . . . . . @ . . . . . . . . . . . . . . . . . . . @ . . . . . @ . . . . . @ . . . @ . . . . . @ . . . . @ . . . . @ . @ . @ . @ . . . @ . . . @ . . . . . . . . @ . . . . . . @ . . . . . @ @
@ . . . . . @ . @ . . . . . . . . . . . . . . @ . . . . @ @ . . . . . . . . @ . . @ . . . . . . . . . @ . . . . . . . @ . . @ . . . . . . . . . . @ . @ . . . . @ . . . . . . . . . . . @ . . . . . . @
@ . @ . . . . . @ . . . . . @ . . . . @ . @ . . . . . . . . . . . @ . . . . . . . . . . . . @ . @ . . @ . . . . @ . . . @ . . @ . . . . . . @ @ . . . . . . . . . . . . . . . . . . . @ . @ . @ . . . @
@ . . . . @ . . . . . . . . . . . . . . . . . @ . . . @ . . . . . . . @ . @ . . . . . . . . . @ . @ . . . . . . . . . . . . . . . . . . @ . . @ @ @ . . . @ . @ . . @ . . . . @ . . . . @ . . . . . . @
@ . . @ . . . @ @ . . . @ . . @ @ . . . . @ . @ . . . . . @ . @ . @ . . @ . @ . @ . . . @ . . . . . . . . @ @ . . . . . . @ @ . . . . . . @ . . . . @ . . . @ . . . . @ . . . . . . . . . @ . . @ . . @
@ @ . . . . . . . . . @ . @ . . . . . @ . @ . . . . . . . . @ . . . @ . . . . . . . . . @ @ . @ . . . . . . . @ . . . @ . . @ . . . . . . @ . @ . . . . . . . @ @ . . . @ . @ . . . . . . . . @ . @ . @
@ . . . @ . @ . @ . . @ . . . . . . . . @ . @ . . @ . . . . . . . . . . . . . . @ . . . . . . . . . . . . . . . @ . @ . . . . . . . . . . @ @ . . . . . . @ @ . @ . . @ . . . @ . . . . . @ . @ . . . @
@ . . . . . . . @ . . . . . . . . @ . . . . . . . . . . . @ @ . . . . . . . . . . @ . . . . . . . @ @ . . . . @ . . . . @ . . @ . . . . . . . . . . . @ . . @ . . . . . . . @ . . . . . . . @ . . . . @
@ . . . . . @ . . @ . . @ . @ . . . . @ . . . @ . @ . . @ . . . . . @ . @ . @ . . . . . . . @ . . . . . . . . . @ . @ . . . @ . . . . . . . . @ . @ . . . . . @ @ . . . . . . . . . . . . . . . . . . @
@ . @ . . . . . . . . . . @ @ . . . . @ . . . . . . @ . . . @ . @ . . . . . . . @ . @ . . . . . . @ . @ . . . @ . . . . . . @ . . . . . . . . . . . . . . . . . . . @ . . @ . . . . . . . . . . . . @ @
@ . . @ . @ @ . . . . . . . . . . . . . . . . . . . @ . . @ . @ . . . . . @ . . @ . . . . @ . . . . . @ . . . . @ . @ . . @ . . @ . . . . @ . . @ . . . . . @ . . . . . . @ . . @ . . @ . . . @ @ . . @
@ . . . . . . . . . . . . . . . . @ . . . . . . . . . @ . . . @ @ . . @ . . . . @ . . . . . @ . @ . . . . . . . . . . . . . . @ . . . @ . . . . . . . . . . . . . . . . @ . . . . . . @ . @ . . . @ . @
@ . . . . . @ @ . . @ . @ . . . . . @ . . @ . . @ @ . . . . . . . . . . . @ @ . . . . . . . . . . . . . @ . . . . @ @ . . . . . @ . . . @ . . . . . . @ . . . . . . . @ @ . . . . . . . . @ . . . . . @
@ . @ @ . . . . . . . . . . . . @ . . @ . . . . . . . . . . . . @ . . . . . . . . @ . @ . @ . . @ . . . . . @ @ . . . . . . . @ . @ . . . . @ . . . . . @ . . @ @ . @ . @ . . @ . . @ @ . . . . . @ . @
@ @ . . @ . @ . . . @ . @ . . @ . . . @ @ . @ . . . . . . . @ . . @ @ . . . @ . @ @ . . @ . . . @ . @ @ . . . . . . . . . . . . . . . @ . . . . . . . . . . . . . @ . . . . . . @ . . . . . @ . . . . @
@ . @ . . @ . . . . . . . . . . . . . . . @ . @ @ . @ @ . @ @ . . . . . . @ . @ . . . @ . @ . . . . . . @ . . . . . . . @ . . @ @ @ . . . @ . . . . . . . . . . . . @ . . . . . . . . . . . . . . . . @
@ . . . . @ . . . . . @ . . . . . . . . . @ @ . . . . @ . . . . . @ . . . . . . . @ . . . . . . @ . @ . . . @ . @ . . . . . . . . . . . . @ . . . . @ . . . . @ . . . . . . . . . . . . . . . . . . . @
@ @ . . . . . . @ . . @ . @ . . . . . @ . . . . . . . . . . . @ . . . . . @ . @ . . . @ . . . @ . . . @ . @ . . . . @ . @ . . . . . @ . . . @ . . . . . @ . . . . . . . @ @ . . @ . . . . . . . . . . @
@ . @ . . . @ . . . . . . . . @ . . . @ . . . @ . . @ . . . . . @ . . . . . . . . . . . @ . . . . . @ . . . . . . . . @ . . . . @ @ . . . . . . . . . . . . @ . . . . . . . @ . . . . @ . . . . . . . @
@ . . . . . . . @ . . . . . . . . @ . . . @ . . . . @ . . . . . @ . . . . . @ . @ . . . . . @ . . @ . . . . . . . . . . . . @ . . . . . . . . @ . . @ . . . . . @ @ . . . . . . . . . . . . . . . . . @
@ . . . . . . @ . . . . . . . . . @ . . . . . . @ . . . . . @ . . . . . @ . . . . . . . . . . . . . . . . . . . . . . . . @ . . . . . . . . . . . . . . @ . . . . . . . . . . . . . . @ . . . . . . . @
@ @ @ @ @ @ @ @ @ @ @ @ @ @ @ @ @ @ @ @ @ @ @ @ @ @ @ @ @ @ @ @ @ @ @ @ @ @ @ @ @ @ @ @ @ @ @ @ @ @ @ @ @ @ @ @ @ @ @ @ @ @ @ @ @ @ @ @ @ @ @ @ @ @ @ @ @ @ @ @ @ @ @ @ @ @ @ @ @ @ @ @ @ @ @ @ @ @ @ @
3
71 14 67 31
75 11 88 54
80 12 84 96
