25 25
@ @ @ @ @ @ @ @ @ @ @ @ @ @ @ @ @ @ @ @ @ @ @ @ @
@ . @ . @ . . @ . . . . . @ . . . . . . . . . . @
@ @ . . . . . . . . . . . . . . @ . . . @ @ . . @
@ . @ @ . . . . . . @ . . @ . . . . . . . . . . @
@ . . . . . . . . . . . . @ . . . . . . . @ . . @
@ . . . . . . . . . . . . . . . . . . . @ . @ @ @
@ . . @ . . @ . @ @ . . @ . . . @ . . . . . . . @
@ . . @ . . . . . . @ . . @ @ @ . . . @ . . @ @ @
@ @ . . . @ . . @ . . . @ . . . . . . . . . @ @ @
@ @ . . . . @ . . @ . . . . . . . . . @ . . @ . @
@ . @ . . . . . . @ . . . @ . . @ . . . . . . @ @
@ . @ . . @ . . . @ . @ . . . @ @ . . . . . . . @
@ . . . @ . . . . . . . . @ . @ . . . . . . . . @
@ . . . . @ . @ . @ . @ . . . . . . . . . . . @ @
@ . . . . . . . . . . . . . . . . . . . . . @ . @
@ . . @ . . . @ . . . . . . . @ . . . . @ . @ . @
@ . . . . @ . . . . . @ @ . @ . . . . . . . . . @
@ . . @ . . . . . . . . . . . . . . . . . . . . @
@ . . . @ . . @ . @ . . @ . . . . @ . . @ . . . @
@ . . . . . . . . . . . . . . . . . . . . . . . @
@ . . . . . . . . . . . . . . . . @ @ . . . . @ @
@ . . . @ . @ @ . . @ @ . . . @ . . . @ . . @ . @
@ . . @ . . @ @ . . . . . . . . . . @ . . . . . @
@ . . . . . . . . @ @ . @ . . @ @ . . . . . . . @
@ @ @ @ @ @ @ @ @ @ @ @ @ @ @ @ @ @ @ @ @ @ @ @ @
3
3 12 3 18
19 9 22 19
3 14 4 22
