50 50
@ @ @ @ @ @ @ @ @ @ @ @ @ @ @ @ @ @ @ @ @ @ @ @ @ @ @ @ @ @ @ @ @ @ @ @ @ @ @ @ @ @ @ @ @ @ @ @ @ @
@ . . . . . . . . . . . . . . . . . . . . . @ @ . . . . . . . . . . . . @ . . . . . . @ . . . . . @
@ . . . . . . . . . . . . . . . . . . . @ . . . . @ . . @ . . . @ . @ . @ @ . . @ . . @ . . . . . @
@ . . . . @ . . . . . . . . . . . . . @ @ . . @ . . . . . @ . . . . @ @ . . @ . . . . . . . @ . . @
@ @ . . . . @ . . . . . . . @ @ . . . . @ . . . . @ . . . . @ . . . . . . . . @ . . . . . . . @ . @
@ . @ @ @ . . . . . . . . . . . . . . . . . . . @ . . @ . . . @ @ @ . . . . @ . @ . . @ . . . @ . @
@ . . . . . . . @ . . . . . . . . . . . . . . . . . . . . @ . . . @ . @ @ . . . . . . . . . . . . @
@ @ . . @ . . @ . . @ . . . @ @ @ . @ . . @ . . . . . . . . . . . . . . . . . . @ . . . @ @ . @ . @
@ . . . @ . . @ . . . . . . . . . . . . . . . . @ . . @ . . . . @ . @ @ . @ . @ . @ . . . . . . . @
@ . @ . . . . . . . . . . . . . . @ @ . . . . . @ . @ . . . . . . . @ . . . . . . . @ . . . . @ . @
@ . @ . @ . . . . . . . . . . . @ @ . . @ . . . . . . . . . . . . @ . . . . . . . . . . . . . . . @
@ . . @ . . . @ . . @ . @ . @ . . . @ . . . . . @ . . . . . . . . . . . . . @ . . @ . @ . . . . . @
@ . @ . . . . . @ . @ . . . . . . . . . . @ . . . @ @ . . @ . . . . @ . . . . . . . . @ . @ @ . . @
@ . @ . . . . . . . . . @ . . @ . @ . . . . . . . . . . . . . . . . . @ . . @ . . @ . . . . . @ . @
@ . . . @ . . . . . @ . . . . @ . @ . . . . . . . . . @ . @ . . . . . . @ . . . . . . . . . . . @ @
@ . @ . . @ . . . . . . @ . . . . . . . . . . . . . . . . . @ @ . @ @ . . . . . . . . . . . @ . . @
@ @ . . . . . . . . . . . . . . @ . . . . . . . @ . . . . @ @ . . . @ . . . . @ . . . . @ . . @ . @
@ . @ . @ @ . . @ . . . . . . . . . @ . . @ . . . . . @ . @ . . . . . @ . @ . . . . . @ . . . . . @
@ . . . . . . . . @ . . . . . @ . @ . . . . . . . . . . . @ . @ . . @ . . . . . . @ . . . @ . . . @
@ . . . . . . . . @ . @ @ . . . . . . @ . . . @ . . . . @ . . . . . @ . . . . . . . . . . . . . . @
@ . . . . . . . . . . . . @ . . . . . . . . . . . . . . . . @ . . . @ . . . . . . @ . . . . . . @ @
@ . . @ . . @ @ @ . . . . . . . . . . @ . . @ . . @ . . . . . . . . . . . . . . . . . . . @ . . . @
@ . . . . . . @ . . . . . . . . . . . . . . @ . . . . . . @ . . . @ . . . . . . . . @ . . . . . . @
@ . . . . @ . . . . . . . . @ . . . . . . . . . @ . . . . . . . @ . @ . @ @ . @ . . . . . . @ @ . @
@ . . . . . . @ . . . . @ . . . . . @ . . . @ . . . . . . . . . . . . . . . @ . . . . . . . @ . . @
@ . . @ . . . . @ . . @ . . @ . @ @ @ . @ @ . . . . . @ @ . @ . . . @ . . . . . . . . @ @ . . . . @
@ . . @ @ @ . . . . . . @ . . . . . . . . . . . @ . . . . . . . . . . @ @ . . . . . . . . @ . . . @
@ @ . @ . @ . @ . . . . . . @ . . @ . . . . . . @ . . . . . . . . . . . . . . . @ . . . . @ . . @ @
@ . . . . . . . . @ . . . . . . . . . . . @ . . @ . @ . . @ . @ . @ . . . . . . . @ . . . . . . . @
@ . . . . . . . . . . . . . . . . @ . . . . . @ . . . . @ . @ @ . . . @ . . @ . @ . @ . @ . . . . @
@ . . . . . . @ . . . @ . . . @ . . . . @ . . @ . . @ . . @ . . . @ @ . . @ . @ @ . . . . . . . . @
@ . . . @ . . . . . . . . . @ . . @ . @ . . @ . . . . . @ . . @ . . @ . . . . . . . . . . . . . . @
@ . . . . . . . @ @ . . . . . @ @ . . . . @ . . . . . . . . . . . . . . . . . @ . . . . @ . @ @ @ @
@ . @ . . @ @ . . . @ . . @ @ . . . . @ @ . . . . . . . . . . . . . . @ @ . @ . . . . . . . . . . @
@ . . . . @ . . . . . . . . . @ . . . . . . . . . . . . . . . @ . . . @ @ . . . . . . . . . @ . . @
@ . . . @ . . . . . . . . . . . . @ . @ . . . . . . . . @ . . . . . . . . . . @ . . @ . . . . . . @
@ . . . . @ . @ @ . @ . . @ . . . . . . . . . . . . . . . . . . . . . . . . . @ . @ . . . . . . . @
@ . . . . @ @ . . . . . . . . . @ . . @ @ . . . . . . . . . @ . . . . . . . . . . . . . @ @ . . . @
@ . @ . . @ . . . . @ . @ . @ @ . @ . . . . . . . . . . @ . . . . . @ @ . . . . . . @ . . . . . @ @
@ . . . . . . @ . . . @ . . . . . . . . . . . . . . @ . . . . @ @ . . . @ . . . @ . . . @ . . . . @
@ @ . . . . . . . . . . . . . . . . . . . . . . . . . @ . . . . . . . . . . . . . . . @ . @ . . . @
@ . . @ . . @ . . . . . . . . . @ . . @ . . . . . . . . . . @ . . . . . . . . @ . . . . . @ @ . @ @
@ @ . . . @ . . . . . . . . . . . . . . @ . @ @ . . @ . . @ . . . . . . . @ . . . @ . . . . . @ . @
@ . . . . . . @ . . . . @ . . . @ @ . @ . . . . . . . . . . . . . @ . . . . . . . . @ . @ . . . . @
@ . . @ . @ . . . . . @ . @ . . . @ . . . @ . . . . . . . . . @ . . . @ . @ . . . . . . . . @ . . @
@ . . . . . @ . . . . . . . . . . . . @ . @ . . . . . @ . . @ . . . @ . . . . @ . . . . . . . . . @
@ @ . . . @ . @ . @ . . . . . . . @ . . @ . . . @ . @ . . . . . @ . . @ . . . . . . . . @ . . . . @
@ . @ . . . . . . . . . . . @ . . @ . . @ . . @ . . @ . @ . @ . . . . @ @ . . . . . . . . . . . . @
@ . . . . @ . . . . . . . . . . . . . . @ . . . . . . . . . . @ . . . . @ . . . . . . . . . @ . . @
@ @ @ @ @ @ @ @ @ @ @ @ @ @ @ @ @ @ @ @ @ @ @ @ @ @ @ @ @ @ @ @ @ @ @ @ @ @ @ @ @ @ @ @ @ @ @ @ @ @
3
31 36 33 17
14 8 29 11
34 3 46 12
