50 50
@ @ @ @ @ @ @ @ @ @ @ @ @ @ @ @ @ @ @ @ @ @ @ @ @ @ @ @ @ @ @ @ @ @ @ @ @ @ @ @ @ @ @ @ @ @ @ @ @ @
@ . . . . . . . . . . . . . . . . @ . . . . . . @ . . . . @ @ . @ . . . . . . . . . @ . . @ . . . @
@ . . . . . @ . . @ . @ @ . @ . . . . @ . . . . . . . . . . . . . . . . @ . @ @ . . @ . . . . . . @
@ @ . . . . . @ . . . @ . @ @ . . . @ @ . . . @ . . . @ . . . . . . . @ . . . . . . @ . . . . . . @
@ . . . . . . . . . @ . . . . . . . . . . . . . @ @ . . . . . . . . . . @ . @ . . . . @ . . @ . . @
@ @ . @ . . . . . . . @ . . . . @ . . . . . . . . @ . @ . . . . @ . . . . . . . . . . . . . @ . @ @
@ @ . @ . . . @ @ @ . . . . . . . @ . . @ . . @ @ . . . @ . . . @ . . . . . . . @ . @ . . . . @ . @
@ @ . . @ . @ . @ . . . @ @ @ . . . @ . . . . . . . . . . @ . . . . . . . . . . . . . . @ . . . . @
@ . . . . @ . . . . . . . @ . . . . @ . . . @ @ . . . . . @ @ . @ . . . . . . . . . . @ @ . . . . @
@ . @ . @ @ . @ . . @ . . . . . . . @ . . . . . . . . . @ @ . . . . @ @ . . @ . @ . @ . . . . . . @
@ . . . @ . . . @ . . @ . @ . . . . . . . . . . . . . . @ . @ . . . @ . . . @ . . . . . @ . . . . @
@ . . . . @ . . . . . . . . . @ . . @ . . . @ . . @ . . . @ . . . @ . . . . . . @ . . @ @ . . . . @
@ @ . . . . . . @ . . @ . . . . @ . . . . . . . . . . . . . @ . . . . . . . . . . . . . . . . . . @
@ . . . . @ . . . . . @ . @ @ . . @ . . . . . . @ . . @ . . . . . . . . . @ . . . . . . . . . . . @
@ . . . @ . . . . . . . @ . . @ . . @ . . . . @ . . @ . . . @ . . . . . . . . . . @ . . . . . . . @
@ @ . . . . @ . . @ . . . . . . . @ . . @ . . . . . . . . . . @ . . . . . . . . . . . . @ . . . . @
@ . . @ @ . @ @ . . . . @ . . . @ . . @ . . . . . @ . @ . . @ . @ . . . . @ @ . . . . . . . . . . @
@ . @ . . . @ . . . @ . . . @ . @ . @ . . @ . . @ . . . . . . . . . . . . . . . . @ . . . . . . . @
@ . @ @ @ . . . . . . @ . . @ @ . @ . . @ . @ . . . @ . . @ . . . @ . . . . . . . . . . . @ . . . @
@ . . . . . . @ . . @ . @ @ @ @ . . . @ . . @ . . . . . @ . @ . . . . @ . . . @ @ . . . . . @ . . @
@ . @ . . . . . . @ . @ . . . @ . . . . . @ @ . . . . . . . . @ @ . . . @ . . . . . . . . . . . . @
@ . . . . @ . . @ . @ . . . . @ @ . . . . . . . . . . . . . . . . . . . . . . . @ . . . . . . . . @
@ . . . . . . . . . . . . . @ . . . . . . . . . @ . . @ . . . . . . . . . . . . @ . . . @ . . . . @
@ . . . . . . . . . . @ . @ . @ . . @ . . . . . . . @ . . . . . . . @ . . . . . . . . . . . . . . @
@ @ . . . . . . @ . . . . . @ . . . . . @ . . . . . . @ . . . . @ . @ . . . . . . . . . . . . . . @
@ . @ . . . @ . . . . . @ . . . @ . . . . . . . . . . . . . . . . . @ . . . . . . . . . @ . . . . @
@ @ . . . . . . . . . @ . . . . . @ . . . @ . . . . @ . . . @ @ @ @ . . . . @ . . . . . @ . . @ . @
@ @ . . . . @ @ . . . . . . . . . . @ @ . . . @ . @ . . @ . . . . . . . . . @ . . . . . . @ . . . @
@ . . . . . . . . @ . . . . . . . . @ . . . @ . . . . @ . . . . @ @ @ @ . . . . . . . . . @ @ @ . @
@ . @ . . . . . . . . . . . . . . . . . @ . . . @ . . . . . . . . . . . . . @ . . . . . @ . . . . @
@ . . . . . @ . . . . . . . . @ . . . . . . . . . . . . . . . . . . . . . . . . . . . . . @ . @ . @
@ . @ . @ . @ . . . . . . . . . . . @ @ . . . . @ . @ . . . . . . . . . . . . . . . @ . . . . . . @
@ . @ @ . . . @ . . . . @ . . . . . . @ @ . . . @ . @ . . . @ . . . @ . . . . . . @ @ . . . . . . @
@ . . @ @ . . . . . @ . . . . . . . . @ . @ . . . . . . . @ @ . . . @ . @ . . @ . . . . . . @ . . @
@ . @ . . . @ . . @ . . . . @ . . @ . . . . . . @ . . . . . . . . . @ @ . . . . . . @ . . . . . . @
@ . . . . . . . . . @ . . . . . . . . . . @ @ . . . @ . @ . . . . . . . . . . . . . . @ . . . . . @
@ @ . . . . @ @ . . . . @ . . . . . . . . . . @ . . @ . . . @ @ . . . . @ . . . . . @ @ . . . @ . @
@ . . @ . . . . . . . @ . . . . . . . . @ @ . . @ . @ . . . . . . . @ . . @ . @ . . . . . @ @ @ . @
@ . . . . . . . . . . . . . @ . @ . @ . . . . . . . @ . . . @ . . @ . . . . . . . . . . . . @ . . @
@ . . @ . . . . . . . @ . @ . . . . . . . . . @ . @ . @ . . . . . . . . . . @ . @ . . . . . . . @ @
@ . . . . . . . . @ . . . . . . @ . . . . . . . . . . . @ @ . . @ . @ . @ . . . . . . @ . . . . . @
@ . . . . . . . . . . . . . . . . . . . @ . . @ . @ . @ @ . . . . . . . . . @ . . . . . . . . . . @
@ . . @ . . . . . @ . . . @ . . @ . @ @ . . . . @ . . . . . . @ . @ @ . . . . . . . @ . . @ . . . @
@ @ . . . . . @ . . . . . . . . . . . . . . . . @ . @ . @ . . . . . . . . . . @ . . . . . . . . . @
@ . . @ @ . . . . @ . . . . . . . . . . @ @ . @ . . . . . . @ @ @ . . @ . . . . @ . . . . . . @ @ @
@ . . . . . . . @ . . . . @ . . @ . . . @ . . . @ @ . @ . . . . @ . @ @ . . . @ . @ . . . . @ @ . @
@ . @ . . . . . . . . . . @ . @ . . . . . . . . . . . . . . . . . . . . . . . . . @ . @ @ @ . . . @
@ . . . . . . . @ @ . . @ . . . @ . . . . . . . . @ . . . @ @ . . . . . @ . . . . . . @ . . . . . @
@ . . . . . @ @ . . . . . @ . . . @ . . @ . . . . . . . . . . . . . . . . . . @ . @ . . . . . @ . @
@ @ @ @ @ @ @ @ @ @ @ @ @ @ @ @ @ @ @ @ @ @ @ @ @ @ @ @ @ @ @ @ @ @ @ @ @ @ @ @ @ @ @ @ @ @ @ @ @ @
3
10 12 30 22
41 8 11 11
28 44 16 41
