25 25
@ @ @ @ @ @ @ @ @ @ @ @ @ @ @ @ @ @ @ @ @ @ @ @ @
@ . . . . . @ . . . . @ . @ . @ . . . . . . . . @
@ . . . . . . . . . . . . . . . @ . . @ . . @ . @
@ . . . . . . . . . . . . . . . . . . . . . . . @
@ . . . . . . @ . @ @ . . . . . @ . . . . . . . @
@ . . . . @ @ . . . . @ . . . . . @ . . . . @ . @
@ . . . . . . @ . . . . @ . . @ . . . . . . . . @
@ . . . . . . . . . . @ . . @ . . . . . @ . @ . @
@ . @ . . @ . . . @ . . . @ . . . . @ . . . . @ @
@ . @ . . . . . . . . . . . . . . . . @ . . @ . @
@ . @ . . . . . . . . . . @ . . . @ @ . . . . . @
@ . @ . . . . . . . . . . . @ . . . . . @ . . . @
@ @ . @ . . @ @ @ . . . . . . . . . . . . . . . @
@ @ . . . . . . @ . . . . . . . . . . @ . . @ . @
@ . . . . . . . . . . . . . . . . . @ . . @ . . @
@ . . . . @ . . . . . . . . . . . . . . . . @ . @
@ . . . . . . @ . . . . @ . . . . . . . . . @ @ @
@ . . . . . . . . . @ . . . . @ @ . @ . . . . . @
@ . . . . . . . . . @ @ . . @ . . @ . . @ . . @ @
@ . . @ . @ . . . . . . . . . @ . . . @ @ . @ . @
@ . . . . . @ . . . @ . . . . @ . . . @ . . . . @
@ . . . . @ . . . @ . . @ @ . . . @ . @ @ . . . @
@ . . @ . . @ . . . . . . . @ . . . . @ . . . . @
@ . . . . . . @ . . . . . . . . . . . . . . . . @
@ @ @ @ @ @ @ @ @ @ @ @ @ @ @ @ @ @ @ @ @ @ @ @ @
3
23 8 4 6
7 19 17 20
1 19 22 13
