12 12
@ @ @ @ @ @ @ @ @ @ @ @
@ . . . . . . . @ . . @
@ . . . . . @ . . @ . @
@ . . . . . . . . . . @
@ . . . . @ . . . . . @
@ . @ . . . . @ . . @ @
@ . . . . . . . . . . @
@ . @ . . . . . . . @ @
@ . . . . . . . . . . @
@ . . . . . . . . . . @
@ . . . . . @ . @ . . @
@ @ @ @ @ @ @ @ @ @ @ @
3
10 4 6 9
9 1 2 2
8 5 6 1
