25 25
@ @ @ @ @ @ @ @ @ @ @ @ @ @ @ @ @ @ @ @ @ @ @ @ @
@ . . . . . . . . . . . . . @ . @ . @ . . . . . @
@ . . . . @ . . . . @ . . . . @ . @ . @ . . . . @
@ @ . . . . @ . @ . @ @ . . @ . . . @ . . . . @ @
@ . . . . @ . @ . . . . . . . . . . . . @ . @ . @
@ . @ @ . @ @ . . . . . . . . @ @ @ @ . . . . @ @
@ . . . @ . . . . . . . . @ @ . . . . . . . . @ @
@ . . . . . . . . . . @ . @ . . . . . . . . . . @
@ . @ . . . . . @ . . . . . . . . @ . . . . . . @
@ . . @ . @ . . . . . . . @ . @ @ . . @ @ . . . @
@ . @ . . . @ . . . . . . . . . . . . . . . . . @
@ . . @ . . . . . . . . @ . @ . . . . . . . . . @
@ . . . . . . . . . . . . . . . . . . @ . . . @ @
@ . . . . . . . @ . . . . . . . . . . . . @ . . @
@ . . . . . . . . . . . . . @ @ . . @ . . . . . @
@ . @ . . . . @ . . . . . . . @ . . . . . @ . . @
@ . . . . . . . @ . . . . @ . . @ . . . . @ . . @
@ . . . . . . . @ . . . . . . . . @ . . . @ . . @
@ @ . . . @ . . . . . . . . . . . . . . . . @ . @
@ . . @ . . . . @ @ @ . . . @ @ . . . @ . @ . . @
@ @ . . . . . . . @ . . @ . . . . . . @ @ @ . . @
@ . . . . . . . @ . . . . . . . . . . . . . . . @
@ . . . . @ . . . . @ . . . . . . . . . . . . . @
@ . . . . . . . @ . . . . @ . . . . . @ . @ . . @
@ @ @ @ @ @ @ @ @ @ @ @ @ @ @ @ @ @ @ @ @ @ @ @ @
3
19 6 10 9
7 19 21 4
17 16 11 8
