25 25
@ @ @ @ @ @ @ @ @ @ @ @ @ @ @ @ @ @ @ @ @ @ @ @ @
@ . @ . . . . . . . . @ . . . . . . . . . . . . @
@ . . @ . . . @ . . . . . @ . . . . . . . . . @ @
@ . . . @ . . . . . . . . . . . . . . . . . . . @
@ @ . . . . . . . . . . . @ . . @ . . . @ . . . @
@ . . . . . . . . . . . @ . . @ . . . . . @ . . @
@ . . . . @ . . . . . . @ . . . . @ . @ . @ . @ @
@ . @ @ . . . . . . . . . . . . @ . . . . . . . @
@ . . . @ . @ . . . . . . @ . . . . . . @ . . . @
@ @ . . . . . . . @ . . . . . . @ . . . . . . . @
@ . . @ . @ . . @ . . . . . . @ @ . . . . . . . @
@ . . . . @ . . . @ . . @ . . @ . . @ . . . . . @
@ . @ . . . . @ @ . . . . @ . . @ @ @ . @ . @ . @
@ . @ . . . @ . @ @ . . @ . . . . . . . . . . . @
@ . . . @ . . @ . @ . . . @ @ . . . . @ . . . . @
@ . . . @ @ . @ . . . . . . . . @ . . . . . . . @
@ . . . . @ . . . . . @ . . . . . . . . . . @ @ @
@ . . . . . . . . . @ . . . . . . . @ . . . . . @
@ . . . @ @ . . . . @ . . @ . . @ . @ . . . . @ @
@ @ . . . . . . @ . . @ . . @ . . @ . . . . . . @
@ . . . . @ . . @ . . . . . . @ . @ . . . @ . . @
@ . . @ . . @ . . @ @ @ . . . . . . . @ . . . . @
@ . . . . . . . . . . . . . @ . . . @ @ . . @ . @
@ . . . . . . @ . . . . . . @ . @ . . . . . @ . @
@ @ @ @ @ @ @ @ @ @ @ @ @ @ @ @ @ @ @ @ @ @ @ @ @
3
14 5 3 3
1 3 14 2
21 16 5 9
