12 12
@ @ @ @ @ @ @ @ @ @ @ @
@ . . . . . . . . . . @
@ . . . . . . @ . . . @
@ . . . @ . . . . . . @
@ . . . . . . . @ . . @
@ @ . @ . @ . . . @ . @
@ . . . @ . . . . . . @
@ . . @ . . . . . @ . @
@ @ . . @ . . . . . . @
@ . . . . . . @ . . . @
@ . . . . . . . . . @ @
@ @ @ @ @ @ @ @ @ @ @ @
3
4 6 6 6
7 10 3 3
10 1 6 7
