12 12
@ @ @ @ @ @ @ @ @ @ @ @
@ . . . . . . . . . . @
@ . . . . . . . . . . @
@ . . . @ . . . . . . @
@ @ . . . . . . @ @ . @
@ . . . . . . @ . . . @
@ . . . @ . @ . . . @ @
@ . . . . . . . @ . @ @
@ . . @ . . . . . @ . @
@ . . @ . . @ . . . . @
@ . . . . @ @ . . . . @
@ @ @ @ @ @ @ @ @ @ @ @
3
9 5 9 10
10 10 4 4
10 8 5 10
