100 100
@ @ @ @ @ @ @ @ @ @ @ @ @ @ @ @ @ @ @ @ @ @ @ @ @ @ @ @ @ @ @ @ @ @ @ @ @ @ @ @ @ @ @ @ @ @ @ @ @ @ @ @ @ @ @ @ @ @ @ @ @ @ @ @ @ @ @ @ @ @ @ @ @ @ @ @ @ @ @ @ @ @ @ @ @ @ @ @ @ @ @ @ @ @ @ @ @ @ @ @
@ . . . . . . . . . . . . . . . . @ . . . . . . . . @ . . . . . . . @ @ . . . @ . . . . . . . . @ . . . . . @ . . . . . . @ . . . . . . @ . . . . . . . @ . . . . . . @ . . . . . . . @ . . . @ @ . . @
@ . . . @ @ . . . . . . . @ . @ . @ . . . . @ . . . . . . @ @ . . . @ . . . . . . . . . . @ . . . . . . . . . . . @ . @ . . . . . @ . . . . . @ . . . . . . . @ . . @ . . . . . . . . . . . . . @ @ . @
@ . . . . . . . . . . . . . . . . . . . . . . . . . . . . . . . . . . . @ . . . . . . @ . . . @ . . @ . . @ . . . @ . . . . . . @ . @ @ @ . . @ . . . . . . @ . @ . . . @ . @ @ . . . . . . . . . . . @
@ . . . . . . . . . . @ . @ . @ . . . . . . . . . . @ . . . @ . . . . @ . @ @ . . @ @ . . . . . . @ . . . @ . . . . . . @ . @ . . . . . . . . . . . @ . . . . . . . . . . @ . . . @ @ . . . . . . @ . @
@ @ . . . . . . . . . . . . . . @ . . . . . . . . @ . . . . . . . . . . @ . . . . . . . . . . . . @ . . . . . . . . @ . . @ . . . . . . . . . @ . . . . . . . . @ . @ . . . . @ @ @ @ . @ . @ . . . . @
@ . @ . . . . . . @ . @ . . . . . @ @ @ . . . . . . . . . . . @ . . . . @ . . . . . . . . . . . @ . . . @ . @ @ . . . . @ . . . . . . . . . . . . . . . . . . . . . . . @ . . . . . . @ . @ . . @ . . @
@ . . . . . @ . . . @ @ . . . . @ . . . . . . . @ . . . . . @ @ . . . . . . . @ . . . @ . . . . . . @ @ . . . . . . @ . . @ . . . @ . . . . . . . . . . . . . @ . @ . . . @ . . @ . . . @ . @ . . @ . @
@ @ . . . @ . . . . . . . @ . . . . . . @ . . @ . @ . . . . . . @ . @ . . . . . @ . . . . . . . . . . @ . . . . . . @ . . @ . . @ . . . . . @ . . @ . . . . . @ . . . . . . . . . . @ . . . . . . . . @
@ . . . . . . . . . . . . . . . . . . . . . . . . . . . . . . . @ . . . . . . . . . @ . . . . . . . @ . . . . . . . . . . . . . . . . . @ . . @ @ . . . . @ . . . . . @ . . . . . . . . . . . . . @ . @
@ @ . @ @ @ . . . @ . @ . . . . @ . @ @ . . . . @ @ . . . . . . . . . . . @ . . . . @ . . . . . . . . @ . @ . . . . . . . @ . . . . . . . . . . . . . . . . . . @ . . . . . . . @ . . . . @ . . . . . @
@ . @ . . . . . . . . . . . . . . . . . @ . . . @ . . . . . . . . . . . . . @ . . . . @ . . . @ . . . . . @ . . . . . . . . @ . . @ . . @ . . . . . . . . . @ . . . @ . . . . . . @ . . . . @ . . . . @
@ . @ . . @ @ . . . . . . @ . @ . . . . . . @ . @ . . . . . . . . . . . . . . @ . . . . . . @ . . . @ . . . @ . . . @ . . . . . . . . . . @ . . . . . . . @ . . @ . @ . . . @ . @ . . . . . . . . . . @
@ . . @ . . . . @ . . . . @ . . . . @ . . . . . . @ . . @ . . @ . . . . . . . . . . @ @ @ @ . . . . . @ . . . . . . . @ . . . . . . . . . . . . . . . . . . . . . . @ . @ . @ . . . . . @ . . @ . . . @
@ . . . . . . . . . @ . @ . . . . . . . . . . . . @ . . . @ . . . . . . . . . . . . . @ @ . . . . . . @ . . . @ @ . @ . . @ . . . . . @ @ . . . . @ @ . . @ . @ . @ . . . . . @ . . @ . . . . . @ . . @
@ . . @ . . @ @ . . . . . . . . . . . @ . . @ . . . . . . . . @ @ . . . . @ . . . . . . @ . @ . . . . . . . @ @ . . @ . . . . @ . . . . . . @ . @ @ . . . . @ . @ . . @ . . @ . . . . @ @ . . . . @ . @
@ . . . . . . . @ @ . . . . @ @ . . . . . @ . @ . . @ . . . . @ . @ . . . . . . . . . . @ . . @ . . . . . @ . . . . . . . . . . . . . . . . . . . . . . . . . . . . . . . @ . . . . . . . @ . @ @ . . @
@ @ . . . . . . . @ @ @ @ . . @ . . . . . . . . . . . . . . . . @ . @ @ . . . . . . @ . . . @ . . . . . . @ . . . . . . . . . @ @ . . . @ . @ . . . . . . . @ . . @ . . . . . @ . . . @ . . . . @ . . @
@ . . . . . . . . . . . . @ . . . . . . . . @ . . . . . . . . . @ . . . . . @ . . @ . . . . . . . . . . . . @ . . . . . . . . @ . . . @ . @ . . . . @ . . . . . . @ . . . . . . . . . . . @ @ . . . @ @
@ . . . . . . @ . . . . . . . . . . . . @ . . . @ . . @ . . @ . . . . @ . . . . . @ . . @ . @ . . . . . . @ . . . @ . . . @ . . . . . . @ . @ . . . . @ @ . @ . @ . @ . . . . . . . . @ . . . . . . . @
@ . . @ @ . . . . . . . @ . . . . . . . . . . . . . @ . . . . . . . . @ . . . . . . . . @ . . . . . . . . @ . . . . . . . . . . . . . . @ . . . @ . . . @ . . . . . . @ . . . . . . . . . . . . . . . @
@ . . . . . . . @ . . . . @ . @ . . @ . @ . . . . . @ . . @ @ . . . . . @ . . @ . . . @ . . . @ . @ @ . . . . . . . . @ . @ . . . . . . . . . @ . . . . . . . . . . . . . @ . . . @ @ . . . . . . . . @
@ . . @ @ . . . . . . @ . . @ . . . . . . @ @ . . @ . . . @ . . . . . . . . . . @ . . . . . @ . . . . . . @ @ @ . . @ . . . . . . . . @ . . . . . . . . . . . . . . @ . @ . . . . . . . . @ . . . @ . @
@ . @ . . . . . . . @ . @ . . . . . . . . . . @ . . . . . . . . . . . . . @ . . . . . @ . @ @ . . @ @ @ . . . . . . . . . . @ . . . . . . @ @ . @ @ . . . . . . . . . . . @ @ . @ @ @ . . . . . @ . . @
@ . . . . . . . . . . . . . . . . . . . . . . . . . . @ . . . . . @ . . . . . @ . . . . . . . @ . . . . . . . . . . . @ . @ . . . @ . @ . . @ . . . . @ . @ . @ @ . . . @ . . . . . . @ . . . . @ . . @
@ . . @ . @ . . @ . . . . . @ @ . . . . . . @ . . . . . . . . @ . . . . . . . . @ . . . . @ . . . . . @ . . . . . . . . @ . @ . . @ . . . . . . . @ . . . . . @ . . . . . . . @ . . . . . . . . @ . . @
@ . @ @ . . @ . . . . @ . . . @ . . . . . . . . . . . @ @ . . . @ . @ . . . . . . . . . . @ . . . . . . . . . @ . . . . @ @ . @ . . . @ . . @ . @ . @ . . . . . . . . . @ . . . . . . . . . . . . . . @
@ . . . . @ . . . @ . . . . . . . . . . . . . . . . @ @ . . . . . @ . . @ @ . . . . . . . . @ . . @ . . . . . . . . . . . . @ . . . @ . . @ . . . . . . . . . . @ . . . . . . . . . . . . . . . . . . @
@ . . @ . @ . . . . . . . . . @ . @ . . @ . . @ . @ . . . . . . @ @ . . . . . . . . . . . . . . . . . . . . . . @ . @ . . . . . . . . . . . @ . @ . . . . . . . . . . . . . . . . . . . . @ @ . . . . @
@ . . . @ . . . @ . @ . @ . . . . . . @ . . . . @ . . . @ . . . . . . @ . . . . . @ . . . . . @ . . . . . . @ . . . . @ @ . @ . @ . . . . . @ . . @ . . . . @ . . . @ . . . . . . . . @ @ . . . . . . @
@ . . . @ . . . . @ . . . . . . . . . . @ . @ @ . . . . . . . . . . . . @ . . . . . . . @ . . . . @ . . . . @ . . . . . . . . @ @ . . . . . @ . . . . . @ . . @ . . . . @ @ . . . . @ . . . . . . . @ @
@ . . @ . . . . @ . . . . . @ . . @ . . . . . . . . . @ . . . . . . . . . . . . . @ @ . . . . . @ @ . . . . @ . . . . . @ . . . . @ . . . . . @ . . . . . . . @ . . . . . @ . . . . . . . . . . @ . . @
@ . . @ . . . . . . . . . @ . . . . . . @ @ . . @ . . . . . . @ @ . . . . . . . . . . . . @ @ @ . . . . . @ . . . . . . . . @ . . @ . . . @ . . . @ . @ . . . . . . . . . . . . . . . . . @ . . . . . @
@ @ . . @ . . . @ @ . . . . . . . . . . . . . . . . @ . . . @ . . @ . . . . . . @ . . . . . . . . . . . . @ . . . . . @ . . . . @ . . . . @ . . . . @ . . . . . . @ . . . . . . . . . . . . . @ . . . @
@ . . . @ . . . . . . . @ . . . . @ . . . . . . . . . . . @ . . . . . . @ @ @ . . @ . @ . @ . . @ . . . . . . @ . . . . . . . . . . . @ . . . . @ . . . @ . . . . . . @ . @ @ . . . @ . . . . . @ . . @
@ . . . . @ . @ . @ . . @ . @ . . . . . . . . @ . . . . @ . . . . . . . . . . . . . . @ . . . . @ . @ . @ . @ . . . . . . . . . . @ . @ . . . . . @ . . . . @ . . @ . @ . . . . . . . @ . . . . . . . @
@ @ . @ . . @ . . . . @ . . . . . . @ . . @ . . . . . @ . . . . . @ . . @ @ . . . . . . . . . . . . @ . . . . . . @ . . @ . . . . . @ . @ . . . . . @ . . . @ . @ . . . . . . @ . . . . . . . . . . . @
@ . . . . . . . . . . . @ . @ . . . . . . . @ . . . @ . . @ . @ . . @ . . . . @ . . . . . @ . . . . . . . . . @ . . @ . . . . . @ @ . @ . . . . . @ . . . @ . . . . . . @ . . . @ . . . @ . . . . . . @
@ . . . . . . . . . @ . . . @ . . . @ . . . . . . @ . . . . . . . . . . . . . . @ . @ . @ . . . . . . . @ . . . . . . . . . . . . @ . @ . . . . @ . . . . . . @ . . . . . . . @ . . . . . . . . @ . . @
@ . @ @ . . . . . . @ . . . . . @ . . . . . . . . @ . . . . @ . . . . . . . @ . . @ . @ . @ . . . . . . . @ . @ . . . @ . . . . . @ . . . . @ . . @ . . . . . . . . . . . . . . . @ . . . . . . . . . @
@ @ . . . . @ . . . . . . . . . . . @ . . . . . . . . . . . . . . @ . . . . . @ . @ . . . . . . . @ . . . . . . . . . . . . . . . . @ . . . . . . . . @ . . . . . . . @ . @ . . @ . . . . @ . . @ . . @
@ . . . . . . @ . . @ . . . . . . @ . . . . . @ @ . . @ . . @ @ . . . . @ . @ . . . . . . . . . . . . . . . . . . . . . . @ . . @ @ . . . . . . . @ @ . @ @ @ . . @ . @ . . . . . . @ @ . . . . . . . @
@ . . . . . @ . . . . . . . . . . . . . . . . . . . . . @ . . . . . @ . . . . . . . @ . . . . . . @ . . . . . . . . . . . . . . . . . @ . . . . . . . . . . . . @ . . . . . . . . . . . @ . . . @ . . @
@ . . . . . . . . . @ . @ . . @ . . . @ . . . . . . . . . . . . @ @ . . . . . @ . . . @ . . . . . . . . . . . . @ . @ . . . . . . . @ . . . @ @ @ . . . . @ . . . . . @ . . . . . . @ . . . . . . @ . @
@ . . . . . . . . . . . . . . . . . . . . . . . . . @ @ . . . . @ . . . . . . . . . . . . . . @ . . . . . . . . . . . @ . . @ . . . . . . . . @ . . . . . . @ @ . . . . . . . . @ . . . . . @ . @ . @ @
@ . . . . @ . . @ . . . . . . . . @ . @ . . @ . . . @ . . . . . . . . . . . . . . . . @ . . . . @ . . @ . . . . @ . . . @ . . . . . . . . . . . . . @ @ @ . . . . . . . @ . . . . . . @ . . . @ @ @ . @
@ . . . @ . . . . . . . . . . . . . . . . @ @ . . . . . . . @ @ @ . . . . @ . . . . . @ . . . . . . @ @ . . . . . . @ . . . . . . . . . . . @ . . . @ . @ . . . @ . . @ . . . . . . . . . . . . . @ . @
@ @ . . . . . . . . . . . . @ . . . . . . . . . . . . @ . . . . . @ . . . . . . . . . . @ . . . . . @ . . @ . . . . . . . @ . . @ . . . . . . @ . @ . . . . . . . . @ . . . @ . @ . . . . . . . . . . @
@ . . . . . . . . . . @ . . . @ . . @ . @ @ @ . . . . . . @ . . @ . . @ . @ . . . . . @ . . . @ . @ . @ . . @ . @ . . @ . . . . . . . . . . @ . . . . @ . . . . . . . . @ . . . . . @ . . @ . @ . . . @
@ @ . . . . . . . @ @ . . . . @ . . . . @ . . @ . @ . . . . . . . . . . . . . @ . . . . . . @ . . @ . . @ . . . . . . . . . . . . @ . . @ . . @ . . . . . . . . . . . @ . . . . @ . @ @ . . . . . @ . @
@ . . . . . . @ . . . . . . . . . . . @ . . @ . @ @ @ @ . . . . . . . . . . . . @ . . . . . . . . . . . . . . . . . . . @ . @ . @ . . . . . . @ . . . . . . . . . . . . . . . . . . . . . . . @ @ . @ @
@ . @ . . @ . . . . . . . . . . . . . . . . . . . @ . . . @ . @ . @ . . . . . @ . @ . . . . @ . . @ . . . . @ @ . . . . . @ . . . @ . @ . . . . . . . @ . . @ @ . . . . . . . . . . . . @ . . . @ . . @
@ . . . . . . @ . @ @ . . . @ . . @ @ . . . . @ @ . @ . . . . . . . . . @ . . . @ . . . @ @ . . . @ . . @ @ . . . @ . . . . . . @ . @ . . . . @ . . . . . . . . . . . @ @ . @ @ . . . . . @ . . . . . @
@ . @ . . . . . . . . . . . @ . . . . @ . . . . . . . . . . . . . . . . . @ . . . . @ . . . @ . . . . . . . . . @ . . . . . . . . . . . . @ . . . . . . @ . . . @ . . . . . . . . @ . . . @ . @ . @ @ @
@ . @ . . . . @ . . . . . . . . . . . . . . . . @ @ . . . . . . @ . . . . . @ . . . @ . @ . . . . . . . . . . . . @ . @ @ . . . . . . @ . . . . . @ . . . . . . . . @ . . . . . . . . . @ . . . . . . @
@ . @ . . . . . . @ . . . @ . . @ . . . . @ . . . . . . . . . . . @ @ . . . @ . . . @ @ @ . . @ . @ . . . . . . . . . . . . @ . . . . . . . @ @ . . . . . . . . . @ . . . @ @ . . . . . . . . @ . . . @
@ @ . . . . . . . . . . . . . . . . . . . @ . . . . . . . . . . @ . . . . @ . . . . . . . . . . . . . . . . . . . . . @ . . . . . . . . . . . @ @ . @ . . . . . . @ . @ . @ @ . . @ . @ . . @ . . . @ @
@ . . . . @ . . . . . . . . . @ . . . . . . . . . . . @ . . . . . . . @ . @ . . . . @ . . . . . @ . @ . . . . . . . . . . @ . @ . . . . . . @ . . @ . . . @ . . @ . . . @ . . . . . . . . @ . . . . . @
@ @ . . . . . . @ @ . . @ . . . . . . . . . . . . @ . . . . . . . . . . . . . @ @ . . . . @ . . . @ . . . . . . . . . . . . . . . . . . . @ . . @ . @ . . . . . . . @ . @ . . . @ . . . @ . . @ @ . . @
@ . . . . . . . @ . . . . . @ @ . . . . . . . . . . . . . @ @ . @ @ . @ . . . . . . . . . . . . @ . @ . @ . . . . . . @ . . . . . . @ . . . @ . . . . . . . . . @ @ . . @ . @ . . . . . . . . . . . @ @
@ . @ . @ . . @ . . . . @ . @ . . . . . . . . . . @ . . . . . . . . @ . . . . . @ . . . . . . . . @ . @ . . . . . . @ . . . . . . . . . . . . . @ . . @ . . . . . . . @ . . . @ @ . . @ . . . . . . . @
@ . @ . . . . . . . @ . @ . . @ . @ . . . . @ . . . . @ . . . . . . . . . . . @ . . . . . . . . @ @ . @ . . . . . . @ . . . @ . . . . . . . . . . @ . . . . . . . . . . . . . @ . . . . . . . . . . . @
@ . . . . @ @ . . . . . . . . . . . . @ . . @ @ . . . . . . . . . . . . . . . . . . . . . . . @ . . @ . . . @ . . . @ . . @ . . @ . . . . @ . . @ . . . . . . . . . . . @ @ . @ . . . . . . . . . . @ @
@ . . . . . . @ . . . . . . . . @ . @ . . . . . . . . . . . @ . . . . . . . @ @ @ . . . @ @ . . . . . . . . . . . . . @ . . @ . @ . . . . . . @ . . . @ . @ . . . . . . . . . . . . . @ . . @ . . . . @
@ @ . . . @ @ . . @ . . . . . @ . . . . . . . . . . . @ . . . @ . . . . . @ . . @ . . . . . . . . . @ . . . . . @ @ . . . . @ @ . . . . . @ . . . . . . . . . . . . @ . . . . . . . . . . . . . @ . @ @
@ . . . @ . . . . . . . . . @ . . . . . @ . . . . @ . . . @ . . . . . . . . . . @ . . . . . @ . . @ . . . . . . . . . . . . . @ . . . . @ . . . . . @ . . . . . . . . . @ . . . . . . @ . . @ . . @ . @
@ . . @ . . . . . . . . . . @ . . . . . . . @ . . . . . . . . . . . @ . . . . @ . @ . . @ . . . . @ . . . . . . . . . . . . . . @ . . @ . . . @ @ @ . . . . @ . . @ . . . . . . . . @ @ . @ . @ . . . @
@ @ . . . . . . . . @ . . @ . . . . . . . @ . @ . . . . . @ . . . . . @ . . @ . . @ . . @ . . @ @ . . . . . . . . . . . @ @ . @ . . . . . . . . . . @ . . . . . . . @ @ . . . . . . . . @ . @ . . . @ @
@ . . . @ . . . . . . . . . . . . . . . . . . @ . @ . . . . . . . . . . . . @ . @ . @ . . . . . . . . @ . . . . . . . . . @ . . @ . @ . . . . . @ @ . @ . . . . . @ . . . . . @ . . . . . . . . . . . @
@ . . . . @ . . . . . . . @ . . @ . . . @ . . . . . . . @ . . @ . . . . . . . @ . . @ . . . . . @ @ . . . . . @ @ . . . . . . . . . . . . . . . @ . . . . . . . . . . . . . . . @ . . . @ . . @ . . . @
@ . . @ . . @ . . . . . . @ . . . . . . . . . . @ . . . . . @ . . @ . . @ . @ . @ . @ . @ . . . . . . . . @ @ . . . @ @ . . . . . . . . . . . . . . . @ . . . . . . @ . . . @ . . @ . . . @ . @ . . @ @
@ . . . . . . . . . . @ . @ . . . @ . . . . . . . . . . . . . @ . . . . . . . . . . . . . . . . . . . . . . . . @ @ . . @ . @ @ . . . . . . @ . @ @ . . . . @ . . . @ @ @ . . @ . . @ . . . @ . @ . . @
@ . @ @ . . @ . . @ . . . . . . . . @ . . @ @ . . . . . . @ . . . . . . @ . . . . . . . @ @ . . . . . . . @ . . . . . . @ @ . . @ . . . . . . . . . . . @ . @ @ . . . . . @ . @ @ . @ . . . . @ @ . @ @
@ . . . . . . . @ . . . @ . . . @ @ . . . . . . . . @ . . . @ @ . . @ @ . . . . . . . . . . . . @ . @ . . . . @ . @ . . @ . @ . . @ . . . . . . . @ . @ . @ . @ . . . @ . . . . . . . @ . . . . . . . @
@ . @ . @ @ . . . . @ @ . . . . . . . @ . . @ @ . . @ @ . . @ . . . . . . . . . . . . . @ . . . @ . . . . . . . @ . . @ . . . . . . @ . @ . . @ . . . . @ . . . . @ . @ . . . . . @ . . . @ . @ . @ . @
@ . . . . @ . . . . . @ . . . . . . . . @ . @ . . . . . @ . . . . . . . . . . . @ . . . . . . . @ . . . . . . . . . . . . . . . . . . . @ . . @ . . . . @ @ . . . . . . . . . @ @ . . . . . . . . . . @
@ . . . @ . . . . . . . . @ . . . . . . . . @ . . . . . . @ @ . . . . . . . . . . . . @ . . @ . . . @ . . @ @ . . . @ . @ . @ . . . . . . . . . . . @ @ . . @ . . . . . . . . . . @ . @ . . . @ . . . @
@ . . @ . . . . . . . @ . @ @ . . . . . . @ . . . . . . . . @ . . @ . . . @ . . . @ . . . . . . . . . . . . @ . . . . . . @ . . . . . . . . . . . @ . . . . @ . @ . . . . . . . @ . . . . . . . . . @ @
@ @ . . . . . . . . . . @ . @ . . . . . . . @ . . @ . . . @ . . @ @ @ . . @ . @ . . . . . . @ @ . . . . . @ . @ . . . @ . . . @ . . . @ . . . . . . . . . . . . . @ . . . . . . . . @ @ . . . . @ . . @
@ . . . @ @ . . . . . . . @ . . . . . . . . . @ . . . . . . . @ . . . @ . . . . @ . . . . @ . . . . . . @ . . @ . . @ . . . . . . @ . @ . . . . @ . @ . . . @ . . . . . . . . . . . . . . . @ . . . . @
@ . . . . . . . . @ . . . . @ . . . . @ . . @ . . @ . . . @ @ . . @ . . . . @ . . @ . . . . @ . . . . . @ @ . @ . @ . . . @ . . . @ . . . . . . . @ . . . . . @ . . . @ . . . . @ . . . . . . @ . @ . @
@ . . . . . . @ . . . . . . . . . . . . . . . . . . . . . . . . . . . @ . . . . . @ . . . . . . @ . @ . . @ . . . . . . . . . . @ . . @ @ . . . . @ . . . . . . . . . @ . . . . . @ @ @ . @ . . @ . . @
@ . @ . . . . . . @ @ . . . @ @ . . . . . . . . @ . @ . @ . . . . . . @ . . . . . . . . . . . . . . . . . . . . . . . . . . . @ . . . . . . . . @ . @ . . . . . . . . . . . . . . @ . . . . . @ @ . . @
@ . @ . . . . . . . . @ @ @ . . . . . . @ . @ . @ . . . . . . . . . . . . . . . . . . . . . . . . . . @ . . . . . . . . . @ . . @ . . . @ . @ . . @ . . . . @ . . . . . @ . @ @ . . . . . . . @ . @ . @
@ . @ . @ . @ . . @ . . . . @ . . . . @ . . @ @ . @ . @ @ . . . . . . . . . @ @ . . . . @ . . . . . . . . . @ . . . . . . . . . @ . . . . . @ @ . . @ . . . . @ @ . . . . . . . . . . @ . . . . . . . @
@ . . . @ . . @ . . . . @ . . @ . @ . . . @ @ @ . @ . . . . @ . . . . . . . . . . . @ . . . . . . . . . . . @ . . . . . . @ . . . . . . . . . . . . . . . . . . . . . @ @ . . . . @ . . . . . . @ . . @
@ . . . . . @ . @ . . . . . . . . . . @ . . @ . @ . . @ . . . . . . . . . . . . . . . . . . . @ . . . . @ . . @ . . . . . . . . . @ . . @ . @ . . . . . . . . . . . @ . . . . @ . . . . . . . . . @ . @
@ . . @ . . . . . . . . . . @ . . @ . . . . @ . . . @ . . . . @ . . . . @ . . . @ @ . . . . . . . . . . . . . . . . . . . . . . . . . . . . . @ . . . . . @ . . . . . . . @ . . . . . . . . @ . @ . . @
@ . . . . . . . . . . . . . . @ . . . @ . . . @ . @ . . . . . . . . . . . . @ . . . @ . . . . . . @ . . . . . . . . . . . . . . . . . . . @ @ . . . . . . . . @ . @ . . . . . . . . . @ . @ . . . . . @
@ . . . . . . . @ . . @ . . @ . . . . . . . . . . . . . . . @ . . . . . . . . . . . . . . @ . @ . . . @ . . . . @ . . . . . . @ . . @ . . . . . . . @ @ . . . . @ . . . . . . . @ . @ . . @ @ . . @ . @
@ . . . . . . . @ . @ @ . . @ . . . . . @ . . . @ . @ . . @ . . . @ . @ . @ . . . . . . @ . . . . @ . . . . . @ . @ . . . . @ @ . . . . . . . . . . . . . . . @ . . . . . . @ . . . . . . . . . . . . @
@ . @ . . . . . . @ . . @ . . . . . . . . @ @ . . . . . @ @ @ . . . . . . . . @ . . @ . . . . . . . . @ . . . . . . . . @ . . @ . . . . . . . . . @ . . . . . . . . . . . . @ . . . . . . @ . . . . . @
@ . . @ . . . @ @ . @ @ . . @ . . @ . . @ . @ @ . . @ . . . . @ . . . @ @ @ . . . . . . . . @ @ . . . . . . . . . . . . @ . . . . . . . . . @ . . . . . . . . . . . . . . . . @ . . @ . . . . . . . . @
@ . . @ . . . . @ . . . . . . . @ . @ . . . . . . . . . . . @ . @ . . . . . . . . . . . . . . . . . . . . . . @ . @ . . @ . . . . . . . @ . . . . . . . @ . . . @ . . @ . . @ . . . . . @ . . . . @ . @
@ . @ @ . . @ . @ . . . . . . . . . . . . . . . . . @ . @ . . . . . . . . . . @ . . . . . . . . @ . @ . . @ . . @ . . . . . . . @ . . . . . . @ . . @ . @ . . . . . . . . @ . . . . . @ @ . . . . . . @
@ . @ . . . . . @ . . . . . . . . . . . . . . . @ @ . . . . . . @ . . @ . @ . @ . . . . @ . . . . . . . . . . . . @ . . . @ @ . . . . . @ @ . . @ . . . . . . . . @ @ . . . . . . . . . . . . @ . . . @
@ @ . . . . . . . . . . . . . . . . . @ . . . . . . @ @ . . . . . . . @ . . . . @ . . @ . . @ . @ . @ . . . @ . . @ . . . . . . . . . . . . @ @ . . . . . . . . . . @ @ . . . . . @ . @ . . @ . . . @ @
@ . . . . . . . @ . @ @ . . @ . @ . . . @ . @ . . . . . @ . . . . . . . . . . @ @ . . @ . @ . . . . . . . . . . @ . @ . @ . . . . . . . . . @ . . . @ . @ . . . . . . . . @ . . . . . @ @ . . . . . . @
@ . . . . . . . . @ . . . . . . @ . . @ @ . . . . . . . . @ . . . @ @ . . . . . . . @ . . . . . . . @ . . . @ . . . . . . . . . . . . . . . . . . . . . . @ . @ . . . . . . @ . . . . . . . . . . . . @
@ @ @ @ @ @ @ @ @ @ @ @ @ @ @ @ @ @ @ @ @ @ @ @ @ @ @ @ @ @ @ @ @ @ @ @ @ @ @ @ @ @ @ @ @ @ @ @ @ @ @ @ @ @ @ @ @ @ @ @ @ @ @ @ @ @ @ @ @ @ @ @ @ @ @ @ @ @ @ @ @ @ @ @ @ @ @ @ @ @ @ @ @ @ @ @ @ @ @ @
3
15 98 5 81
63 98 77 43
61 71 64 12
