12 12
@ @ @ @ @ @ @ @ @ @ @ @
@ . . . . . . . . . . @
@ . @ . . . . . . @ . @
@ @ . . @ . . . . . . @
@ . . . @ @ . . . . . @
@ . . . . @ . . . . . @
@ . . . . . . . . @ . @
@ . @ . . @ . . . @ . @
@ . . . . . . . . . . @
@ . @ . . . @ . @ . . @
@ . . . . . @ . . . @ @
@ @ @ @ @ @ @ @ @ @ @ @
3
7 8 7 4
1 8 3 8
2 7 3 5
