100 100
@ @ @ @ @ @ @ @ @ @ @ @ @ @ @ @ @ @ @ @ @ @ @ @ @ @ @ @ @ @ @ @ @ @ @ @ @ @ @ @ @ @ @ @ @ @ @ @ @ @ @ @ @ @ @ @ @ @ @ @ @ @ @ @ @ @ @ @ @ @ @ @ @ @ @ @ @ @ @ @ @ @ @ @ @ @ @ @ @ @ @ @ @ @ @ @ @ @ @ @
@ . . . . @ @ @ . . . . . . . . . . . . . . . . . . . . . . . . . . . . . . . . . . . . @ . @ . . . . . . . . . . . . . . . . @ . . . . . . @ . . . . . @ . . . . . . . @ . . . . . . . . . . . . @ . @
@ . . @ . . . . . @ . . . @ . . . . . @ . . . . @ . . @ . @ . . . . . . . . . . . @ @ . . . . @ . . . . . . . . . @ . . @ . . . . . . . . . . @ . @ . . . . . . @ . . . . . . . @ . . @ @ @ . . @ . . @
@ . . . @ . @ . . @ . . . . . . . . . . . . . . . @ . @ . . . . . . . . . . . . . . . @ . . . . @ . . . . @ . . @ . . . . . @ @ . . . . . . . . . . . . . @ @ . . @ @ . . @ . . . @ . . . . @ . . . . @
@ . . . @ . . . @ . . @ . . . . . . . . . . . . . @ . . . . . . . . . . . @ . . . . . . . . . . . . . . . . @ . @ . . . @ . . . . . . @ . . . . . @ . . . . . . . . . . . . @ . @ . . @ . . . . . . . @
@ . . . . @ . . . . . . . . . . . . . . . @ . @ @ . . . . . . . . . . . . . . . @ . . . . . . . . . . . . . . @ @ . . . . @ . . . @ . . . @ @ . . . . . . . @ . . . . @ . . . . . . . . . . . . . . . @
@ @ . . @ . @ . . . . . . . @ . . . @ @ @ . . . . . @ . . . . . @ . . . . @ . . . . . . @ . @ . . . . . . . . . . . @ . . . . . @ . . . . . . . . @ . . . . . . . @ . . . . @ @ . . . . @ . . . . . . @
@ . . . . . . @ . @ . @ . . . . @ . . @ . . . . . . . @ . . . @ . . . . @ . . . . . . . . @ . @ . . . . . . . @ . . . . . . . . . . . . @ . . . . . . . . @ . . . . . . . . . @ . . @ @ . @ . . . @ . @
@ . @ @ @ @ . @ @ . . . @ . . . @ @ . @ . . @ . . . . . . . . . . @ . . . . . . . @ . @ . . @ . . . . . . . . . . . @ . . @ . . @ . . . . . . . . . . . . . . . . . . . . . . . . @ . @ . . . . . . @ @
@ . . . . . @ . . . . . . . . @ . @ . . . @ . . @ @ . @ . . . . @ . . . . . . . @ . . . . @ . . . . . . . . @ . . . . . . . . @ @ . . . . . . . . . . . @ @ . . . . . . . @ . . . . . . . . . . . . . @
@ . . . . @ . @ . . @ . . . @ . . . . @ . . @ . . . @ . @ . . @ . @ . @ . . . . . @ . @ . @ . @ . . . @ . . @ . . . . . @ . @ . . @ . . . . . . @ @ . @ . . . @ . @ @ . . . . . . . . . @ . . . . . . @
@ . . . . . . . . . . @ . . . @ . . . . . . . . @ . . . . @ @ . . . . . @ . . . . . . . @ . . . . . @ . . . . @ . . . @ . . . @ . . . . . . . . . . . @ . . . . . . . . . . . . . . . @ . . . . . . . @
@ . . . . @ . @ . . . . . . @ . . @ . . . . . . . . @ . @ . . . . . @ @ . @ . . . . @ @ . @ @ @ . . . @ . . . . . . . . . . . . . @ @ . . @ . . . . . . . . . . . @ . . . . . . . . . . . @ . . . . . @
@ . . . . . . . . . @ . . . . . . . . . @ . . . . . . . . . . @ @ . . . . . . . . . . . . . . . @ . . . . . . . . @ . . . . @ @ . . . @ . . . . . . @ . . . . @ . . . . . . . . . . @ . @ . . . . . . @
@ . . . . . . @ . . . . . @ . . @ . . . . . . . . . . . . @ . . . . . . . . . . @ . @ . . . . @ . . . . . . . . . . . . . . . @ . . @ . . . @ @ . . . . . . . . . . . @ . . . . . . @ . . @ . . @ . . @
@ . . . . @ . . . @ . . . @ . . . . . . . @ . . . @ @ . @ . . . . . . . . @ . . . . . . . . . . . . . . @ . . . . . @ @ @ . . . . . @ . . . . @ . . @ . . . . . . . . . . . . . @ . . . @ . @ . . . . @
@ . . . . . @ . @ . . . . . @ . . . @ . @ . . . . . . . @ . . . . . . . . . . . . . . . @ @ @ . . . . . @ @ . . @ . . . @ . . . @ . . @ . . . . . . . . . . @ . . . @ . @ . . . . . . @ . . . . @ . . @
@ @ . . . . . . . . @ . @ . . . . @ . . . . . . . . . . . @ . . . @ . @ . . . . . @ @ @ . . . @ . . . . @ . . . . . . . . @ @ . . . . @ . . @ . . . . . . @ . . @ . . @ . . . . . . . . @ . . . . . . @
@ . @ . . . . . @ @ . . . . . . . . . @ . @ . . @ . . @ . . . . @ . . @ . . . @ @ . . . . . . . . . . @ . . . . . . @ . . . . . . . . . @ . . @ . . . @ . . . . . . . @ . . . . . @ . @ . . . . . . . @
@ . . . . . . @ . . . @ . . . . . . . . . . . . . . . . . . . . . . . . . . . . . . . . . . . . . . . . . . . @ . @ . . . . @ . . @ . . . . . . . . . . . . @ . . . . . . @ . . . . . . . . . @ . . . @
@ . . . @ . . . . . . . . . @ . . . @ . . . @ . . . . . . . . @ . . . . . @ . . . . . . @ . . . . . . . . @ . . . . . . . . . . @ . . @ . @ . . @ . . . . . @ . . . @ . . . @ . . . . @ . @ . . . @ . @
@ . . . @ . . . . . . . . . . . . . . . . @ @ . . . . @ . . . . @ . . . . . . . @ @ @ . . . . . @ . @ . . . . @ . . . @ . @ @ @ @ @ . . @ . . . . . . . . . . . . . . . . . . @ . . @ . @ . . @ . . . @
@ . . . . . . . . . . @ . . . . @ . @ . . . . @ . @ . @ . . . . . . @ . . . @ . . . . . . . . @ . . . . . . . . . . @ . . . . . . @ . . . . . . . . . . . . @ . @ . . . . . . . . . . . . . . . . . . @
@ . . . . . . . . . . . . @ @ @ . . . @ . . . . . . . . . . . @ . . . . . @ . . . . . . @ . @ @ @ . @ . . . . . . . @ . @ . @ @ . . . @ . . . @ . @ @ @ . . . . . . . @ @ . @ . . . @ . @ . . @ . . . @
@ . . . . . . . @ . @ . . . . . @ . . . . . . . @ . . . . . . . . . . @ . . . . @ . . . . . . . . . . . . . @ . . . . . . @ . . . . . . . . . . . . @ @ @ . . . . . @ . . . . . . . . @ . . . . @ . . @
@ . . . @ @ . . . @ . . @ . . . . . . . @ . . . . . . @ . . @ . . . @ @ . @ . . . . . . . . . . @ . . . @ . . . @ @ . . . . . . . @ . . @ . . . . . . . . . . . . . . . . . . . . . . @ . . @ . . . @ @
@ . . @ . . . . . . . . . . @ . . . . . @ . @ . . . . . @ . @ . . . . . . . . . @ . . @ . . @ . . . . @ . . . . . . . . . @ . @ . . . . . . @ . . . . @ @ . . . . @ . @ . . . @ . . @ . . @ . . . . @ @
@ @ @ . . @ . . @ . . . . . . @ . . . @ @ . . . . . . @ . . . . @ . . . . . @ . . . @ . . . . . @ . . . . . @ . . . . . . . . . . @ . . . . . . @ . . . . . @ . . . . . . . @ . . . @ . . . . @ . . . @
@ . . @ . . @ @ . . . . . . . . . . . . . @ . . . . . . . . @ . . . . . @ . . . . . . . . . @ . . @ . @ . . . . . . . . @ @ . . . . @ . . . . . . . . . . @ . @ . . . . @ . . @ . . . . . . @ . . . . @
@ . . . . . . . . . . @ . @ . . . . . . . . . . . . @ . . . . . . @ . @ @ . . . . . . @ . @ @ . . . . . . . . . . . . . . . . . . . . . @ . . @ . . . . . . . . . . . . @ . . @ @ . . . . . . . . . @ @
@ . @ . . . . . @ @ . . . . . . . . . . . . . @ . . . . . . . . . . . . . @ @ . . . @ . . . . @ . . . . . . . . . . @ . @ . . @ . . @ . . . . . . . . . . . . @ . . . . . . . . . . . . . . . . @ . @ @
@ . . . . . @ . . . . . . . @ . . . . . . @ . . . . . . @ . . . . . . . . . . @ @ . . . . . . . . . . . . . . @ . . . . @ @ . @ . . . . . . . @ . . . . . . @ . @ . . @ . . . . . @ . @ . @ . . . . . @
@ . . . @ . . . . . . . . @ . . . . @ . @ . @ @ . @ . @ . . . . . . . . @ . . @ . . . . . @ @ . . . . . . . @ . . . . . . . . . @ . . . @ . . . . . . . . . . @ . . . . @ @ . . @ . . . @ . . . @ @ . @
@ . . @ . @ @ @ . . . . . @ . . @ . @ . . . . . @ . . . . . . @ . . . . . . . . . . . . . . . . . . @ @ . . . . . . . @ @ . . . . @ . . . . @ . . @ @ @ . . @ . @ . . @ . . . . . . @ . . . . . . . @ @
@ @ . . . . . . . . . . . . . . @ . . . . @ . . @ . @ . . @ . . . @ . @ . . @ . . . . . . . . . @ . . . . . . . . @ . . @ . . . . . . . . . . @ . . @ . @ . . . . . . @ . . . . @ . . . . . . . . @ . @
@ @ . . . . . . @ . . @ . . . . . . @ . . @ . @ . . . . . . . . @ . . . . . @ @ . @ . . . . @ @ . . @ . . . . . . . @ @ . . . . . @ . . . @ . . . @ . . . . @ @ . . @ . . . . . @ . . . @ . . . @ . . @
@ . . . . . . . @ . @ . . . . @ . . . @ . . @ . . @ . @ . . . . . . . . . . @ . . . . . . . . @ . . . . . @ . . . . . . . . . . . . . @ . . . . . @ . . . @ . . . @ . @ . . . . . @ . @ . . . @ . . . @
@ . . . . . @ . . . . . . . . . . . . . . . . . . . . . . . . . . . @ . . . @ . . @ @ . . . . . . . . . . @ . @ . . . . . . @ @ . . . . . . . . . . . . @ . . @ . . . @ . . . @ . . . . . . @ . . . . @
@ . . . . @ . @ . . . . . . @ . . . . . . . . @ @ . @ @ @ . . . . . . . . @ . @ . . @ @ . . . . . @ . . @ . . . . @ . @ . . . . . . @ . . . . . @ . . . . . . . . @ . . . . . . . @ . . @ . . . . . . @
@ @ . . . . @ . . . . . . . . @ . . . . . . . . . . . . . . . . . . . . . . . . . . . . . . . . @ . . @ . . . . . . . . @ . . . . . . . . . . . @ . . . . . . @ . . . @ . . . . . . . . . . . . . . . @
@ . . . @ . . @ @ . . . . . . . . @ . . @ . . @ . . . . @ . @ . . . @ @ . . . . . . . . . . . . . . . . . . . . . . . @ . . . . . . . . . @ . . . . . . . . . . @ . . . @ . . . . . . . . @ . . . . . @
@ . . @ . @ . @ . . . . . . @ . @ . . . @ . . . . @ @ . . . . . . . . . . . @ . . . . . . . . . @ . . @ . @ . . . . . . . . . . @ . . . . . . @ . . . . . . @ . . . . . . . . . . . . . . . @ @ @ . . @
@ . . . @ . @ . . . . . . . . . . . . . . . . . @ . . @ . . . . @ . . . @ @ . . . . . . . . . . . . . . . . . . . . . . . . . . . . @ . . . @ . @ . @ . . . . @ . . . . @ . . . . . . . . . . . . . . @
@ . . . . . . @ . . . . . . . . @ . . @ . . . . @ @ . . . @ . @ . . . . . . @ . . . @ . . . . . . . . . . . . . . @ . . . . . @ . . . . @ @ . @ . . . @ . . . . . . . . . @ . @ . . . . . . . . . . . @
@ . @ . @ @ . @ . @ . @ . @ . . @ . . . . @ . . . . . . @ . . . . . . . . . . . . . . . @ . . . . . . . . @ . . . . . . . . . @ . @ . . . . . . @ . . . @ . @ . . . . . @ . . . @ . . . . . . . . @ . @
@ . . . @ @ . . . @ . . @ . . . . . . . . . . . . . . @ . . . . . . @ . . . . . @ . . . . . . @ . . . . . . @ . . . @ . . @ . . . . . . . . . . . . @ . @ . . . . @ . . . . . . @ . . . . . @ . @ . . @
@ . . @ . . @ . . . . . @ . @ . . . . . . . . . @ . . . . . @ . . . @ . . . . . @ . @ . . . . . . . . . . . . . . @ . . . . . . . . . . . @ . . . . . . . . . . . . . . . . @ . . . . . . . . . . . . @
@ . @ . . . . . . . . . . @ . @ . . . . . . . . @ @ . . . . . @ . . . @ . @ . . . . . . . @ . . @ . . . . @ . . . . . . . . . . . . . @ . . . . . . . . . . . . . . . . @ . @ @ . . @ . . . @ . . @ . @
@ @ . . . . . . . . . . . . . . . . . . . . . . . @ . @ @ . . . . . . . . . . . . . . @ . . . . @ . . . @ . . . . . @ . . . . . . . . . . . @ . . . . . . . . . @ . . . . @ . . . . . . . . . . @ . . @
@ . . . @ . . . . . . . @ @ . . . . . @ . @ . . . @ . . . . . . @ . . . . . . . . . . . . . . . . . . . . . . . . . . . . . . . . @ . . . . . @ . . . @ . . . . . @ . . . . . . . . . . . . @ . . . . @
@ . @ . . . . . . . . @ . . . . . . . @ . . @ . . . . @ . . . . . . @ . . . @ . @ . . . @ . . . . . . . . @ @ . @ . . . . . . . . . . . . . . . . . . . . . . @ . . . @ . @ @ . @ . @ . . . . . . @ . @
@ . . . . . @ . . . . . . @ @ . . . . . . . . . . . @ . . @ . . . . . @ . . . . . . . . . . . . . . . @ . . . . @ . . @ @ @ . . . . . . . . @ . . @ . . . . . . @ . . . . . . . . . . . . . . . . . . @
@ . . . . . . @ . . . . . . . . . . . . . @ . . . . . . . . . . . . . @ . . . . . @ . . . . @ . @ @ . . . . . @ . . . . . . . . . . . . . . . . . . . . . @ . . . . . . . @ . . . . . @ . . @ . . . . @
@ . @ . . . . . @ . . . . . . . . . . . . . . . . . . . . . . . . . . . @ . . . @ . . . . @ . @ . . @ . . . . . . . . . . . @ . . . . . . . . . . . . . @ . . . . . . . . . . . . . @ . . . . . . @ . @
@ . @ . . . . @ . . @ . . . . @ @ . . . . . . . . . . . . . . . @ . . . . . . @ . . @ . . . . . . . @ . . . @ . @ . . . . . . . . . . . . . . . . . . . . . . . . . . . . @ . . . . . . . . . . . @ . @
@ . . . . . . . . @ . @ . . . . @ @ . . . . @ . @ . . . . . @ . . . . . . . . . . . . . @ . @ . . . . . . . @ . . . . . . . . . . . . . . @ . @ . . . . . @ . . @ @ . . . . . . . . . . . @ . . . @ . @
@ . . . . . . . . . . . . . . @ . . @ . @ . @ . . . . . . . . . . . . . . @ . . . . . . . . . . . . . . @ @ . . @ . . @ . . . . . . . . . . @ . . . . @ . . . @ . . . . @ . . . @ . . . . @ . . . . . @
@ . @ @ . . @ . . @ . . . . . . . . . . @ . @ @ . . @ . . @ . . . @ . . . . . . . . . . . . . . . . . . . . . . . . . . @ . @ @ . . @ . @ . . . . @ . . . . . . . @ @ . . . . @ . . . . @ . . @ . @ . @
@ . . . . . . @ . . @ . . . . . . . . . . . @ . @ @ . . . . @ . . @ @ . . . . . . . . @ @ . . @ . . . . . @ . @ @ . . . @ . . @ . . . . @ . . . . . . . . . . @ . @ . @ . . . . @ . . . . . . . . . . @
@ . . . . . . . @ @ . @ @ . @ . . . . @ . . . . . . . . . . . . @ . . . . . . . . . @ . @ @ . . . . . . . @ . . . . . . . . @ . @ . . @ . @ . . . . . . . . . . . . . . . @ @ . . . @ . . . @ . . . . @
@ @ . . . . . . . . . . . . @ . . . @ . . @ . . @ . . @ . @ . @ . . . . . . . @ . . @ . . . . @ . . @ . . . @ . @ . . . @ . . . . . @ . . . . . . . . . . @ . . @ . . @ @ . . . @ @ . . @ . . . . @ . @
@ @ . . . . @ . . . . . . . . @ . . . . . . . . . . . . . . . . . . @ . . @ . . . . . . . @ . . @ . . . . . . . . . @ . . @ . @ . . . . . . . . . @ . . @ @ . @ @ . . . . . . @ . @ . . @ . . . . . . @
@ . @ . . . . @ . . . . . . . . . @ . . . . . . @ @ @ . @ @ . @ . . . . . . @ . @ . . . . . . @ . . . . . @ . . @ . . . . . . . . . @ . . . . . . . . . . . . . . . . @ @ . @ . . . . . . @ . . . . . @
@ . . . . . . . @ . . . . . . . . . . . @ . . . . . . . . . . . . . . @ . . @ . . . @ . . . . @ . . . . . . @ . @ . . . . . . . @ . . . . @ . . . . . . . @ . . . @ . . . . . . @ . . . . . . . . . . @
@ . . . . @ . . . . . @ @ . . . . . . . @ . . . . . @ . @ . . . . . . . @ . . . . @ . @ . @ . . . . . . . . . @ . @ . @ @ . . @ . . . @ . . . . . . . @ . . . @ . . . @ . . . @ . . . @ . . @ . . . . @
@ @ @ . @ . . . . . . @ . . . . . . . . . . . @ . . @ . . . . . . . . . . . . . @ . . . @ . @ @ . @ . . . . . . . . . @ @ . . . . . . . . . @ . . . . . . . @ . . . . . . . . . . . . . @ . . . . . . @
@ . . @ . . . . . @ . . @ @ . @ . . @ . . . @ . . . . @ . . . @ . . . . . . . . . . . . . . . . . . . @ . . . . . . . @ . . . . . . . . . @ . . . . . . @ @ . @ . . . . . . . . @ . . @ . . . . . . . @
@ . @ . . . . . . . . . . . . . . @ . . . @ . . . . . . . . . . . . . . @ . . @ . . . . . . . . @ @ . . @ . . . . . @ . @ . @ . . . . . . @ @ . @ . . . . . @ . . @ . . . @ . . . . . . . @ . @ . @ . @
@ . . . . @ . . @ . . . . . . . @ . . . . . . @ . @ . . @ . @ . . @ . . . @ . . . @ . . @ . . @ . . . @ . . . . . . . . . . . . . . . . . . . . . . . @ . . . @ . . . . @ . . . . . . @ @ . . @ . . . @
@ . @ . . . . . . @ . . . . . . . @ . . @ . @ . . @ . . . . . . . . . . . . . . . @ . . . . @ . . . . . . . @ . . . . . . . . . . . . @ . . . . @ . . . . . . . @ . . . . . . . . . . . @ . . . . . . @
@ . @ . . . . . @ . . . . . @ . @ . . . . . . . . . . . @ . . . . . . . . @ . @ @ . . . . . . . . . . . @ . . . . . . . . . . . . . . @ . . . . . @ @ . . . . . @ . . @ @ . . . . @ . . . . @ . @ . . @
@ . @ @ . . . . . . @ . . . . @ . @ @ @ @ . . . . . . @ . . . . @ . @ . @ . . . . . . . . . . . @ . . @ . . @ . . . . @ . @ . . . . . . . . . . @ @ . @ @ . . . . @ . . . . @ . . . . . . . @ . . . . @
@ . . . @ . . . . @ . . . . . . @ . . . . . . @ @ @ . . . . . . @ . . . . . . . . @ . . . . . @ . @ @ . . @ . . . . . . . . @ . . . . . . . . . . . . @ . . @ @ . . . . . . @ @ . . @ . @ . . . @ . . @
@ @ @ @ . . . @ . . . . . . @ . . . . . . . . . . @ @ . . . . . . . @ . @ . . @ . @ @ . . @ . @ . . . . . . @ . . . . . . . . . . . . . . . . . . . . . . . @ . . . @ . . . . . . @ . . . @ . . . . . @
@ . @ . . @ . . . . . . . . @ . . . @ . . . . @ . . . . . . . . . @ . . . . . . . . . @ @ . . . @ . . . . . . . @ . . @ . . . . . . . . . . . . . . @ . . @ . . . . @ . . . . . . . . . . . . . . . . @
@ . . . . . . . @ @ . . @ . @ . . . . . . . . . . . @ . . . . . . . . . . . . @ . . . . . . @ . . . . . . . @ . . . . @ . @ . . . . . . . . . . . . . . . . . . . . . . . @ . @ . . . @ . . . . . @ . @
@ . . . . . . . . . . . . . . . . @ . . . . . @ . . . @ . . . . . @ . . @ . . . @ . . . . . . . . . . . . . . . @ . . . . @ . . . . . . @ . @ . . . . . . . . . . . . . . @ . . . . . . . . . @ . . . @
@ . @ @ . . . . . . . . @ . . . @ . . . . . . . . . @ . . . . . . . . . . @ . . @ . . . . . . . . . . . . @ . . . . . . . . . . . . . . . . @ . . . . @ . . . . . . . . @ . @ . . . @ . @ . . . . . . @
@ . . . . . . . . . . . . . . . . . . @ . . . @ . @ . . . . . @ . . . . . . . @ . . . @ . . @ . . . . @ @ . . . @ . . . @ . . . @ . . @ @ . . . . . @ . @ . . . . . . . . . . . . . . . . @ . @ @ . . @
@ . . . . . . @ . . . . @ . @ . @ . . . @ . @ . @ . . @ . . . @ @ . . . . . . . . @ . . . . . . @ . . . @ . . . . . . . . @ . . . @ @ . . . . @ . . . . . . . . . . . . . . . . . . @ . . . . @ . . . @
@ . . . . . . . . . . . . . . . @ . . . . . . . . @ . . . . @ . . @ . . . . @ . @ . . . . @ . . . . . @ . @ . @ . . . . . . @ . . . . . . . . . . . @ . . . . . . . @ . @ . . . . . . . @ . . . . . . @
@ @ @ . @ @ . . . . . . . . . . . . . @ . . . . . . . . . . . . @ . . @ . . . . . . . . @ @ . @ . . . @ . @ . . @ @ @ . . @ . . . . . @ . @ . . @ . @ @ . . . . . @ . . . @ @ . @ . . . . @ . . . @ . @
@ . . . @ . @ . @ . . . . . . . . @ . . . . . . @ . . . . . . . . @ @ . . . . . @ . . . . @ . . @ . @ . . . . . . . . . @ . @ . . . . . @ . . . @ . . . . . . @ . . . . . . . . . . . . . . . . . . . @
@ . . . . . @ . . . . . . . @ . . . . @ . . . @ . . . . . . . . @ . @ . . @ @ . . . . @ . . @ . . . . . . . . . @ . . . . . @ . . @ . . . . . . . . . . . . @ . . . . @ . . . . . . . @ . . . @ . . . @
@ . . @ . . . . @ . @ . . . . . . . . . @ . . . . . . @ . . @ . . @ . . . . . . . . . . . . . . . . @ . . . . . . . . . . . . . . . . . @ . . . . . @ . . . . . . @ . . . . . @ . . . . @ . . . . . . @
@ . . @ . . . . . . @ . . . . . . . . . . . . . @ . . @ . . . . . . @ @ . . . . @ . . . . . . . . @ . . . . . . . . . . . . . @ . . @ . . . . . . . . . . . . @ . . . @ . @ . . . . . . . @ . . @ . . @
@ . . . @ . . . @ . . . . . . . . . . @ . @ @ @ . @ . . @ @ . . . . . @ . . . . @ @ . . . . @ . . @ . @ . . . . . . @ . . @ . . . . . . @ . . . @ @ . . . . @ . . . . . . . . . @ . . . . . . . . . . @
@ . . . @ . . . . . @ . . @ @ . @ @ . . . . . . . . . . . . @ . @ @ . . . . . @ . . . . . @ . @ @ . . . @ . . . . . . @ @ . . . . . @ . @ . . . . @ . . @ @ . . . . . . . . . . . . . . . . . @ . . . @
@ @ . . . . . . . . . . . @ . . . . . . . . . @ . . @ @ . @ @ . . . . . . @ . . @ . . @ . . . . . . . @ . . . . . . . . . . . . @ . . @ . . . @ @ . . . . . . . @ . . . . @ . @ . . . @ . . . . . . . @
@ . . . . . . . . @ . @ . @ . @ . . . . . . . @ . . . . . . . @ . . . @ . . . . . . . . @ . . . . . . . . . . @ . . . . . . . . . . . . . @ . . . @ . . @ . @ @ . . . @ . . . . . . . . @ @ . @ . @ . @
@ . . . @ . . @ . . . . @ . . . . @ . @ . . . . . @ . . . . . . . . . . . . . . . . @ @ . @ . @ . . @ . @ @ @ . . . . . . . . . . . @ @ . @ . . . . . . . @ . . . . . . . . @ . . @ . . . . . . . . @ @
@ . @ . . @ . . . . . . . . . . . . . . . . . @ @ @ . . . . . . . . . . . @ . . @ @ . . . . . . @ . . . . . . . . . . . . @ . . @ . . @ . @ . . . . . @ . . . . . . . @ @ . . . . . . . . @ . . @ . . @
@ @ . . . @ . @ . . . . . . . . . . . . . . . . . . . . . . . @ . . . . . . @ . . . . @ . . @ . . @ . . . @ . . . . . @ . . . . . . . . . . . @ . . . . . @ . . . . . . @ @ . . . . . . . . . . @ . @ @
@ . . . @ . @ . . @ . . @ . . . . . . . . . @ . . . . @ . . . . @ @ @ @ . . . @ . . . . . @ . . . . . @ . . . . @ @ . . . . . . . . . . . . @ . . . . @ . . . . . @ . . . . . . . @ . . . . . . . . . @
@ . . @ . . @ . . . . . @ @ @ . . . . @ . . . . . . . . . . @ . @ . @ . . . . . . . . . . . @ . . @ . . . . . . . . . @ . . . . . . . . @ . . . @ . . . @ . . . @ . . . . . . . . . . . . . . @ . . @ @
@ . . . . . . . . . . . . @ . . @ @ . @ . . . . . . @ . . @ @ . . . . @ . . . . . . . . . @ . . . @ . . . @ @ . . . . . . . @ . @ . @ . . . @ . . @ @ . . . . @ . . . . @ . . . . . . . . . . . @ . . @
@ @ . @ . @ . . . . . . . . @ . . . . @ . . . @ . . . . @ . @ . . @ . @ . . . . . . @ @ . . . . . . . . . . . @ . @ . . . @ . . . . . . . @ . . @ . @ . . . . . . . . . . . . . . . . . . . . . @ . . @
@ . . . . . . . . . . . @ . . . . @ . . . @ @ . . . . . . . @ @ . . . . @ . . . . . . . . @ . . @ . . . @ . . . . @ . . . . . . @ . . @ . . @ @ . . @ @ . . . @ . @ @ . @ . . . @ . @ @ . @ . @ . . . @
@ . . . @ . . @ . . . . . . . . . . . . . . . . . . . . . . . . . . . . @ @ . . @ . . . @ . @ . . . . @ . @ . . . @ . @ . . . . . . @ . . . . . . . . . @ . . . . @ . . . @ . . @ @ . . . . . . . . . @
@ @ @ @ @ @ @ @ @ @ @ @ @ @ @ @ @ @ @ @ @ @ @ @ @ @ @ @ @ @ @ @ @ @ @ @ @ @ @ @ @ @ @ @ @ @ @ @ @ @ @ @ @ @ @ @ @ @ @ @ @ @ @ @ @ @ @ @ @ @ @ @ @ @ @ @ @ @ @ @ @ @ @ @ @ @ @ @ @ @ @ @ @ @ @ @ @ @ @ @
3
64 72 76 37
32 86 45 37
38 10 52 44
