25 25
@ @ @ @ @ @ @ @ @ @ @ @ @ @ @ @ @ @ @ @ @ @ @ @ @
@ . @ . . . . @ . . . . . . . . @ . . . . . . . @
@ . . . . @ . . @ . . @ . . @ . @ @ . . @ . . . @
@ . . . . . @ @ . . . @ @ . . . . . . . . . @ . @
@ . . . @ . . . . . . @ . . . . @ . . @ . . . . @
@ . . . . . . @ . . @ . . . . . . @ . . . . . . @
@ . . . . @ @ @ @ . . . . . . . . @ @ @ . @ . . @
@ . . . @ . . . @ . . . . @ . . . . . @ . . . . @
@ . . . . . . . . . . @ . @ . . . @ . @ . @ . . @
@ . . . . . @ @ . . . . . . @ . @ . . . . . . . @
@ . . . . . . . . . . . . . . @ @ . . . . . . . @
@ . . . . . . . . . @ . @ . . . @ . . @ . . . . @
@ . . . . . . . . . . . @ @ @ . . . @ . . . . . @
@ . . . . . . . . . . . . . . . . . . @ . . . . @
@ . @ . . . . @ . . @ . . @ . @ . . @ . . . @ . @
@ @ . . . . . . . . . . . . . . @ . . . . . . . @
@ @ . . . . @ . @ . @ @ . . . . . . . . . . . . @
@ . . @ . . . . @ . @ . . . . @ . . . . @ . . . @
@ @ . . . . . @ . @ . . . @ . . . . . @ . . . @ @
@ . . @ . . . @ . @ . @ . . . . . @ @ . @ @ . . @
@ @ . . . . . . . . . . . . . . . . . . . @ @ . @
@ @ . . . . . . . . . . . . @ . . . . . . . . @ @
@ . @ . @ . . . . . . . . . @ . @ @ @ . . . @ . @
@ . . . . . . . . @ . . . . . . @ . . . . . . . @
@ @ @ @ @ @ @ @ @ @ @ @ @ @ @ @ @ @ @ @ @ @ @ @ @
3
21 11 10 3
20 11 16 14
18 17 20 3
