12 12
@ @ @ @ @ @ @ @ @ @ @ @
@ . . . . . @ . . . . @
@ @ . . . . @ . . @ . @
@ . . . . . . . @ . . @
@ . . @ . . @ . . . . @
@ . . . . @ . . . . . @
@ . @ . . . . . @ . @ @
@ @ . @ . . @ . . @ . @
@ . . . @ . . . . @ . @
@ . . . @ . . @ . . . @
@ . . . . . . . . . . @
@ @ @ @ @ @ @ @ @ @ @ @
3
1 3 1 5
4 1 9 8
3 3 10 1
