12 12
@ @ @ @ @ @ @ @ @ @ @ @
@ . . . . . . @ . . . @
@ . @ . . @ . . . @ . @
@ . . . . . . . . . . @
@ @ . @ . . . . . . @ @
@ . . @ . @ . . . . . @
@ . . . . @ . . . . . @
@ @ . . . . . . . . . @
@ . . . . . . . @ @ . @
@ . . . . . . . . . . @
@ @ . . . . . . @ . . @
@ @ @ @ @ @ @ @ @ @ @ @
3
7 6 9 6
2 3 9 4
7 3 9 10
