100 100
@ @ @ @ @ @ @ @ @ @ @ @ @ @ @ @ @ @ @ @ @ @ @ @ @ @ @ @ @ @ @ @ @ @ @ @ @ @ @ @ @ @ @ @ @ @ @ @ @ @ @ @ @ @ @ @ @ @ @ @ @ @ @ @ @ @ @ @ @ @ @ @ @ @ @ @ @ @ @ @ @ @ @ @ @ @ @ @ @ @ @ @ @ @ @ @ @ @ @ @
@ . . . . . @ . @ . . . . . . . . @ . . . . . . . . . . . . . . . . . . . . . . . . . . . @ . @ . . . . . . @ . @ . . . . . . . . @ . . . . . . . . . @ . . @ . . . . . . . . @ . . . . . . . @ . . . @
@ . . . . . . . . . @ . . . @ . . . . . . @ . . . @ . . . . . . . @ . . . @ . . . . . @ @ . . . . . . . . . . . . . . . @ . @ . . @ . . . . . . . . . . . . . . . . . @ . @ . . @ . . . @ . @ . . @ . @
@ . @ . @ . . . @ . . . . . . . . @ . . . . . . . @ @ . . . . . . @ @ . . . . . . . . . . . . . . . . . . . . . . . . . . . @ . @ . . . @ . . . . . @ . . . . . . . . . . . . . @ @ . . . @ . @ . . @ @
@ . . . . . . . . @ . . . . . . . . . @ . . . . . @ . @ . . . . . . @ . @ . . . @ @ . @ . . @ @ . @ . . @ . . . . . . . . . . @ . . @ . . . . . @ . . . . @ . . . . @ . . @ @ . @ . . . . . . . @ @ . @
@ . . . . . . @ . @ . @ . @ . @ . . @ . . . @ @ @ . @ . . . . . . . @ . . . . . . . . . . . . . . . . . . . . . . @ . . . . @ . . . @ . . . . . . . . . . . . . . . . . . . @ . . . . . . . @ @ . @ . @
@ . . . @ @ . . . . . . . . . . . @ . . . . . . . . . . . . . . . @ . @ . . . . . . @ . . . . . . . . . . . . @ . . . . . . . . @ . @ @ . . . . . . . . . . . . . . @ . . . . . @ . . . . . . @ @ . . @
@ . @ @ . . . . @ . . . . @ @ . . . . @ . . . . @ . @ . . . @ . . @ . . . @ . . . . . . . . . . . . . @ . . . . . . . . . @ @ . . . . . . . . . . . . . . @ . @ . . . . . . @ . . . . . . . @ . . . . @
@ . . . @ @ . . . @ . . . . . @ . . . . . . . @ . . @ @ @ . . . . . . . . . @ . @ . @ . @ . @ @ @ . @ . . . @ . . . . . . . . . . @ . . . . . . . . . . @ . . . . @ . . @ . . . . . . . . . . @ . . . @
@ . . . . . . . . . . . . . . . @ . @ . . . . @ . . . . . @ . . . . . @ . @ . . . . . . . @ . . . @ @ . . . . . . . . . @ @ . . @ . . . . . . . . . @ . . . . . . . . . . . . . . . . . @ @ . . . . @ @
@ . . . . . . . . . @ . . . @ . . . . . @ . . @ . . @ . . . @ . . . . . . . . @ . @ . . . . @ . . . . . @ . . . . . . . . . . . . . . . . . . @ . . . @ . @ . . . . . . @ . @ . . . . . . . @ . @ . . @
@ . @ . . . . . . . . . . . @ . @ . . . . @ . . . . . . @ @ . . . . @ . . . . . . . . @ . . . . . . . . . @ . . @ @ @ . . . . . . . . @ . @ . . @ . . @ . . @ . . . @ . . . . . . @ . . @ . . . . . . @
@ . . . . . . . @ . . . . . . . . . . . . . . @ . . . . . . . . @ . . . . . . . . . . . . . . @ . . . @ . . @ . . . . . . . . . . . . . . . @ . . @ . . . @ . . . . . . . . . . . . . . . @ . @ . . . @
@ . . . . . . . . . . . . . . . . . @ . . . . . . . . @ @ . . @ . . . . . . . . . . . . . . . @ . . . . . . . . . . . . . . @ . . @ . . . . . . . . . . @ . . . . . . @ . . . . @ . . . . . . . . . . @
@ . . . @ . . . . @ . . . @ . . @ . . . . . . . . . . @ . . @ . @ @ . . @ . . . . @ . @ . . . . . @ . @ . . @ . @ . . . @ . . @ . . @ @ . . . @ . . @ . . . . @ . . . @ . @ . . . . . . . @ @ . . @ . @
@ . . . @ . . . . . . . . . . @ . . . . . . . . . @ . . . . . . . @ . . . . . . . . . @ . . . . @ . @ . . . . . . . @ . . . . @ . @ . . . . . . . . . . . . @ . . . @ . . . . . . . @ . @ . . . . . . @
@ . . . . @ . . . . . . . @ . . . @ @ . @ . @ . . . . @ @ . . @ . . . . @ @ . . . @ . . . . . @ . . . . . @ @ . @ . . . . @ . @ . . . . . . . @ . . . . @ . . . . . . @ . . @ . . . . . @ @ . . . . . @
@ . . . . . . @ . . . . . . . . . . . . @ . . @ . . . . . . @ . . . . . . . . . . . @ . . . . . . @ . @ . . . @ . . . . . . . . . . . . . @ . . . . . @ . . . . . @ . @ . . . @ . . . . . . . . . . . @
@ . . . @ . . . @ @ . . . . . @ . . . . . . @ . . . . . . . . . . . . . . . . @ @ . . . . . . . . @ @ . @ . @ . . . @ . @ . @ . . . . . . . . . . . @ @ . . . . @ . . . . @ . @ . . @ . . @ . . . @ . @
@ . . . @ . . . . @ . . @ . . . . @ . . . . . . . . . . . @ . . . . . . . . . . . . . . . . . . @ . . @ . . . . @ . . . . . . . . . . . . @ . . . . . . . . . . . . . . . @ . . @ . . . . . . @ . . . @
@ @ . . . @ @ . . @ @ . . . . . @ . . . . . . . . . . . . @ . . . . @ . @ . . . @ . . @ . . . . . @ . . . . . . . . . . . . . @ . @ . . . . @ . . . . @ . . @ . . @ . . . . . . . @ . . . . . . . . @ @
@ . . @ . . @ . . . . . . . . . . . . . . . . @ . @ . . . . . . . . . . . . . . . . @ . . . . . . @ . . . . @ . . . @ . . . @ . . . . . . . @ . . . . . . . @ . . . . . . . . . . . . . . . . @ . @ . @
@ . . . . @ . . . @ . @ @ @ . . @ . . . . @ . . @ . . @ . @ . . @ . . . . . . . @ @ . . . . . . . . . . . . . @ . . . . @ . @ . . . . @ . . @ . . . . . . . . . . . . . . . . . @ . @ . . . @ . . . @ @
@ . . . . @ @ . @ . . . . . . . @ . . . . . . . . . . @ . . . . . . . @ . . @ . . . . @ . @ . . . . . . @ @ . . . . . . @ . . . . . . . . . . . . . . . . . @ . . . . . . . . . . . . @ . . @ . @ . @ @
@ . . . . @ @ . . . . . . . . . . . @ . @ @ . . . . . . . @ . @ @ . . . . @ . . . . . . . . . . . . @ . . . . . . . . . . . . . . @ . . . . @ . . . @ @ . @ . . . . . . . . . . . . . . @ . . . . . @ @
@ . . . . . @ @ . . . . . @ . . . . . @ . . . . . . . . . . . @ . . . . . . . . @ . . . . . . . @ . . . . @ . @ . . . . @ @ . @ . . . . . @ . . . . . . . . . . . . . @ . . . @ . . @ . . . . . . . . @
@ @ @ . . . . . . . . @ . . . @ . @ . . . @ @ . @ . @ . . . . . @ . @ . . . . . . . . . @ . . . @ @ . @ . . . . . . @ . . . . . . . . . . @ . @ . . @ . . . . @ . . @ . . . . @ . . . @ @ . . . @ . . @
@ @ . . . . . @ . . . . @ @ . . @ . . . . . . . . . . @ . @ . . @ . . . . . . . @ . . . . . . . . @ . . . . . @ . @ @ . . . . . @ @ . . . . . @ . @ . . . . . . . . @ . @ . . . . . @ . . . . . @ . . @
@ . . @ . . @ . . . . . . . . . . . @ . . . @ @ @ . @ . . . . . @ . . . @ . . . . . @ . @ . @ . @ . . . . . . . . @ . . @ @ . . . . . . . . . @ . . . . . @ . @ . . @ . . . . . . @ . . . . . @ @ . . @
@ . . . . . . . . . @ . . . @ . . @ . . @ . . . @ . . . . . . . . . . . . . . . @ . . . . . @ @ . @ @ @ . @ . . . . . . . . . . . . . . . . . . @ . . . @ @ . . . . . . @ . . . . @ . @ . . . . . . . @
@ . . . . . . . . . . . . . @ . . . . . . . @ . . . . . . @ . . . @ @ . . . . . . . . . . . . @ @ . . . @ . @ . @ . . . . . . . . . @ . . . . @ . . . . . . . . @ . . . @ @ . . . . @ . . . . . . . . @
@ . . . . . . @ . @ . @ . . . . @ . . . . . . @ . . . @ @ . . @ . . . . . . . @ . @ . . . . . . . . . . . . . . . . @ @ . . . @ . . . . . . . . . @ . . . @ @ . . @ . . . . . . . . . . . . @ . . . . @
@ . . . . . @ . . . @ . . @ . . . . . . . . . . . . @ . @ . . . . @ . . . @ . . @ . @ . . @ @ . . . @ . . @ . @ . @ . . . @ . . . . . . . . . . . . . @ . . . . @ . . . . . . . . . . . @ . . . @ . . @
@ @ . . . . @ @ . . . . . . @ . . . . . @ . . . . . . . @ . . . . . . . . . . . . @ . . . . . . . . . . . . . . . . . . . . . @ . @ . . . @ . . . . . @ . @ . . . . . . . @ @ . . . . . . . . . @ . @ @
@ . . . . . . . @ . @ . . . . . . . @ . @ . . . . @ @ . . . . . @ . . . . @ . @ . . . . . . . . @ . . . . @ . . . @ . . @ . . . . . . @ . . . . @ . . . @ . . . @ @ . . . . @ . . . @ . . . @ . . . . @
@ . . . @ . . . . . . . . . . . @ . . . . . . . . . @ . @ . . . . . @ . . . . . @ . . . . @ . . . . . . . . . . . . . . . . . @ @ . @ . . . @ . . . . . @ . . . . @ . . . . . . . . . @ . . . . . . . @
@ . . @ . @ . . @ . . @ . . . . . @ . @ . . . . . @ . . . . @ . . @ . . . . . . . . . @ . . @ . @ @ @ . . . . . . . . . . . . . . . . @ . . @ . . . @ @ . . . . . . . . . . . . @ . . . . @ . @ . . . @
@ . @ . . . . . . . . . @ . . . @ . . @ . . . . . . . . . . . . . . . . . . @ @ . . . . . . . . @ @ . . . . . . @ . @ . . . . . @ . @ @ . . . . . . . . @ . . . . . . . . . . @ . . . . . . . @ . . . @
@ . . . . . . . @ . . . . . @ . . . . @ . . @ . . . . . . . . . . . . . . . . . . . . . . . . . . . . . . . . . . . . @ . . @ . . . . . @ . @ @ . . . . . . . @ . . @ . . . . . . @ . @ . . . . . . . @
@ @ . . . . . @ . . . . . @ . . . . . @ . . @ . . @ @ . . . @ . . . . . @ . . @ . . . . . . . . . . . . . . . @ @ . @ . @ . . . @ . @ . . . . . . . @ . . . . . @ . . . . . . . @ . . . . . . . . . . @
@ @ . . . @ . @ . . . @ . @ . . @ . . . . . . . . . . . . . . . . . . . . . @ . . . @ . @ . . . . . . @ . . . . . . @ . . . @ . . . . . . . @ . . . . . . . . . . . . . . . . . . . @ . . . @ . . . . @
@ . . . . . . . . . . @ . . . . . . . . . . @ @ @ @ . . @ . . . . @ . . . . . @ . @ . . @ . . . . . @ . . . . . . . . . . . . . . . . . . . . @ . . . @ . . . . . . . . . @ . @ . @ . . . . . . . @ . @
@ @ . @ @ . . . . . . . @ @ . . . @ @ @ . . . . @ . . . . . . . . . . @ @ . . . . . . @ . @ . . . @ . . @ . . . . . @ @ . @ . @ . . . . . . @ . . . . . . . . . . . . . . . . . . @ . @ . . . . . . . @
@ . . @ . . . . . . @ @ . . . . . . . . . @ . . . . . @ . @ . @ . . . . @ . @ . . @ . . . . @ . . . . . . . @ . . . . . @ . . . . . . . . . . . . . @ . . . @ . . @ . . . . @ . @ . @ . . . . . @ @ . @
@ . @ . . . . . . . . . . . . . @ . . . . . . . . . . . . . . . . . . . . . . . . . @ . . . . . . . . . . . . . . . @ . . . . . @ . . @ . . . @ . @ @ @ @ . . . . . . . . . . . @ . . . . . @ . . @ . @
@ . @ . . @ . . @ . . . . . . . . . . . . . . . . . . . . @ . . . @ . . . . . . @ @ . . . . . . . . . . . . . . . @ . . . . . . @ . @ . . . . . . . . . . . @ . @ @ . . @ @ . . . . . @ . . . . . . . @
@ . . . . . . @ . . . . . . . . . . @ . @ . . . . . . . @ . @ . . . @ . . . . @ . . . @ . . . . . @ @ . . . . . . . . . . @ . . . . . @ . . @ @ . . . . . . . . . . . . . . . . . . @ . . @ . . . . . @
@ . . . . . @ . . . @ @ . . . . . . @ . . @ . . . . . . @ . @ . @ . . . . . . . . . . @ . . . . @ . . @ @ . . . . @ . . . . . . @ . @ . @ . . . . @ . @ . . . . . . @ . . . . . . . @ . . . . . . @ . @
@ . . . . @ . . . . . @ @ . @ . . @ . . @ . . . . @ . . . @ . . . @ . . . . . . . . . . . . . . . . . . . . . . @ . @ . . @ @ . . . . @ . . . . . @ . @ . . . . . . . . . @ @ . . @ . . . . @ . @ . . @
@ . @ . . . @ . . @ . @ . . . . . . . . . @ @ . . . @ . . . . . . . . . . @ @ . @ @ . . . . @ @ . . @ . @ . . . . . . . . @ . @ . . . . . @ . . . . @ . . . . @ . . . . . . . . . . . @ . . . . . . . @
@ . . . . @ . . . @ . . @ . . . . . . . . . . @ . . @ . . . . . . . @ @ . @ . . . . . . . . @ . . . . . . . . . . . . . . @ . . . . . . . . . . . . . . . @ . @ . . @ . . . . @ . . . . . . . . . @ . @
@ . . @ . . . . . . . . . . . . . . @ . @ . . . . . . . @ . @ @ . . . . . . . . . . . @ . . . . . . . . . . . . . . . . . . . . . . . . . @ . @ . . . . @ . . . . @ @ @ . . @ . . . @ . @ . @ . . . . @
@ . . . . . . . . . . . @ . . . . . . . . @ @ . . . @ . . . . . . @ . @ . . @ . @ . . . . . @ . . . . . . @ . . . . . . . . . . . . @ . @ . . . @ @ @ . . . . . @ . . @ @ . . @ . . . @ . @ @ . . . . @
@ @ . . . @ . @ . . . . . . . @ . @ @ . . . . . . @ . . . . . @ . . . . @ . . . . . . . . . . @ . . . @ . . . @ . @ . . . . . @ . . . . . . . . @ @ . . . @ . . . . @ @ . . . . . . . . . . . @ . @ . @
@ . . @ . . . . . . . . . . . . . . . . . . . @ . . @ . . . @ . @ . . . . . . . . . . . . . @ . . . @ . . . . . . @ . @ . . . @ . . . . @ . . @ . . @ . . . . . . . . . . . . . . . . . @ @ . . . . . @
@ . . . @ . @ . . . @ . @ . @ . . . . . . . . . . @ . . . . . . . . . @ . @ . . . . . . . . . . . . . . . . . . @ . . . . . . . . . . . . . . . . @ . . . . @ . @ . @ . @ . . . . . @ . . @ @ . . . . @
@ @ . . . . . . . . . . @ . . . . . . @ . . . . . . . . @ . @ . . . . . . . @ . . . . . . . @ . @ . . . . . . . . . . . . . . @ . @ . . . . . . . @ . @ . @ . . @ . . . . . . @ . . . . . . . . . @ . @
@ . @ . . . @ . . @ @ . . . . . @ @ . . . . . . @ . @ . . . . . . . @ . . . @ @ . . . . @ . . . @ . @ . @ . . @ . . . . @ . . @ . . . . . . . . . . . . . . @ . . . . . . @ . @ . . . . . . . . . . . @
@ . . . . . . @ . . . . . @ . @ . . . . . . @ . . . . @ . . . . . . . @ . . . . . . . . . . . . . . . . @ . @ . . . . . @ . . . @ . . . . . @ . . . . . . @ . . . @ . . . . . @ . . . . @ . . . . . . @
@ . @ @ . @ . @ . . . . . . . @ . . . . . . . . @ . . . @ . . . . . @ . @ . . . . . . . . . . . @ . . . @ . . . . . . . . . . . @ . . . . . . . . . . . . . . @ . . . . . @ . . . @ @ @ . . . . . @ . @
@ @ . . . . @ . . . . . . . . @ . . . . . . . . . . . . . @ @ . . @ . . . @ . . . @ . @ . . @ . @ . . . . . . . . . @ . . . . . . . . . . . . . . . . . . @ . . . . . . . . @ . . . . . . . . @ . . @ @
@ . @ . . . . . . @ . . . . . . . . . . . @ . . @ . . @ . . . . . . . . @ . . . . . . . . @ . . . . . . . . @ . @ @ . @ . . . . . . . . . . . . . . . . . . . @ . . @ . @ . . . . @ . @ . . @ . @ . . @
@ . . . . . @ . . . . . . . @ . . . . . @ @ . . . . . . @ . . . . . . . . . @ . . . . . . @ . . . . . . . . . . . . . . @ . . . . @ @ . @ . @ . @ . . . . @ . . . . @ . @ . . . . . . . . @ . . . . . @
@ . . . . . . . @ . . . @ . . . . . @ @ @ . @ @ . @ . @ . . . . . . . @ . @ . . . @ . . . . . . . . @ @ . . . . . @ . @ . @ . . . . . . . . . . . . . . . . . . . . @ . @ . @ . . . . . @ . . @ . . . @
@ . . . @ . . @ . @ @ . . @ . . . . . . . . @ . . @ . @ . @ . . . . . @ . . . @ . . . . @ . @ . . . . . . . . . . @ @ . . . . @ . . . . @ . . @ . . . @ . @ . . . . . @ . . . . . . . . . @ . @ . . . @
@ . . . . . . . . . . @ . . . . @ . . . @ . . . . . @ . @ . @ @ . . . @ . . @ . . @ . . . . . . . . . . . . . . . . @ . @ . . . . @ . . . . . . @ . . . . . @ . . @ . . @ . . . @ . . . . . . . . . . @
@ . . . . . @ . . . . . @ . . . . . . . . . . . . @ . . . . . . . @ . . . . . . @ @ . . . . . . . . . . . . . . . @ . @ . . . . . . @ @ . . @ . . @ . . . . @ . . . . . . . . . . . @ . . . . . . . . @
@ . . . @ . . . . @ . @ . . . . . . . . . . . . . . . . @ . . . . . . . . . . . . . . . . . @ . . . @ . . . . @ . . @ . . . . . @ . . . . . . . . @ . . . . . . . . . . . . @ . . . @ . . . @ . . @ . @
@ . @ . . . . . . . . @ . @ . @ @ . . . @ . . @ @ @ . . @ . . . . . . @ @ . . . . . @ . . . . . . . @ @ . . . @ . @ @ . @ . . . . . . . . . . . . . . . . . @ . . @ . . @ . . . . . . . @ . . . . . . @
@ . . . . . @ . . @ . . . . @ . . @ . . @ . . . . . @ . . . . @ . . . @ . . . . . . @ . @ . . @ @ . . . . . . . . . . . . . @ . . . @ @ . . . . . . . . . . . . . . . . @ . . . . . @ . . . . . . . . @
@ . . . . . . . . . . @ . @ . . @ . . @ . @ . @ . . . @ @ @ . . . @ @ . . @ . . @ @ . . . . . . . . . . @ . . . . . @ . . . . . @ . . . @ . @ . . . @ . . . . . . . . . . . . . . . . . . . @ . . . @ @
@ . @ . . . . @ . . . . . . . . . . . . . @ . . . . @ . @ . . . . . . . . . . . . . . . . . . @ @ @ . . . . . . . @ . . . . . . . @ @ . . . . . . @ . . . . . @ @ . . . . . . . . . . . @ . . @ . . . @
@ . . . . . . . @ @ . . . . . . . . . . @ @ . . . . . . . . . . . . . . . . . . . . . @ . . . . @ . . . @ @ . . . . . . . . @ . @ . . . @ . . . . . @ . @ . . . . . . . . . . @ . . @ . . . . . . . . @
@ . . @ @ . . . . . . . . . . . . . . . @ . . @ . . . @ . . . . . . . . . . . . . . . . . . @ . @ . . . . @ . . . . . . . . . . . . . @ . . . . . . . . @ . @ . . @ . . . . . . . . . . . . @ . . @ @ @
@ . . @ . @ . . @ . . . . . . . . . . . . @ . . . @ . . . @ . . . . . . . . . . @ . . . . . . . . . @ . . . @ . . . @ . . . . . . . . . . @ . . . . @ @ @ . . . . . @ . . . . . @ . . . . . @ . . . . @
@ . . . . . . . . . @ . . @ . . . . . @ . @ @ @ . . . @ . . . . @ . @ . . . . @ . @ . . . . . . . . . . . . . @ . . . . @ . . . @ . . . @ . . . . @ . . @ . . . @ . . . . @ . . . @ . @ . . . . . @ . @
@ @ . . . @ . @ . . @ . . . . . . . @ . @ . . . @ . . . @ @ . . @ . @ . @ . . . . . . . . @ @ . . . . @ @ . @ . . @ . . @ . . . . @ . . . . . . . . . @ . . . . @ . . @ . . . . . . . . @ . . . . . . @
@ . . . @ . . . . . . . . . . @ . . @ . @ . . . . . . . . . . . . . . . @ . . @ . . . . . . . . . . . . @ . . . . . . . . . . . . @ . . . . . . . . . . @ @ . . . @ . . . . @ . . . . . . . . . . . . @
@ . . . . . @ @ . @ . . @ @ . . . . @ . . . . . . . . . . . . . @ @ . . . . . . . . . . . . . @ . . . @ . . . @ @ . . . @ . . . . . . . @ . . . . . . . . . @ @ . . . . . . . . . @ . . . . . @ . . . @
@ . @ . @ . . . . . @ . . . . . @ . . @ . . . . @ . . @ @ . . . . . . . . . . @ . . . . . . . . @ . @ . @ . . . . . . . . @ @ . . . . @ @ . . . . . . . . . . . . @ . . . . . . . . . . . . . @ . . . @
@ . . . . . . @ . . @ . . . . @ . . @ . . . . . . @ . . @ @ . . @ . . . . . . . . . . . . . @ . . . . . . . @ . . . . . . . @ . . . . . . . . . @ @ . . . . . . . . . . . . . . . . . . . . . . @ . . @
@ @ . . . @ . @ . . . . . . . . . . @ @ . . . . . . @ . . . . . . . @ . . . . . . . @ . . @ . . . @ . @ . @ @ . . . . . . . . . . @ @ . . @ . . . . . . . . . . . @ . . . @ @ @ . @ . . . . . . . . . @
@ . . . @ . @ @ @ . . @ . . . . . . . . . . @ @ . . . . @ . @ . . . . . . . . @ . . . . . . . . . . . . . . . @ . @ . . . . . . . . . . . . . . @ . @ . . . . . . @ . . . . . . . . . . . @ . . . @ . @
@ @ . @ . . . . . . . @ . . . @ @ . . . . @ . . . @ @ . @ . . . @ . . . . . . . . . . . . @ . . @ . . . . . . @ @ . . . . . . @ . . . . @ . . . . . @ . . @ @ . . @ . . . . . . . @ . . . . . @ . . . @
@ . . . . . . . @ @ . . . . . . @ . . . . . . . @ . . . . . . @ . @ . . . . . @ . @ . @ . . . . . . @ . . . . @ @ . . . . . . . . . . . . . . . @ . @ . . . . @ @ . . . @ . @ . @ . . . . . . . . . . @
@ . . . . . @ . @ . . . . @ . @ @ @ . . . . @ . . . . . . . . . . . . . . . . . . @ . . . @ . . . . . @ . . . . . . . . . . . . . @ . @ . @ . . . . @ . . . @ . @ . . @ . . @ . . . . @ @ . . @ . . @ @
@ . @ . @ . @ . . . . . . . . . @ . . @ @ . . . . . . . . . . . . . . @ . . @ . . . @ . . . . . . . . . . @ . . . . . . . . @ . . . @ . @ . . . @ . . . @ . . . . @ . @ . . . . . @ . . . . . . @ @ . @
@ . . . . . @ . @ @ . . @ . @ . . . . @ . . @ . @ . @ @ . @ . . . . . . . . . . . . . . . . . @ . . . @ . . . . . . . @ . . . . . . @ @ . . . . . . . . . . . . . . . . . . . . . . . . . . . . . . . @
@ . . @ . @ . . . . . . . . . @ . . . . . . . . . @ . . . . . . . . . . @ . @ . . . . . . . . . . . . . . . @ . . . . . @ . . . . . . . . . . @ @ . @ @ @ . . . . . . . . @ . @ . . . . . . @ . @ . . @
@ . . . . @ . . . . @ . . . . . . . . . @ @ . . . . . @ @ . . @ . . . . . . . . . . @ . . . . . @ . . . . . . . . . . . . . . . . . @ . . . . . . . . . . . @ . . . . . . . . @ @ @ . . @ . . . . . . @
@ . . . . . @ . . . @ . @ . . @ . . . . . @ . . . . . . . . . . . . . . . . . . @ . . . @ . . . . @ . . . . . . . . . @ . . . . . @ . . . . . @ . . @ . . . . . . @ . . . @ . . . . . . . . @ . . . . @
@ . . . . . . . @ . . . . . . . . @ @ . @ . . . @ . . @ . . @ . @ . . . @ . . . . @ . . . . . . @ . . @ @ @ . @ . . . @ . . . . . . @ @ . @ . . . . . . @ . . . . . . . @ . @ . . @ . . . . . @ . . . @
@ . @ . . . . . . . . . . . . . . . . . . . . . . . . . . @ . . . . . @ . @ . . @ . . . . @ . . . . . . . . . @ . . . . . . . . @ . @ . . . @ . . . . . . . . @ @ . . . . . . . @ . . @ . @ . . . @ . @
@ . . @ . @ . . . . . @ @ @ . @ . . . . . @ @ . . . . . . . . @ . . @ . . . . . @ . . . @ . . @ . . @ @ . . . . . . @ . @ . . . . . . @ @ . @ . . . . . . . . @ . . . . . . . . . . @ . @ . . . . . . @
@ . . @ . . @ . . . . . @ . . . @ . @ . @ . . . @ @ . @ . . . . @ . . @ . . . . @ . @ . . @ . @ . . . . . @ . . . . . . . @ . @ . . . . . . . . . . . . . . . . . . . . @ . . . . @ . @ . . . . . . @ @
@ . . . @ @ . @ . @ . @ . @ . . . . . . . . @ . @ . . . . . . . . . . . . . @ . . @ . . . . . . @ . . . @ . . @ . . . . . . . . . . . . . . . . @ . @ . . . . . . . . . . @ . @ @ . . @ . . . . @ @ . @
@ . . . . . . @ . . . . . @ . . . @ . @ . . . . . . . . . . . . . . . @ . . . . . . . . . @ . . . @ . . . . . . . . @ . . @ . . . . @ . . . . . @ . . . . @ . . @ . . . @ . . . . . . . . @ . . . . . @
@ . . . . . @ . . . @ . . . . . . . @ . . . . . . . . . . @ . @ @ . . @ . . . . . @ @ @ . . . . . @ . @ . . . . . . @ . . . @ . . @ . . . . . . . . . . . . @ . . @ . . . . . . . . @ . . . @ . . . . @
@ . . @ @ . . . . . . . . . . . @ . . . . . . . . . . . . . . . . . @ . @ . . . . . @ . @ . @ . . . . @ . . . @ . @ . . . . . . . @ . . . . . . . . @ . . . @ . . . . . . . . . . . . . . . . . . . . @
@ @ @ @ @ @ @ @ @ @ @ @ @ @ @ @ @ @ @ @ @ @ @ @ @ @ @ @ @ @ @ @ @ @ @ @ @ @ @ @ @ @ @ @ @ @ @ @ @ @ @ @ @ @ @ @ @ @ @ @ @ @ @ @ @ @ @ @ @ @ @ @ @ @ @ @ @ @ @ @ @ @ @ @ @ @ @ @ @ @ @ @ @ @ @ @ @ @ @ @
3
66 28 15 72
82 38 21 7
83 90 90 64
