50 50
@ @ @ @ @ @ @ @ @ @ @ @ @ @ @ @ @ @ @ @ @ @ @ @ @ @ @ @ @ @ @ @ @ @ @ @ @ @ @ @ @ @ @ @ @ @ @ @ @ @
@ . . . . . . . . . . . . @ . . . @ . @ . . . . . . . . . . . . . . . . . . . . . @ . . . . . . . @
@ . . @ . . . . . . . . . . @ . . . @ . . . . . . . @ . . . @ . . . . . . . . . . . @ . . . . @ . @
@ . . . . . . @ . . @ @ . . . @ @ . . . . . @ . . . . . . . . . . . @ . . . . . . @ . . . . . . . @
@ . @ @ . @ . @ . . . @ @ . . . . . . . . . @ . @ . . . . . . . . . . . . . . . @ . . . . . . @ . @
@ . . . . . . . . . . . . . . @ . . . . . . @ @ . . . . @ . @ @ . . @ . . @ . . . . . . . @ . . . @
@ . @ . . . . . . . @ . . . . @ . . . @ . . . . . . . @ . . . . . . . . . . . . . . . . . . . . . @
@ . . @ . @ . . . . @ @ . . . . . . @ . . . @ . @ . . . . . . . @ . @ . . . . . . . . . @ . . . @ @
@ @ . . . . . . . . . . . . . @ . . . . @ @ . . @ @ @ . . . . . . . . . . . @ . . . . @ . . . . . @
@ . . . @ . . @ @ . @ . @ . . . . . . . . @ . @ . . @ @ . . . @ @ . . . . . . . . . . . . @ @ . . @
@ . . . @ . @ . . . . . . . . . . . . @ @ . . @ . . @ . . . . . . . . . . . . . @ . . . . . . . . @
@ . . . . . . . . . @ . . . @ . . . . . . . . . @ . . . . @ . . . . . . . @ . . . . . . . . . @ . @
@ . . . . . . . . . . @ . . . @ . . . . @ . . . . . . . . . . . . @ . . @ . . . . . . . @ . . . @ @
@ . . @ @ . . . . . @ . . . . . . @ @ . . @ . . . . @ . . . . . . @ @ . . . . . . . . @ . @ . . . @
@ @ @ . . @ . . . . . . . . . . . @ . . . . . . . . . . . . . . . @ . . @ . . . . . . . @ . @ . . @
@ . @ . . @ . . . . @ . . . . . . . . . . . @ . . @ . . . @ . . . @ . @ . . @ . . . . . . . @ . . @
@ @ . . . . @ . @ . . @ . . . @ @ @ . @ . @ . @ . . . . . . . . @ . @ . . @ . . . . @ . @ . . . . @
@ . . . . . . . . . . . . @ . . . . . . @ . @ @ . . @ . . . @ . . . . . . @ . . . @ . . @ . . . . @
@ . . . . @ . . . . @ . . . @ . . . @ . . . . @ . . . . . @ . . . . . . . . . @ . . . . . . @ . . @
@ . . @ . . . . . . . . @ . . @ . @ . @ . . @ @ . @ . @ . . @ . @ . . . . @ . . . . . . . . . . @ @
@ . . . . . . @ . . . . . @ . @ . @ . . . . @ . . . . . @ . @ . . @ . . . . . . . @ . . . @ . . @ @
@ . . . . . . . . . . . @ . . . . . @ . . . . . . @ @ . . . . . . . . @ . . @ . . . . @ . . . . . @
@ . . . . . . . . . . . . @ . @ . . . . . . . . . . . @ . . . . . . . . . . . @ . . . . @ . . . . @
@ . . . . . . . @ @ . @ @ . . . . @ . @ . . . @ . . . @ . . . . @ @ . @ . . . @ . . . . . . @ . . @
@ . . @ . . @ . . . . . . . . . . . . . . . @ . . . . . @ . . . . . @ . . . @ . . . . . @ . . . . @
@ . . . . . . . @ . . @ . . . . . . @ . . @ . . @ . . . . @ . . . . . . . @ . . @ . . @ . @ @ . . @
@ . . . @ . . . . . . . . @ . @ . . . . @ @ . . . . . . . . @ . . . . @ . . . . . . @ @ @ . . . . @
@ . . @ . . . . . . @ . . . . . . @ . . . . . @ . . . . . . . . . . . . . . @ . . @ . @ . . . . . @
@ . . . . . . @ . @ . . . . . . . . . . . . . . . . . . . . . . . . . . . . . . . @ . . . . @ . @ @
@ . . . @ . . . . . . @ . . @ . . . . . . @ . @ . . @ . . . . . . . @ . @ . . . . . . . . . . . . @
@ @ . . . . . . . @ . . . @ @ . @ . . . . . . . @ . @ . . . . @ . . @ . . @ . @ . . . . @ . . @ @ @
@ . @ . . . . @ . . . @ . . . . . . @ @ @ . @ . . @ . . . @ . . . . . . . . . . . . . @ . . . . . @
@ . . . @ . . . . . . . . . . @ @ . . . . . . . . . . . . . . . . . @ . . . . . @ . . @ @ . . . . @
@ . @ . . @ . . . . . . . . @ . . @ . . @ . @ . . . @ @ @ . . @ . . . . . . . . . . . . . @ . @ . @
@ . . . . . @ . . . . . . . @ . @ . @ . . @ @ . . . . @ . . . . @ @ . . @ . . . @ @ . . @ . . . . @
@ . . . @ . . . . . . . . . . . . @ . . . . . . . . . . . . . . @ . @ @ . . @ . @ @ . . . @ . . . @
@ @ @ . . . . @ . . . . . . @ . . @ . . . . @ . . . . @ @ . . . . . . . . . . . . . . . . . . . @ @
@ . . @ . . . . . . . . . . . . . . @ . @ . . . @ . @ . . @ . . @ . . . . . . . . . @ . . . @ @ . @
@ . @ . . . . . . . . . . . . . . . . @ . @ . . . . . . . . . . . . . . . . @ . . . . . . . . . . @
@ . . . . @ . . . . . . . . . @ . . . . . . @ . @ . . . . . . @ @ . . . . . @ . . . . @ . . . . . @
@ . . @ . . @ . . @ . @ . . . . @ . . @ @ . . @ . . . @ . . . . . . . . . . . . @ . . @ @ . . . . @
@ @ . . . . . @ . . . . . . . @ . . . . @ . . @ @ . . . . . . . . . . . . . . . . . . @ . @ . . . @
@ . . . . . . . . . . . @ . . . . . . @ . . . . . . . . . @ . . . . . @ . . . @ . . @ . . . . @ . @
@ . @ . . . . . @ . . . . . . . . . @ @ . . . . @ . . . . . . . . . . . . . . . . . . . . . @ . @ @
@ @ . @ . . @ . . . . . . . . @ . . . @ . . . . . . . @ . . @ . @ . . . . . . . . . . . . . . . @ @
@ . . @ . @ . . @ . . . . . . @ . . . . @ . @ . @ . @ . . . @ . @ . . . . @ . . . . . . . . . . . @
@ . . . @ . . . @ @ . @ @ . . . @ . @ . . . . @ . . . . . @ . . . . @ . . @ . . . @ . . @ . . . . @
@ . . . @ . . . . . . . . @ . @ @ . . . . . . . . . . . . . . . . @ . . @ . @ @ . . . . . . . . . @
@ . . @ . . @ . . . . . @ . . . . . . . . . . . . . . . @ . . . . . . . . . . @ . . . . . . . . . @
@ @ @ @ @ @ @ @ @ @ @ @ @ @ @ @ @ @ @ @ @ @ @ @ @ @ @ @ @ @ @ @ @ @ @ @ @ @ @ @ @ @ @ @ @ @ @ @ @ @
3
25 7 2 22
41 44 33 19
20 39 30 28
