50 50
@ @ @ @ @ @ @ @ @ @ @ @ @ @ @ @ @ @ @ @ @ @ @ @ @ @ @ @ @ @ @ @ @ @ @ @ @ @ @ @ @ @ @ @ @ @ @ @ @ @
@ . . . . . . . . . . . . . @ . @ . . . . @ . . . . . @ . . . . @ . . . . . . . @ . . . . . @ . . @
@ @ . @ . . @ . . . @ . @ @ . @ . @ . @ . . . . . . . @ @ . . . . . @ . . . @ . . . . . . @ . . @ @
@ . . . @ . . . @ @ . . . . @ . . . @ . . . . . . @ . . . . . @ . . . . . @ . . . . . @ @ . . @ . @
@ . @ . . . @ . . . . @ @ . @ . @ . . . . . . . . . . @ . @ . . . . . @ . . . . . . . . @ . . . . @
@ . . . . . . . . . @ . . . . . . @ . . @ . . . . . . @ . . . . . @ . . @ . @ . . . . . @ @ . . . @
@ . . . @ . . . . . . . . . . @ . . . . @ . . . . @ . . @ . . . @ . @ . . . @ . @ . . @ . . . . . @
@ . @ @ . . . @ . . . . . . . . @ @ . . . . @ . . . @ . . . . . . . . . . . . . . @ . . . . . . . @
@ @ . . . . . . . . . . . . . @ @ . @ . . . . . . . . . @ . @ . . @ . . @ . . @ . . @ . . . @ @ . @
@ . @ . @ . . . @ . . . . . . . . . . . . . . @ . . . @ . . . . . . . . . @ @ . . . . @ . . . . . @
@ . . . . . . @ . . . . . . . . . . . . . . @ . . . . . . . . . . . . . . . . @ . . @ . . . . . . @
@ . . . . . . . . . @ . . . . @ . . . . . . @ . . @ . . . . . . . @ . . @ . . . . @ . . @ @ . . @ @
@ . . . @ . . . @ . . . . . . . . @ . . . @ . . . @ . @ @ . . . . . . . . . . . @ . . . . . @ @ . @
@ . . . @ . @ . . . . . @ . @ . . @ . . @ . . . . . . . . . . . . . . . @ . . @ . . @ . . . @ . . @
@ . . . . . . . . . . . . @ . . @ . . . . . . . . . @ . @ . . . . . @ . . . . . . @ . . @ . @ . . @
@ . . @ . . . . . . . . @ . @ @ . @ . . @ . . . . . . . . . @ . @ @ . . . . @ . @ @ @ @ . . . @ . @
@ . . . . . . . . . @ . . . . . . . . . . . . . . . . . @ @ . . . . . . . @ . . . . . . @ . . . . @
@ . . . . . . . . @ . . . @ @ @ . . . . . . . @ . . . . . . . @ . . . . @ . . . . . @ . . . @ . . @
@ . . @ . . . . @ @ . . . . . . . . @ . . . . . . . . @ . . . . . . @ . . . @ . . . @ . . . . . . @
@ . . . . . . @ . . @ . @ . @ . . @ . . . . . . . @ . . . @ . . . . . . . . . . . @ . . . . . . . @
@ . . . . . @ . . . . . . . . . . . . . . . . @ . . @ . . . . . . . @ . . . @ . @ . @ . . @ . . . @
@ . . . . . . . . . . . . . . . @ . . . . . . . . . . . . @ . . @ . . @ . . . . . . . . . . . . . @
@ . . . @ . . . . . . . . . . @ . . . @ . . . . . . @ . . @ . . . . @ . . . . . @ . . @ @ . . . . @
@ . . . . . . . . . @ @ . . . @ @ . . . . . . . . . @ . . . . . @ . . @ . . @ . . . . . @ . . . . @
@ . . . . @ . . . . . . . . @ . . . @ . . . . . . . . . . @ . . . . . . . @ . @ . . . . . . . . @ @
@ . @ . @ . @ . @ . . . . . . . . . @ . . . . . . @ . . @ . @ . . . @ . . @ . . @ @ . . . . . . . @
@ . . @ . . . . . . . . . . . . . . . . . @ . . . . . . . @ . . . . . . . . @ . @ . . @ . . . . . @
@ @ @ . . . @ . . . @ . . . @ . . . . . . . . . . . . . @ . . @ @ . . . . . . . . . . . . @ @ . . @
@ . . . @ . . . @ . @ . . @ . @ @ . . . . @ . . . @ . . @ . . . . . . . . . . @ @ . @ . . . . . @ @
@ . . . . . @ . . . . @ . . . . . . . . . . @ . . . . . . . . . @ . . . . . . . . . . . . . . . . @
@ . . . . . . . @ . . . . . . . @ . . . . . . . . @ @ . . . . @ . . @ . . . . . @ . . @ . . . @ . @
@ . . . . . . @ . . . @ . . @ . . . @ . @ . . . . . . . . . . . . . . . . @ @ . . . . . . @ . . @ @
@ . . . @ . @ . . @ . @ @ . . . . . . @ . . . @ . . . . . . . @ . . . . . . . . . . . . . . . . @ @
@ . . . . . . @ . @ . . . @ . . . . @ . @ . . . . . . . @ . . @ . . . . . . . . . . . . . . . . . @
@ . . . . . . . . @ . . . . . . . . . . . . . . . . . . @ @ . . @ . . . @ . . . . . . . . . . . . @
@ @ . . . . . . . . . . @ . . . @ @ @ . . . . . . . @ . . . . @ . . @ . . . . . . . . . . . . . @ @
@ . . . @ . . @ . @ . . @ . . . . . . . . @ . . . . . . . . . . . @ . . . . @ . @ . . . . . @ . . @
@ . @ . . @ @ @ . . @ . . . . . . . . . . . @ . . . . . . . . . . . . . . . . . . . . . @ @ . . . @
@ @ . . . @ @ . . . . . @ . . . . . . . . . . . . . . @ @ . . . @ . . . . . . @ . . @ @ . @ . . . @
@ . . . . . @ . . @ . . . . . . . . . . @ . @ . . @ . . . @ . . @ . @ . . . . . . @ . . @ . @ . @ @
@ . . . . . . . @ . . . . . . @ . @ . . . . . . . . . . . . . . @ @ . . @ . . . . . . . . @ . . . @
@ . . . @ . . @ . . . @ . @ . . . . @ . . . . . . @ @ . @ @ . @ . . . @ . . . . . . @ . . . . . . @
@ . . . @ . . . @ @ @ . . . . . . . . . @ @ . . . @ . . . . @ . . . . . . . . . . . . . . . . . . @
@ . . . . . . . . . . . . . @ . . . . . . . @ @ @ . . @ . . . . . . . . @ . . . . @ @ . . . . . . @
@ . @ @ . @ . . @ . . . . . . . . . . . . . . . . . . . . . . . . . . . . . . @ . @ @ . . @ . . . @
@ . . . . . . . . @ . @ . . . . . . . . @ . . . . . @ @ . . . @ . . . @ @ . . . . . . @ . . . . . @
@ . . . . . . . . . @ . . @ @ @ . . . @ . . . @ . . . . . . @ . . . . . . . @ . . . . . @ @ @ . @ @
@ @ . . . . . @ @ @ . . . . . @ . @ . . . . . . . . . . @ . . . @ . . . @ . . . . . . @ . @ . . . @
@ . . @ . @ . . . . @ . . . . . . @ . . @ . @ . . . . . . . . . . . . . . @ . @ @ . . . . . . . . @
@ @ @ @ @ @ @ @ @ @ @ @ @ @ @ @ @ @ @ @ @ @ @ @ @ @ @ @ @ @ @ @ @ @ @ @ @ @ @ @ @ @ @ @ @ @ @ @ @ @
3
1 34 13 10
30 9 47 3
7 42 9 47
