25 25
@ @ @ @ @ @ @ @ @ @ @ @ @ @ @ @ @ @ @ @ @ @ @ @ @
@ @ . . . . . @ . @ . . . . . @ . . . @ . . . . @
@ . . . . . . . . . . . . . . . . . . . . @ . . @
@ . . @ . . @ @ . . . . . . @ . @ . . . . @ . . @
@ . @ . . . . . . . . . @ . . . . . . . . . . . @
@ . . . . . @ . . . . . @ . . . . . . . @ . @ . @
@ . @ . @ . . . . . @ . . . @ . . . . . . . . . @
@ @ . . @ . . . . . @ . . . @ . @ . . . @ @ . . @
@ @ @ . . . . . . @ @ . @ . @ . . . @ . . . . @ @
@ . . . . . . . . . . . . @ . . . . . . . . . @ @
@ . . . . . . . @ @ . . . . . . . . . . . . @ . @
@ . . . . . @ @ . @ . @ . . . . @ . @ . @ . @ . @
@ . . @ . . . . . @ @ . . . . . . . . . @ . @ . @
@ @ . . @ . . . . . . @ . . . @ @ . . . . . . @ @
@ . . . @ . . @ @ . @ . @ @ . . . @ . . . . . . @
@ . . . . . @ . . . . @ . . . @ @ . . @ . . . . @
@ . . . @ . . . . . @ . @ . @ @ . . . . . . . . @
@ @ @ . . . @ . . . . . . . . . . . @ . . @ . . @
@ . . . . . @ . . . @ . . . . @ . . . . . . . . @
@ . . @ @ . . . . . . . @ . . . . . . . . . . . @
@ . . . @ @ . . . @ @ . . . . . . . . @ . . . . @
@ . . . . . . . @ . . . . . . . @ . . . . . @ . @
@ @ . . . . . . @ . . . . . . @ . . . . . . . . @
@ . . . . @ . . . @ . . . . . . . . . . @ . . . @
@ @ @ @ @ @ @ @ @ @ @ @ @ @ @ @ @ @ @ @ @ @ @ @ @
3
23 8 12 8
19 1 17 20
17 8 15 21
