12 12
@ @ @ @ @ @ @ @ @ @ @ @
@ . . . @ . . . . . . @
@ . . . . . . . . . . @
@ . . . . . . . . @ @ @
@ . @ . . . . . . . . @
@ . . . . . . . . . . @
@ . . . . . @ . . . . @
@ . . . . @ . . . . . @
@ . @ . . @ . . . @ . @
@ . . . . . @ . . . . @
@ . . . . . . @ . . . @
@ @ @ @ @ @ @ @ @ @ @ @
3
2 6 2 3
6 2 3 7
5 5 1 7
