100 100
@ @ @ @ @ @ @ @ @ @ @ @ @ @ @ @ @ @ @ @ @ @ @ @ @ @ @ @ @ @ @ @ @ @ @ @ @ @ @ @ @ @ @ @ @ @ @ @ @ @ @ @ @ @ @ @ @ @ @ @ @ @ @ @ @ @ @ @ @ @ @ @ @ @ @ @ @ @ @ @ @ @ @ @ @ @ @ @ @ @ @ @ @ @ @ @ @ @ @ @
@ . . . @ . . . . . . @ . . . . . . . . . . . . . @ . . . . . . . . . . @ . . . . . . . . . . . . @ . . . . @ . . . . . @ . . . . . . . . . . . . . . . . . @ . . . . . . . . . . @ . . . . . . . . @ @
@ . . . . . . @ . . . . . . @ . . . . . @ . . . . . @ . . . . . . . . @ . . . . . . . . @ . . . @ . . . . . . @ . . . @ . @ . . @ . . . . . . . . . . @ . . @ . . . @ . . . . . . . . @ . . . . . . . @
@ . . @ . . . @ . . . . . . . . . . . . . . @ . . . @ . . . . . . . . @ . @ @ . . . @ . . . . @ . . . @ . . . . @ . . . . . . . . . . . . . . . . . @ . . . . . . . . . . . . . . . . . @ . . . @ . . @
@ @ . . @ . . . . @ . . . @ . . . @ . . . . . @ . @ . . @ . . . . @ . . . . . . . @ @ . @ . . . . @ . . @ . @ . . . . . @ . . . . @ . . @ . @ . . . . . . . @ . @ . . @ . @ . . . . . . . . . @ . @ . @
@ . . . . @ . . . . . . . @ . @ . . @ . . . . . . . . . . . . @ . . . . . . . @ @ . . . . . . . . @ . . . . @ . . . . . . . . @ . . @ . . . . . . . . . @ . . . @ . @ . @ . . . . . . . . @ . . . . . @
@ . . . . . . . . . . @ . . . @ @ . . . . . . . . . @ . . . . . . . . . @ . . . . . . . . @ . . . . . @ . . . @ . @ . . . . @ . @ . . @ . @ . . @ . . . . . . . . . . @ . . . . @ . . @ . . . . . . . @
@ . . . . @ . . . . . . . . . . . . @ @ . . . . . . . . . . . . . . . @ . . . . @ . . . . . . . . . @ . . . . . . . . . . . @ . . . . . @ @ . . . . . . . @ . . @ . @ . . . . . . @ @ . @ . . . . . . @
@ . . . . . . . @ . . @ . . . . @ . @ . . . . @ . . @ . . . @ . . . @ . . . . @ . @ . . . @ . . . . @ . . . . . . @ . . . . . . @ . . . . . . @ . . . . . . @ . . . . . . @ . . . . . . . . @ . . @ . @
@ . @ . . @ . . . @ . . . . . . @ . . . @ . . . . . . . . . . . . . . . . . @ . . . . @ . . @ . . . . . @ . . . @ . @ . . . @ . @ . . . . . . . . . . @ . . . . . . . . . . . . . . . . . @ . @ . . @ @
@ . . . . . . . . . . @ . . . . . @ . . . @ @ . @ . . . . . . . . . @ . . @ @ . . @ . . . . . . . . . . . . . . . . @ . @ . . . . . . . . . . . . @ @ . . . . . @ . . . . . . . @ . . . @ . . . . . . @
@ . . . . . . . @ . . . . . . . . @ . . @ . . . . . . . . . . . . . . . @ . . . . @ . . . . . . . @ @ . . @ . . . . . @ . @ @ . @ . . @ . @ @ @ . . @ . . . . . . . @ . . . @ . . . . . . . . . . @ . @
@ . . . . . . @ . . @ . . . . @ . @ . . . . @ @ . . . . . . . . . . . . . . . . . @ @ @ . . . . . @ . . . . . . . . . . . . . . . . . . . @ . @ . . . @ . . . . . . . @ @ . . . . @ . . . . . @ . . . @
@ @ . . . . . . . . . . . . . . . . . @ . @ . . . . . . . @ . . @ . . @ . . . @ . . . @ . . . . . . . . . . . . . @ @ . @ . @ . @ . @ . . . . . @ . @ . . . . . . . . . . . . . . . @ . @ . @ . @ @ . @
@ . . @ . @ . @ . . . . . . . . . . . . . . . @ . . . . @ . . . . . . . @ . . @ . . . . @ . . . . . . . @ . @ . . @ . . . @ . . . . @ . . . . . . . . . . . . . . . @ . . . . . . . . . . @ . . . . @ @
@ . @ . . . . . . . . @ . . @ . . . . @ . . . . . . @ . . . . . . . @ . @ . . . . . @ . . @ @ @ . @ . . @ . . . @ . . . . . . . . @ . . . . . @ . . . . . . @ . @ . . . . @ @ . . . . . @ . @ . . . . @
@ . @ . . . . . . . . @ . . . @ . . . . . . . @ . @ . . . . . . . @ . @ @ . . @ . . . . . . . . . . . @ . @ . @ @ . . . . @ @ @ . . . . . @ . . . . @ . . @ . . . @ . . . . . . @ . . . . @ . . . . . @
@ . . . . . . . . . . . . @ . . @ . . . . . @ . . . . . . @ . . . . . . . . @ . . . @ . . @ . . . . . . . . @ . . . @ . . . . @ . @ . . . . . . @ . . . . . . . . . . . . . . . @ @ . . . . . . @ . . @
@ . . . @ . @ . . . . . @ . . . @ . @ . . @ . @ . . @ . . @ . . . . . . @ . . . @ . @ @ . . @ . . . @ . . . . . . . . . . . . @ @ . @ . . . . . . @ @ . . . . . . . . . . . . . . . . . @ @ . . . . . @
@ . . . @ . . . . . . . . . . . . . . . . . . . . . . . . . . . . @ @ . . @ @ @ . @ . @ . . . . . . . . . . . . . . . @ . . . . @ . . . . @ . @ . . . @ . . . . @ . . @ . . . . . . . @ @ . @ . . . . @
@ . @ . . . @ . . . . . . . @ . . @ . @ @ . . . . . . . . . . @ . . . . . . . . . . . . . . . . @ @ . . . . . . . @ . @ @ . . . . . . . . . . . . . . . @ . . . . @ . . . . . . @ @ . . . . @ . . . . @
@ . . . . . . . . . @ . . . . . . . . . . . . . . . . . @ . . . . . . . . @ @ . . . @ . . . . . . . . . @ . . . @ . . @ . . . . . . . @ . . . . . . . . . . . @ . . . . @ . . . . . @ . @ . . . . . . @
@ . . . . @ . . @ @ . . . @ . @ . . . @ . @ . @ . . @ @ . . . . . . . . . . @ . . @ @ . . . . . . . . . . . . . @ @ . . . . . . @ @ . . . . . . @ . . . . . . . . . . . . @ . . @ . . . . . @ . @ . . @
@ . @ @ . . @ @ . . . @ . . . . @ @ . . . . . . . . . . . . . . . . . . @ . . . . . @ . @ . @ . . . @ . . . . . . @ . . . . . . . . . . . . . . @ . @ . . . . . @ . . @ . . @ . @ . . . . . . . . @ . @
@ . . . . . . . . . . @ . . . . . . @ . . . . . . @ . . . . . @ . @ . . . . . . . . . . @ . . @ . . . . . . . . . @ . . . . . . . . . . @ . . . . . . @ . . . . @ . . . . @ . . . . @ . . . . . . . . @
@ . @ . @ . . @ . . @ @ @ . . . . @ . . . . . . . . . . @ . @ . . . . . . . @ . . @ @ . @ . . . . . @ . @ @ . . . . . . . . . . @ . @ . . . . @ . . . . @ . @ . . @ @ @ . . . . @ . . . . . @ . . . . @
@ . . . . . . . . . @ . . . . @ @ . . @ . . . . . . @ . . . . . . . . . . . @ . @ . @ . @ . . @ . @ @ . . . . . @ . . @ . . . . . . . . . . . . . . . . . . @ . . . . . . . @ . @ . @ @ . @ . . @ . . @
@ . . . . . . . . . @ . . . . . . @ @ . . . . . @ . . . . . . . @ . . . . @ . . . . @ @ . . @ . @ . . @ . . . . . . . . . @ . . . . . @ . . . @ . @ . . . . . @ @ . . . . . . . . . . @ . . . . @ . . @
@ . . . . @ . . . . @ . . . . . . . . @ . . . . . . . . . . . @ . . . . . . @ . . . . . . . @ . . . . . . . . . . . @ . . . . . . . . . @ @ . . . . @ . @ . . @ @ . @ @ @ . @ . @ . @ . . . . . @ . . @
@ . . . . . . @ . @ . . . . . . . @ . @ . . . . . . . . . . @ . . . . . . . . . . @ . @ . . . @ . . . . . . . . . . @ . . . . . @ @ . @ . . . . . . . @ . . . . . . @ @ @ @ . . @ . . . . @ . . @ . . @
@ . . @ . . . @ @ . . . . . . . @ . . . . . @ @ . . . . . . . . . . @ . . . @ . . . . . @ . . @ . . @ . . . @ . @ . . . . @ . . . . . @ . @ . . @ @ . . . . . @ . . @ . . . . . . . . . @ . . . . . . @
@ . . . . @ . . @ . . @ . @ @ @ . @ . . . . . . @ . @ . @ . . . @ . . @ . . . . @ . . . . @ . @ . . . @ . @ . . . . . . . . @ @ . @ . . . . @ . . . . @ . . @ . . . . @ . . . @ . . @ . . . . @ . . . @
@ . . . . . . . . @ @ . @ . . . . . . . . . . . . . . @ . . . . . . . . @ . . @ . . @ . . . . . . . . . . @ . . . . . . . . . @ . . . . . . . @ . . . . @ . . . . . . . . . . . . . . . . . . . . . . @
@ . . . @ . . . . . . . . . . . . . . @ . @ . . . . @ . . . . . . . . . . . . . @ . @ . . . . . . . . . . . . . . . @ . @ . . . . @ . . @ . . . @ @ . @ . @ . . . @ . . . . @ . . @ . . . @ . . @ . @ @
@ @ . . . . . . . . . . . . . . . . . . . . . . . . . . . . . . . . . . @ . . @ . . . . @ . . . @ @ . . . . . . . . . . . . . . . . @ . . . . . . . . . . . . . . . . @ . . . . . . . . . . . . . . . @
@ . @ . . . . . . . . . . . . . @ . . . . . @ . . @ . . @ . . . . . . . . @ . @ . @ @ @ . . . . @ . . . @ . . . @ . . . . . @ . . . . . . . . @ @ . . @ . . . @ . @ . . . . @ . . . . . . . . . . . . @
@ . @ . @ @ . . . @ @ @ . . @ . . @ . @ @ . . . . . . . . @ . . . . . @ . . . @ . . . . . . @ . . . . . . . . . . . . . @ . @ . @ . . . . @ . . @ . . . . . . . . . @ . @ . . . . @ . . @ . . . . . . @
@ . . . . . . . @ . . @ . @ . . . . . @ . @ . . . @ . . . . . . . . @ . . . . . . . . @ . @ . . . . . . . . . . . . . . . . . . . . . @ . . . . . . . . . . . . @ . . . . . @ @ . . . . @ . . @ . . . @
@ . . @ . . . . @ . . . . @ . . . . . . . . . . . . . . . . . . . . . . @ . @ . . . . . @ . . . . . . . . . @ . @ @ . . . . . @ . . . @ . @ . . @ . . . . . . . . . . . . . . . @ . . . . @ . . . . . @
@ . . . . . . . . . . . . . . . . . . @ . . . . . @ . . . . @ @ . . . . . . . . . . . . . . @ . . . . . @ . . . . . . . . @ . @ . . . . . . . @ . @ . @ . . . . . . . . @ . . . . . . . . . . . . . . @
@ . @ . @ . . . . @ . @ . @ . . . . . . . . . . . . @ @ . . . @ . . . . @ . . . . . . . . @ @ @ . . . . @ @ . . . @ . . . @ . . . . . . . @ . . . . . . . . @ @ . . @ @ . @ @ . . . . . . @ . . . . . @
@ . . . . . . . . . . . . . . @ . . . . @ . . . . . . . . . . . @ . . . . . . . . . . . . . . . . @ . . . @ . . . @ . . . . . . . @ . . . . . . . . . . . . . . . @ . . @ . . @ . @ . . . . . . . @ . @
@ . . . . . . @ . . . . . . @ . . @ . . . @ . . . . @ . . . . . . . . @ . . . . . . . . @ . . @ @ . @ . . . . @ . . . . . . @ . . . . @ @ . . . . @ . . . . . @ . . . . . @ . @ @ . @ @ . . . . . . @ @
@ . . . . . . . . . @ . . . . @ . . . @ . . . . . @ . . . . . . . @ . @ @ . . . . . . . . . . . @ . . . @ . . . . . . . . . . . . . . . . @ . . . . . . @ . . @ . . . . . . . . . . . . . . . @ . . . @
@ . . @ . . . . . . . . @ . . . . . . . @ @ @ . . . @ . . @ . . . . . . @ @ . . . @ . . . . . @ . @ . . . . . . @ . . . . . . . . @ . . . . . . . . @ . @ . . . . @ . . . . . . @ . @ . @ . . . . . . @
@ . . . . . . @ . . . . . . @ . @ . . . . . @ . . . . . . . . @ . . . . . . . . . . @ . . . . . . @ . . . @ . . . . . . @ . . @ . @ . . . . . . . . . . . . . . . . @ . @ . . . @ . . . . . . . . . @ @
@ . . . . . . . . . @ @ . . @ . . @ . @ . . . @ . @ . . @ . @ . . @ . . . . @ . . @ . . . @ . @ . . . . . . . . . . . . . . . . . . . . . . . . . . . . @ . . @ . . . @ . . . @ . . @ . . . . . @ . . @
@ . . . . . @ . . @ . . . . . @ @ . . . . . . . . . @ . . . @ . . . @ . . . . . . . . @ . . . . @ . . . . . . . . . @ . . . . . . . . . . @ . . . . @ . . . . . . . . . @ . . . . . . . . . @ . . . . @
@ . . . . . . . . . . . @ @ @ . . . . . . . . @ @ . . . @ . . @ . . . . . . . . . . . . . . . . . . . . . . . . . . @ . . . . . . . . . . . . @ . . . @ . . @ . . . . . . @ . . @ @ . . . . . . . . . @
@ . . . . @ . . . . . . @ . . . . . @ . . . . . . . . . . . @ . . . . . . . . . @ @ . @ . . . . . . . . @ @ . . . . . . . . . @ . . . . . . . . . @ @ . . . . . . . . @ @ @ . . . . . . . . @ . . @ . @
@ . . . . . . . @ . . . . . . . . . . . . @ . @ @ . @ . @ . . @ . . . . . . . . . . . . @ . @ . @ . . @ . . . . . . . . @ . . . . @ @ . . . @ @ . . . . . . . @ @ . @ . . . @ @ @ . . . . . . . . . . @
@ . . . . . @ . . . @ . . . . . . @ . . . . @ . . . @ . . @ @ @ . . . @ @ . @ . @ . . . . . . . . . . . . . . @ . . . . . . . . . . @ . @ . . . . . . @ . . . . . . @ . . . . . . @ . @ @ . @ . . @ . @
@ . . . @ . . . @ . @ . @ . . . . . . . . @ . . . . . . . . . . . @ @ . . . . @ . . . . . . . . . . . . . . . . @ . @ . . . . . @ . . . @ . . . @ . . . . . . . . . @ . . . . . . @ . @ . . . . . . @ @
@ . @ . . . . . . . @ . . . . . @ . . . . . . . . . . . @ . . . . . . . . . . @ . . . . . @ . . . . . . . . . . . @ . . . . . . . . . . . . . . @ . . . . @ . . . . . @ . . . . . . . . . @ . . . . @ @
@ . . . . . . . . . . . . . . @ . . . . . . . . . . . . . . @ . . . . . . @ @ . @ . . . @ . . . . . . . . . @ . . . . . . . . . . . . . . . . @ . . . . . . . . . @ . @ . @ . . . . . . . . . . @ . . @
@ . @ . . @ . @ @ . @ . . @ . . . . . . . @ . . . @ . . . . . . @ . . . . . . . @ . @ @ @ . . . . . . @ . . . . @ . @ . . . . . @ . . . . . @ . . @ @ . . . . @ . @ . . . . . . @ . . @ . . . . . . . @
@ . . @ . . . . @ . . @ . . . . @ . . . @ . @ . . @ . . . . . @ . . . . . . . . . . @ . . . . . . @ . . . . . . . . @ . . . . @ . @ . . . . . . . . . . . . @ . @ @ . @ . . . . . @ . . . @ . . . @ . @
@ . @ @ . . . . . . . . . . . . . @ @ @ @ . . @ . . . . . . @ . . . @ . . . . @ . . @ . . @ . . . . @ . . . @ @ . . . . . . . . . @ . . . . . . . . @ . @ . . . . . . @ . . @ @ . . . . @ . . @ . . . @
@ . . . . . . . @ . @ . . . . . @ . . . . @ @ . . @ . @ . . . . . @ . . . . @ . . . . . . . . @ . @ . . @ . @ . . . . . @ @ . . . @ . . . . . @ . . . . . @ . . . @ @ . @ @ . . @ . . . @ . . @ . . . @
@ . @ . . @ . . @ . . . . . . . . . . . . . . . . . . . . . @ . . . . . . @ . . . . . . . . . . . . @ . . . . @ . . . . . . . . @ . . . . . . . @ . . . . . . . @ . . @ . . . @ . @ . . . . . @ . . . @
@ @ . . @ . . @ . @ @ . . . . . . @ . . . . . . . . . . . @ . . . . . . . . . . @ . . . @ . . . @ . . @ . @ . @ . . @ . . . . . @ . . . . . . . . @ . . . . @ . . . . . . @ . . . @ . @ . . . . . . @ @
@ . . . . . . . . . . . . @ . . . . . . . . . . @ @ . . . . @ . . . . . . . . @ @ . . @ . . . . @ . . . . . @ @ @ . . . . . . . . . . @ . . . . . . . . . . . @ . . @ . . . . @ . . . . . . . @ . @ . @
@ . @ @ . . . @ . . . . . . . . . @ . . . . . . . @ . . @ . . . . . . . @ . @ . . @ . . @ @ . . . . . . . . . . @ . . . @ . . @ . . . . @ . @ . . . . . . . . @ . . . . . @ . . @ . . . . . . . . . . @
@ . . . . @ . . . . @ . . . @ . . . . . . . . . . . . . . @ @ @ . . . . . . . . . . . @ . . . . . . . @ . . . . . . @ . . . . . @ . . . . . @ . . . . . . . . . . . . . . . . . . . . . . . @ @ . . . @
@ @ . . . . . . . . . . . . . . . . . @ . . . . @ . . @ . . . . @ . . @ . . @ . . . . . . . . . . . . @ . . . . . . . . . . . . . . . . . . . . . . @ . . . @ . @ . @ . . . . . . . . . . @ . . . @ . @
@ . @ . @ @ @ . . . . . . . . . . @ @ . . . . @ . . . @ . . . @ . . . . . . . . . . . . @ . . @ . . . @ . . . @ . . @ . . . . @ . @ . @ . . . . . . . @ . @ . @ . . . @ . . . . . . . @ . . . . . . . @
@ . . . . . . @ @ . @ @ . . @ . . . . . . . . . . . . . . . . . . . . @ . @ @ . . @ . . . @ . . . @ . . . . . . @ . . . . . . . . . @ . . . . . . . . . @ . . . . . @ . . @ . . . @ @ . . . . . . . . @
@ . . . . . . . @ . . @ . . . . . @ . . . . @ . . . . @ . . @ @ . @ . . . . . @ . . . . . . . . . . . . . . . . . . @ . . . . . . @ . . @ @ . . . @ . . . . . . @ . . . @ . . @ . . @ . . @ . . . . . @
@ . @ . . . @ . . . . . . . . . . . @ . . @ . @ . . . . . . @ . . . . . . . . . @ . . . . . . . . @ . . @ . . . . . . . . . . @ . . . @ . . @ . . . . @ . . . . . . . @ . . @ . . . . @ . . . . . @ . @
@ . . . . @ . . . . . . . . . . . . . . . @ . @ . . . . . . @ . . . . . . . @ @ . . @ . @ . @ . . . . @ . @ . @ . . . @ . . . . . . . . . . . . @ . . @ . . . . . . . . . . . . . . . . . . . @ . . . @
@ . @ . . . . . . . . . . . @ . . . . . @ . . . . @ . . . . . @ . . . . . @ . @ . . . . . . . . . @ . . . . . . . . . @ . @ . . . . . . . . @ . . . . @ . . @ . @ . . @ @ . . . . . . . . @ . . . @ . @
@ . . @ . . . . @ @ . . @ . . @ . . . @ . . . . . @ . . . @ . . . . . . . . . . @ . . . . . . . . . . @ @ . . @ . . @ . . . . @ . . @ . . . @ . . . . . . . . . . . @ @ . . @ @ . . . . . . . . @ . @ @
@ . . . @ . @ . @ @ @ . . . . . . . . . . . . . @ . . . . . . . . . . . . . . . . . . . . . . . @ . . @ . . . . . . . . @ . . . . . . . . . . @ . . @ . . . . . . . . . . . . . . . . @ . . . . @ . . @
@ . @ . . @ . . . @ . . . . . @ . . . . . . . . . . . @ @ . . . . . . . @ . . . . . . . . . . . . . @ . . . @ . . @ . . . . . . . . . . . . @ . . . . . . . @ . . . . . . . . . . @ . . @ . @ . . . . @
@ . . @ . . . . . . . @ . . @ . . . @ . . . @ . @ . . . . . @ @ . . . . . . . . @ . . . . @ . . . @ . . . . . . . . . @ . @ . . . . . . . . . . . . . @ . . @ . . . . . . . . . @ . . . . . . . . . @ @
@ . . . . @ . . . . . . . . . . . @ @ . . . . @ @ . . . . . @ @ . . . . . . . . . @ . . . . . . @ . @ . . . . . . . . . @ . . . . . . @ . . . @ . . . . . . @ . . . @ . . . . . @ . . . . . . . . . . @
@ @ . . . . . . . . @ @ . . . . . @ . @ . . @ . . . . @ . . . . . . . @ . . . . @ . . . . . . . . . . . . . . . . . . @ . . @ . . . . . @ . @ . . . . . . . @ . @ . . . @ . . . . . . . . . . . . . . @
@ . @ . . . . . . . . . @ . . . @ . . . . . @ @ . . @ @ . @ @ . . . . . . @ . . . . . . . @ . . @ . . . . . . . . . . @ @ . . @ . . . . @ @ . @ . . @ . . . . . . . . . . . . @ . . . @ @ @ . @ . . . @
@ . . @ . . . . . . . . . . . . . . . . . . . . @ . . . . . . . . . . . . . . . . . . . @ . . . . . . . @ . . . @ . @ @ . . . . . . . . . . . . . . . . . . . . @ @ . . . @ . . . . . . . . . . . . . @
@ . . . . . . . @ . . @ . @ . . . . . . . @ . . . @ @ . . . . . . . . . @ . @ . . . . . . . . . @ . . @ . . . @ . . . . @ . . . . @ @ . . . @ . . . . @ @ . . . @ . . . . @ @ . @ @ . . . . . . . . . @
@ . . . . . . . . . . . . . . . . . . . . . @ . . . . . . . . . . . . . @ @ . @ . @ @ . . . . . . @ . . . . . . . @ . . . . @ . . . @ . @ . @ . . . . . . . . . . . @ @ . . . . . . @ . . . . . . . . @
@ . . . . . . . . @ . . . . . . . . . . . . . @ . . . . . . . . . . . . . . @ . @ . @ @ . @ . . . . @ . . @ . @ . . . . . . . . . . . . . @ . @ . . . . . . . @ . @ . @ . @ . . . . . . . @ @ . . . . @
@ . . . . . . . . @ . . . @ @ . . . . . . . . @ @ . . . @ . . . . @ . @ . . . @ @ . . . . . . . @ @ . . . @ . . @ . . . . . . . . . @ . . . . @ . @ . @ . @ . . @ . . . . @ . @ . . . . @ . . @ . . . @
@ . . . . . . @ . . . . . . . . . . . . . . . . . . @ . . . . @ . . @ . @ . . . . . @ . . . . . . . . @ . . @ . . . @ . . . . . . @ . @ . . @ . . . . @ . . @ . . . @ . . . @ . . . . . . . . . . . . @
@ . . @ . . . . . . . . @ . . . . . . . . . . . . . . . @ . . . . . . . . . . @ . . @ . @ . . . @ . . . . . . . . . . . @ . . . . . . . . . . @ @ . . . . . . . . . . . . . . . . . @ . @ . @ . . . . @
@ @ . . . . . @ . . @ . . . . @ @ . . @ . . . . @ . . . . . . . . . @ . . . . . . . @ . . @ . @ . @ . . . . . . . @ . . . . . . @ @ . . . @ @ . . . . . . @ @ . . . . . . . . @ . . . . . @ . @ . . . @
@ . . . . . . . . . . . . . . . . @ . . . . . . . @ . . . . . . . . . . . . @ @ . @ . . . . . . . . . . . . . . . . @ . . . . . @ . . . . . . . @ . . . . . @ . . . . . @ . . . . . . @ . @ . . . . . @
@ . . . . . @ . . . . . . . . @ . @ . . . . . . . @ . . . . . . . . . . . . @ . . . . . @ . . . . . @ . . . . . . . . . . . . @ @ . . . . . . . . . @ . . . @ . . @ . . . . . . . . . @ . . @ . . . . @
@ . . . . . . @ . . @ . . . . . . . . . . @ @ . . . . . @ . . . @ . . . . . . . . @ @ . . @ . . . . . . . . @ . . . . @ . . . . . . . @ . @ . . . . . . @ . @ . . . @ . @ . . . . @ . . . . . . . @ . @
@ . . . . . . . . . @ . . @ @ @ . . . . . . . . . @ . . . @ . . . . . . @ . . . . @ . @ . . @ . @ . . @ . . @ . . . . . . @ . . . . . . . . . . . . . . . . . . . . . . . . @ . . . . . . . @ . . @ . @
@ @ . @ . . . @ . . . . . . @ . . . . . . . . . . . . . . . . . . . @ . . . . @ . . @ . . . . . . . @ . . @ . . . . . . . . . . . . . . . @ @ . . . . . @ . @ . @ . . @ . . . @ @ . . . . . . . . . . @
@ . @ . . . . @ . @ @ @ . . . . . . . . . @ . . . . . . . . . . . . . . . . . @ . @ . . . . . . . . . . . . . . . . . . . . . . . . . . . @ . . . . . . . . . . . . . . . @ . . @ @ . . . . . . . . . @
@ . @ . . @ . @ . . . . @ . . . . . @ . . @ . . . @ . . . @ . . . . . @ . . . . . @ @ . . . @ . . . @ . . . . . . . @ . . . @ . . . . . . @ . . . . @ . . . @ . . . . . . . . . . @ . . . . @ . . . . @
@ . . . . @ . . . . @ @ @ . . . . . . . . . @ . @ . . . . . . . . . . . . . . . . . . @ . . . . . . . . . . @ . @ . @ . . . . . @ . . . . . . . . . . . . . . . . @ . . . . . @ . . @ . . @ . . . @ . @
@ . . . . . . @ . @ . . . . @ . . . . . . . . @ . . . . @ . @ . . . . @ . . . . . . @ . . . . . . . . . . . . . . . . . . . . . . @ . . . . . . @ . @ . . . . . . . . @ @ . @ . . . . . . . . . . @ . @
@ . . . . . . . . @ . @ @ . . @ @ . . . @ . . . @ . . . . . . . . . . . . . . . @ . . . . . @ . . . . . . . . @ . . . . . . . . . . . @ @ @ . . @ . @ . . . . @ . . . . . . . . . . . . . @ . . . . . @
@ . . . . . . . . . @ . . . . . @ @ @ . . . @ . . @ . . . . . . . @ @ . . . . @ . @ @ . . @ . . @ . . . @ . . . . . @ @ . . . . . . . . . . . . . . . . . . @ . . @ . . @ . . . . . . . . . . . . . . @
@ . . . . . . @ . . . @ . . . . @ . . . . . . . . . . . . . . . . . . . @ . . . @ . . . . . . . . . . . . . . @ . . . @ . . . . . . . . @ . . . . . . . . . . . . . . . . @ . . . . . @ . . . . . @ . @
@ . . . . . . . . . . . . . . . . . . . . . . @ . . . . . @ . . . . . @ . @ . . @ @ . . . . @ . . . . @ . @ . . . . @ . @ . . . @ . . . . . . . . . . . . . . . @ . . . . . . . @ . . . . . . . . . . @
@ @ @ @ @ @ @ @ @ @ @ @ @ @ @ @ @ @ @ @ @ @ @ @ @ @ @ @ @ @ @ @ @ @ @ @ @ @ @ @ @ @ @ @ @ @ @ @ @ @ @ @ @ @ @ @ @ @ @ @ @ @ @ @ @ @ @ @ @ @ @ @ @ @ @ @ @ @ @ @ @ @ @ @ @ @ @ @ @ @ @ @ @ @ @ @ @ @ @ @
3
94 95 72 65
32 7 54 73
38 40 14 40
