50 50
@ @ @ @ @ @ @ @ @ @ @ @ @ @ @ @ @ @ @ @ @ @ @ @ @ @ @ @ @ @ @ @ @ @ @ @ @ @ @ @ @ @ @ @ @ @ @ @ @ @
@ . . . . . . . . . . . . . . @ . . . . . @ . . . . . . . @ . . . . . . . . . . . . . . . . . . . @
@ . @ . . . . . . @ @ . . . . . . . . . @ . @ . . . . . . . @ @ @ . . . . . . . . . . . @ . . @ . @
@ . @ . . . . . @ . . . . . . . . . . @ . @ . . . . @ @ . @ . @ @ @ . . . . . . . . @ . . . . . . @
@ . . . @ . . . @ . . . . @ . @ . @ . . . . . . . . . . . . . @ . . . . . . . @ . @ . @ . . . . . @
@ @ . . @ . . . . . @ . . . @ . . @ . . . @ @ @ @ . @ . . @ . . . @ . @ . . . . . . . . . . . @ . @
@ @ . . . . @ @ . . . . . . @ . . . . . . . @ . . . . . @ . @ @ . . @ . . . . . . . . . @ . . . . @
@ . . . @ @ . . . @ . . @ @ . . . . . . . @ . . . @ . . . @ . . . @ . . . @ . . . @ . . . . . @ . @
@ . . @ . . . . @ . . @ . . . . . . . . . . . . . . . . . . @ . @ . . @ @ @ . . . . @ . . @ @ . . @
@ . . @ @ . . . . . . . . . . @ . . . . . . . . . . . . . @ . . . . . . . . . . . . @ . . . @ . . @
@ . . . . . . . @ . . @ @ . . . . . . @ @ . . . . . . . . . . @ . . . @ . . . . . . . . @ . . . . @
@ . @ . . . . . . . . @ . @ @ . . @ . . . . . . . . @ @ . . . . . . . @ . @ . . . . . @ . . . . @ @
@ @ . . . . . . . . . . . @ . @ . . @ . . . . . . . . . @ . . . . . . . . . . . . @ . . . . @ . . @
@ . . . . . . . . . . . . . . . . . . . . . . . . . . . . . . @ @ . . . . . . . . . . . . . . . . @
@ . . @ . . @ @ . . . @ . . . . . . . . @ . . . . . . . . @ . @ . . . . @ . @ @ . @ @ . . @ . @ . @
@ . . . @ . . . . . . . . . . . . . . . @ . . @ . . . . . . . . . . . @ . @ . . . @ . . . . . . . @
@ . . . @ . . @ . . . . . @ . @ . . . . . . . . @ . @ . . . . . . @ . . . . . . . . . . @ @ . . . @
@ . . . . @ . . . . . . . @ . . . . @ . . . . . . @ . . @ . . . . . . . . . . . @ . . . . . . . . @
@ . @ . . . . . . . . . @ . . @ . . . . . . @ @ @ . . @ . . @ . . . . . @ . . . . . . . @ . . . . @
@ . . . . . . . . . @ . . . . . . . . . . . . @ . . . . . . . @ . . . . @ @ @ . . . . . . . @ @ @ @
@ . . . . @ . . . . . . . @ . @ . . @ . . . . . . . . . . . . @ . @ . . @ . @ . . . @ @ . . @ @ . @
@ . . . . . . @ . . . . . . . . . . . . . @ . . . . . . @ . . @ . . . . . @ . . . . . @ . . . . . @
@ . . @ . @ @ . . . . . . . . . . . @ . . . . . @ . . . . . . . . @ @ . . . . . . . . . . . . . . @
@ . . . . . . . . . . . . . . . . @ . @ . . . @ @ . . @ . . . . . . . . @ . . . . . . @ @ @ . . . @
@ . @ . . @ . . . . . . . @ . . @ . . . . @ . . . . @ @ . . . . . . . . . . @ @ . . . . @ . . . . @
@ . . . . . @ . @ . . @ . . . @ . . . . . . . . . . . @ . . . . @ @ . . . @ . @ @ . . @ . . @ . . @
@ . . . . . . . . . . @ . @ . . . @ . . . @ . . . . . . . @ . @ . . . . . . . . . . . @ @ . . @ . @
@ . . . . . . . . @ . . . . . . . . . . . . . . . . . . . . . . . . . . . . . . . @ . . . . . . . @
@ . . . @ . . . . . . . . @ . . @ @ . . . @ . @ . . . @ . @ . . . . . . . . . . . . . @ @ . @ . . @
@ . @ . . . . @ . . @ . . . . . . . . . . . @ @ . . . @ . @ . @ . . . @ @ . . @ . . . . . . . . . @
@ . . . . . @ . . @ . . @ . . . . . @ @ . @ . . . . . . . . . . . . . . . @ . . @ . @ . . @ . . . @
@ . . . . . . . . . . . . . . . @ . . . . . @ . . . . . . @ . . . . @ . . . . . @ @ . . @ . . . @ @
@ . . . . . . . . . . . . . . . . @ . . . @ . . @ . . . . @ @ . . . . . . @ . . . . . . . . . . . @
@ . . @ . . . . @ . . . . . . . . . . . . . . . . . @ @ . . . . . . . . . . . . @ . . @ . . @ @ . @
@ . . . . . . . . . . . . . @ . . . @ . @ . . @ . . . @ . @ . @ . . . . . . . @ @ . . . . . . . . @
@ . . . . . @ . . . . . @ . @ . . @ . . @ . . . . @ . . . @ . . . . . . . . . . . @ . . . . . . . @
@ @ . @ . . . . . . @ @ . . . . . . . @ @ . . . @ . . @ . . . . . . . . . . @ @ @ @ . . . . . @ . @
@ . @ . . . @ . . @ . . . . . @ . . . . . . . . . . @ . . . . . . . . @ @ . . . . . @ . . . @ . . @
@ . . @ . . @ . . . . . @ . . @ . @ . . . . . @ . . . . . . . . @ . . . . . @ . . . . . . . . . @ @
@ . . . . . @ . . @ . . @ . . . . . . @ . . . . . . . @ . @ . . . . @ . . @ . @ . . . . @ . . @ . @
@ . @ . . . . . . . . . . . . @ . . . . . @ . . . . @ . . . . . . . . . @ . . . @ . . . . . . . . @
@ . . @ . . . . . . . . . . . . . . . @ . @ . . @ . . . . . @ . . . . . . . . . . . . . @ . . @ . @
@ . . . @ . . . . @ . . @ . . . . @ @ . @ . . . @ . . . . . . . . . . . . . . . . @ . @ . . . . . @
@ . . @ . . . . @ . . . . . . . @ . . @ . . @ @ . @ . . . . . . . . . @ . . . . . . . . . @ . . . @
@ @ . @ @ . @ @ . . . . . . . . . . @ @ . . . . . . @ . . . . . . . . . . . . . . . @ . . . . . . @
@ . . . . . @ . . @ . . . . @ . . @ . @ . @ . . . . . . @ . . . @ . . . . . . . . . . . . . @ . . @
@ . . . . . . . . . . . . . . . . . @ . . . @ @ . . . @ @ . . . . . . . . . @ . @ . . @ . . . . . @
@ . @ @ . @ . . . @ . . . . . . @ . @ . @ . . @ @ . . . . @ @ . . . @ . @ @ . . . . . . . . . . . @
@ . . . . . . . . . . . . @ . . . . . . . . . . . . . . . . . @ . . . . . . . . . @ . . @ . . . . @
@ @ @ @ @ @ @ @ @ @ @ @ @ @ @ @ @ @ @ @ @ @ @ @ @ @ @ @ @ @ @ @ @ @ @ @ @ @ @ @ @ @ @ @ @ @ @ @ @ @
3
12 39 24 18
2 41 26 26
34 28 38 47
