25 25
@ @ @ @ @ @ @ @ @ @ @ @ @ @ @ @ @ @ @ @ @ @ @ @ @
@ . . . . . . . . . . . . . . . . . . . . @ . . @
@ . @ . . . . . @ . . . @ . . . . . . . . . . . @
@ . . . . @ . @ . . @ . . @ . . @ . . @ . . . @ @
@ @ . . . . . . . . . . . @ . @ . . . . . . . . @
@ . @ @ . . . . . . . . . . . . . . . . . @ . . @
@ . . . . . . @ . . . . . @ . . . . . @ . . @ . @
@ . . @ . . . . . . . . . @ . . . . @ . . . . . @
@ . . . . . . . . . . . . . . . . . . . . . @ . @
@ . . . . . . . . . . . . . . . . . . . . . . . @
@ . . . @ . . . . @ . . @ . . @ . . . . . . . @ @
@ @ . . . @ . . . . . . . . . . . . . . . . . . @
@ . @ @ . . . . . . . . . . . . . @ @ @ . . @ . @
@ . . @ . @ @ . . @ . . . . . @ . . @ . . @ . @ @
@ . . . . . . . . . . . @ . . @ . . . . . . . @ @
@ . @ . . . . . . . . . . . . . . . . . . @ . . @
@ . . . @ . . @ . @ . @ @ . . @ @ . @ . . . . @ @
@ . . . . @ @ . . @ . . . . . @ . . . @ . @ . . @
@ @ . . . . . . @ . . @ @ @ . . . . . . . . . . @
@ . . . . . . . . . . @ . . . . . @ . @ @ . . . @
@ . . . @ . @ . . @ . . . @ . . . . . . . . . @ @
@ . @ . . @ @ . . . . . . . . @ . . . . . . . . @
@ @ . @ . . . @ . . . . . . . @ . @ . . . . . . @
@ . . . . . . . . . . . . . . . . . . . . . . . @
@ @ @ @ @ @ @ @ @ @ @ @ @ @ @ @ @ @ @ @ @ @ @ @ @
3
18 10 8 13
7 22 5 7
17 2 9 5
