12 12
@ @ @ @ @ @ @ @ @ @ @ @
@ . . . . . . . . . . @
@ . . . . . . . @ . . @
@ . @ . . . . . @ . . @
@ . @ . . @ . . . . . @
@ . . . . . . . @ . . @
@ . . . . @ . . . . . @
@ . . @ @ @ . . . . . @
@ . . . . . . . . . . @
@ @ . . . . @ . . . . @
@ . . . . . . . . . . @
@ @ @ @ @ @ @ @ @ @ @ @
3
2 10 9 5
2 7 6 3
1 8 10 1
