12 12
@ @ @ @ @ @ @ @ @ @ @ @
@ . . . . . . @ . . . @
@ . . @ @ @ @ . . @ . @
@ . . . . . @ . . @ . @
@ @ . @ . @ . . . . . @
@ . . . . @ . . . @ . @
@ . . @ @ . . . . . . @
@ . @ . . . . . . . . @
@ . @ @ @ . @ . . . @ @
@ . . . . . . @ . . . @
@ . . . . . . . . . . @
@ @ @ @ @ @ @ @ @ @ @ @
3
4 9 5 6
2 8 7 4
3 5 9 9
