12 12
@ @ @ @ @ @ @ @ @ @ @ @
@ . . . . . @ . . . . @
@ . . @ . . . @ . . @ @
@ @ . . . @ @ . . . . @
@ . . . . . . . . @ . @
@ . @ . . @ @ @ . . . @
@ @ . . @ . . @ . . . @
@ . . @ . @ . . . . . @
@ . . . . . . . . . . @
@ . . . . . @ @ . . . @
@ . . @ . @ . . . . . @
@ @ @ @ @ @ @ @ @ @ @ @
3
2 8 5 8
6 9 10 8
7 9 2 5
