25 25
@ @ @ @ @ @ @ @ @ @ @ @ @ @ @ @ @ @ @ @ @ @ @ @ @
@ @ . . . . . @ . . . . . @ . . . @ . . . . . . @
@ @ . . . . . . . . . . . . . . . @ . @ . . . . @
@ . . . . . . @ . . . . . . . . @ . . . . @ . . @
@ . . . @ . . @ . . @ . . @ . @ . . @ . . . @ @ @
@ . . @ . . . @ @ . . . . . @ . . . . @ . . . . @
@ @ @ . . . . . . @ . . . . . . @ . . . @ . . . @
@ . @ . . . . . @ @ . @ . . . . . . . . . @ . . @
@ . . . . @ . . . . . . . . . . . . @ @ . . . . @
@ . @ . . . . . . . @ . . . @ . @ . . . . . @ . @
@ . . @ . . . . . . @ @ . . . . . . @ . . . . . @
@ . . . . . . . @ . @ . . . . . . @ . . . . . . @
@ . . . . . . @ . @ . . @ . . . . . . . . . . . @
@ @ @ @ . . . . . . . . . . @ . . . @ . . . . . @
@ . . . @ . @ @ . . . . . . . . @ . . . . @ . . @
@ . . @ . . . . . . . . . . . . . @ . . . . . @ @
@ @ . . . . . @ . . . . . . . . @ . @ . . . . . @
@ . . . @ @ . . . . . . . . @ . . @ . . . @ @ @ @
@ . . . . . . . . . . @ . . . . . . . . @ . . . @
@ . . . . . . . . . . . . @ @ . . . . . . . . . @
@ . @ . . . @ . @ . . . . . . . . . . @ @ . . . @
@ . @ . @ . . . . . . . . . . . @ . . . . . . . @
@ . . . . . . . . . . . . @ . @ . . . . . . . . @
@ . . . . . . . . . . . . . . . . . . . . . . . @
@ @ @ @ @ @ @ @ @ @ @ @ @ @ @ @ @ @ @ @ @ @ @ @ @
3
15 2 5 15
2 15 3 14
7 4 13 7
