12 12
@ @ @ @ @ @ @ @ @ @ @ @
@ . . . . . . @ . @ . @
@ . . . @ @ . . . . . @
@ . . . . . . . . @ . @
@ . . . @ . . . . . . @
@ . . @ @ . . . . . . @
@ . @ . . . . . @ . . @
@ . . . . . @ . . . . @
@ . . . . . . . . . . @
@ . @ . @ . . . . @ . @
@ @ . . . . . . . . . @
@ @ @ @ @ @ @ @ @ @ @ @
3
6 9 2 9
7 7 3 1
8 5 4 3
