25 25
@ @ @ @ @ @ @ @ @ @ @ @ @ @ @ @ @ @ @ @ @ @ @ @ @
@ . . . . . . . . . . . . . @ . . . . . @ . . . @
@ . . . . . . . . . . . . @ . . . @ . . . . . . @
@ @ @ . . . @ . . . . . . @ . . . . @ @ . . . . @
@ . . . . . . . . @ . . . . . . . . . . . . . . @
@ . @ @ . . . . . @ . . . @ . . . . . . @ . . . @
@ . . . . . . . . . . . @ . . . @ . . . . . . . @
@ . . @ . . . . @ . . . . @ . . . @ . . . . . . @
@ . @ . . . . . . . . @ . . @ . . . . . . @ @ . @
@ . . . . @ . . @ . . . . @ . @ . . . . . . . . @
@ . . . . . . . . . . . @ . . . . . . . . . . . @
@ . . @ . @ . . . @ @ . . . @ . . . . . @ . . @ @
@ @ . . . . . . . . . . . @ . . . @ . @ . . . . @
@ . . . @ . . . . . . . . . @ @ . . . . . . . . @
@ . . . @ . . . . . . . . . . . . . @ . @ . . . @
@ . . @ . . @ . . . . . @ . . . @ . . @ . . . . @
@ . . . . . . . . . . . . . . . . . . . . . . . @
@ . . . . . @ . @ . . . . . . . . . . . . @ . . @
@ @ . @ . @ . . . . . . . @ . . . . . . @ . . . @
@ . . . . . @ . . . . . . . . @ . @ . . . . . . @
@ . . . . . @ . . . @ . . @ . . . . . @ @ . . . @
@ . . . . . @ . . . . . . . . . . . . . . . . . @
@ . . . @ . . . . . . . . @ @ . @ . . . @ . . . @
@ . @ . @ . . . @ . . . . . . @ . . . @ . . . . @
@ @ @ @ @ @ @ @ @ @ @ @ @ @ @ @ @ @ @ @ @ @ @ @ @
3
3 22 15 15
6 4 19 11
16 11 6 18
