50 50
@ @ @ @ @ @ @ @ @ @ @ @ @ @ @ @ @ @ @ @ @ @ @ @ @ @ @ @ @ @ @ @ @ @ @ @ @ @ @ @ @ @ @ @ @ @ @ @ @ @
@ . . @ . . . @ . . @ . . . @ @ . . . . . . . . . . . . @ . . . . . . . . . . @ . @ . . . . @ . . @
@ . @ . . . . . @ . . . . . . . . . @ . . . . . . . . . . . . . . @ . . @ . . . . . @ . . . @ . . @
@ . . . . . . . . . . . . . . . . . . . . . . @ @ . @ @ . . . . . @ @ . @ . . . . . . . . . . . . @
@ @ . @ . . @ @ . . . . . . . . . . . . . @ . . . . . . . @ . . @ . @ . . @ . . . . @ . . . . . . @
@ . . . . . @ @ . . . . . . . @ @ . . . . . @ . @ . @ . . . . . . @ . . . @ . @ . . . . . . . . @ @
@ . . . . . . . . . . . . . . . @ @ . . . @ . . . . . . @ . . @ . . . . . . . . . . . @ @ . . . . @
@ . . @ . . . @ @ . . . @ . @ . . . . @ . . @ . . . . @ . @ . . . . . . @ . @ . . . . . . . . @ . @
@ . . . . . . . . . . . @ . . @ . @ . . . . . . . . . . . . . . @ . . @ . . . . . . . . . . . . . @
@ . . @ . . @ @ . . . . @ . . . . @ . . . . . . . . . . . . . @ . . . . . . . @ . . . . @ . . . . @
@ @ . . . @ . . . . . . . . . . . . . @ . . . @ . . @ . . . . . @ . . . . . . . . . @ . . @ @ . . @
@ . . . @ . . . . . . . . @ . . . . . . . . . @ . . . . . . . . . . . . . . . . . . . . . @ . . . @
@ @ . . . . . . . . . . . . . . . . . . . @ . . . @ @ . . @ . . . @ . @ . @ . @ . . @ . . . . . . @
@ . . @ @ . . . . . . . . @ . . @ . @ @ . @ . . . . @ . . . @ . . . @ . . . . . . . . @ . . @ . . @
@ . @ . . @ . . . @ . @ @ . . . @ . . . . . . . @ . . . . . . . . . . . . . . @ . . . . . . . . . @
@ . . . . @ . . . . . . . . . . . . @ @ . . @ . . . . @ @ @ . @ . . . . . @ . @ . . @ . . @ . . @ @
@ . @ . @ . . . . . @ . @ . @ . @ . . @ . @ . . . . @ . . . . . . @ . . . @ @ . . . . . @ . . . . @
@ . @ . . . . . . @ @ . . @ . . . @ . @ . . @ . . . . . . . . . . @ . . . . . . . . . . . . . . . @
@ . . . . . . . @ . . . @ . . . @ . . . . . @ . . . . . . . . . . . . @ . . . . . . . @ . . . @ . @
@ . @ . . . . . . . @ . . . . . . . @ . . . . @ . . . . . . . . . . @ . . . . @ @ @ . . . @ . . . @
@ . . . @ @ . . . . . . @ . @ . . . . . . . @ . @ . @ . @ . . . . . . . @ . . @ . . . @ . . . . . @
@ . . . . . . . . . . @ . . . . . @ . . . . . . . @ . . . . . . . @ . . . . . @ . . @ . . . . . @ @
@ @ . . . . @ @ . @ . . . . . @ . . @ . . . . . . @ @ . @ . . . . . @ @ . . . . @ . . . @ . @ . . @
@ . . @ @ . . . . . . @ . . . . . . . . . @ . . . @ . @ . . @ . @ . . . @ . . . . . . @ . . . . @ @
@ . . . . . . @ . . . . . . . @ . @ . @ . . . . . @ . . . . . . @ . . . @ . . @ . . . . @ . . . . @
@ . . . . . @ . . . @ . . @ . @ . . @ . . @ . . @ . . . @ . . . . . . . @ . @ . . . @ @ . . . . @ @
@ @ . . . . . . . . @ . . . . . . . @ . . . . . @ @ . . . . @ . . . . . . . @ @ . @ . . . . . . @ @
@ . . . . . . . . . @ . . . . . . . . . . . . . . . . . . . . . . . . . . . @ @ . . . . . . . . . @
@ . . . . . . . @ . . . . . . @ . @ . @ . @ @ . . @ . @ . . . @ . . . @ . . . . . . . . . @ . . . @
@ . @ . . . @ . . . . . . . . . . . . . . . @ . @ . . . @ . @ . . . . . @ . . @ . . . . @ . . . @ @
@ . . . . . . . . . . @ @ @ . . . . . . . @ . . . . . . . @ @ . . . @ . @ . @ @ . @ . . . . @ . . @
@ . . . . @ @ . @ . . . . . . . . . . . . . . . . . @ . . . . . @ @ . . . . . @ . . @ . . . @ @ . @
@ . . . . . . @ . . . . . . . . . @ . . . . . . . . . . @ . . . . @ . . . . . . . . . . . . @ . @ @
@ . . . . . . @ @ . . . @ . . @ . . @ . . . . @ . . . . . . @ . . . . . . . . . . . . . . . . . . @
@ . . . . . . . . . . @ . . . . . . . . . . @ . . @ . . @ . . . . . . . . . . . . . . . . . . @ . @
@ . @ . . . . . . @ . . . . . . . @ . . . . . @ . . @ . . . . . . . . @ . . . @ @ . . . . . . . . @
@ . . . . . . . . . . . . . @ . . . @ . @ . . . . . . . . . . . . . . . . . . @ . . . @ . . . @ . @
@ @ . . . @ . . . . . . . @ . . . . @ . . @ . . . @ . @ . . . . . . @ . . @ @ . . . . . . . . . . @
@ . . . . . . . . . @ . . . . . . . . . @ . . . . . @ . . @ @ . . . . . . . . . . . @ . . . . . . @
@ @ . . . @ . . @ . . . @ . . @ . . . . . . . . . @ @ . . @ . . . . . . . @ . . . . . . @ . . . . @
@ . . . . . . . . . . @ . . . . @ . . . . @ . . . . . . . . . . @ . . @ . . . . . . @ . . @ @ . . @
@ . . . . . . @ . . @ . @ . . . . . . . . @ . . . . . . . @ . . @ . . . . . . @ . . . @ . @ . . . @
@ . . . . . . . . @ @ @ . @ . . . @ . . . @ . . . . . @ . . . . . . . . . . . . @ . @ . . . . @ . @
@ . @ . . . . . . . . . @ . . . . . @ @ . . @ . . . . . . . . . . @ . . . . . . . . . . . . . . @ @
@ @ . . @ . . . . . . . . . . . . . . . . . . . . . . . . @ @ . @ . . . . @ @ . . . . . . . . @ . @
@ . . . . . . @ . . . . . @ . . @ . @ . . @ . . @ . @ . . . . . . . . . . . . . . @ . . @ . . . . @
@ . @ . . . . . . . . @ . . . . . . . . . . . . . @ . . . . . . . . . . . . . . @ . . . . . @ . @ @
@ @ . . . @ . . . . . @ . @ . . . . . . . . @ . . . . . @ . @ . . @ . . . @ . @ . . . . . . . . . @
@ . . . . . . . . . . . . . . . . . . . @ . . . . . . . . . . . . . . . @ . . . . . . @ . . . . . @
@ @ @ @ @ @ @ @ @ @ @ @ @ @ @ @ @ @ @ @ @ @ @ @ @ @ @ @ @ @ @ @ @ @ @ @ @ @ @ @ @ @ @ @ @ @ @ @ @ @
3
46 36 1 17
28 2 2 25
31 31 45 15
