25 25
@ @ @ @ @ @ @ @ @ @ @ @ @ @ @ @ @ @ @ @ @ @ @ @ @
@ . . . . @ . @ . . @ . @ . @ . . . . . . . . . @
@ . . . . . . . . . . . . @ . . @ . . . . . . @ @
@ . . . . . . . . . . @ . . . . @ . . . . . . . @
@ @ . @ . . @ . . . . . . @ . . . . @ . . . . . @
@ . @ . . . @ . @ @ @ . . . . . . @ @ . . . @ . @
@ @ . . . . . . . . . . . . . . . . . . . . . @ @
@ . @ . @ . . . . . . . @ . . . . . . . @ @ . . @
@ @ . . . . . @ . @ . . @ . @ . . . . @ . @ @ . @
@ . @ . . . . . . . . . . @ @ . . . . . . . . . @
@ . . . @ . . @ . @ . . . . @ @ . . . . . . @ . @
@ . . . . . . . . . @ @ @ . . . . . @ @ . . . . @
@ . . @ . . . . . . . . . . . . . . . . . . . . @
@ . . . . . . @ . @ @ . . . . . @ . . . . . . . @
@ . . @ . @ @ . . . . @ . @ . . @ . . . @ . @ . @
@ . @ . . . . . @ . . @ . . . . . . . @ . @ . . @
@ . . . . . . @ @ . . @ @ . @ . . @ . . . @ . . @
@ . @ . . @ . . . . @ . . . . . . . @ . @ . . . @
@ @ . . . . . . . . @ @ . . . . @ . . . . @ . . @
@ . . . . . . . @ . . . . . . . @ . @ . . . . . @
@ . . . . . . . . . . @ @ @ . . . @ . @ . . @ . @
@ . . . . . . @ . . @ . . . . @ . . @ . . @ . . @
@ . . . . . @ . . . @ . . . . @ . . @ . . . . . @
@ @ . . . . . . . . . @ . . . . . . . . @ . . @ @
@ @ @ @ @ @ @ @ @ @ @ @ @ @ @ @ @ @ @ @ @ @ @ @ @
3
4 14 1 22
4 11 16 1
15 10 18 14
