12 12
@ @ @ @ @ @ @ @ @ @ @ @
@ . . @ . . . . . . . @
@ . . . . . . . . @ . @
@ @ @ @ . . . . . . . @
@ @ . . . . . . . @ . @
@ . . @ @ . . . . @ . @
@ @ . . @ . . . . . @ @
@ @ @ . . . @ . . . @ @
@ @ . . . . . . . . . @
@ @ . . . . . . . . . @
@ . . . . . . . . . . @
@ @ @ @ @ @ @ @ @ @ @ @
3
9 3 9 8
1 6 6 7
4 6 2 5
