50 50
@ @ @ @ @ @ @ @ @ @ @ @ @ @ @ @ @ @ @ @ @ @ @ @ @ @ @ @ @ @ @ @ @ @ @ @ @ @ @ @ @ @ @ @ @ @ @ @ @ @
@ . . . @ . . . . . . . . . . . . @ . @ . . . . . . . . . . . . . . @ . . . . . . . . . . @ . . . @
@ . @ . . . @ . . . . . . . . . @ . . . @ . . . @ . @ . . . . . . . . . @ . . . @ . . @ . . . . @ @
@ . . @ . . . @ . @ . . . @ . . @ . . . . @ . . . @ . @ . @ . . @ . . . . @ @ . . . . . @ . @ . . @
@ . . . @ . . . . . . . . . . . @ . . . . @ . . . . . . . . . . . . . . . . . . . @ @ . . @ . . . @
@ . . . . . . . . . . . @ . @ . . @ . @ . . . @ . . . . @ . . . . . . @ . . . . . . . . . . . . . @
@ . . . . . . . . . @ . . @ . @ . . . . @ . . . @ . . . . . . . . . . . @ . @ . . . . @ @ . . . . @
@ . . @ . @ . @ . . . . . . . . . . . . . @ . . @ . . . . @ . . . . @ . . . . . . . . . . @ . . . @
@ . @ . @ . @ . . @ . . @ . . @ . @ . @ . . . . . . . . . . . . . . . @ . . . @ @ . . @ . . . @ . @
@ . . . @ @ . . . . . . . . . . . . . . . . @ . . . @ @ . . @ @ . . . . . . . . . . . . . . . . . @
@ . . . . . . . . . @ . @ @ . . @ . . @ . @ @ . . . . @ . @ . . . @ . . . . . . . . @ @ . . . @ . @
@ . . . . . . . @ . . . . . . . . . . . . @ . . . . . @ . . . . . . . @ . . . . . . . . . . . . . @
@ . . . . . . . . . . . . . . . . . . . . @ . . . . . . . . . . . . . . . . @ . . . @ . . . . . . @
@ . @ . . . . . . . @ . . . . . . @ . . . . . . . . . @ . @ . @ . . . . . . @ . . . . . @ . . . . @
@ . . . @ . . . @ . @ . @ . . @ . . . . @ @ . . . . @ . @ . . @ . . . . . . . . . . . . . . . . . @
@ . . @ . . . @ . . . . @ . . . . . . . . . . . . . . . @ . . . . . @ @ . . . @ . . . . @ . . . . @
@ . . . . . . . @ @ . . . . . . . . . @ . . . . . @ . . . . @ . . @ @ @ . @ . @ . . . @ . . . . @ @
@ . @ . . . . . @ . @ . . . . @ . . @ . . . . . @ @ @ . . @ . . . @ . . . . . . . . @ . . @ . . . @
@ . . . . . . @ . . . @ . . . . @ . . . @ . @ . . . . . . . . . . . . @ . . @ @ . . . @ . @ . . . @
@ . . . . . . . @ . . . . . . . . . @ . . . . . @ . . . @ . @ . . . @ . . . . @ . . . . . . . @ . @
@ @ . @ . . . . . . . . . . . . @ . . . @ . . @ . . . . . . . . . @ . . . @ . . . @ @ . . @ . . . @
@ . @ . . . @ . . . . . @ @ . . . . . . . . @ . @ @ . . . @ . . @ . . @ . . . . . @ . . . . . . @ @
@ . . . . . . . . @ . . . . . @ . . . . . . . @ . . . . . . . @ . . . . . @ . . @ . . @ . @ . . . @
@ @ @ . . . . . . . @ . . . . @ @ . . . . . . . . . . @ . @ . . . . @ . @ . @ . @ . . @ . . . . . @
@ . . . . . . @ . . @ . . . . . . . . . . . . @ . @ . . . . . . . . . . . . . . . . . . . . . . @ @
@ . . . . . . . . . . . . . @ . @ @ . . . . . . . . . . . . @ . . @ @ . . . @ . . . . . . @ . . . @
@ . . . . . . . . . @ . . @ . . . . @ . . . @ . . . . . . . . . . . @ . . . @ . . . . . . . . . . @
@ . . . @ . @ . . . . . @ . . @ . . . . @ . @ @ . . . . . . @ . @ . . @ . @ . . . @ . . . @ . . . @
@ . . @ . @ . . . . . . . . . @ . . . . . @ . . . @ . @ . . . . . @ . @ . . . . . . . @ . . . . . @
@ @ . . . . . . . @ . . . . @ . @ @ . . . . . . . . . . . . . . . . . . . . . . . . . . . . @ . . @
@ . . . @ . . . . . . @ . . . . . @ . . . @ @ . . . . . . . . . . . . . @ . . @ . . . . . . . . . @
@ . . . . . . . @ . . @ . . . . . . @ . . . . . . @ . . . . @ . . . @ . . . . . . . . . . @ . @ . @
@ . . . . . . . . . @ @ . . . @ @ . . . . . . @ . . . . @ . . . . . . . @ . . . . @ . . . . . . . @
@ . . . . . . . . . . . . . . . . . . @ . . @ . . . . @ . . . . . . . . . @ . @ . . @ . . . @ . @ @
@ @ . . . @ . . . . . . . . . @ . . . . @ . . . @ . . . . . . . . . . @ . . @ . . . . . . . . . . @
@ . . . . . . . . . . . . @ @ . . @ . . . . @ . . @ . . . . @ . @ . . . @ . . @ . . . @ . . @ . . @
@ . . @ . . . @ . . . . . @ @ . . . @ . . . . . . . @ . . @ . . @ . . . . . . @ . . . . . @ . . . @
@ . . . . . . . @ . . . @ . . . . @ . . . . . . . . . . . @ . . @ . . . . @ . . . . . @ . . . . @ @
@ . . . . . . . . . . . . @ . . . . @ @ . . @ . . . @ . . @ . . . @ @ . . . . . . . . . . . . . @ @
@ . . . . . @ . . . . @ . @ . . . . . . . @ . . . . . . . . . . . . @ . . . @ @ @ . @ . . . . . . @
@ . . @ . . . . . . . . . . @ . @ . . . @ . @ . . @ . . . . . . . . . . . . @ . . . . . @ . . @ . @
@ . . . . . . . . . . . . . . . . . . . . . . . . . . . . . @ . . . . . . . . . . @ . . . . . . . @
@ . @ . . . . . . @ . . . @ . . . . . . . . . . @ @ . . . . . . . . . . @ . . . @ . . . . @ @ @ @ @
@ . . . . . . . . . . @ @ . . . @ . . . . @ . . . . . . @ . . @ @ . . . . . . @ . . . . @ . . . . @
@ . . . . . . . . . . @ . . . . . . . . @ . @ . . . . . . . . @ . . @ @ @ . . . . . . . . . . @ . @
@ . @ . . . . @ . @ . @ . . . . . . . @ . . . . . . @ . . . @ . . @ . . . . . . @ . @ . . . . . . @
@ . . . . . . @ . @ . @ . @ . . . . @ . . . . @ . . . @ . . . @ . @ @ . @ . . . . . . . . . @ . . @
@ @ . . @ . . . . . . @ . @ . @ . . . . . . @ @ @ . . . . @ . . . . . . @ . . @ . . . . . @ . . . @
@ . . @ . . . . . . . . . . @ . . . . . . . . . . . @ . . @ @ . . . . . . @ . . . . . . . . . . . @
@ @ @ @ @ @ @ @ @ @ @ @ @ @ @ @ @ @ @ @ @ @ @ @ @ @ @ @ @ @ @ @ @ @ @ @ @ @ @ @ @ @ @ @ @ @ @ @ @ @
3
43 41 14 27
13 35 24 9
41 1 19 4
