50 50
@ @ @ @ @ @ @ @ @ @ @ @ @ @ @ @ @ @ @ @ @ @ @ @ @ @ @ @ @ @ @ @ @ @ @ @ @ @ @ @ @ @ @ @ @ @ @ @ @ @
@ . . . @ . . . . . . . . . . @ . . . . . . . . . . @ . . . . . . . . . . . . . . . . . @ . . . . @
@ . . . . @ . . . @ . . . . . . . . . . . . @ . @ . . . . . . @ . . . . @ @ . . . . . . . . . . @ @
@ . . . . . . . @ . . . . . . . @ . . . . . . . . . . @ . @ @ . @ . . . . . . . . . . . . . . . . @
@ . . . . @ @ . . @ . . . . . . @ . . . . . . @ . . . . . . . . . . . . . . . . . . . @ . . . . . @
@ . @ . . . . . @ . . . @ . @ . . @ . . @ . . . . @ . . @ . . . . . . @ . @ . . . . @ . @ . . . @ @
@ . @ . . . . . @ . @ @ . . . . . . . @ . . . . . . . . . . . . . . . @ . . @ . . . . . . . @ . . @
@ . . . . . . . . . . . . . . @ . . @ . @ @ . . @ . . . . . @ . . . . . . . @ . . . . @ . . . @ . @
@ . . . . . . . . . . . . . . . . @ . @ . @ @ . . . . . @ . . . . @ . . . . . @ . @ . . . . . . . @
@ . . . @ . . . . . . @ . . @ . . . . . . . . . @ . . . . . . . @ . . . . . . . . . . . . . @ . . @
@ . . . . . . . @ . . @ . @ . . . . @ . . . . . . . . . . @ . @ . . . . . . @ . . . . @ . . . . . @
@ . . . . @ . . . . . . . . . . . . @ . . . . . . . . . . . . . . . . @ . @ . . . . . . . . . . . @
@ . . . . . . . . . . . . @ . . . . . . . . . @ . . @ . @ . . . . . . @ . . . . . @ . . . . @ @ . @
@ . . @ . . @ . . . . @ . @ . . . . . . . . @ . . . @ . . . . . . . . . . . @ . . . @ @ . @ . . . @
@ . . . . . . . . . . . @ @ . . @ . . . . @ . . . . . . . . . . . . . . . . . @ . . . . . . @ . @ @
@ . . . . . . . . . . . @ . . . . @ . @ . . . . @ . . @ . . . . @ . . . @ . @ . @ . . @ . . . . . @
@ . @ @ . . . . @ . . . . @ . . @ . . . @ . . . @ . . . @ . . . . . . . @ @ @ . . . . . @ . . . . @
@ . . . . . . . . . . . @ . . . . . . . . . . . . . . . . . . . . . . . @ . . . . . . . . @ . @ . @
@ . . . . . @ . . @ . . . . . . . . . . @ . @ . . . . . . @ @ . @ . . . @ . . . . . . . . . . . . @
@ . @ . @ @ . @ @ . . @ . . . . . . . . . @ . . . @ . @ . @ . . @ @ . . . @ . . . . . . @ . . . . @
@ . . @ . @ . . . @ @ . . . . . @ . . @ . . . . . . . . . . . . . . . . @ . . . @ . . @ @ . @ . @ @
@ . @ . . . . . @ . . . @ @ . . . @ . . @ . @ . . @ . . . @ . . . . . . @ . . . . . @ . . . . . . @
@ @ . . @ . . @ . . . . . . . . . . . . . . . . . . . . . . . . . . . . . . . . . @ . . @ . @ . . @
@ . @ . . . @ @ . . . . . . @ . . @ . @ @ . . . . . . . @ . @ . . @ . . . . . . . . . . . . . . . @
@ . . . . . . . . . . . . @ . . . . . . . . . . . . . . . @ @ . . . . . . . . . @ . . . . . . . . @
@ . . @ . . . . . . . . . . . . . . . . @ . . . . . . . @ . . . . . . . . . . . . . @ . . . . . . @
@ . . . . . . . . . . . @ @ @ . . @ . . . . . . . @ . . . . . @ . . . @ . @ . . . . . @ . . @ @ . @
@ . . . . . . . . . . @ @ . . . . @ . @ . . . . . . . . . . . . . . . . . . . @ . . @ . . . . . . @
@ . . . @ . . . . . . @ . @ . @ . . @ . @ @ . @ . . . . . @ . @ @ . . . @ @ . . . . @ . . . . . . @
@ . . . . . @ . . . @ . @ . @ . . . . . . @ . . . . . . @ . . . . . . . . . . . . @ . . . . . . . @
@ . . . . @ . . . . . . . . @ . . . . . @ @ . @ @ . @ . . @ . @ . . @ . . @ . . . . . @ . . . . . @
@ . . . . . . @ . . . . . @ @ . @ . . @ . . . . @ . . . . . . . . . . @ . @ . . . . . @ . @ @ @ . @
@ . @ . . . . . . . . . . . @ . . @ . . . . . @ . . . . . . @ . . . @ . . . . . @ . . . . . . @ @ @
@ . . . . . @ . @ @ . . . . . . @ . . . . . . . @ . . . . @ . . @ . @ . . . @ . . . @ . . . @ . . @
@ . @ . . . . . . . . . @ . . @ . . . . @ . . . . . . . . . . . . @ @ @ . . . . . @ . . . . . . . @
@ . . . . . . @ @ . . . . . . . . . @ . . . . . . . . . @ . @ . . @ . . @ . @ . . @ . . . @ . . @ @
@ . . . . . . . . . . @ @ . . . . @ @ . . @ . . . . . . . . @ . . @ . . . . . @ . . . @ @ . . . . @
@ @ . . . . . . . . . . . . . . @ . . . @ . . @ . . @ @ . . . @ . . . . . . . . . @ . . . @ @ . . @
@ . . . . @ . @ . . @ . . . . . . . . . . . @ . . . . . . @ . . . @ . . . . . . . . . . @ . . @ . @
@ @ . @ . . . . . @ . . . @ . @ @ @ . . . . . @ @ . . . . . @ . . . @ . . . . . . . . . . . . . . @
@ . @ . . . . . . . . . . . @ . @ . . . . . @ . . @ . . . . . . . @ . . . . . . . . . . . @ . . . @
@ . . . . . . . . . . . @ . . @ . @ . . @ . . . . . . @ . @ . . . . . @ . . . . . . . . . @ . . @ @
@ . . . @ . . . . . . . . @ . . @ . @ . . . @ . . . . @ . . . . . . . . . @ . . . @ . . . @ . . . @
@ . @ . . @ . . @ . . @ . . . . . @ @ . . . . @ . . @ . . . . . . . . . . . @ . . . . . . . . @ . @
@ @ . . . . . . . . . . . . . . . . @ . . . . . . . . . . . . @ . . @ . . . @ @ . . . . . . . . @ @
@ . . @ . . . . . . . . . @ . . . @ . . @ @ . @ . @ @ . @ . . . . . . . . @ . . . @ . . . . . . . @
@ . . . . . . @ @ . . . . . . . . . . @ . . @ . . . . . . . . . . @ @ . . . . . . . . . . @ . . . @
@ . . @ . . . . . . . . @ @ @ . @ . @ . . . . @ . . . . . . . @ . . . . . @ @ . . @ @ . . . @ . . @
@ . . . . . . . . . . . . . . . . . . . . . . . . . . @ . . . . . . . @ . . . . . . . . . . . . . @
@ @ @ @ @ @ @ @ @ @ @ @ @ @ @ @ @ @ @ @ @ @ @ @ @ @ @ @ @ @ @ @ @ @ @ @ @ @ @ @ @ @ @ @ @ @ @ @ @ @
3
26 26 1 21
47 25 46 42
33 4 38 16
