100 100
@ @ @ @ @ @ @ @ @ @ @ @ @ @ @ @ @ @ @ @ @ @ @ @ @ @ @ @ @ @ @ @ @ @ @ @ @ @ @ @ @ @ @ @ @ @ @ @ @ @ @ @ @ @ @ @ @ @ @ @ @ @ @ @ @ @ @ @ @ @ @ @ @ @ @ @ @ @ @ @ @ @ @ @ @ @ @ @ @ @ @ @ @ @ @ @ @ @ @ @
@ . . . . . . . @ . . . . . . . @ . . . . . . . . . . . . . . . . . . . . . @ . . . . . . . . . . @ . . . . . . . . . . @ . . @ . . . . . . . . . . . . . . @ . . . . . . . . . . . . . . . . . . . . @
@ . . . . . . @ . . . . . @ . @ @ . . . . . . . . . . . . . @ . . . . @ . . . . @ . . . . . . . @ . @ . @ . . . . . . . . . @ . @ . . . . . @ . . . . . @ . . . . . . . . . @ . . . . . . . . @ . @ @ @
@ . . . . . @ . @ . . . . @ . . @ . . @ . . . . . @ . . @ . . . . . . . @ . . . . @ . . . . . . . . @ . . . . . @ . . . . @ . . . . . . . @ . . @ . . . . . . . @ @ . @ . . @ . . . . . @ . . . . . . @
@ . . . . . . . . . . . . . . . . @ . . . . . . . . . . @ . . . @ . . . . . @ . . . @ . . . @ . . . . @ . @ . . . . . . . . . . @ . . @ @ . @ . . . . @ . . . . . . . . @ . @ . . . . . . . . @ @ @ . @
@ . . . @ . . . . . . . @ . . . . . . . . . . . . . . @ . . . @ . . . . . . . . . @ . . . . . . . . @ . @ @ . . . @ . @ . . . . . @ . . . @ . . . @ . . . @ . . . @ . . . @ . . . . . . . @ . . . . . @
@ @ . . . . . . . . . . @ @ . . . @ . @ . . . . . . @ . . . @ . @ @ . . . . . . . @ . . . . . . . @ . . . @ . . . . . . . . @ . @ . @ . . @ . . @ . . . . . . . @ . . . . . @ . . . . . . . . . . . . @
@ . . . . @ . . . . . . @ . @ @ . . . . . . . . @ . . @ . . . . . . . @ @ . . . @ . . . . . . . . @ . . . . . . . . @ . . . @ . . . @ @ . . . @ . . . . . . @ . . . . @ . . . . @ . . . . . . . . . . @
@ . . . . . . . . @ . . . . . . . . . . . . . . . . . . . @ . . @ @ @ @ . . @ . . . . . . @ . . . . @ . . . @ . . @ . . . . . . . . . . . . . . . . @ . . . @ @ . . @ . . @ @ . . . @ . . . . @ . . . @
@ . . . @ @ . . . . . . . . . @ . . . @ . . . . . @ . @ @ . . . . . . . . . @ . . . . . . . . . . . . @ . . . . @ . . . . . @ . . . . . @ . @ . . . . . . . . . . . . . @ . . . . @ . . . . . . . . @ @
@ . @ . . . . @ . . . @ . . @ . . . . @ . @ . . . . . @ . . . . @ . . . . . . . . @ @ . . . . . . . . @ . . @ . . . . @ . . . . . @ . . . . . @ . . . . . . . . . . . . . . . . . . . @ . . @ . . . . @
@ . @ . @ . . . . . . . . . . . . . . . . . . . . . . . . . . . . @ . . . . @ . . . @ . @ . . . . . . . . . . @ . . @ . . . @ . . . . . @ . . . . . . . @ . . @ . . . @ @ . @ @ . . . . . . . . . . @ @
@ . . . . . . . . . . . . @ . . . @ . . . . . . @ @ . . . . . . . . . . . . . . . . . . . . . . . @ @ . . . . . . . . . . @ @ . . . @ . . . . . . . . . . . . . . . @ . . . . . @ . @ . . . . . . . . @
@ @ . . . . . . . . . @ . . . . . . . @ . . . . . . . . . . . . . . . @ . . . . . @ . . . . . . . . . . . @ . . . @ . . . . . . . . . . . . @ . . . . @ . . . @ . . . @ @ @ . . . . . . . . . . . . . @
@ . . . . . @ . . . @ . . . . . . @ . . . . . @ . . . . . . @ . . . . @ . . . @ . . . . . . @ . . . . @ . . . . . . . . . . . . @ . . @ . . . . . . . @ . . . . . @ . . . . . @ . . . . . . . . @ @ . @
@ . . . . . . . . . . . . @ @ @ . . . . . @ . . @ . . . . . . @ . . . . . . . . . . . . . @ . . . . . . @ . . . . . . . . . @ . . . . @ . . . @ . . . . . @ . @ @ . . . . @ . @ . @ . . . . . . . @ . @
@ @ . . @ . @ @ . . @ . . . . . . . . . @ . . @ . . @ . @ . . . . . . @ @ . . . . . . . . . . . . . . . @ . . . . . . @ . . . @ . @ . @ . @ . @ . . . . . . . . . @ . . . . . . @ . . . . . . . . @ . @
@ . . @ . . . . . . @ . . . . . . . . . . . . . @ . . @ . . . @ @ . . . @ . . @ . @ . . . @ . @ . . . . . . . . . . @ . . . . . . . . @ . . . . . @ @ . . . . . . . @ . @ @ . @ . @ . @ . . . . . @ . @
@ . . . . . @ @ . . . @ . . . @ . . . @ . . . @ . . . . . . . . . . @ . . . @ . . . . . . . @ . . . . . . . @ . @ . . . . . . . . @ . . . . @ . . . . . . . . . . . @ @ . . . . . . . . . . . . . @ . @
@ . . @ . . . . . . @ . . . . . . . . . . . . . @ . . @ . @ . . . . . . . . . . . . . . . . . . . . . . @ . @ . . . . @ . . . @ . . . @ . . . . . . . . @ . . @ . . . @ . . . @ . . . . . . . . . . . @
@ . . . . . @ . . . . . . . @ . . . . . . . @ . . . . . . . @ . . . . . . . . . . @ . . @ . . . . @ @ . . . . . . . . . . . . . @ . . . . . . . @ . @ . . . . . . @ . . . . . . . . . . . . . . . . . @
@ . . . . . . @ . . . . . . @ . . . . . . . @ . . . . . @ . . . . . . . . . . @ @ . @ . . . . @ . . . @ @ @ . @ . . @ . . . @ . . . . . @ . . . . . . @ . . . . . . . . . . . . @ . . @ . . . . . @ . @
@ @ . @ . . . . . . . . @ . . @ . . @ . . . . . . . . . . . @ . . . . @ . . . . . @ . @ . @ . @ . . . @ . . . @ . . . . @ . . . . @ . . . . . . . . @ . . . . . . . . . . . . . . . . . . . . . . . . @
@ @ . @ . . . . @ . @ . . . . . . @ . . . . . . . . @ . . . . . . . . @ . . . . . . . @ . . . . @ . . @ . . . . . . . . . . . . . . @ . . . . @ . . . @ . . @ . . . . @ . . . . . @ . . . . . . . . . @
@ . @ @ . . . @ . . . . @ . . . . . . @ . . . @ . . @ . . @ . . . . . . . @ @ . . . . @ . . . . . @ . . . . . . @ . . @ . . . @ . . . . . . . . . . . . @ . . . . @ . . . . . . . . . . . @ . @ . . . @
@ . . @ . . . . . . . . . . @ . . . @ . @ . . . . @ . . . . . @ . . . @ . . . . . @ @ . . . . . @ . . . @ . . . . . @ . . . . . . . . . . @ . . @ . . . . . . . . @ . . . . . . @ . . . . . . . . . . @
@ @ . . @ . . @ . @ . . . . . . . . . @ . . @ . . . . . . @ . @ . . . @ . . . . . @ . . . . . . . . . . . . . . . . . . . . . . . @ . . . . . . @ . . . @ . . . . . @ . . . . @ . . @ . . . . . . . . @
@ . . . . . . @ . . @ . . . . @ . . . . . . . . . . . . . . @ @ . . . . . . . @ . . . . . . . . . . @ . . . . . @ @ @ . . . . @ . . @ . @ . @ . . . . . . . . . . . @ . @ . . . . . . @ . @ . . @ . . @
@ . @ . . @ . . . . @ @ . @ . @ . . . . . @ . . . . . . . . @ . . . . @ . . . . . @ . @ @ . . . . . . . . @ . @ . . . . . @ . @ . . . @ . . . . . . . . . . . . . . @ . . . . @ . . . . . @ . . . @ . @
@ . @ . . . . . . . . . . . . . . . . . . . . . . . . . . . @ @ . . @ . . . . @ @ . . @ @ . . . . . . @ . . . . . . . . . . . . . . . @ . . . @ @ . @ . . . . . . . . @ . . . . @ . . . . . . @ @ . . @
@ . . . . @ @ @ . . . . . . . . . . . . . @ . @ . . @ . . . . . . . . . . . . . . . . . @ . . . @ . . . . . . . . . . . . . @ . . . . . @ . . . . . . . . @ @ . . . @ @ . . @ . . . . . . . @ . . . . @
@ . . @ @ . . . @ . . @ . . @ . . . . . . . . @ @ . . . . @ . . . @ @ . . @ . . . . @ . @ . . . . . . . @ . @ . . . . . . . . . . . . . . . . @ . . . . @ . @ . . @ . . . . . @ . @ . . . . . . @ . . @
@ . . . . @ . . . . @ . @ . @ @ . . . . @ . . . @ . . . @ . @ @ . @ @ . . . . . . . . . . . . . . . . @ . @ . . . . . . . . . . @ @ . . . . . . . @ . . . . . . . . . . @ . . . @ . . . . . . . . @ . @
@ . . . @ . . . @ . . . . . . . . . @ . . . . . @ @ @ . . @ . @ . . . @ @ . . . . . @ . . . . . . . . . . . @ . . . @ . . . . @ . . . . . . . . . . . . . . . . . . . . @ . @ . . . . . . . @ . . @ . @
@ . . @ . . @ . . . . @ . . . @ . . . . . . . . . . . . . . . @ . . . . . . . . @ . @ . . . @ @ . . . . . . @ . @ . @ . . . @ . . . . . . . . . . @ . . @ . . @ . . . . . . @ @ . . . . . @ . . . @ . @
@ . . . . . . . . @ @ @ . @ . . . . . . . . . . . . . . @ . @ . . @ . . . . @ . . . . . . . . . . . . . . . . . . . . . . . . . . . . @ . . . @ @ . @ . . . . @ . . . @ . @ . @ . . @ . . . . . . . . @
@ . . . . . . . . . . . . @ . . . @ . @ . @ @ . @ . . @ . @ . . . . . . . . . . . . . . . . . . . @ . . . . . . @ . . @ . . . . . . . . @ . . . . @ . . . . . . @ @ . . @ . . . . . @ . . . . . . . @ @
@ . . . @ . . . . . . @ . . @ . . . @ . . . . . . . @ . . . . @ . @ . . . @ @ . . . . . . . @ . . . . . . . . @ . @ . . . @ . . . . . . . @ . @ . . @ . . . . . . . @ . . @ . . . . @ . . . . . . . . @
@ . . . . . . . @ @ . . @ . . . . . . . . . . . . . @ . . @ . . . . @ . . . . . . . . . . . . . @ . . . . . . @ . . . @ . . . . @ . . . . . @ . . . . @ . . . . . @ . . . . @ @ . . . . @ . . . . @ . @
@ . . @ . . . @ . . . @ . . . @ . . . . . . . . . . . . @ . . . . . . . @ . @ @ . @ . . @ . . . . @ . . . . . . . . . . . . . . . . . @ . . . . . . . . . . . . . . . . . . . . . . . . . . . @ . . . @
@ @ . . . . . @ @ . . . . . . . . . @ . . . . . . . . . . . . . . . . @ . . @ @ . . . . . . . . . . . . . . . @ . @ . . . . . . . . . . . . . . @ @ . @ . @ . @ . . @ @ . . . . . @ . . @ . . . . . . @
@ . . @ . @ . . @ . . . . . @ . . @ . . . . . . @ . . . @ . . . . . . . @ . . . . . . . @ . @ @ . . @ @ . . . . . . . @ . . @ . . . . . . . . . . . . . @ . . @ . . . . . . . . @ . . . . . . . . . . @
@ @ . . @ . . . . . @ . . . . . . @ . . . . . . . . . @ . . . . @ . . @ . . . . @ . . . . . . . @ . . . @ . . . . . . . . @ . . . . . . . @ . . . @ . . @ @ . . . . @ . . . . . @ . . @ . . @ . . @ . @
@ . . . . . . . . . . . . @ . . . . . . . . . @ . @ . . . . . . . . . @ . @ . . @ . . . . . @ . . . . . . @ . . . @ . . . . @ . . . . . . @ . . . . . . . @ . . . . . @ . . . . . . @ . . . . . . . . @
@ . . . . . . . . . . . . . . . . . . . @ @ . . . @ . . . . . . . . @ . . . . . . . . . . . . . . . . . . . . . . . . . . . . . . . . @ @ . . . . . . . . . . . . . . . . @ @ . . @ . . . . . . . . . @
@ . . . . . @ . . . @ . . . . . . . . . . . @ . . . . . . . . . @ . . . . . . . . . . @ @ . . . . . @ . @ . . . . . . . @ @ . . . @ . @ . @ . . . . . . . . . . . . . . @ . . . . . . . . . . . . . . @
@ . . @ . . . . . . . @ . . . . @ . . @ . . @ . . . . @ . . . . . . . . . . . . . . . . . . @ . . . . @ . @ @ . . @ @ . @ @ . . . . . . . . . . . . . . . . . @ @ . . . . . . @ . . . . . . . . . . . @
@ . . . . . . . . . @ . . . . . . . . @ . . . @ . . . . . . @ . . . . . . @ . . . @ . . . . . . @ . @ . . . . . . . . . . . . . . . . . . @ . . @ . . . . . . . . @ . . . . @ . . . . @ @ . . @ . . . @
@ . . . . @ . . . . . . . @ . @ . . . . . . . . . . @ . @ . . @ . . . . @ . . . . . . . . . . @ . . . . . @ . . @ . @ . . . . . . . . . . @ . . . . . @ . . . . . . . . . . . . . . @ @ . . . . @ . . @
@ . . . @ . @ . . @ . . . . @ . @ . @ . . . . . . . @ . . . . . @ . . . . . . . . . . . . @ . . . . . @ . . . . @ . . . @ . @ . . . . . @ . . @ @ . @ . . . @ . . . @ . . . . . . . . . . . . . . @ . @
@ . . . . . . . @ @ . . . . . . @ @ . . . . @ . @ . . . @ . . @ . . . . . . . . @ . . . . . . . . @ . . . . . . . . . @ . . . . . @ . . @ . . . . @ . . . . . . . @ . . @ . @ . . . . . @ @ . . @ . . @
@ . . . . @ . . . . . @ . . . . . @ @ @ . . . . . @ . . . . . @ . . . . @ . . . . . . . @ . @ @ . @ . @ . . . @ @ . . . @ @ . . . . . @ . . @ . . @ . . . @ . . . . . @ . . . . @ @ . . . . . . . . @ @
@ . . . . . . . . . . . . . . . . . @ . . @ . . . . @ . @ . . . @ . . . . . . . . . . @ . . . . . . . . . @ . @ @ . . @ @ . . @ . @ . . . . . . . @ . . . . . . . . . . . . @ . . @ @ @ . @ . . . . . @
@ @ . . . @ . . . . . . . . . . . @ . . . . . @ . . . . . . . . . . . . . . . . . . . @ . . . . . . . . . . . . . . . . . . @ . . . . . . @ . . . . . . . . . . . . @ @ . @ . . . . . . . @ . . . . . @
@ . @ . . . . . . . . @ . . . . . . . . @ . @ @ . . . . @ . . . . . . . . . . . . . . . . . . . . . . . . . . . . . . . @ @ . . @ . @ . @ . @ . . @ . @ . . . . . . . . . . . . . . . . . . @ . . . . @
@ . . . . @ . . . . . . . . . . . . . @ . . . . . . @ . . . . @ . @ . . . @ . . @ . . . . . . . . . . . . . . . . . . . . . . . . . @ . . @ . . . @ . . . @ . . . @ . . . @ . . @ . @ @ @ . @ @ . . . @
@ . . . . . . . . . . . . . . . . . . . . . . . . . . . @ . . @ . . . . . . . . @ . . . . . @ . . @ . . . . . . . . . . . . . . @ . . @ . . . . @ . . . . . @ . @ . . @ . . @ . . . . . . . . . . . . @
@ . . @ . . . . . . . . . . @ . . . . . @ . @ . . . . @ @ . . . . . . . . . . . . . . @ . . . . . . . @ . . @ . . . . . . . @ . . . . @ . . . . . @ . . @ . . . . . . . @ . . . . . . . . . @ . @ . . @
@ . @ . . . @ . . . . . . @ . @ . . . . . . . . . . . . @ . . . . . . @ @ . . . . . . . . . . . . . . . . @ . . . . . @ . . . . . @ . . . . @ . @ . . . . . @ . . . . @ . . . . . @ . . . . @ . . @ . @
@ . @ . . @ . @ . . @ . . . . . . . . . . . . . . . . . . . @ . . . . . . . . @ @ . . . . . . . . . . . . . @ . . . . @ @ . . . . . @ . . @ . . . . . . . @ . . . . . . @ . . @ . . . . . . . . . . . @
@ . . . . . . . @ @ . . . @ . . . @ @ . . . . . . . . . . @ . . . . . . . . . . . . . . . @ @ . . . . @ . . . . . . . . . . . . . . . . . . @ . . . . . . . . @ . @ . . . . . . . . @ . @ . . @ . . . @
@ . @ . . . . . . . . . . . . @ . . . . . . . . . . . . . . . @ . . . @ . . . @ @ . . . @ . . . . @ @ . . @ . . . . . . . . @ . . . . . @ . . . @ @ . . . . . . @ . . @ . . . . . . . . . . . . . . . @
@ . . @ @ . . . . . . . @ . . . . @ . @ . . . @ . . . . @ @ . . . @ . @ . . @ . . . @ . . . . . @ . @ . . @ . . . . @ . . . . . . @ . . . . @ . . . . @ . . . @ . . . . . . @ . . @ . . . @ . @ @ . @ @
@ . . . . . . . . . @ . . @ . @ . . . . . . . . . . . @ . @ . . . . . @ . @ . . . . . @ @ . . . . . @ . . . . @ . . @ . . . . @ . . . . @ . . . . . . . . . . . . @ . . . @ . . . . . . . @ . @ . . . @
@ . . . . . . . . @ . . . . . . . . @ . . . . . . . @ . . @ . @ . . . . . . . @ . . @ . @ @ . . . . @ . . . . . @ . . @ . @ . . . . . . . . . . . @ . @ . . . . . . . . . . . . . . . . . @ @ . @ . @ @
@ . @ . . @ @ @ . . . @ . . . @ . . @ . . @ . . . . . . . . . . . . . . . . @ . . . . @ . . @ . . . . . . . . . @ . . @ . . . . . . @ . . @ . . . . . . . . . . . . . . @ . . . . . @ . . . . @ . . . @
@ . . @ . . . . . . . . . @ . . . . . @ . . . . @ @ . . . . . . . . . . . . @ . . . . . . . . @ . . . @ . . . @ . @ . . . . . . . . . . @ . . @ @ . . . @ . @ . @ . . . . . . @ @ . . . @ . @ . . . . @
@ . . . . . . . . @ . . . . . . . . @ . . . . . . . . . . . @ . . @ . @ . . . @ . . . @ @ . @ . . . . . . @ . . . . . . . . . . . . @ . . . . . @ . . . . . . . . . . . . . . @ . . . @ . . . . . . . @
@ . . . . @ . . . . . @ . . . @ @ . @ . . . . . @ @ . . . . . . . . @ . @ . . @ . . . . . . . . . @ . . . . . . . . . . . . . . . @ . . . . . . . . . . . @ . . @ @ . . . @ . . . @ . . @ . . . . @ . @
@ @ . . . . . . . @ . . @ . . . . @ . . . @ . @ . @ @ . . . @ @ @ @ . @ . . . . . @ . . @ . . . . @ . . . . . . . @ . . . . . @ . @ . . . . . @ . . . . . . . @ @ . . . . . . . . . . . @ @ . . . . . @
@ @ @ . . . . . @ . @ . . . . . . . . @ . . . . . . . . . . . . . . . . @ . @ . . . . . . . . . . . . . . . . . . . . . . . . @ . . . . . . . . . . . . @ . . . . . . . . . . . . . @ . . . . . @ . . @
@ . . . . . . . @ . @ . . . . . @ @ . @ . . . @ . . . . . . . . . . @ . . . . @ . . . . . . . . . @ . . . . . . . . . . . @ @ . . . @ . . . . . . . . @ . . . . . @ . . . . . . . @ . . @ @ . . . . . @
@ . . . . @ @ . . . @ @ . . . . @ . . . . . . . @ . . . . . @ @ . . . . . . . . . @ . . . . . . @ . @ . . . . . . . . . . . . . . @ . . . . . . @ @ . @ @ . . . . . . . . . . . . @ . . . . . @ . . . @
@ . . . . . . . . . . . . . . . . . . . . . . . . . . . @ . . . . . . @ @ . . . . . . . . . . . . . . . @ . . . @ @ . . . . . @ . . @ . . . . . . @ . . @ . . . . . . . . . @ . . . . . . . . @ . . . @
@ . . . . . . . @ . . @ . @ . . . . . . . . . . . . @ . . . . . . @ . . . . . . . . . . . . . @ . . @ . . . . . @ . . . . . . . . . @ @ . . . . . . . . @ . . . . . . . @ . . . . . . . . . . . . . . @
@ . . . . . . . . . . . . . @ . . . . . . . . . . . . . . . . . . . . . . . @ . . . . . . . . . . . . @ @ . . @ . . . . @ . . . . . @ . . @ . . . @ @ . . . . . . @ . @ . @ @ . @ . . @ . . @ @ . @ . @
@ . . @ . . . . . . . . . . . . . . @ . . . @ . . . . . . @ . . . . . . . . . @ . . . . . . . . @ @ . . . . . @ . . . . . . . . . . @ . @ . . . . . . @ . . . . . . . . . . . . . . . . . . . . . . . @
@ . . . . . @ . . . . . . . . . @ . . . . . . . . . . . . . . . @ @ . . . . . . . . @ . . . . . . . . . . . . . . . . . . @ . . . . @ . . @ . @ @ . . . . @ . @ . . . @ . . . . . @ @ . . @ . . . . . @
@ . . . @ @ . . @ . . @ @ . . . . . . . . @ . . . . . @ . @ . . . @ . . . . . @ @ . . . . . . @ . . . . . . . @ . . @ . . . . . . @ . . . @ . . . . . @ . @ . . . . . . . @ . . . . . . . . . @ . . @ @
@ . . . @ @ . . . @ @ . . . . @ . . . . . . . . . . . . . . . . . . @ . . . . . . . . . . . @ . @ @ . . . @ . @ . . . . . @ . . . . . . . . . . . . . . . . . . . . . . @ . . . . @ . . . . . . . . . @
@ . . . @ . @ . . @ . @ @ . @ . . . . . . . . . . . . . . . . . . . . @ . . @ . @ . . . . . . @ . . . . . . . . . . . . . . . . . . . . . @ . . . . . . . @ . . . @ . @ . . . . . . . . . . . . . . . @
@ @ . . . @ @ @ . . @ . . . . @ . . . . @ . . . . . . @ @ . . . @ @ . . . . . . . . . . . . . . . @ . . . . . . @ @ . . . . . . . . . . . . . . . @ . . @ @ @ . . . . . . . @ . . . . . @ . . . . @ . @
@ . . @ . . . . . . . . . . . . . . . . . . . . . . . . . @ . . . . . . . @ . @ . . . . . . . . . . . . . . @ . . . @ . @ . . . . . . . . . . . . . . . . . @ . . . . . . . . . . @ @ . . . . . . . . @
@ . @ . . . . @ . @ . . . . . @ . @ @ . @ . . . . . . . @ . . . . . . @ . . . . . . . . . @ . . . . . . . . @ . @ . . . . @ @ . . . . @ . . . @ . . . . . . . . @ . @ . . @ . @ . @ . @ . @ . . . . . @
@ @ . . . . . . . . . . @ . . . . . @ . . . . @ . @ . . . . . . @ . . . . . . . @ @ @ . . . . . . . . . . . . @ @ . . . . . . . . . @ . @ . . . . @ @ . . . @ . . @ . . @ . . @ . . . . . . . . . . . @
@ . . . . . . . . . . . @ . . . @ . . @ . @ . . . @ . . . . . . . . . . . . . . . . . . . @ . . @ . . . @ @ @ . . . . @ . . . . @ . . @ . . . . . . @ . . . . . . . @ . . . . . @ . @ . . . . . @ . . @
@ . . . . . @ @ . . . @ . @ . . . . . . @ . . @ . . . . . . . . . . . @ . . . . . . . . . . . . . . . . . @ . . @ @ . . @ . . @ . . . . . . . . . . . . . . @ . . . . . . . . @ @ . . . . @ @ . . . . @
@ . . . . . . . . . . . . @ . @ . . . . . . . . . . . @ . . . . @ . . . . @ @ . . @ . . @ . @ . . @ . . . . . . . . @ . . . @ . . . @ . . . . . @ . . @ . . . @ . . . . @ . . . . . . . . . . . . . . @
@ . . . . @ . . . . . . . @ . . . . . @ . . . . @ . . . @ . @ . . . . . . . . . . . . . . . . . . . . . . . . . . . . . . . . @ . @ @ . . . . . @ . . . . . . . . @ . . . . @ . . . . . @ @ @ @ . . . @
@ @ . . . . . . . . . @ . . . . . . . . . . . . . @ . . . . . . @ . . . @ @ . . . . . . . @ . @ . @ . . . @ . . @ . . . @ . @ . . . . . . . . . . . . . . . . . . . . . @ . . . . . . . @ . . . . @ . @
@ . . . . . . @ . . . . . . . . . @ . . . @ . . @ . . . . . . . . . . @ . . @ . . . . . . . . . . . . . @ . . . . . . . . . . . . . @ . . . . . . @ . . . . . @ . @ . . . . @ @ @ . @ . . . . . @ . . @
@ . . . . . . . . . . . @ @ @ . . . . . @ @ . . . . . @ . . . . . . . . @ . . . . . . . . . . . . . @ . . . . . . . @ . . . @ @ . . . . @ . . . . . . . . . . @ . . @ @ . . @ . . . @ . . . . @ . . . @
@ @ @ . . . @ . . . @ @ . . . . . . . . . . . @ . . @ . . . . . @ . . . . @ . . . . . . . . . . . . @ . . . . . . @ . . . . . . . @ . . . . . . . . @ . . . . . @ . . . . . . . . . . . . @ . . . . . @
@ . . . @ . . . @ . @ . . . . . . . . . . . . . . . @ . . . . @ . . . . . @ @ . @ @ . . . @ . . @ . . . . . @ . . . . . . @ . . . . . . @ . . . @ . . . . . . . . @ . . . @ . . @ . . . . . . . . . . @
@ . . . . . . @ . . @ . @ . . @ . . . @ . @ . . . . . . . . . . . . . . @ . . . . . . . @ . . . . @ @ . . @ . . . . @ . . . . . @ @ @ . . . . . . . @ . . . . . @ . . . . . . . @ . . . . . . @ . . . @
@ . . @ . . . . @ . . . @ . @ @ . @ . . . . . . @ . . . @ . . . . . . . . . @ . . . @ . . . . . @ . . . . . . . . @ . @ . . . . @ . . . @ . . . @ . . @ . . . . @ . . . . . . @ . . . . . @ . . . . @ @
@ . . . . . . . . . . . . . @ . . . . @ . @ . . . . . . . . @ . . . @ @ . . . . . . . @ . . . @ @ . . @ @ @ . . . . . . @ . . . @ @ . . . @ . . . @ . . . @ . . . . @ . . @ . . . . . . @ . . . . . . @
@ . . . . @ . . . @ @ . . . @ @ . . . . @ @ . . . @ . . . @ . . . . . . . @ . . . . . . . . . . . . . @ @ . . . . . @ . . . @ . . @ . . . . @ . . . . . . . . . . . . . . . @ . . . . . . . . @ @ . @ @
@ . . @ . . . . . . . . . . . . . . . @ . @ . . . . . . . . . @ . . @ @ . . . . . . @ . . @ @ . . . . . . . . @ . @ . . . . . @ . . . . . . @ . . . . @ . . . . . . . . . @ . . . . . . . . . . . . . @
@ @ @ @ @ @ @ @ @ @ @ @ @ @ @ @ @ @ @ @ @ @ @ @ @ @ @ @ @ @ @ @ @ @ @ @ @ @ @ @ @ @ @ @ @ @ @ @ @ @ @ @ @ @ @ @ @ @ @ @ @ @ @ @ @ @ @ @ @ @ @ @ @ @ @ @ @ @ @ @ @ @ @ @ @ @ @ @ @ @ @ @ @ @ @ @ @ @ @ @
3
92 75 55 3
17 48 91 80
18 36 37 44
