50 50
@ @ @ @ @ @ @ @ @ @ @ @ @ @ @ @ @ @ @ @ @ @ @ @ @ @ @ @ @ @ @ @ @ @ @ @ @ @ @ @ @ @ @ @ @ @ @ @ @ @
@ . . . . . . . . . @ @ . . . . . @ . . . . . . . . . . . . @ . . . @ . . . @ @ . . . . . @ . . . @
@ . . . @ . . @ . . . . . . . @ . . . @ . . . . . . . . . @ . . @ . . . . . @ . . . . . . . . @ . @
@ . . @ . . @ . . . . . @ . . . . . . . . . . . . @ @ . . . . . . . @ . . @ . @ @ . . . . . . . . @
@ . . @ . . . . . . . @ . . . @ . . . . . . . . @ . . . @ . . @ @ . . . @ . . . . . . . . . . . . @
@ . @ . . . . . . . . . @ . . @ . . . . . . . . . . . . @ . . . . @ . . . . . . . . . . . . . . . @
@ @ @ @ . . . @ @ . . . . . . . . . . . . . . @ . . @ . @ . . . . @ @ . . @ . . . . . . @ . . . . @
@ . @ . . . . . . . @ @ . . . . . . . . . . . . . . @ . . @ . . . . . . . . @ . . . @ . @ . . @ . @
@ . @ . . . @ . @ . . . . . . . . . @ . . . . . @ . . . . . . . . . @ . . . . . . . . . . . . @ . @
@ . . . @ . . . . . . . . . . . . @ . . . @ @ . . . . @ . . . . . . . @ . . . . . . @ . . . . . @ @
@ @ . . . . . @ . . . . . . @ . . . . . . . . . . . @ . . @ . . . . . . . @ . . . . . . . . . . . @
@ @ . . @ . . . . . . . @ . . . @ . . . . . . . . . . . . . . @ . . . . @ @ . . . . . . . . . . . @
@ . . . . . . . @ . . . . . @ . . . . . . . . @ . . . . . . . . . . . . . . . . . @ . @ . . @ . @ @
@ . . . @ . . . . . . @ . @ . . . . @ . . . . . . . . @ . . . . . . . @ . . @ . @ . . . . . . . . @
@ . . . . . . . . . . @ @ . . . . . . . . @ . . . . . @ . . . . . . . . . . . @ . . @ . @ . @ . . @
@ . @ . . . @ . . @ . . . . . @ @ . . . . . @ . . . . . . @ . . @ . . . . . . . @ . . . . . . . . @
@ @ . @ @ . . . . . @ . . . . . . . @ . . . . . . . . @ . . @ . . . . @ . . . @ @ . . . . @ . . . @
@ . . . @ . . . . . . @ . . . . @ . @ . . . . . . . . . . . . . . . . . @ . . @ . . . . . . . . . @
@ . @ . . . @ . @ . . . . . . @ . . . . . . . . @ . . . . @ @ @ . . . . @ @ . . . . . @ . . . . . @
@ . . @ @ . . @ . . . @ . . . @ . . . . . . . . . @ @ . . . . . . . @ . @ . . . . . @ . . . . . . @
@ @ @ . . @ . . @ . . . . . . . @ . @ . . . . . . . @ . . . . @ . . . @ . . . . . @ . . @ . . . . @
@ @ . . . . . . . . . . @ @ . . @ . . . @ @ @ . . . @ . . . . . @ . . . . . . @ . @ @ . . . . . . @
@ . . . . . . . . . . . . . . . . . . @ . . . @ . . . . . . . . @ . . @ @ . . . . . . . @ . @ . . @
@ . . @ . . . @ . . . @ . . @ . . . . . . . @ . . . @ . . . . . . . . . @ . . . . . . . . . . . . @
@ . @ @ . . @ . . . . . . . . . . . . @ . . @ . . . . . . . . . . . . . . . . . @ . . . . . . . @ @
@ . @ . @ . . . @ . . @ . . . . . . . . . . . . . . . . @ . . . . . . . . @ . . . . . . . @ . @ . @
@ . . . . . . . . . . . @ . . . . . . . . . . . . . . @ . @ . . . . . @ . . . @ @ . . . . @ @ . . @
@ . @ . . @ . . . @ . . . . @ . . @ . . . . . @ . @ . . . . . . . . . . . . . . . . . @ . . . . . @
@ . . . . . . . . @ . . @ . . @ . . @ . . . . . . . . . @ . . . . . . . . . . . . . . . . . . . . @
@ @ . . . . . . . @ . @ . . . . . . . . . . . . @ @ . @ . . . . . . . . @ . . . @ . . @ . . . @ @ @
@ @ @ . . . . @ . @ @ . @ . . . . @ . @ . . . . . . . . @ . . . . . . @ . . . . . . . @ . . . . . @
@ . . . @ . . . . . . @ . @ @ . . @ . @ . . . . . . . . @ . . . . . @ . . @ . . . . . . . . @ . . @
@ . . . . . . . . . @ . . . . . @ . . . . . . . . . . @ . . . . . . . . @ . . . . . @ . . . @ . . @
@ . . . . . @ . . . . @ @ . . . . . . @ @ . . . . @ . . . . . . . . @ . . . . . . . @ . . @ . . . @
@ . @ . . . . . . . . . @ . . . . . @ . . . . @ . @ . . . @ . . . . . . . . . . . . . . . . @ . . @
@ . . . . @ . . . @ . @ . . . . . . . . . . . . @ . . . @ . . . . . @ . . . . @ . . . . . . . . . @
@ . @ . . . . @ . . @ @ . @ . . . . @ . . . @ . . . . . . . . . @ . . . . @ . . . . . . . . . . . @
@ . . @ . . . . . @ @ . . . @ . @ . . . . . . . . . . . . . . . . @ . . . @ . . . . . . . . . . . @
@ . . . @ @ . . . . . . . . . . . . . @ . @ . . . . . . . . @ . . . . . @ . @ . . . . . @ . . . . @
@ . . @ . . . . @ . . . . . @ . . . . . @ . . . . . . . . . @ . . . . . . . . . @ . . . . . @ . . @
@ . . . . . @ . . . . . . . . . @ . . . . . @ . @ . . . . . . . @ . . . . . . . @ . . . . . . . @ @
@ . @ . . @ . . @ . @ . . . @ @ . @ . . @ . . . . . . . . . . . . . @ . . . . . . . . . . . @ . @ @
@ @ . . . @ . . . . . . @ . @ . . @ . @ . . . . . @ . . . @ . . . . @ . . . . . . . . @ @ @ . . . @
@ . . @ . . @ . @ @ . . . . . . . . . . . . @ . @ . . @ . @ . . . @ . @ . . @ . . . @ . . . @ . . @
@ . @ . . . . . @ . . . . . . . . . . @ . @ . . . . . @ . . . . . @ . . @ . . . . . . . . . @ . . @
@ . . . . . . @ . . . . . . . . . . . . . @ . @ . @ . . . . . . . . . . . @ . @ @ . @ . @ . . @ . @
@ . . . . . . . . . @ . . . . . . . . @ . . @ . . @ . . . . @ . . . . . . . . @ . . . . @ . . . @ @
@ . . . . . . @ . @ . . . . . . . . . . . . . . . . @ . @ @ . . . . @ . . . @ . @ . . . @ @ . . . @
@ . . . . . . . . . . . . . . @ . . . . . @ . . @ . . @ . . @ @ . . . . @ . @ . . . . . . . . . . @
@ @ @ @ @ @ @ @ @ @ @ @ @ @ @ @ @ @ @ @ @ @ @ @ @ @ @ @ @ @ @ @ @ @ @ @ @ @ @ @ @ @ @ @ @ @ @ @ @ @
3
2 35 9 12
10 21 13 48
45 20 4 27
