100 100
@ @ @ @ @ @ @ @ @ @ @ @ @ @ @ @ @ @ @ @ @ @ @ @ @ @ @ @ @ @ @ @ @ @ @ @ @ @ @ @ @ @ @ @ @ @ @ @ @ @ @ @ @ @ @ @ @ @ @ @ @ @ @ @ @ @ @ @ @ @ @ @ @ @ @ @ @ @ @ @ @ @ @ @ @ @ @ @ @ @ @ @ @ @ @ @ @ @ @ @
@ . . . @ . . . . . . @ . . . . . . . . . @ . . . . . @ . . . . . . . . . . . . . . . . . . . . . . . . . . . . . @ . . . @ . @ . @ . . . . . . . . . @ . . @ . . . . . . . . . . . . . . . @ . . . . @
@ @ . . . . @ . @ . . @ . . . . . . @ . . . . @ @ @ . . . @ . . . . . . . . . . @ . @ . . . . . . @ . . . . @ . . . . . . . @ . . . . . . @ @ . . . @ . . . . . . @ @ . . . . @ . . . @ . @ . . @ . . @
@ . . . . . . . . . . . . . . . @ . . . @ . . . . . . . . . . . . . @ . . . . @ . . . @ . @ . . . @ . @ . . . . . . . @ . . . . . . . . . . @ . . . . . . . . . . . . . . . . @ . . . . @ . . . . . . @
@ . . @ . . @ . . @ . . . @ . . . @ . . . . . . . . . . . . . . . . . . . . . . . @ . @ . . . . . . . . . @ . . . . @ . @ . . . . @ . . . . . . . . . @ . . . . . . @ . . . . . . . . . . . . . . . . @
@ . . . . @ @ . @ . . . . . . . . . . . . . . . . . . . . . . . . . . . . . . . @ . . . . . @ . . . . . . . . . . . . . . . . . @ @ . . @ . . . . @ . . . . . . . @ . . . . . . . @ . . . . . . . . . @
@ . @ . . @ . . . . . . . @ . . . . . . . . . @ . . . . @ . . . @ . @ . . . . . . @ . . @ @ . @ . . . @ . . . @ . . . . . @ . . . . . . . . @ . . . @ . @ . . @ @ . . . . . . . . . . . . @ . . @ . . @
@ . @ . . @ . . . . . . @ . . . . . . . . @ . . . . . . . . . . . @ @ . . . . . . . . . @ @ . . . . . @ . . . . . . . . @ . . . . @ . . @ @ . @ . . . . . . . @ . . . @ . . . . . . . . . . . . . . . @
@ . @ . . . . @ @ . . . . . . . . . . . . . . . . . . . . . . @ . . . . @ . . . . . . . . . . . @ . @ . . . . . @ . @ . . . . . . . . @ . . . . @ @ . . . . @ . . @ @ . @ . . . . . . . . . . . . . . @
@ . . . . . . @ . . . @ @ . . . . . . . @ . . @ @ . . . . . . . @ . . . . @ . . @ . . . . . . . . . . . . . . . . @ . @ . . . . @ . . . @ @ . @ . . @ . . @ @ . . . . @ . . . . @ . . . @ . . . . . . @
@ . . @ @ . . . . . . . . . . @ . . . . . . . @ @ . . . @ . @ @ . . . @ . . . . @ . @ . . . . @ . . @ . . . . . . . . . . . . . . . . . . . . . . . . . . @ . . . . @ . . . @ . . . . . @ . . @ . . . @
@ . . . @ . . . . . . . . . . @ . @ @ . . . . . . . . @ . @ @ . . . . . @ . . . . . . @ . . . . . . @ . . . . . . . @ . @ @ . . . . . . . . . . . @ . . @ @ . @ . @ . @ . . @ . . . . @ @ . . . . . . @
@ . . . . . . . . . . @ . . . . @ . . . . . . . @ . . . . . . . . @ . . . . @ . . . . . . . . . . @ @ . @ . . . . @ . @ . . . @ . @ . . @ . . . . . . @ . . . @ . @ . @ . . . . @ . @ . @ . . . . . . @
@ . . . . . . . . . . . . @ . . . . @ . . . . . . . @ . . . . . @ . @ . . . @ . . . . @ . . . . . . @ @ . . @ . . . . . . . . @ . . . @ . . @ . . @ . . . . . . . . . @ . . . . . @ . . . . . . @ . . @
@ . . . . . . . . . . . . . @ . . . . . . @ . . . . . . . @ @ . . . . @ @ . . @ @ . . . . . . . . . . . . @ @ . @ . @ . @ . . . . . . . @ @ . . . . . . . . . . @ . . @ . . . . . . . . . . . . . . . @
@ . . . . @ . @ . @ . . . . . . . . @ . . . . . . . . . . . . @ . . . . . @ . . . . . . . . . @ . . @ . . . . . . @ . . . . @ . . . . . . @ @ . @ . . . . @ . . . . . . . . . . . . . . . . . . . . . @
@ . . . @ @ . @ . . . . . @ . . . . . @ . . . . . @ . . . @ . . . . . . @ . . . @ . . . . @ . . @ @ . . . . . . @ . . @ . . . @ . . . . . . . . @ @ . . . . . @ . . . . @ . . . . @ . . . . . . . . @ @
@ @ . . . . . . . . @ . . . . . . . . . . . . . . . . . . . . . . . . @ . . @ . . @ . . @ @ . . . . . . . . @ . . . . . . . @ . @ @ . . . . @ . . . . . @ . . . . @ . . . . . . . @ @ . . . . @ . . . @
@ . . @ . . . @ . . . . . @ . . . . @ . . . . . . . . . . . . . . . @ . . . . . @ . @ . . . @ . . . . . . . . . . . @ . . . . . @ . . . . . . . . . . . . . . . . . @ . . . . . . . . . . @ . . . . @ @
@ . @ . . . . . . . . . . . . @ . @ . . . @ . . @ . . . . @ . . . . @ . . @ . . . . @ . . . . . . . . @ . . . . . . . @ . . @ . . . . . . . . . @ . . . . . . @ . . . . . @ . . . . @ @ . . . . @ . . @
@ . . @ . @ . . . . @ . . @ . . . . . . . . . . . . . . . . . . . . . . . . . . . . . . . . . . . . @ . . . . . . . . . @ . . . @ . @ . . . . . . @ . . . . . . . . . . . @ . . . . . . . . . . . . . @
@ . . . . . . . . @ . @ . . . . @ . . . . . . . . . @ . . . . . . . @ @ . . . . . . . . @ . . . . . . @ @ . . . . . @ . . @ . . . . . . @ @ . @ @ . . . @ . . . . . . @ . . . . . . @ . . @ . . . . . @
@ . @ @ . . . . . . . @ . . @ @ @ . . . . . . . . . . @ . . @ . . . @ . . . . . . . . . . . . . . @ . . . @ . @ . . . . . . . . @ . . . . . . . . . @ . . @ . . . @ . . . . . . . @ . . . . . . . . . @
@ . @ @ @ . . . @ . @ . @ . . . @ . . @ . . @ . @ . . . . . . . . . . @ @ . . . @ . . . . . @ . . @ . . . . @ . . . . . . . . @ . . . . . . . . . . . . . . . . . . . . . . @ . . . @ . . @ . . . . @ @
@ . @ . . . @ . . . . @ . . . @ . . @ . @ . . . . . @ . . . . . . . . @ . @ @ . @ . . . . . . . . @ . @ . . . . @ . . . . . . . @ . . . . . . . . @ . . @ . . . . . . @ . . @ . . . . . @ . . . . . @ @
@ . . . . . . . @ @ . . . @ @ . . @ . . . . . . . . . . @ @ . . . . . . . . . . @ . . . . @ @ . @ . @ @ . . . . . . @ . . @ . . . . . . . . . . . . . . . . . . . . . @ . @ @ . @ . @ . . . . . . . . @
@ . . @ @ . @ . . . . @ . . . @ . . . . . . . @ @ . . . . . @ . @ . . @ . . . . . . . . . . . @ . . . @ . @ . . . . . . . . . . . . @ . . . . . . . . @ @ . . . . . . . . . . . . . . . . . . @ . @ . @
@ . . . . @ . . . @ . . . @ @ . . . . @ . . . @ . @ . . . . . . @ . @ . . . . . . . . . . . @ . . . . . . . . . @ . . @ . . . @ . . . . . . . . . . . . . @ . . . @ . . . @ @ . . . . @ . . . . . . . @
@ . . @ . . . . . @ . . . . . . . . @ . @ . . . . . . . . . . . @ . . . @ . . . . . @ @ . @ @ . @ . . . @ . @ . . . . . . . . . @ . . . . @ @ . . @ @ . . . @ . @ . @ . . . @ . @ . . @ . . @ . . . . @
@ . @ . . . . . . . . . . . . . @ . . . . . . . @ @ . . . @ . . . . . . . . . . . . . @ . @ . @ . . . @ . . . . @ . . . . . . . @ . . . @ . @ . . @ . . . . . @ . . . . @ . . @ . . . . . . . . . . . @
@ . . . . . @ @ @ . . @ . . . . . . . . . . . . . . . @ @ . . . . @ . . . . . . @ @ . . . . . . . . . . . . . . . . . . . . . . @ . . . . . . @ . . . . . . . . . . . . . . . @ . . . . . . . . . . . @
@ . . . . . . . @ . @ . @ . . . . . @ . @ @ . . . . . @ . . . . @ . . . . . . @ . @ . . @ . . . . . . . @ . . . . @ . . . . @ . . . @ . . . . . . . . . . . @ @ . @ . . . @ @ @ @ . . @ . . . @ @ . . @
@ @ . . @ . . . . . . . . . @ @ . . . . @ . . . . . . . @ . . . . . . @ . . . . . . . . . . @ . . . . . . . @ . . . . @ . . . . @ . . . @ . . . . . . . . @ . . @ . . . . . . . . @ . . @ . . . . . . @
@ . . . . . . @ . @ . . . . . . @ . . . . @ . . . . . . . @ . . . . . @ . . . @ . . . . . . . . . . @ . . . . . . . . . . @ . @ @ . . . . @ . @ . @ . . . . . . @ . . @ . . . . . @ . @ . . . . . . @ @
@ . . @ . . @ . . @ . . . . . . . . . . . . . . . . . . . . @ . . . . @ . . . . . . @ . @ @ . . . @ . . . . @ . @ @ . . . . . . . . @ . @ . . . . . . . . . . . . . @ . . . . . . . @ . . . . . . . . @
@ . . . . . . . . @ . . . @ @ . . . . @ . . . . . @ . @ . . . . . . @ . . . . . . @ . . @ . . . . . . . . . . @ @ . . @ @ . . . . . . . . . . . . . . . @ . . @ . . . @ . . . . . @ . . . . . @ . . @ @
@ . . . . . . . . . . . . . . @ . @ . . @ . . . @ . . . . . . . @ . @ . . @ . @ . . . . . . @ . @ @ . @ . . . . . . . . . . @ . . @ . . . @ . @ . @ . . @ . . . . . @ . . . . @ @ . . . . . . . . @ . @
@ . @ @ @ . . . @ @ . . @ . . @ . . @ . . . . . @ . @ . . . . . . . . . @ . . . . . @ . . . @ . . @ . . . . . @ . . . . . @ @ . . . . . . @ . . . . . @ . . . . . . . . . . . . . @ . . . . @ . . @ . @
@ . . @ . . . . @ . . . . @ . . . . . @ . . . . . . . . . . . . . . . . . . . . . . @ . . @ . . @ . . . . @ . . @ . @ . . . . . . . . . . . . @ . . . . @ . . . . @ . . . . @ . . . . . . . . . . . . @
@ . @ @ . . . . . . . . . . . . . . . . @ . . . @ @ . . . . . . . . . . . . . . . . . . . . @ . . . @ @ . . . . . . . @ @ . . @ . . . . @ @ . . . . . @ . . . . . . . . @ . . @ . . . . @ . . . @ . . @
@ @ . . @ . . . . . @ . . . . . . . . @ . . . @ . . . . . . . . . . . @ . @ @ . . . . . . . . @ . . . . . . . . . . . . . . . . . . . @ . . . . . . . . . @ . . . . . . @ . @ . . . . . . . . . . . . @
@ . . . . @ . . . . . . . . . . . . . . . . . . . @ . . . . . . . . . . . . . @ . . . . . . . @ . . . @ . @ . . . . . . . . . . . @ . . . . . . . @ . . . . . . . . @ . . . @ @ . . @ . . . . . . @ . @
@ @ . . . @ . . . . . . . . @ . @ . @ . . . . . . . @ . . @ . . . @ . . . . . . . . . . @ . . . . . . . . . @ . . . @ @ . . . @ @ . . . . @ . . . @ . . . . @ . . . @ . @ @ . . . . @ . . . . . . . @ @
@ . @ . . . @ . . . . . . . . . @ @ . @ . . . . . @ . . . . . . . . . @ . . . . . . . @ . . . . . . . . . . . . @ . @ . . . . @ . . . . . . . . @ . . . . @ . @ . . . . . @ . . . . . . . . . . . . . @
@ . @ . . . . . @ . @ . @ . . . . @ . . . . . . . . . . . . @ . @ . . . . . . . . @ . . . @ . . . . . . . . @ . . @ . . @ . @ . . . . . @ . @ . . . . . . . . . . . @ . . @ . . . . . @ . . . @ . . @ @
@ . . . . . . . . @ . . . @ @ . . . @ . . . . . . . @ . . @ . . . . . . @ . . . . @ . @ @ . . . . . . . @ . . . . @ . @ . @ . @ @ . . @ . . . . . . . . . . . . . . . . . . . . . @ . . . @ @ @ . . . @
@ . . @ @ . . . . . . . @ . @ . . @ . @ . . @ . . . . . . . . . . . . . . @ . . . . . . . . . . . . . @ . . . . @ . . . . . @ . . . . @ . . @ . @ . @ . . . @ . . @ . . @ . . . . . @ @ @ . . @ . . . @
@ . . . . . . . . . . . . . . . @ . . . . @ . . . . . . . . . @ @ . @ @ @ . . . . . @ . @ . @ . @ @ . . . . @ . . . . . . . . . . . . . . . . . . . . . . . . @ . . . @ . . . . . . . . . @ . . . @ . @
@ . . . . . . . . . . . . . . . @ . . . . . . @ . . . . . . . . . . . . @ . . . . . . . . . . . . @ . @ . @ . . @ . . . . . . . . @ . . . @ . @ . . @ . . @ . @ . @ @ . . . . @ . . . . . . . . . . . @
@ . . . . @ . . . . . @ . . . . @ . . . . . . . . . @ . . . . . . . . . . @ . @ @ . . . . @ @ . . . . . @ . @ . . . @ . . . . @ . . . . . . . . . . . . . . @ . @ . . . . . . . @ . . @ @ . . . . . . @
@ . . . . . . . . . . . . . @ @ . . . @ . @ . . . . . . . . . . . . . . . . . @ . . @ . . . . . . . @ . . @ . . @ @ . . . . @ . @ . . . . . . . . . . @ . @ . . . @ . . . @ . . . . @ . . @ . . . . . @
@ . . . @ . . . . . @ @ . . . . . . @ . . . . . . . . . . . @ . @ . . . . . @ . . . . . . . @ . . . . . . . . . @ . . . . . . . . . . . . . . . @ @ . . . . . . @ . @ . . . . . . @ . . . . . . . . . @
@ . . . . . . . @ . . . . . @ . . . . . @ . . . . . . . . . . . . . . @ . . . . @ . . @ . . . @ @ . . @ . . . . . @ . . . @ . . . . . . . . @ . @ . . . . . . . . . . . @ . . . . . @ . @ . . @ . . . @
@ . . . . . . . @ . @ . . . . . . @ . . . . . . . @ . . @ @ @ . . . . . . @ . . . . @ . . @ . @ . . . @ . . @ . @ @ . @ . . . . . . . . . @ . . @ . . . . @ . . . . . . . . . @ @ . . . @ . . . . . . @
@ . @ @ . . . . . . . . . @ . . . . @ . . . . @ . @ . . . . . @ . . @ . @ . @ . . . . . @ . . . . @ . @ . . . . . @ . @ . . . . . @ . . @ @ . . . . . @ . . . @ . . . . . . . . @ . . . . . . . . . . @
@ . . @ . . . . @ . . . @ . @ . . . . . @ @ . . . . . . @ . @ . . @ . . . @ @ @ . @ . . . . . . . . . . . @ . . . @ . . . . . . @ @ . . . . . . . . . . @ . . @ @ @ . . . @ . . . . . . . . . . . . . @
@ @ . . . . . . . . @ . . @ . . . . @ . @ . . @ . @ . . . . . . . . . @ . . . @ . @ . . . . . @ . . . . @ . . . @ . . @ . . . . @ @ . . @ @ . . . . . . . . . @ @ . @ . . . . . . . . . . . . . @ . . @
@ . . . @ . @ . @ . . . . . . . . . @ . . @ @ . . . . . . . . . . . . @ . . . . . @ . . . . . . . . . . . . . . @ . . . . @ . @ . . . . . @ . . . . @ . . @ . . . . . . @ . . . . . . . . . . . . . . @
@ . . . . @ . @ . . . . . . . . . . . @ . . . . . . . @ @ . . @ . . . . . . . . . . @ . @ @ . . . . . @ @ . @ . . @ . . . . . . . . @ . . . . . . @ . @ . . . . . @ . . . . @ . . @ . . . . . . . . . @
@ . . @ . . @ . . . . . @ @ . . . . . . . . . . . @ @ . @ . . . . . @ . . @ . . @ . . @ . . . @ . . . @ . . . . . . . . . . @ . @ @ . . . @ . . . . . . . @ . . @ . @ . . . . . . . . . @ . . . . . @ @
@ . . . . . @ . . . . . . . . . . . . @ . @ @ . . . . . . . . . . . . @ @ @ . . @ . . . . . @ . @ . . . @ . . . . . . . . . . . . . . @ . . @ . @ . . . . . . . @ . . . . . . . . . . . @ . . @ @ . . @
@ . @ . . . @ . . . . . . @ . @ . . . . . . . . @ . . @ . . . @ . @ @ . @ . . . . @ . @ @ . . @ . . @ . @ . @ . . . . @ . @ @ . . . @ . . . . . . . . . . @ . . . . @ . . @ . . . . . . @ . . @ . . . @
@ @ . . . . . . @ . . . . . . . . @ . . . . . . . @ . @ . . . . . . . . . . @ . . . @ . . . . . . . . @ . . . @ . . . @ . . . . @ . . . . . . . . . . . . @ . . . . . . . . . . @ @ . @ . @ . @ . . . @
@ . @ . . . . @ . . . . . . . . . . @ . . . . . . @ . . @ . . . @ . . . . . . @ . . . . . . . . @ @ @ . . . . @ . . . . . . . . . . . . . . . . . . . . . . . @ @ . . . . @ . . . . . . . @ . . @ . . @
@ @ . . . @ . . . . . . . @ . . . . . . . . . . @ . . . . . . . . . . . . . @ . . . . . @ . @ . @ . . . . . . . . . . . . . . @ . @ . . . . @ . . . . . @ . . @ @ @ . @ . . . . @ . . . . @ @ . . . . @
@ . . . . . . @ . . . . . . . @ . . . . . . . . @ . @ . . @ . @ . . . . . @ . . . . . . . . @ . . . . . . . . . . @ . @ . . . . . . . . . . @ . @ . @ . . @ . . @ . . @ . . @ . . . @ . . @ . . . . . @
@ . . . . @ @ . . . . . . @ . . @ . . . . . . . . . . @ . . . . . . @ . . . . . . @ . . . @ . @ . . @ . . . . . . . . . . . . . . . . @ . . . . . . . . . . @ . . . . . . . @ . . . . . . . . . @ . . @
@ . . @ . . . . . . . . . @ . . @ . . @ @ @ @ @ . @ @ . . . @ . . @ . . @ . . @ @ . . . @ . . . . . . . . @ . . . . . . . . @ @ @ . . . . . . . . . . . @ . . . @ . @ . . . @ . . . . . . @ . @ . . . @
@ . . . @ . . . . . . . . . @ . @ . . . . @ . . . . . . . @ @ . . @ . . . . . . . . . . . . . . . . . . . . . . @ . . . . @ . . . @ . . . @ . . . . . . . . @ . . . . @ . @ . . @ . . . . . . . . . . @
@ . . . . @ . . . . @ . . . . @ @ @ . . . . @ . . . . . . . . . @ . . . . . @ . @ . . . . . @ . . . . . . . @ . . . . . . @ . . . . @ . . . . . . . . . . . @ . . @ . . @ @ . . . @ @ . . @ . @ . . @ @
@ @ . @ . . . . @ . @ . . . . . . . @ . . . @ . . @ . . @ . @ . . . . . . . . @ . . . @ @ . . . . . @ . . . . @ . . . . . . . . . @ @ . . @ . . . . . . @ . . . . . . . . . . . . . @ . . . . . . . . @
@ . . . . . . . @ . . . @ @ . @ . . . . @ . . @ . @ . . @ . . . . . . . . . . . . . . . . @ . @ . . . . . . . . . . . . . . @ . . . . @ @ . . . . . . @ . . . . . . . @ . . . . . . @ . . @ . @ . . . @
@ @ @ . . . . . . @ @ . . @ . . @ . . @ . . . . . . . . . . . . . . . @ . . . . . . . . . @ . . . . . . . . . @ . @ . . . . . . . @ . . . . . . . . @ . @ . . . . . . . . . . . . @ . . . . . . . . . @
@ . . . . . . . . @ . @ . @ . @ . . . . . @ . . . . . . @ . . . . . . . @ . . @ . @ . @ @ . . . @ . . . . . . @ . . . . @ . . . . @ . . . . . . . . @ . @ . . . . @ . . . @ . . . . . . @ . . @ . @ . @
@ . . . @ . @ . @ . . . . . . . . @ . @ . . @ . @ . . . . . . . . . . . . . . . . . . . . @ . . . . @ @ @ . . . . . . . . . . . . . @ . . . . @ @ . . . . . @ . . . . . . . . @ . . @ . . . . . . @ @ @
@ . . @ . . . . . . . . . . . . . . . . @ . . . @ . . . . . . . . . . @ . . @ . . . @ . . . . . . . . . . . . . . . . @ . . . . . . . . @ . . . @ @ . . . . . . @ . . @ . . . . . . . . . @ . @ . . . @
@ . . @ . @ . . . . @ . . . . @ . . . . . @ . . . . . . @ . . . . . . . . @ . @ @ . @ . @ . . . . @ . . . . . . . . . . . . @ @ . . . . . . . . . . . . . . . . . . . . . . . . . @ . @ . . . . . . @ @
@ . @ . @ . . . . . . . . @ . . . @ . . . . . . . . . . @ . . . . . @ . . . . . . . . . @ . @ . . . . . . . . @ . @ . @ . . . . . . . . . . . @ . . . . . . . . . @ @ @ @ @ . @ . . . . @ . @ . . . . @
@ . . @ . . . . . @ . . . . . . . . . . @ @ . . . . . @ . . . . . . . @ . . . . . . . . . . @ . . . . . @ . . . . . @ . . . . . . @ @ . . @ . . . @ . . . . . @ . . @ . . . . . @ . @ . . . . @ . . . @
@ @ . @ . . . . . @ . . . . . . . . . . . . . . . . . . . . . . . . . @ . . . . . . . . . . . . @ . . @ . @ . . . . . . . . . . @ . @ . . . @ @ @ . . . . . . . . @ . . . . . . @ @ . @ . . . @ @ . . @
@ . @ . @ @ . . . . . . . . . . @ . . . . . . . . . @ @ . . . . . @ . . . @ . . . @ . @ . @ . . . . @ . . . . . . . . . . . . . . . . . . @ @ . . . . . @ @ . . . . @ . . . . . . . . . @ . @ . . . . @
@ . . @ . . . . . . . . . . . . . . . . . . . . @ . @ . . . @ . . . . . . @ . . . . . @ . . . . . @ . . . . @ . . @ . . @ . . . . @ . . . @ @ . . @ . @ . . . . . . @ . . . . . . . . @ . . . . . . . @
@ . . . @ @ @ . . . . @ @ . . . . @ . . @ . . . . . . . . @ . . . @ . . . @ . @ . . . @ . . @ . . . . @ . . . . . @ . . . . . . @ . . @ . @ . . . . . @ . . . . . . . . . . @ @ . @ . . . . . . . . . @
@ . . @ . . . @ . . . @ . . . . . . . . . . @ . . . . . . . . . . . . . . . . . . . . . . . . . . @ . . . . . . . . . @ . . . . @ . . @ . @ . . . . . . @ . . . . . @ . . . . @ . . . . . . . @ . . . @
@ . @ . @ @ . . . @ . . . @ . . . . @ . . . . . . . . . @ . . . . . @ . . @ . . . . . . @ . . . @ . . . . . . . @ . . . . . . . . . . . . . . . @ . . @ . @ . @ . @ . . @ . . . . @ . . @ . . . . . . @
@ . . . . . . . . . . . @ . . . . . . . . . . @ . . . . . @ . . . @ @ . @ . . . . @ . . . . . . . . @ @ . . . . . @ . . . . . . . . . . . . . . . . . . . . @ . @ @ . . . . . . . . . . . . . . . . . @
@ @ . @ . . . . . @ @ . @ . . . . @ . . . @ . . @ . @ . @ . . @ . . @ . . . @ @ . . @ @ . . . . . . . . @ . . . . . . . . @ . . . . @ . . . . @ . . . @ . . . . . . . . @ . @ . . . . . @ . . . . @ . @
@ . @ . . . . @ . . . . @ . @ @ @ . . . . . . @ . . . . . . . . . . . . @ . . . . . @ . . . @ @ . . @ . @ @ . . . . . . . . . . . . . . . . . @ . . . . . @ . @ @ . . . @ . . . . . @ . . . . . @ . . @
@ . . @ @ . . . . . . . . . @ . . . . @ . . . . . @ @ . . . . . . . . . . @ @ . @ . . . @ . . . . . . @ . . @ . . . . . @ . . . . . . . @ . . . . . . . . . . . . @ . . @ . @ @ . . . . . . . . . . @ @
@ . . . . @ . . . . . . . . . . . . @ . . @ . . . @ . . . . @ . . . . . . . . . . . . . . . . . . . . . . @ . @ @ . . . @ . . . @ . . . . . . . . . . . . . . . . . . @ . . . @ . . . . . @ @ @ . . . @
@ . . . . . @ . @ . . . . . . . . . . . . . . . . . . . . @ . . @ @ @ . @ . @ . @ . @ . @ . . @ . . . . @ . . . . @ . . . . . . . . . @ . . . . . . . . . . . . . . @ . . . . . . @ . . @ . . @ . @ . @
@ @ . . . . . @ . . . @ . . . . @ . . @ . @ @ . @ . . . . . . . @ . @ . . . . . . . . . . . . @ . . . . . . . . @ . . . . . . . . . . . . . . . @ . . . . . . . . . . . . . @ @ . . @ @ . @ . . . . . @
@ . @ . @ . . @ . . @ . . @ @ . . @ . . @ . @ @ . @ . . . . @ . . . . . . @ . . . . . @ @ . . . . . . @ . @ . . . . . . . @ . . . . . . @ . . . . . . @ . . . @ . @ . . . . . . . . . . @ . . @ . . . @
@ . . . . . . . . @ . . . . . . . . . . @ . . . . . . . . . @ @ . . . . . . . @ . . @ . . . @ . . . . . . . . . . @ . . @ @ . . . . @ . . . . . . . @ @ @ . . . @ . . . . . . . . . . . . . . . . . . @
@ . . . . . . . . . . . . . @ . @ . . . @ . . . . . . . . . . @ . . . . @ @ . . . . @ . . @ . . . . . . . @ . . . . . . . . . . . . . . . @ . . . . . @ . . . @ . . . . . . . . . . . . . . . @ . @ . @
@ . @ . . @ . . . . . . . . . . @ @ . . . . . . . @ . @ . @ . . . @ . . . . . . . . . . . . @ . @ @ . @ . . @ . . . . . . . @ @ . . . . @ . . . . . . @ . @ @ . . . . . . . @ . @ . . . . . . . . . . @
@ . . . . @ . . . . . . @ . . . . . @ . . . . . . . . . . . . . . @ . @ . @ . . . @ . . . . . . . . . . . . . @ . @ . . . @ . . . . . . @ . . . . @ . . . . . @ . . . @ . . . . . . . . . @ . . . . . @
@ . @ . . . . . . . . . . . . . @ @ . . . . . . . @ . . . . . . . . . . . . . . @ . . . . . . . . . . . . @ . . . . . . . . @ . . . . . @ . . . . . . . . . . . . . @ . @ . . @ @ . @ @ . . . . . . @ @
@ . . . @ . . . . . . . . . . . . . . . . @ . . . . . . . . . . @ . . . . . . . . . @ . @ . @ @ . . . . @ @ . . . . . . . . . . . . . . . @ . . . . . @ . . . . . . . . @ . . . . . . . @ . . . . . . @
@ @ @ @ @ @ @ @ @ @ @ @ @ @ @ @ @ @ @ @ @ @ @ @ @ @ @ @ @ @ @ @ @ @ @ @ @ @ @ @ @ @ @ @ @ @ @ @ @ @ @ @ @ @ @ @ @ @ @ @ @ @ @ @ @ @ @ @ @ @ @ @ @ @ @ @ @ @ @ @ @ @ @ @ @ @ @ @ @ @ @ @ @ @ @ @ @ @ @ @
3
61 1 5 7
1 74 53 91
46 57 3 9
