25 25
@ @ @ @ @ @ @ @ @ @ @ @ @ @ @ @ @ @ @ @ @ @ @ @ @
@ . . @ . . . . . . . . . . @ . . @ . @ @ . @ . @
@ . . . @ . . . . . . . . . . @ . . . . . . . @ @
@ @ @ @ . . @ . . . @ . @ . @ . . . . . @ . @ . @
@ @ . . . . . . @ . . . . . . . . . . . . . . . @
@ @ . @ . @ @ . . . @ . @ . . . . . . . . @ . . @
@ . @ . . @ . @ . . @ . . . . . . . . @ . . @ . @
@ . . @ . . @ . . . @ @ . . . . . . . . @ . . . @
@ . . @ @ . . @ . . . . . . . . . . . . . . . . @
@ . . . . . . . . . . @ . . . . . . @ . . . . . @
@ @ . @ @ . . . . @ . . . @ . . @ . @ @ . @ @ . @
@ . . . . . . . . . . . . . @ . @ . . . . . . . @
@ . . @ . . . @ . @ @ . . . . . . . . . @ . @ . @
@ . @ . @ @ . . @ . @ . . . . . . @ @ . . . . . @
@ @ . @ . . . . . @ . . @ . . . . . . . . . @ . @
@ . . @ @ @ . . . . . @ . . . . . . . . . . . . @
@ @ . . . . @ . . . . . @ . @ . . . . . . @ . @ @
@ . . @ . . . @ . . . . . . . . @ . @ . @ . . . @
@ @ @ . . . @ . . . . . . . . . . . . . @ . . . @
@ . . . . . . . . . . @ . . . @ . . @ . @ . . . @
@ @ . . @ @ . . @ . . . . @ . . . . . . . . . @ @
@ . . . . @ . . . @ . . . . . . . . . . . . . . @
@ . . @ . @ . . . . . . @ . @ . . . . . . . . . @
@ . . . . . . . . . . . . . . . @ . . . . . . . @
@ @ @ @ @ @ @ @ @ @ @ @ @ @ @ @ @ @ @ @ @ @ @ @ @
3
2 14 12 8
3 17 3 13
17 13 18 9
