100 100
@ @ @ @ @ @ @ @ @ @ @ @ @ @ @ @ @ @ @ @ @ @ @ @ @ @ @ @ @ @ @ @ @ @ @ @ @ @ @ @ @ @ @ @ @ @ @ @ @ @ @ @ @ @ @ @ @ @ @ @ @ @ @ @ @ @ @ @ @ @ @ @ @ @ @ @ @ @ @ @ @ @ @ @ @ @ @ @ @ @ @ @ @ @ @ @ @ @ @ @
@ . . . . @ . . . . . . . . @ . @ . @ . . . . . . . @ . . . . . . . . . . . . @ @ . . . . @ . . . @ . . . . . @ . . . . . . . @ . . . . @ . @ . @ . . . . . @ @ . . . . . . . . . . @ . . @ . . . . . @
@ . . . . . @ . @ . . . . @ . . . . . @ @ . . @ . . . . @ @ . . . . @ . . . . @ . . . . . . . @ @ . @ . . . . . @ @ . @ . @ . . @ . @ . . . . . . @ . . . . @ . . @ . . . @ . @ . . . @ @ . . . . @ . @
@ @ . . . . . . . . @ . . . . @ . . . . . . . . . . . . . . . . @ @ . . . . . . . . . @ . . . . . . . @ . . . . . . . . . . . @ . . . . . . . @ . . . . . . . . . . . @ . . . . @ . . . @ . . . . . @ @
@ . @ . . @ . . @ . . . . . @ . . . . @ . . @ . @ . . . . . @ . . . @ . . . @ . @ . @ . . . . . @ . . . . . @ @ . @ . . . @ . @ . . . . . @ @ . . . . . . . @ @ . . . . @ . . . . @ . . @ . . . @ . . @
@ . . . @ @ . . . @ @ . . . . . @ . . @ . . . . . . . . . . . @ . . . . . . @ . @ . . . . . . . . . . . . . . . . @ . . . . @ . . . . . . @ @ . . . . . @ . . . . . . @ . . . @ . . . . . . . . . . . @
@ . . . . . . . @ . . . . . @ . . . . . . @ . . . . . . . . . . . . . . . . . @ . . . . . . @ . . @ . @ . . @ . . . . . . . . . . . . . @ . @ . . . @ . . . @ . @ . . @ . . . . . . . . @ . @ . . . . @
@ @ . . . . . . . . . . . . . . @ . @ . . . . @ @ . @ . . . . . . . @ . . . . . @ . . . . . . . @ @ . . . @ . . . . . . . . . @ . . . . . . . . . . . . @ . . . @ . . . . . @ . . @ . . @ . . . . . . @
@ . . . . . . . . @ . . . . . . @ . . @ @ . @ . . . . . . . . @ . . . . . . . . @ @ . . . @ . @ . . . . @ . . @ . @ . . . . . . . . . . . . @ . @ . @ . . @ . @ @ . . . . . @ . @ . . @ . @ . . @ . . @
@ . . @ . . @ . . . . . @ . @ . . @ . . . . . . @ . . . . @ . . . . @ . @ . . . . . . . @ . . . . . @ . . . @ . . . . . . . . . . . . . @ . . . @ . . . . @ . . . . . . . . . . . . . . . . . . . . . @
@ . . . . . . . . . @ @ . . @ @ . . @ . . . . . . . . . . . . . @ . . . . . . . . @ . . . . . . @ . . . . . . . . . . . . . . @ @ . . . . @ @ . . . . . . @ . @ @ . . . . . . . . . @ . . . . . . . . @
@ . . . . . @ @ @ . . . . . . . . @ . @ . . . @ . . . . . . . . @ . . @ . . . . . . . . @ . . . @ . . @ . . . . @ . . . . . . . . . . . . . . . . @ . . . . . . . . @ . @ . @ . . . . . . . . . . . . @
@ . . . . . . . . . @ @ . . . . . . @ . . @ @ . @ . . . @ . . . . . . . @ . . . . . . . . . @ . . . . . . @ . . . . . . . @ . . . . . . . . . . . . @ . . . . . . . . @ @ . @ . . . . @ . . . . @ . @ @
@ @ . . . . . . . . . . . @ . @ . . . . . . @ . . . . . . . . . . @ . @ . . . . . . @ . . . . . @ . @ . . . @ @ . @ . . . . . . . . . . @ . @ . . . . . . . . . @ . . @ . . . . . . . . . . @ . . @ . @
@ . . . . . . . . . . . . . @ . @ . . . . . . . . . . . @ . . . . . . . . . . . . . . . @ . . . . @ . . . . @ . . @ . . . . . . . . . @ . . . . . . . @ . . @ . . @ . . . . . . . . . . . . . . @ . . @
@ @ . @ . . . @ . . . . . . . . . . @ . @ . . @ . . @ . . @ . . . @ @ . . . . . . @ @ . . . @ . @ . . . . . . . . . . . . . @ . . . . @ . @ . . . @ @ . @ @ . . . . . @ . . . . . . . . . . . . . @ @ @
@ . . @ . . . . . . @ . . . . . . . . . @ . . . . @ @ . . . . . . . . . . . . @ . . . . . @ . . . . . . . . . . . . @ . . . . @ . . . . . . . . . . . . . . . . . . . . . @ . . . . . . . @ . . . . @ @
@ . . . . . @ . . . . @ . . @ @ . . . . . . . . . . . . . . . . . . . . @ . . . . . . @ . . @ . . . . @ . . . . . @ . . . . . . . . . . . . . . . . . @ . . @ . . . . . . . . . @ . . . . . . . @ . . @
@ . . . . . @ . . @ . @ . . . . . . . . . . . . . . @ . . . . . . @ . . . . . . . . . . . . . . . . . @ . . . @ @ . @ . . . . . . @ . . . . . . . . . . . . . . . . . @ . . . @ . . @ . . . @ . . . . @
@ . @ . @ . . . . . @ . . . . . . . . . . . . . . . @ . @ . . . . . . . . . . @ . . . @ . . . . . . . . . . . . . @ @ . . . . . . . . . . . . @ . @ . . . @ . . . . . . . . . . . . @ @ @ . . @ . @ @ @
@ . . . @ . . . . . . . . . . @ @ . . . @ . . . . . . @ . . . . @ . . . . . . . @ . @ . @ . . @ . . . . . . . . . . . . . . @ . . . . . . . . . . . . @ . . . @ . . . @ . . . . . . . . . . . . . . . @
@ . @ . . . . . . . . . . @ . @ . @ . . . . . . . @ . . @ . . . . @ . @ @ . . . . . . @ . @ @ @ @ . . . . . @ . . @ . . . @ . . . @ . . @ . . . . . . @ . . . @ . . . . @ . . . @ . . @ @ . @ . @ @ . @
@ . . @ . @ . . . . . . . . . . . . . . . . . . . . . . . . . . . . . . . @ . . . . . . . . @ . . . . . . @ . . . . . . . . @ . . . . . . . . . . @ . . . . . . @ . . . . . @ . . . . . @ . . . . . . @
@ . @ . . . @ . . . @ . . . . . . @ . @ . . . . . . . . . . . . @ . . . . . . @ . . . . . . . . @ . . . . . . . . . . @ . . . . . . . . @ . @ . . . . @ . @ . . @ . @ . . . . . . . . . . . . . . . @ @
@ . . . . . . . . . . @ . . . @ . . . . . @ . . . . @ . . . . . . @ . @ @ . . @ . . . . @ . . . @ . . . . . . . @ . . . . . . @ . @ . . @ . . . . . . . . @ . @ . . @ . . . . @ . . . @ . . @ . . . . @
@ . . . . . . @ @ . . . . @ . . . @ . . . . . . . . . . . . . . . . . . . @ . . . @ . . @ . . . @ . . . . . . . . @ . . . . . . . . . . . @ . . @ . . . . . . . . . . . . . @ . . . . . . . @ . @ . . @
@ . . . . . . . . @ . @ . @ . . . . . . . . . . . . . . . . @ . . @ . @ . . . . . . . . @ . . . . . . . . @ . . . . @ @ @ . . @ . . . . . . . . . @ @ . . @ @ . @ . @ @ . @ . . . . . . @ . . . . . . @
@ . . . . . . . . . . @ . . @ . . . . . @ @ . @ @ . @ . @ . . . . . . . . . . . . @ . . . . . . @ . . . . . . . . . . . . @ . . @ . . . . @ . . @ . . . . . . . . . . . @ . . @ . @ . . . . . . . . . @
@ . . @ . . . . . . . @ . . . . @ . . @ . . . . . @ . . . . . . . . . . . . . . . @ @ . . . . . . . . @ . . @ . . . @ . . @ . . . . . @ . . . . . @ . . . @ . . . . @ . . . @ . . . . . . . . . . . . @
@ . . . @ . . @ . . . . . . . . . @ . . . @ . . . . . . . . . . . . . . . . . . . . . . . . . @ @ . . . . @ . @ . . @ . . . . . . @ . . . @ . . . . @ . @ @ . @ . @ . . . . . @ . @ . @ . . . . . . . @
@ . . . . . . . . @ . . . . @ . . . . . . . . . @ . . . @ . . @ . . . . . . . . . . . . @ . . . @ . . . . . @ . @ @ @ @ . . . . . . . @ . . @ . . @ . . @ . . . . . . . @ . . . . . . . . @ @ @ . . @ @
@ . . . . . . . @ . @ @ . . . . . . . . . . . . . . . . . . . . @ . @ @ . . . . . @ . . . . @ . . . . . . @ . . . . . . . . . . . . . . @ . . . @ . . . . . . @ . . . . . . . . . . @ . . . . @ . . . @
@ @ . . . . . . . . @ . @ . . . . . . . . . . . . @ . . . @ . . . . . . . @ . . @ . . @ . @ . . @ . . @ . . . . . . . . @ @ . . . . . . . @ . . @ . . . . . . . . . . . . . . . @ . . @ . . @ . . @ . @
@ . . . . . @ . . . . @ . . . @ . . . . . . . @ . . @ . . . . . . . . . . . . . @ . . @ . @ . . @ . . . . . @ . @ . . . . . . . . @ . @ . . . @ . . . . . @ @ @ . . . @ . . . . . . . . @ . . . . . . @
@ @ @ . . @ . . . @ . . . . . . . . . . . . . @ . . . @ . @ . @ @ @ . . . . . . . . . . . . . . . . . . @ . . . . @ . . . . . @ . . . @ . . . @ . @ . . . . . . @ . @ . . . . . . . . . . @ . . . . @ @
@ . . . . @ . . . @ @ . . . . . . . . . @ . . . . . . . . . @ . . . . @ . . . @ . @ . . . . . . @ . . . @ . . . . @ . . . . . . . . . @ . . @ . . . . . . . @ . . @ . . . . . . . . @ . . @ . . . . @ @
@ . . @ . . . . . . . . . . . @ @ . . . . . . . @ . . . . @ . . . . . . . . . . @ . . @ . . . . . @ . @ . . . . . . . . . . . . . . . . . . . . @ . . . . . . . . . . . @ . . . . @ . . @ . @ @ . @ @ @
@ . @ @ @ . . . . @ @ . . @ . . . . . . @ . . . @ . . . . . . . @ . @ . . . . . . . . . @ . . . . . . . . . . . . . . . . . @ . . . @ . . @ @ . . . @ . . . . . . @ . . . . @ @ @ . . . . . . . @ . . @
@ . . . . . . . . . . . . . . . . . . . . . . . . . . . . @ . . . . . . . . . @ . . . . . . . . . . . . . . . . . . . . @ @ . . @ . . @ . @ . . @ . . @ . . . . . . @ . . . . . . . . . . . . . @ . @ @
@ . . . . @ . . . . . . . @ . . @ . . . . . . . @ . . . . . . @ . @ . . @ . . . . . . @ . . . . @ . . . . . . . @ . . . . . . . @ . . . . . @ . . . . . . . . @ . . @ . . . . @ . . . @ . . . . . . . @
@ @ . . . . . @ . @ . @ @ . . . . @ . . . . . . @ . . . . . . . . . . . . @ @ @ . @ . . . @ . . . . . . . . . . . . . . . . . . . . @ . . . . . . . . . @ . @ . . . . . . . . . @ . @ . @ . . . . . . @
@ . . . . . . . . . . . . . . . . @ . @ . . . . . . . . . . @ . . . . . . . . . . . . @ . . . . . . . . . . . . . . . . . . . . . . . . . . @ . . . . . . . . @ . @ . . . . . . . . . . . @ . . . . . @
@ @ . @ @ . . . . . . . . @ . . @ . @ . . . . . . . @ . . . @ . @ . . . @ . . . @ . . . . . . @ . . . . . . . . . . @ . . . . . @ . . . . . . @ . . . . . . . . . . . . . . . . . @ @ . . . . . . . . @
@ . . . . . . . @ . . @ @ . . . . @ . . . . @ @ . . . . @ . . @ @ @ . . . . . . . . . . . . . @ . @ . . . . @ . . @ . . . . . . . . . . . . . . . . . @ . . @ . . . . . @ . . @ . @ . . . . . . . . . @
@ . . . . @ @ . . . . . . . . . . . . . . . . . . . . . . @ @ . @ . . . . . . . . . @ . @ . . . . @ . . . . . . . . . . . . . . . @ . . . . . . . . . . . . . . . . . . . . . . . . . . @ . . . . . . @
@ . . @ . . . . . . . @ . . . . . . . . . . . . . . . . . @ . @ . . @ . @ . @ . . @ . @ . @ @ . . . . . . @ @ . . . @ . . . . . . . . @ . . @ . . . . . @ . . . @ . . @ @ . . @ . . . @ . . . . . @ . @
@ . @ . @ . . . @ . . . . . . . . . . . . . @ . . . . . @ . @ . @ @ . @ . . . . . . . . . . . . . . @ . . . . @ . @ . . . @ . . . . . . @ . . . @ . . @ . . . . . . . . . . . . . @ @ . . . . . . . . @
@ @ . . @ . @ . . . . . . . . @ . . . . . @ . @ . . . . . . @ . . . @ . . @ . . @ . @ . @ . . . . . . . . @ . . @ . @ . . . . . . . @ . . . . . . . . . @ . . . . . . . . . @ . @ . . @ @ @ . . . . . @
@ . . . . . . . . @ @ . . @ . . . . . . . . . . . . . . @ . . . . . . @ . . @ . . . . . . . . . . @ . . . @ . . . . . @ . @ . . . . . . . @ . . @ . . . . . . @ . . @ . . @ . . . . . . . . . @ . . @ @
@ @ . @ @ . @ . . . . . . @ . . . . . . . @ @ . . . . . @ . . . @ @ . . . . . . . . @ @ . . . . . . . @ . @ . . . . . . . . @ . @ . . . . . . . . . . . . . . . . . . . . . . . @ . @ . . . @ . . . @ @
@ . . . @ . . . @ . . . . . @ . @ . @ . . @ . @ @ . . . . @ . . . . . . . . . . . @ . . . . . @ . . . . . . . . @ . . . . . . . . . . . . @ @ . . . . . . . . . . . . . . . . . . @ . @ . . @ . . . . @
@ . . . . . @ . . . . @ @ . . . . . . @ . . . . . @ . @ @ . . . @ . . . . . . @ . @ . . . . . @ . . @ . . . @ . @ . . . . . @ . . @ . . @ @ . @ . . @ . . . . @ . @ . . @ . @ . . . . . @ . . . @ @ . @
@ . @ . . @ . . . . @ . . . @ @ . . . . . @ . . . . . . . . . @ . @ . . @ @ . . . . . @ @ . . . . @ . . . . . @ . . @ @ . . @ . . @ . . . . @ @ . . . . . . @ . . @ . . @ . . . . . . . . . . . . . @ @
@ . . . . . . . . . . . @ . . . . . @ . . . . @ . . . . . @ @ . . . @ @ . . . @ . @ . . . . @ @ . . . . . . @ . . . . . @ . . . . . . . . @ @ . . . . . . . . @ . . . . . @ . . . . . . . . . . . @ . @
@ . . @ . . @ . . . @ @ . . . . . @ . . . . @ . . . . . . . @ . . . @ . . . @ . . @ @ . . . . . . . . . . . . . . . @ . . . @ . . . . . @ . . @ . . . . . . . . . @ . . . . . . . . . . . . . @ . . . @
@ . . . . . . . . . . . . . . @ . . . . . @ . . . @ . . . . . . . . . . . @ . @ . . . . . . . . . . . @ . . @ . @ . @ . . . . @ . . . . . @ . . @ . . . . . . . . . . . . . . . . . . . . . @ . @ . . @
@ . . . . . . . . . @ . . . . . . . . @ . . . . @ . . . . . . . . . . . . . @ . . . . . . . . . . . . . . . . @ . . @ . . . . . . . . @ . @ . . . . . . . . . . . . . . . . . @ @ @ . . @ . . . . . . @
@ . . . . . . @ . @ . . . . . . . . @ . . . . . . @ . . . . . . . . . . . . . . . . . . . . @ . . . . . . . . . . @ . @ . . . . . . . . . . . . . . . . @ . . . . @ @ . . @ @ . . . . @ . . @ . @ @ . @
@ @ . . . . . . . . @ . . . . . . . . @ . @ . @ . . . . . . @ . . . . @ . . . . . . . @ . . . . . . @ . . . . . . . . . . . . . . @ . . . . . . . . . . . . . . . . @ . @ . @ . . @ . . . . . . . . @ @
@ . @ . . . . . @ @ . . . @ . @ . . . . @ . @ . . @ . . . . @ . . . . . . @ . . . . . . @ . @ . . . . . . . . . . . . . . . . @ . . . @ . . . . . @ . . . . . . @ . . @ . @ . . @ . . . . . . . . . @ @
@ . . @ . @ . . . . @ . . . . . @ . . . . . @ . . . . . . @ . . . . @ . . . . . . . . . @ . . . . . . . . . . . . . . . . @ . @ . @ . . . . . . @ . . . . . . . . . . . . . @ @ . . . . @ @ @ . . . . @
@ @ . . . . . . @ . @ . . . . . . . . . . . . @ . . @ . @ . . @ . . . . . . @ @ @ . . . . . @ . . . @ @ . . . . . . . . . . . @ . . . . . @ . . . . . . @ . . . . . . . . . . . . . @ . @ . . @ . . . @
@ . . . . . . . . @ . . . . . . @ . . . . . . @ . @ . @ . . . . . . . . . . . . . @ . @ . . @ . . . . . @ . . @ . . . @ @ . . @ . . . . . @ . @ . . . . @ . . . . . . @ . . . @ . @ . . . . @ . . . @ @
@ . . . . . . @ . @ . @ . . . . . . . . . . @ . . . . . . . . @ . . . . . @ . . . . @ . . . . . . . @ @ . . . . . . @ . . . . . . . . . . @ @ . @ . . . . @ . . . . @ . . . @ . . @ @ . . @ . . . . . @
@ @ . . . @ . . @ @ . . . . . . . @ . . . . . . @ . . @ . . . @ @ . . . @ . . @ . . @ . . . . . . . . . . . . . @ . . . . . . . . . . . . . . . . . . . . . @ . @ . . @ . @ . @ . . . . . . . . . . . @
@ . . . . . . . . @ . . . . . . . . @ . . . . . . . @ . . . . . . . . . . . . . @ . . @ . . . . . . . . . . @ . @ . . @ . . . . . @ . . . . . @ . . . @ . . . @ . . . . . @ @ . . . . . . . . . . . . @
@ . . . . . . @ . . . @ . . . . . . . . . . . @ . . . @ @ . . . . . . @ . . . . @ . . . . . . . . . . @ @ . . @ . . @ . @ . . . . . . @ . . @ . . @ . . . @ @ . . . . . . . . . @ . . @ . . @ . . . . @
@ . . . . @ @ . . . . . . . . . @ . . . . . . . @ . . . . . . . . . . . . @ . . @ . . . @ . . . . . . . . . . . . . . . . . . @ @ . . . . . . . . . . . . @ . . . . . @ . @ . . . . @ . . . . @ . . . @
@ . . . . . . @ . . . . @ . . . . @ . . . . . . . @ . . . . @ . @ . . . . . . . . . . . . . . @ . . . @ . . . . . . . . . . . . . . @ . . . @ . . . @ . . . . . . . . . @ . . @ @ @ . . . . . @ . @ . @
@ . . . . @ . @ . . @ . . . . . . . @ @ . . . . . . . . . . . . . . . @ . . @ . @ . . . @ . . . . . . . . @ . . . . @ . @ . . . . @ . . @ . . . . . . . @ . . . @ . @ . . . . . . . . . . . . . @ . . @
@ . @ @ . . @ @ . . . @ . @ . . . @ . . . . . . @ . . . . . . . . . @ . . . . . . @ @ . . . . . @ @ . . @ . . . . @ @ . . . . . . @ . . . . @ . . . . . @ @ . . @ @ . . . . @ . . . . . . . . . @ . . @
@ . . . . . . . . . . . . . . . . . @ . . @ . . . . . . . . . . . . @ . . . . . . . . . . . . . . . . @ . . . . @ @ @ . . . . @ . . @ @ . . . . . . . . . . . . . @ . @ . @ . . . . . . . @ . . . @ . @
@ . . . . . @ @ . . . . . . . . @ . . . . . . . . . @ . . . . . . . . . . . . @ . . . @ @ . . . . @ . . . . @ . . . . . . . . . @ @ . . . . . @ . . . . . . . . @ @ . . @ . . . @ @ . . . . . . . @ . @
@ . @ . . . . . . . @ . @ @ . . . . . . . . @ . . . . @ . . . . @ . . . @ . . . . @ . @ . . . . . . . @ . . @ . . . . @ . @ . . . . @ . . @ @ . . @ . . . . @ @ . . . . . . . . @ . . . @ . . . @ . . @
@ . . . . @ . . . . . . . @ @ . . . . . . @ . @ . . . . . . . . . . . . . @ . @ . . . . . . @ . . . @ . . . . . @ . . . . . . @ . @ . @ . . . . . . . . . . . . . . . . . . . . . @ @ . . . @ @ . @ . @
@ . . . . . . . @ . . . . . . . @ . . @ . . . . . . . . . . @ . @ . . @ . . . . . . . . . @ @ . @ . . @ @ . . @ . . . . . . @ . . . . . . . . . . @ . . @ @ . . . . @ . . . . . . . . . . . @ . . . . @
@ @ . . @ @ . . . . . @ . . . . . . . @ . . . . . . @ @ @ @ . . . @ . . . . . . @ . @ @ . @ . @ . @ . . . . @ . . @ . . . . . @ . . . . @ . . . @ . @ . @ @ . . . . . . . . . . @ . @ . . . . . @ @ . @
@ . . . . . @ . . . @ @ . . @ . @ . . . . . . . . . . . . . @ . . @ . . . @ . . . . . . . @ . . @ . . . . @ . @ . . @ @ @ . @ . @ . . . . . . . . . @ . . . . . @ . @ . . . . . . . . . @ . . . . . . @
@ . . . . @ . @ . . . . . @ . @ . . . . . @ . . @ @ . . @ . . . @ . . . . . @ . . . . . . . . . . . . . . . . . . . . . . . @ . . . . . . . . . . . . . . . @ . . . . . . @ . . . . @ . . . @ . @ . . @
@ @ . . @ . . . . . . . . . @ . . . . . . . @ . . . . @ . . . . . . . @ . . . @ . @ . @ . . @ . . . . . . . . . @ . . . . . . . . . . . @ @ . . . . . . . . . . . . . . . . . . . . . . . . . . . . . @
@ . . @ . @ . @ . @ . . . . . . . . . . . . . @ . . . @ . . . . . . . @ . . . . . . . . . @ . . @ . @ . . . . . . . . . . . . . . . . @ . . . @ . . . . . . . . . . . . . . . . . @ . . . . . . . . . @
@ . . . @ . . . . . @ . @ @ . @ @ . . . @ . @ . . . . . @ @ . . . . . . . @ @ . @ . . . . . @ . . . . . @ . . . . . . @ @ @ . @ @ . . . @ . . . . . . @ . . @ . @ . . @ . . . . . . . . . @ . . @ . . @
@ . . . . . . . . . . . . . @ . @ . . @ . . . . . . . . . . . . . . . . . . . . @ . . . . . . @ . @ . . . . . . . . . . . . . . @ . . @ . . . @ . . . . . . . @ . . . . . @ . . . . . . @ . . . . . . @
@ . . . . . . . . . . . . . . @ . . . . . . . . . . . . . @ . . . . . . . . @ . . . . . . . . . @ . @ . . . . . . . . . . @ . . @ . . . . . . . @ . . . . . . . @ . . . . @ . . @ . . . . . . . . . . @
@ . @ . . @ . . . @ @ . . @ . . . . . . . @ . @ . . . . . @ . . . @ @ . . . . @ . . . @ . . . @ . . @ . . . . . . . . @ . . . @ . . . . @ . . . . @ . . . . @ @ . . . . . . . . . . . . . . . . . . . @
@ @ . . . @ . . . . . . . . . . @ . . . @ . . . @ . . . . . @ . @ . . . . . . . . . . . . @ . . . . . . . . . . . . . @ . @ . . . . . . . . @ . . . . . @ . . . . . . . . . @ . @ . . . . . . @ . . . @
@ . . . . . . @ @ @ . . . @ . . . . . . . . . . . . @ @ . . . . . . . . . . . . @ . . . @ . . . . @ . . . . @ . . . . . . . . . . . . . . . . . . . . . . . @ @ . . . . . . . . . . @ . . @ . . @ . . @
@ . . . . . . . . . @ . . . @ . . . . . . . @ . . @ @ . . . . . . @ @ . . . . . . . . . . . @ @ @ . . @ . . . . . . @ . . . . @ . . . @ . . @ . . . . . . @ . . . @ . @ . @ @ . . . . @ . . . @ . . . @
@ . @ @ @ . . . . . . . . . . . . . . . @ . . . . . . . . . @ . . . . . . . . . . . . @ . @ . . . . . . @ . @ . . . @ . . . . . . . . . . . @ . @ . . @ . . . . @ . @ @ @ . . . . @ . . . . . @ . . . @
@ . . . . . . @ . . . . @ @ . . @ @ . . . . . . . . . . . . . . . . . . . . . . @ . . . . . . . @ . @ . . . . . . . @ . . @ . . . @ . @ @ . . . . . @ . . . . . @ . @ . . . . . . . . . . . . . . . . @
@ @ @ . . . . . @ . . . . . . @ . . @ . . . . . . . . . . . . . . . . . . . @ . . . . . @ . . . . . . @ . . . . . . . . . . @ . . . . . . . . . . . . @ @ . . @ . . . @ . . . . . . . . . . . . @ . . @
@ . . . . . @ . . . @ . @ . . . . . @ @ . . @ . . @ . . . @ @ @ . . . . . . . . . . . . @ . . . . @ . @ . @ . . . . . . . . . . . . . . . . . . . . . @ . @ . @ @ . . . @ . . . @ . . . . . . . . . . @
@ . . . . . . . . . . . @ . @ @ . @ . . . . . . @ . . @ . . . . . . . . . . . . . . . @ . . . . @ . . . . . . . @ . @ @ . . . . . . . . . . . . . @ @ . . . . . . . @ . . . . . @ @ . . . @ . . . . . @
@ . . @ . . . . . . @ @ . @ . . . . . . . . . . . @ . . . . @ . . @ . . @ . . @ . . @ . . . . . . . . . . . . . . . . . . . . @ . . @ @ . . . . . @ . . @ @ . . . . . . . @ . . . . @ . . . . @ . . . @
@ @ . . . . . . @ @ . . . . . . . . @ @ . . . . . . . . . . . @ . . . . . . . . . . . . . @ . . . . . @ . . . . . . . . . . . . @ . . . . . @ . . . . . . . . . @ . . @ . . . . . . . . . . . @ @ . . @
@ @ . . @ @ . . . . . . . . . . . . . . . @ @ . @ . . . @ . . . . @ . . @ . . . . . . . . . @ . . . @ . . . . . . . . . @ @ . @ . . . . . . . @ . . . . . @ . . @ . . @ . . . . . . . . . . . @ . @ . @
@ @ . . . . @ @ . . @ . @ @ @ . @ . . . . @ . . . . . . . . @ . . . . . . . . . . . . . . . . @ . . @ . . @ . @ @ . . . . . . . . . . . . . . . @ @ . . . . @ . . . . . . @ . . . . @ @ . @ . . @ . . @
@ . . @ . . . . . @ . . @ . . @ @ . @ . . . . @ . . . . . . . . @ @ . @ . @ @ . . . . . . . @ . . . . . . . . . . . . @ . . . . . . . . . . . . . . . @ @ . . . @ . . . . . . . . . . . @ @ . . . @ . @
@ . . . . . . . . . . . . . . @ . . . . . . . . . . . . . . . @ . . . . . . . . . . . . @ . . . @ . . . . . @ . @ . . . . . . . . . . . . . . . . . @ . . @ . . . @ . . . . @ . . . . . . . . . . . . @
@ @ @ @ @ @ @ @ @ @ @ @ @ @ @ @ @ @ @ @ @ @ @ @ @ @ @ @ @ @ @ @ @ @ @ @ @ @ @ @ @ @ @ @ @ @ @ @ @ @ @ @ @ @ @ @ @ @ @ @ @ @ @ @ @ @ @ @ @ @ @ @ @ @ @ @ @ @ @ @ @ @ @ @ @ @ @ @ @ @ @ @ @ @ @ @ @ @ @ @
3
7 36 18 28
98 2 60 25
90 93 9 22
