50 50
@ @ @ @ @ @ @ @ @ @ @ @ @ @ @ @ @ @ @ @ @ @ @ @ @ @ @ @ @ @ @ @ @ @ @ @ @ @ @ @ @ @ @ @ @ @ @ @ @ @
@ . . . . . . . @ . @ . @ . . . . . . . . . . . . . . @ . @ . . . @ @ @ . . . @ . . . . . . . . . @
@ @ . . . . @ @ . . @ . . @ . @ . . . . @ . . @ . . @ . @ @ . . @ . . @ . . @ . . . . @ . . @ @ . @
@ . . . . . . . . . @ @ . . . @ . @ . . . . @ . @ . . . . . @ . . . @ . . . . . . . . . . . . . . @
@ . . . . . . . . @ . . @ . . . . . . . . . . @ . . . @ . . . . . @ @ . @ @ @ . . . . . . . . . . @
@ @ . . . . . @ @ . . . . . @ . . . @ . . . . @ @ @ @ . . . . @ . @ . . . . . . . . . . @ . . . @ @
@ . . . @ . . . . @ . . . . . . . . . . . . @ . . . . . . . . . . . . . . . @ . . . . . . @ . . . @
@ . . . . . . . . . . . . . . . . . @ . @ . . . . . . . . . @ . . . @ @ . @ . . . @ . . . . . . . @
@ . . @ . . . . . @ . . . . . . . . . @ . . . @ . . @ . . . . . . . . . @ . . . . @ . . . . . . . @
@ . . . . . . . . . @ . . . . . . . . . . . @ . . . @ . @ . . . . . . . . . . . @ . . . . @ . . @ @
@ . @ @ . . . . . . . . . . . . . . . . @ . . . . . @ . . . . . @ @ . . @ . . . . . . . . . . . . @
@ . . . . . . @ . @ . . . . @ . . . . . . . . . . . . . . . @ . . . . . . . . . @ . . . . . . . . @
@ @ . . . . . @ . . . . . . . @ . . . @ . . @ . . . . . . @ . . . . . @ . . . . . . . . . . . . . @
@ . . . . . . . . . . . @ . . . . . @ . . . . . . @ . . @ . . . . @ . . . . . . . . . . . . . . . @
@ . . . . . . . . . . @ . . @ . . @ . . @ . . . @ . . . @ . . @ . . . . . @ . . . . . . . . . . . @
@ . . . . . . . . . . . . @ . . . . @ . @ . . . . @ . . . . . . . . @ . . . . . . @ . . @ . . . . @
@ . . . . . @ @ . . . . . . . . . . . . . . @ . @ . . . @ . . . . . . . @ . . . . . . . . . . . . @
@ . . . @ . . . . . . . . @ . . . . . @ . . . . . . @ . . . @ . . . . . . . . . . . . @ . . . . . @
@ . . @ . . . . @ . . . . @ . . . @ . . . . . . . . . . . @ . . . . . . . . . . . . . . . . . . . @
@ . . . . . . @ @ . . @ . . @ . @ @ . . . . . . . . . . @ . . . . . . @ . . @ . . . . . . . . . . @
@ . @ @ . @ . . . . . . @ . . . . . . . . . . . . . . . @ . . @ @ . @ . . . @ @ . @ . . . . . @ . @
@ . @ . @ @ . . . . . . . . @ . @ . . . . @ . @ . . . . @ . . . @ @ . @ . . . . @ . @ . . . @ . . @
@ . . . . . . . . . @ . . . . . . . @ . @ . . . . . . . @ . . @ . . . . . . . . . @ . . . . . @ . @
@ . . . . @ . . . . @ . . . . . @ . . . @ . @ . . . . . @ . . . . . . . @ . . . . . . . . . @ . . @
@ @ . @ . . . . . . . . . . . . @ . . @ . . . @ . . @ . . @ . . . . . . . . . . . @ . @ . @ . @ @ @
@ . . . @ . . . . . . . @ . . . . . . . . . . . . . . @ @ . . . . @ . . . . . . . . . . @ . @ . . @
@ . . . . . . . . . . @ . . . . . . @ . . @ . . @ . . . . . @ . . . . . . @ . . . . . . . . . @ . @
@ . . . . @ . . . @ @ . @ . . . @ @ . . @ . @ . . . . . . . . . . @ . . @ . . . . . . @ . . . . . @
@ . . . . . . . . @ . . . . . . . . @ . @ . . . . . . . @ . @ . @ . . . . . . . . . . @ . . . @ . @
@ . . @ . . . . . . . . . . . . . . . @ @ . . . @ . . . . @ . . . . . . . . . . . . . . . @ . . . @
@ . @ . @ . . . . . . . . . @ . . . . . . . . . . . . . . . . . . . . . . . . . . . @ . @ . . . . @
@ . . . . . @ . . @ . . . . . . . . @ . . . . . . . . . . . . . . . . . . . @ . . . @ @ . @ . @ . @
@ . @ . @ . . . @ . . . . . . @ . . . . . . . . @ . . @ . . . . . . . . . . . . . @ . . . . . . . @
@ . . . . . . @ . . . . . @ . . @ . @ . @ . . @ . @ . . @ @ . . @ @ . . . . . . . . . . . . . . . @
@ . . . . . . . . . . . @ . . . . . . . . . . @ . . . . . @ . . . . . . . @ . . . . . @ . . . . . @
@ . . . . . . @ . . . . . . . . . . @ . . . . . . . . . . . @ . . . . . . . . . . . . . . . @ . . @
@ . . @ . . . . @ @ . . . . . . . . @ @ @ . . . . . . @ . . . . @ . . . . . . . . . . . . . . . . @
@ . . . . . . . . . . . . @ . . . . . . . . . . . . . . . . . . @ . . @ . . . . . @ . @ @ . . . @ @
@ . . . . . . . . . . @ . . . . . @ . @ . @ . @ . . . . . @ . . . . . . @ . @ . @ . . @ . . . . @ @
@ . . @ . . . . . @ . @ . . . . . . . . . . . . . . . . . . . . . . @ . . . . . . @ . . @ . . . . @
@ . . . . . . . . . . . . . @ . @ . . . @ . . @ . . . . . . . @ . . . @ . . @ . . @ . . . . . . @ @
@ . . . . @ . @ . . . @ . . . . . . . . @ . . . . . . . . . @ . @ . @ . . . . . . . . . . @ . @ . @
@ . . @ . . . . . . . . . . @ . . . . . . . . . . . @ . . . . . . . @ . . . . . . @ . . . . . . . @
@ . . . . . . . . . @ . . . @ . . . . . . . @ . . @ . . . . . . . . @ . . . . @ . . . . @ . . . . @
@ . . @ . . . . . . . . . . . @ . . . . . . . . @ . . . . @ . . . . . @ @ . @ . . . . . @ . . @ . @
@ @ @ . . . . . @ @ . . . . . . @ . . @ . . . . . . @ . . @ . @ . . @ . . @ . . . . @ . . . . . . @
@ . . . . . . @ . @ . . . . . . . . . @ @ . @ . . . . . . @ . . . . . @ . . . . . . @ @ . . . . . @
@ . . . . . . . @ . . . . . . . @ . . . . . . @ . . . . . @ . . @ . @ . . @ . . . @ . @ . . . @ . @
@ . . . . . . . . . @ . @ . . @ . . . . . @ . . . @ . . . . . . . . . . . . . . . . . . . . . . . @
@ @ @ @ @ @ @ @ @ @ @ @ @ @ @ @ @ @ @ @ @ @ @ @ @ @ @ @ @ @ @ @ @ @ @ @ @ @ @ @ @ @ @ @ @ @ @ @ @ @
3
33 34 6 3
13 30 28 26
30 40 12 4
