12 12
@ @ @ @ @ @ @ @ @ @ @ @
@ . . . . . . . @ . . @
@ . . . . . . @ . . . @
@ . . . @ . . . . @ . @
@ . . . @ @ . . @ . . @
@ . . . . . . . . . . @
@ . . . . . . . . . . @
@ . . . . . . . . . . @
@ . . @ . . . . . . . @
@ . @ . . . . . . @ . @
@ . @ @ . . . . . . . @
@ @ @ @ @ @ @ @ @ @ @ @
3
7 2 2 2
1 3 10 1
7 10 2 1
