12 12
@ @ @ @ @ @ @ @ @ @ @ @
@ . @ . @ . @ . . . . @
@ . . . . . . . . . . @
@ . . . @ . . . . . @ @
@ @ . . . . . . . @ . @
@ . . . . . . . . . . @
@ . . . . @ . . . . . @
@ . . . @ . . . . . . @
@ . . . . . . . . @ . @
@ . . . . . @ . @ . . @
@ . . . . . @ . @ . . @
@ @ @ @ @ @ @ @ @ @ @ @
3
1 10 4 5
7 6 6 7
1 1 8 7
