25 25
@ @ @ @ @ @ @ @ @ @ @ @ @ @ @ @ @ @ @ @ @ @ @ @ @
@ . . . . . . @ . @ . . . . . . . . . . . . . . @
@ . @ . . @ . @ . . . . @ @ . . @ . . . @ @ . . @
@ . @ . @ . @ . . . . . . . . . . @ @ . . . @ . @
@ . . . . @ . . . . . @ . . . . . @ . . . . . @ @
@ . . . . . . . @ . . . . . . . . . . . . . @ . @
@ . . . . @ @ . . @ . . @ . . . . @ . . . @ . . @
@ . . @ . . . . . . . . . @ . . . . . . . @ . . @
@ . . . . . . . . @ . @ @ @ . @ . . . . . . . . @
@ @ @ . . . . . @ @ . . @ . @ @ . . . . . . . . @
@ . . . @ @ @ @ . . @ . @ . . . . @ . . @ . . . @
@ . . . . . . . . @ . . . . . . . . . . . . . . @
@ . . . . @ . . . . . . . . . . @ . . . . . . . @
@ . . . . . @ . . . . . @ . . . . . @ . @ . . . @
@ . . . . . . . @ . . @ . @ . @ . . . . . . @ . @
@ . . @ . . @ . @ . . . . . @ . @ @ . . . . . . @
@ . . . @ . . . . . @ . . . . @ . . . . @ . . . @
@ @ @ . . . . . . . . @ . @ . . . . @ . . . . . @
@ . . @ . . @ . . . @ @ . . . . . . . . . . @ . @
@ . @ . . . . . . . . . . . . . . . . @ . . @ @ @
@ @ . @ . . . @ . . . . . . . . . . . . . . . . @
@ @ . . . . . . . . @ . . . . @ . . @ . . . . . @
@ . . . . . . . @ @ . . . . . . . . . . . . . @ @
@ . . . . . . . . . . . . . . . . . . . . . . . @
@ @ @ @ @ @ @ @ @ @ @ @ @ @ @ @ @ @ @ @ @ @ @ @ @
3
5 23 11 2
11 23 15 18
23 14 23 18
