25 25
@ @ @ @ @ @ @ @ @ @ @ @ @ @ @ @ @ @ @ @ @ @ @ @ @
@ . @ @ . . . . . . . . . @ . @ @ . . . . . . . @
@ . . . . @ . . . . . . . @ . . @ . @ . @ . . . @
@ . @ . @ . @ . @ . . . @ . . . . . . . . . . . @
@ . . . . @ . . . @ . . . . . . . . . . . . . . @
@ . . . . . @ . . . . . . . . . . . . . . @ . . @
@ . . @ @ . . @ . . @ . . . . . . . . @ . @ @ @ @
@ . . . . . . . . . @ . . . . . . . . . . @ . . @
@ . @ . . . . . . . . . . . . @ . . @ . . . . . @
@ . . . . . . @ . . @ . . . . . . . . . . . . . @
@ . @ . @ @ . . . . . . . . . @ . . . . . . @ . @
@ . . @ . . . . . . @ . . . @ . @ . . . . @ . . @
@ . . @ . . @ . @ @ . . . . . . . @ . @ . . . . @
@ . . @ . . . @ . . . . . . . @ . . . . . @ @ . @
@ . @ . . @ . . . @ . . . . . @ . . @ . . . @ @ @
@ . . . . . @ @ . @ . @ . . . . . . . . . . . . @
@ @ . . . . . . . . . . . . . . . @ . @ . . @ @ @
@ @ . . . . . . . @ . . . . @ @ . . @ . . . . . @
@ . . . . . @ . . . @ @ . . . . . . . . . . @ . @
@ . . . . . . . . . . . @ . @ . @ . . . . . . . @
@ . . . . @ @ . . . . . . . . . . . . . . @ . . @
@ . . . . @ . . . . . . . . @ . . . . . @ @ . . @
@ . . . . . @ . . @ . . . . . @ . . @ @ . . @ . @
@ @ @ . . . . . . . . . @ . . . . . . . @ . . . @
@ @ @ @ @ @ @ @ @ @ @ @ @ @ @ @ @ @ @ @ @ @ @ @ @
3
6 6 6 11
4 13 1 4
9 18 19 22
