50 50
@ @ @ @ @ @ @ @ @ @ @ @ @ @ @ @ @ @ @ @ @ @ @ @ @ @ @ @ @ @ @ @ @ @ @ @ @ @ @ @ @ @ @ @ @ @ @ @ @ @
@ . . . . . . @ . @ . . . . . . . . . . . . . @ . . . . . . . . . @ . . . . @ . @ . . . . . . . @ @
@ . . . . . . . . . . . . . . . @ . . @ @ . . . . @ . . . @ . . . . . . . . . . . . . . . . . . . @
@ @ . . . . . @ . . . . . . . . . @ . . . . . . @ . . . . @ . @ . . @ . . . . @ @ . . @ . @ @ . . @
@ . . . . . @ . @ . @ @ . . @ . @ . . . . . . @ . . . . . . . @ @ . . @ . . . . . . . . @ . . @ . @
@ . . . . . . . . @ . . . . . . . @ @ . @ @ . . . . . . . . . . . . @ . . . . . . . . . . . . . @ @
@ . . . . . . . . . . . . . . . . . . . . . . . . @ . . @ . . . . . . @ . . . . . . . . @ . . . . @
@ . . . . . @ . . . @ @ @ . . . . . . . @ . . . . . . . . @ . . . . . @ . . . @ @ . . . . . @ . . @
@ @ . . . . . . . . . . . @ . . @ @ . . . . . . . . . . @ @ . @ . . . . . . . @ . @ . . . . @ . . @
@ . @ . . . @ . . @ . . . . @ . . . @ . . . . . @ . . @ . . @ . . . . . . . . . . . . @ . . . . . @
@ . . . . @ . . . . . @ . . . . @ . @ . . . . . . . @ . @ . . @ . . . @ . . . @ . . . . @ . . @ . @
@ . . . . . . . . . . . . . . . @ . @ . . @ . . . . . . . . . . @ . . . . . . . @ . . . . @ . . . @
@ . . @ @ . . . . . . . . . . . @ . . . @ . . . . . . @ . . @ @ . . @ . . . . . . @ . @ . . . . . @
@ @ . . . . . @ . @ . . . @ . . . . . . . . . . . . . . . . . @ . . . @ . . . @ @ . . . @ . . @ . @
@ . . . . . . . @ . . @ . . . . . . @ . . . . . . . . . . . . . . . @ . . . . . . . . . . @ @ @ . @
@ . . . . . . . . . . . . . . . @ . . @ . . . . . . @ . . . @ . . @ . @ . . . . . . . . @ . . @ . @
@ . . . . @ . . . @ . @ . @ . . . . . . . . . . . @ . @ . . . . . . @ . . . . @ . . . . . @ . . . @
@ @ . . . @ . . . . . . . @ . . @ . . @ . . . . . . . . . . . . . @ . . . @ . . . . @ @ . . . . . @
@ @ @ @ . . . . @ @ . @ . . @ @ @ . . . . . . . . . @ . . . . . @ . . . . . . . . . @ @ . . . . . @
@ . . . . . @ . @ . . . . . . . . . @ . . . @ . . . . . @ @ . . . @ . @ . @ . . . . . . . . . . . @
@ . . . . . . . . @ . . . . . . @ . . . . @ @ . . . @ . . @ . . . . . . @ . . . . @ . @ . @ @ @ . @
@ . . . . . @ . @ . . . . @ . . . . . . . . . . . . . @ . . . . . @ . . @ . . . @ . . . . . . . . @
@ . . @ . . . . . . . @ . . . . . . . . . @ . @ . . . . . . . . . . . @ . . . . . . @ . . . . . . @
@ . . . @ . . . . @ . . . @ . @ . . . . . . . . . . . @ . @ . . . . . . . @ . . . . @ @ . . @ . . @
@ . . . . . . . . . . . . . . @ . . . . . . . . . . . . . . . . . . . @ @ . @ @ . . . @ @ . . . . @
@ . . . . . . . . @ . . @ . . . . . . . . . . . . @ @ @ . . . @ . . . . . . @ @ . @ @ . . . . . . @
@ . . . @ . . . . . . . . . @ @ . . @ . . @ . . . . . . . . . . . . . . . . . . . . . . . . . . @ @
@ @ . . . . . . . . . . . . . . . . . . . . @ . . . . . . . . . . @ @ . . . . . @ . . . . @ . . . @
@ . . . . . @ @ . . . @ . . @ . . . @ . @ . . . . . @ . . . . . . . . . @ . . . . . . . . . . . . @
@ . . @ . . . . . @ . . . . @ @ . . . . . . . . . @ . . . . . . . . . . . . . . . . . . . . . . @ @
@ . @ . . . . . . . . @ @ . . . . . @ . @ . . . . . . . . . . . @ @ . . . . @ . . . @ . . @ @ . . @
@ @ . . @ . @ . . . . . . . . . . . . . . . . . @ . . . . @ . . . @ . @ . @ . . . . . . @ . . . . @
@ . @ . . . @ . . . . . . @ . . . . . . . . . . . @ . @ . . . . @ . @ . @ . . . . . . @ . . . . . @
@ . . . . @ . . @ . . . . . . . . @ . @ . . . . . @ . . . . . . . @ . . @ . @ . . . . . . . . . . @
@ . @ @ . . . . . . . @ . . @ . @ . . @ . @ . . . . . @ . . . . . . . @ @ @ . . . . . . . . . . . @
@ . . . . . . . . . . . . @ . . . @ . @ @ . . . . . . . . . . . . . . . . . @ . . . . . . . . . . @
@ . . . . . . @ . . . . . . . . . . . . . . @ . . . . . . @ . . . . . . . . . . . . @ . . . . . . @
@ . . @ . @ . @ . . . . . . . @ . @ . . . @ . . . . . @ . . @ . . . . @ . . @ . . . . . . . @ . . @
@ . . . . . . . . @ @ @ . . . . . . . . . . @ . . . @ . . . @ . . @ . @ . . @ @ . @ @ @ @ . . @ . @
@ . . @ . . . . . . . @ . . . . . . . @ . . . . . . . . . . @ . . . . . @ . . . @ . . . . . . . . @
@ . . @ . . . . . . . @ . . . . . . . . . . . . . . . . . . @ . @ . @ @ @ @ . @ . . @ . . . . . . @
@ @ @ . @ . . @ . . . . . . . . . . . . . . . @ . . . . . . . @ . . . . . . . . . . . . . . . . @ @
@ . @ . @ @ . . . . . @ . @ . . . @ . @ . . . . . @ . @ . @ . . @ . @ . . . . . . . . . . . . . . @
@ . . . . . @ . . . . @ . . @ . @ . . . @ . . @ . . @ . . . . . . . @ @ @ . . @ . . . . . @ . . . @
@ . . . . . . @ . . . . @ . @ . . . . . . @ . . . . . . . . . . . . . . . . . . . . @ . . . . . @ @
@ . . . . . . . . . . . . . @ . . . @ . . . . . . . . . @ . . . . . . . . @ . . . @ . . @ . . . . @
@ . . . @ . @ . @ . @ . . . . @ . . . . . . . . . . @ . . . . . . @ . . . . @ . . . @ @ . . . . . @
@ . . . . . . . @ . . . . @ . . . . . . . @ @ . @ . . @ . . . . . . . . @ . . . . . . . . @ . . . @
@ . . . . . . . . . . . . . . . . . . . . . . . . . . . . . @ @ @ . . . . @ . . . . . . . . . . . @
@ @ @ @ @ @ @ @ @ @ @ @ @ @ @ @ @ @ @ @ @ @ @ @ @ @ @ @ @ @ @ @ @ @ @ @ @ @ @ @ @ @ @ @ @ @ @ @ @ @
3
10 42 26 45
19 36 8 2
39 25 16 48
