50 50
@ @ @ @ @ @ @ @ @ @ @ @ @ @ @ @ @ @ @ @ @ @ @ @ @ @ @ @ @ @ @ @ @ @ @ @ @ @ @ @ @ @ @ @ @ @ @ @ @ @
@ . . . @ @ @ . . . @ . @ . . . . . . . @ . . . . . . . . . . . @ . @ . . . . . . . @ . . . . . . @
@ . . . . . . . . @ . . . . . . . . . . . . . . . @ . . . . . @ . . . . . . . . . @ @ . . . . @ . @
@ . . . . . . . . . @ @ . @ . . . . . . . . . . . @ . . . . . . . . . . . . . . @ . . . @ . . . . @
@ . . . . . . . . @ . . @ . . @ . @ . . . . . . . . . . @ . . . . . . . . @ . . . . . @ . . @ . . @
@ . . @ . . . . . . . . . . . . . . . . . . . . @ . . . . @ . @ . . @ @ . . . . . @ . . . @ . @ . @
@ . . . @ . . . . . . @ @ . @ . . . . . . . . . . . . . . . . . . . . . . @ . . . . . @ . . . . . @
@ @ . . . . . . . . . . . @ . . . . . @ . . . . @ . . . . . @ . . . @ . . @ @ . . . . . @ . . . @ @
@ . . . . . . @ . . . . . . . . . . . . @ . . @ . . . . . . @ . . . . @ . . . . . @ . . . . . . . @
@ . . . @ . . . . . . . . . . . . . . . . . . @ @ . . @ . . . @ . @ @ . . . . . . @ . . . . @ . . @
@ . . . . . . . . . . . . . . . . . @ . . . @ . . . . . . . . . . @ . . . @ . . . . . . @ . . @ . @
@ . @ . . . @ . . . . . . . . . . . . . . . . . . . . @ . . . @ . . . @ @ . . . . . . . . . @ . @ @
@ . . . . @ @ . . . . . . . . . @ . . . . . . . @ . . . . . . . . . @ . . . . . . . @ @ . . . . . @
@ . . . . @ . @ . . @ . . . @ . . . . . . . . . . @ @ . @ . . . . . . . . . . . . @ . . . . @ . . @
@ . . . . . . . @ . . @ . . . . . . . . @ . . . . . . . . . . . . @ . . . . @ . @ . . @ . @ . @ . @
@ . . . . @ . . . . . . . @ . . . . . . . . . . . . . . . . . . . . . . @ . . . . . . . . . . @ . @
@ @ @ . . . @ . . . @ . . . . . @ . . . . . . . @ . . @ . . . . @ . . . . . . . . . . @ . . . . . @
@ . . . . . . @ . . . . . @ . . . @ . @ . . . @ . . . . @ . . . @ @ . . . @ . . @ . . @ . . . @ . @
@ . . . . @ . . @ @ . . @ . . . @ . . . . . . @ . . . @ @ . . @ . . . . . @ . . . . @ . . . @ . @ @
@ . . @ . . . @ . @ . . . @ . . . . . . . . . . . @ @ . . . @ . . . . . @ . @ @ @ . @ . . . . . . @
@ @ . . . . . . @ . . . . . . . . @ @ @ . . @ . @ @ . . . @ . . . . . @ . . . . . . . . . . @ @ . @
@ . . . . @ . . . . . . . . . . . . . . . . . . . . . . . . @ . . . . . @ . . . . . . . . . @ . . @
@ . . @ . . . . . . . . . . . . @ . @ . . @ . . . @ . . . . . . @ . . . . . . . @ . . . . @ . . . @
@ . . . . . . . . . . . . . . . . @ . . @ @ . . . . . . . . @ . . @ . . . @ . . @ @ . . @ . @ . . @
@ @ @ @ . @ . . . . @ @ . . . @ . . . @ . . . . . . . . . . @ . . . . . . . . . @ . . @ . . . . . @
@ . . . . . @ . . . . @ . . . . . . . . . . @ . . @ . . @ . . . @ @ . . . @ . . . . . . @ . @ . . @
@ . . . . . . . . @ . . . @ . . . . . @ . . . @ . . . . . @ . . @ . . . @ . @ . . . . . . . . . . @
@ . . . . . . . @ . @ . . . . . . . . @ . . . @ . @ . . . . @ . . . . . . . @ . . . . . . . . . . @
@ . . . . . . . . @ . @ . @ . . . . . . . . . . @ . . . . . . . @ @ . . . . . . . . . . . @ . @ . @
@ . . . . . @ . . . @ . . . . . . . @ . . @ . . . . @ . . . . . . . . @ . . . . . . . @ . . . . . @
@ . . @ . . . . . . . . . @ . . . @ @ . . . . . . . . . . . . . . . @ . . . . @ . @ . . . . . . . @
@ . . . . . . . . . . @ . . . . . . . . . . . . @ . . . . @ . . @ @ . @ . . @ . @ . . @ . . . . . @
@ . . . . . @ . . . . . . . . @ . @ @ . . . . . . @ . . . @ . . . @ . . @ . . . . . . @ . . @ . . @
@ . . . . . . @ . . . @ . . . . @ . . . . @ . . . . @ . @ . . . . . @ . . @ . . . . @ . . . @ @ @ @
@ . . . . . . @ . . . . . . @ . . . @ . . @ . . @ . . . . @ . @ . . @ . . @ . . . @ . @ . . . . @ @
@ . . . . . @ . . . . . @ . . . . @ . . @ . @ @ . . . . . . . . . . . @ @ . @ . . @ . . @ . . . . @
@ . . . @ @ . . . @ . . @ . . . @ . . . . . @ . . @ . . @ . . @ . . . @ @ . . . . @ . . . . . . . @
@ . . . . . . @ . . . @ . . . @ . . . . . . @ . @ @ . . . . . . @ . . @ . @ . . @ . . @ . @ . . . @
@ @ . . @ . . . . . . . . . . . . . . . . . . . . . @ . . . @ . @ . . . . . . . . . . @ . . . . . @
@ . . . . . . . . @ @ . . . . . . . . . . . . . . . . . . . . . . . @ . . . . . . . @ . . . . . . @
@ . . . @ . . . . . . . . . . . . . . . . . . . . @ @ @ . . . . @ . . . . @ . . . . . @ . . . . . @
@ . . . @ . . . . . . . . . . . @ . . . . . . . . . . . . . . . . @ . . . . @ . . . . . . . . . . @
@ . . . . . . . . @ . . . . . . @ @ . . . . . . . . . @ . . . . . . . . . @ . . . @ . @ . . @ . . @
@ . . . . . . . @ . . . . . @ . . . . . @ . . . . @ @ @ . @ . . . . . . . . @ @ . . @ . . . . @ . @
@ . . @ . . . . . . . . . . . . . . . . . @ . @ . . . . . . . @ . @ . . . . . . @ . . . @ . . . @ @
@ . . . @ . @ . . . . . . @ . . . @ @ . . . . . . . @ . . . . . @ . . . . . @ . . . . @ . . . . . @
@ . . . . . . . @ . . @ @ @ @ . . . @ . . . . . . . . @ . . . @ . @ . . . . . . . @ . . @ . @ . . @
@ . . . . . . . . . @ . . . . . @ . @ . . . @ . . . . . @ . . . . @ . . . . . @ . . . . @ . . . . @
@ . . . . . . . @ . @ . . . . . . . . @ . . . . @ . @ . . . . . . . . . . . @ . . . . . . . . . . @
@ @ @ @ @ @ @ @ @ @ @ @ @ @ @ @ @ @ @ @ @ @ @ @ @ @ @ @ @ @ @ @ @ @ @ @ @ @ @ @ @ @ @ @ @ @ @ @ @ @
3
35 15 34 17
24 28 35 1
31 37 8 24
