12 12
@ @ @ @ @ @ @ @ @ @ @ @
@ . . @ . . . . . . . @
@ . . . . . . @ . . @ @
@ . @ . @ . @ . . . . @
@ . @ . . . . . . . . @
@ . . . @ . . . . . . @
@ . @ . . . . @ . . @ @
@ . . . . . . . . . . @
@ . . . . . . . . . . @
@ . . . . . . . . . . @
@ . . @ . . @ . . . . @
@ @ @ @ @ @ @ @ @ @ @ @
3
7 4 10 7
6 1 1 7
3 10 10 1
