12 12
@ @ @ @ @ @ @ @ @ @ @ @
@ . @ . . . . . . . . @
@ @ . . . . . @ . . . @
@ . @ . . . @ . . . . @
@ . . . . . . @ @ . . @
@ @ . . . . . . @ . . @
@ . . @ . . . . . . . @
@ . . . . . . . . @ . @
@ . . . . . @ . . . . @
@ @ @ . . . . . . . . @
@ . . . @ . . . @ . . @
@ @ @ @ @ @ @ @ @ @ @ @
3
4 6 8 4
1 9 10 10
7 3 1 4
