12 12
@ @ @ @ @ @ @ @ @ @ @ @
@ . . . . . @ . . . . @
@ . . . . @ . @ . @ . @
@ . . . . . @ . . . . @
@ . . . . . . @ @ . . @
@ . @ . @ @ . @ . . . @
@ . . . @ . . . . . . @
@ . . @ . . . . . . . @
@ @ . . . . . . . . . @
@ . @ @ . . @ . . . . @
@ . . @ . . . . . . . @
@ @ @ @ @ @ @ @ @ @ @ @
3
3 4 5 9
8 7 7 9
5 8 5 6
