100 100
@ @ @ @ @ @ @ @ @ @ @ @ @ @ @ @ @ @ @ @ @ @ @ @ @ @ @ @ @ @ @ @ @ @ @ @ @ @ @ @ @ @ @ @ @ @ @ @ @ @ @ @ @ @ @ @ @ @ @ @ @ @ @ @ @ @ @ @ @ @ @ @ @ @ @ @ @ @ @ @ @ @ @ @ @ @ @ @ @ @ @ @ @ @ @ @ @ @ @ @
@ . . . . @ . . . . . . . . . . . . . @ . . . . . . . . . . . . . . . . . . . . . . . . . @ . . . . . . . . . . . . . @ . . @ . . . . . . . . . . . . . . . . . . . @ @ . . . . . . . . . @ . . . . . @
@ . . . . . . . . . . @ @ . . @ . . @ . . @ . @ . @ . . . . . @ . . . . @ @ . . @ . . . @ . . @ . . . @ . . . . . . . . . . . . . . . . . . . . @ . . . . . . . . . . @ . . . @ . . . . . . . @ . . . @
@ @ . . . . . @ . . . . . . . . . . @ @ . . . . . @ . . . . . @ . @ . . . . . . . . @ . . . . . . . @ . @ . . . . . @ . . @ . . . . . . . @ . . . . . . . @ . . . . . . @ . . . . . . . . . @ @ @ @ . @
@ . . . . . . . . . @ . . . . . . . . . . . @ . . . @ . . . . @ . . . . . . . . @ @ . . . . @ . . . . @ . . @ . . . . @ . . . . @ . . . . . . @ @ @ . . @ . @ . . . . @ . . . . . . . . @ . . . . @ . @
@ . . . . . @ . . @ . . . . . . . . . . . . @ . . . . . . . . . @ @ . . . @ . . . . . . . . @ . . . . . . . . . . . . . . . . @ @ . . . . . . . . . . . . . . @ . . @ . . . . . @ . . . . . . . @ . . @
@ . . . @ . . . . . . . . . @ . @ . . . . . . . . . . . . . . . . . . @ . . @ . . . . @ . @ . . . . . @ . . . . . . . . . @ . @ . @ . . @ . . . . . . . . . . . @ . . . . . . . . . . . . . . . . . @ @
@ . . . . . @ . . . . . . . . . . . . . . . . . @ . . . . . . . . . . . . . . . . . @ . . . . . . @ . . . . . . . . . . . . . . @ . . . . . . . . . . . . . . . . @ @ . . . . @ @ . . . @ . . . . . . @
@ . @ . @ . . . . . . . . . . . . @ . . . . . . . . @ . @ . . @ . . . @ . . @ . @ . . . . @ . . . @ . . @ . . . . @ @ . @ . . . . . . . . @ . @ . . . . . @ . . . @ . @ . . . . . . . . . @ . . @ . . @
@ . . @ . . . . . . . . . . @ . . @ . . . @ @ . @ . . @ . @ . . . . . . @ . . @ . @ @ . . @ . . . @ . @ . @ . . . . . . . . . . . . . . . . . . @ . . @ . . . . . . . . @ . . . . . . . . . . . . . . @
@ . . . . . . . . . @ . . . . . . . @ . . . . . . . . . . . . . . . . . @ @ . . . @ @ . . . . . . . . . @ . . . . . . . . . . . . . . . . . . . . . @ @ . . . . . . . . . . . . . . . . . . . . @ . . @
@ . . . . . . @ . . . . . . . @ . . . . . . . . . . . @ . . @ @ . . . . . . . . @ . . . . . . . . . . . @ . . . . . . @ . . . . @ . . . . . . . . . . . . . . . . @ . . . . . . . . . . @ . . . . . . @
@ . . . . . . . . . . @ . . . . . . . @ @ @ . . . . . . . . . . @ . . . . . . . . . @ . . . . . . . . @ . . . . . . . . . . . @ . . . @ . . . . @ . . . . . . . @ . . . . . . . . @ . . . . . . . . . @
@ @ . . . . . . @ . . . . . . . @ . . . . . . . @ . . . . . . . . . . . @ . . . . . . . @ . . . . . . @ . . . . . . @ . . . . @ . . . . . @ . . . . @ . @ . . . . . . . . @ @ . . . @ . . . . . . @ . @
@ . . . @ @ . . . @ . @ . . . . . . . . . . . . . . . . . . . . . @ . . . . . @ . . . @ . . . @ . . @ @ . . . @ . @ . . . . . . . . . . . . . @ @ @ @ . . . . . @ . . @ @ . . @ . . . . . @ . . . . . @
@ . . . . @ . @ @ . . . . . . @ . @ @ . . @ . . . @ . . . . . . . . . . . . @ . . @ . . . @ . @ . . . . . . . @ . . . . @ . . . . @ @ . . . . . . @ . @ . @ . . . . . . . . . . @ . . . . . . . . . . @
@ . . . . @ . . . @ . . . . . . . . . . . . . . @ . . . @ . . . . . . . . . . . . . . @ . . . @ . . . @ . . . @ . . . . . . . @ . . . . . . . . @ . . . @ . . . . . . . . . . @ . . . . . . . . @ . . @
@ . . @ . @ . @ . . . . . . . . . . . . . . . . @ . . . . . . . . . . . @ @ . . . . . . . . @ . . . . . . . @ . . . . . . . . . @ . . @ . . . @ @ . . @ . @ . . . . @ . . . @ . . . . . @ . @ @ . . . @
@ . @ . @ . . . @ . @ . . . @ @ . . . @ . . . . . . . . . . . . . . @ . . @ @ . . . . . . . . . . . . @ . . . . . . . . . . . . . @ . . . . . . @ . . . . . . . . . . . . . . . . . . . . . . . . . . @
@ . . . . @ . . . . . . . @ . . @ . . . . . . . . . . . @ . @ . . @ . . @ @ . . . . . . . @ . . . . . . @ . @ @ . . @ @ . . . @ . @ . . @ . @ . . . . @ . . @ . . . . . . . @ . . . . . . . . . @ . . @
@ . . . @ . . . @ . . . . . @ . . . @ . . . . . . . @ . . . . . . . . . @ @ . @ . . . . . . . . @ . . . . . . @ . . . . . . @ . @ @ . . @ @ . . . . . . . . . . . . . . @ . . . . . . . . . @ . . . . @
@ . . . @ . . . . @ @ . . . . . @ . . @ . . . . @ . @ @ . @ @ . . . . . . . . @ . . @ . . . . @ . . . . . . . @ . . @ . @ . . @ . . . . . . @ . @ . @ . . . @ . . . . . . @ @ . . @ @ . . . . . . . . @
@ . . . . @ . . . . . @ . . . @ . . . . . . . @ @ . . . . . . . @ @ . . @ . . . . . . . . . . @ . . @ . . . . . . . . . . . . . . . . . . . @ @ . . . @ . . . . . @ @ . . . . . . . . . . . @ . . @ . @
@ . . @ . . . . @ . . . . . @ . . @ @ . . . . . . . . . . . . . @ . . . . . @ . @ . @ . . . . . . . . . . . . . . . . . . @ @ . . . . . . . . . . . . . @ . @ . @ . . . @ . @ . . . . . . @ . . . . . @
@ @ @ . . . . . @ . @ . . . . . @ . . @ . . . . . . @ . @ . . . . @ . @ . . . @ . . . . . . . . @ @ . . @ . . . @ . @ . @ @ . @ . . @ . @ . . . . . . @ . . . . . @ . . . . . . . . . . . . @ @ . . . @
@ @ . . . . . . . . @ @ @ . . @ . . . @ @ @ @ . . . . @ . . . . . @ . . . . . . . . . . . . . @ . . . . @ . . . . . . @ @ . . . @ . . . . . . . @ . . @ . . . . . . . . . @ . . @ . . . . . . . . . . @
@ . . @ . . @ . @ @ . . . @ @ @ . @ . @ . . . . . . . . @ . . . . . @ @ . . . . . . @ . . . . . . . . @ @ . . . . . . @ . @ @ . @ . . . @ . . @ . . . . @ @ . . . . . @ @ . . . @ . . . . . . . . . . @
@ . @ . . . . . . . @ . . . . @ @ . . . @ . . . . . . . @ . . . . . . . . . @ . . . . . . @ . . . . . . . . @ . . . . . . . . . . @ . . . . . . @ . . @ . . . . @ . . . . . . . @ . . @ . . . . . . . @
@ . . . . . . @ . . . @ @ . . . . . . . . . @ . . . . . . . . . . . . . @ . @ . . . @ . . . . @ . . . . . . . . . . . . . . @ . . @ . . . . . . @ . @ . . . @ @ . . . . . . . @ . . @ . . . @ . . . . @
@ . . @ . . . . @ . . . . . . . @ @ @ . . . . . . @ . @ . . . . . . . @ . . . . . . . . . . @ . @ . . . . @ . @ . @ . . . . . . @ . . @ . . . @ . . . . . . . . @ . . . . . . . . . @ . . @ . . @ . . @
@ . . . . . . . . . @ . . @ @ . . @ . . . . . . . . . . . @ @ . . . . @ . . . @ . . . @ . @ . . . . . . . . @ . @ @ @ . @ . . . @ . @ . . . . . . . . . . . . . . . . @ . @ . . . . . @ @ . . . . . . @
@ . . @ . . . . @ @ . . . . . . . . . . . . . @ . . . . . . . . . . . . . . . . @ . . . . . . @ . . . . . . @ . . . . . . . . @ . . @ . . . . . . @ . . . . . . . @ . . . @ . . . . . @ . . . . . @ . @
@ . @ . @ . . . . . . . . @ . . . . . . . . . . . . . @ . . . . . @ . . @ . . . . @ . . . @ . . . . . . . . . @ . @ . . . . . . @ . . @ . . . . . . . @ @ . @ . . . . . @ . . . @ . . . . . . . . . . @
@ . . . @ . . . . . . @ @ . . . . . . . . . . @ . . . . @ . . . . . . @ @ @ . . . . . . . @ . . . . . @ . . . . . . . @ . . @ . . @ @ . . . @ . . . . . . . . @ . . . @ . . . @ . . . @ . . . . . . . @
@ . @ . . . . . . @ . . . . . . @ . . . . . . . . . . . . . @ @ . . . . @ . @ . . . . . . . @ . . . . . . . . . . . . . . @ @ . . . . . . . . @ . . @ @ @ @ . . . . . . @ . . . . . . . . . @ . . . . @
@ . . . @ . . . . @ . . . . . . . . . . . . . . . . @ . . . . @ . . . . . . @ . . . . . @ . . . . @ . . . . @ . . . . @ @ . . . . @ . . @ . . . . @ . . . . . . . . . . . . @ . . @ . . . . . . . . @ @
@ . . . . . . . . . . . . . @ . . . . @ . . @ . . . . . . . . . @ . . . . @ . . . . . @ . . @ . . @ . . @ @ . . . . . . . . . @ . . . . @ @ . . . . . @ . . . @ . . @ . . . @ . . @ . . . . @ . . . . @
@ . . . @ . . . . @ . . . . . . . . . . . . . . @ . . . @ . . . . . . . . . . @ . @ . . . @ @ . . . . . . . . . @ . . . . @ . . @ . . . @ @ . @ . . . . . @ . . . . . . . . . . . . . . . . . . . . @ @
@ . . . . . @ @ . . @ . . . . @ . @ . @ . . . . . . . . @ . @ . . . @ . . . . @ . . . . . . . . . . @ @ @ . @ . . . . . . . . . . . . . . . @ . . @ . . . . . . . . . @ . . . @ . . . . @ . . . . . . @
@ . . . . . . . . . . . @ . @ . . . . . . . . @ . . @ . . . . @ . . . . . . . . . . . . . . @ . . . . @ . . . . . . . . . . . . . . . . @ . . @ . . . . . . . . . . . . . . . . . . . . . . . . . @ . @
@ . . . . . @ . . . . . @ . . . . @ . . . @ . @ . . . . . @ . . . . . . . . . . . . . . . . . . . . @ . . . . . . . @ @ . . . . @ . @ . . @ . . . . . . . . @ . . . @ @ . @ @ . . . . . . . . . . . . @
@ . . . . . . . . . . . . . . @ @ . . @ . . @ . . . @ . @ . . . . . . . @ @ . @ . . . . @ . . . . . @ . . . . @ @ . . . . . . . . . . . . . . . . . . . . . . . . . . . . . . . . . . @ . . . . . @ . @
@ . . . . . . . . . . . @ . @ . . . @ . . . . . . . . . . . . . . . . . @ . . . . . . . @ . . . . . . . @ . @ . . . . . . . . . . . . . . . @ . . . . . @ . . . . @ . . . . . . @ . . . . . . @ . . . @
@ @ . . . . . @ . . . . @ . . . . . . . @ . . @ @ . . @ . . . . . @ . . . @ . . . @ . @ @ . . . @ . . @ . . @ . . . . @ . . . . . . . @ . . . . . . . . . . . . . . . . . @ @ . . . . . @ @ . . @ . . @
@ . . @ . . . . . . . @ . . . . . @ . . . . . . . . @ . . . . . . . . @ @ . . . . . . . . . . . . . . . . . . . . . . . . . . . . . . . . @ . . . . . . . . . . . . . . . . . . . . @ . . . . . . @ . @
@ . . . @ . . @ . . . . . . @ . . . . . . . . . . . . . @ . . @ . . . . @ . . . . . . . @ . . . . . @ . . . . . . @ . . . . . . . . @ . . . . @ . . . . @ @ . @ . . . . . . @ . . . . . . @ . . . . . @
@ . . . . . . . . . . . . . . @ @ . . . . . . . . . . . . . @ . @ . . . . . . . @ . . @ . . . . . . . . @ . . . . . . . . @ . . . . . . . . . . . . . . . . . . . . . @ . . . . . . @ . @ . . @ . . . @
@ . . . . @ . . . . @ . . . . . . . . . . . . . . @ . . . . . @ . @ . . . . . . . @ . . @ . . @ @ . . . . @ . . @ . . . @ . . . @ . . . . . . . . . . @ . . @ . @ . @ @ @ . . . . . . @ . . . . . . . @
@ . . . @ . . . . . . . . . . . . . . . . . . . . . . . . . . . . . . . . @ . @ . @ @ . @ . . . . . @ @ . . @ . . . . @ . . . . . . . @ @ . . @ . . . . . . . . . . . . . @ . . . . @ . . . . . . . . @
@ . . . . . . @ . . . @ @ . . . @ . . . . . . . . . . . @ . . . . . @ . @ . . . . . . @ . . . @ . . . . . . . . . @ . . . . @ . . . . . . @ . . . . @ . . . . . @ . . . . . . @ . @ . . @ . . . . . . @
@ . . . . . . @ . . . . . . . . . @ . . . . . . . . @ . . . . . . . . @ . . . . . . . . . . . @ . . . . . . . . . . . . . @ . @ @ . @ . . . . . . . . . @ . . . . . @ . @ . . . @ . . . . . . . @ @ . @
@ . @ . . . . . . . @ . @ . . . . . . . . . . . . . . . @ . . . @ . . . . . . . . . . . . . . . . @ . @ . . . . . . @ . @ . . . . @ . . . @ . @ . . . . . . @ . . @ . . . @ . @ . . . @ . @ . @ . . . @
@ . @ . . . . @ @ . . . . . . . . @ . . @ . . . . . . @ . . . . . . . . . . . . @ . . . . @ . @ . . . . . . . . . . . . . . . @ . . . . . @ . @ . . . @ . @ . . . . . . . . . @ . . . . . . . . . . . @
@ . . . @ . @ . . . . . . . @ @ . . . . . . . . . @ . @ . . . . @ . . . . . . @ . @ . . . @ @ . . . . . . @ . . . . . . . . . @ @ . . . . . . . . . . . @ . . @ @ . . . . . . . @ @ . . . . . . @ @ . @
@ . . . @ . . @ . . . . . . . . . . . . . . . @ . @ . . . . @ . . . @ . . . . . . . @ . . . @ . @ . . . . . @ . . . . . . . . . @ . @ . . @ . . @ . . @ . . . . . . . . . . @ . . . . . . . . . . . @ @
@ . . . . . . . @ . . @ @ . . . . . . . . @ . @ . . . . . @ . . . @ . . @ . . . @ . . . @ . . . . . @ . . @ . . . . . . . . . @ . . . . . . @ . . . . @ . . . @ . . . . . . @ @ . . . . @ . . . . . . @
@ . @ . . . . . . . . . . @ @ . . . . @ @ . @ . @ . . . . . . . . . . . . . . . . . . . . . . . @ @ . . . . . . . . . . . . . . @ . . @ . . . . . @ . . . . @ . . . @ . . . . . @ . . . . . . . . @ . @
@ . . . . . . . . . . @ . . . . . . . . . . @ . @ @ . . . @ . . . . . . . . . @ . . . . . . . . . @ . . . . . . . @ @ . . . @ . . . . . . . . . . . @ . . . . . . @ . . . . . . . . @ . . . . . . . . @
@ . . . . . . . @ . . . . . . @ @ @ . @ @ . . . @ . @ . . @ . . . . . . . . . . @ . . . . . . . . . . @ . . . @ . . . . . . @ . . . . . @ . @ . @ . . . . @ . . . . @ . . @ . . . . . . . . . . . @ . @
@ . . . @ . . . . . @ . . . . @ @ . . . . . . . . . . . . . . @ . . . . . . . . . . @ . . . . @ @ . @ . . . . . . . . . @ @ . @ . @ . . . . @ . . . . . . . @ . . . @ . . . . @ . . . . . @ . . @ . . @
@ . . . . . @ . @ . . . . @ . . . . . . . . . . . . . . . @ . . . . @ . @ . . . . . . . . . @ . @ . . @ . @ . . . . . . @ . . . . . . @ . . . @ . . . @ . . . @ . . . . . . @ . @ . . . @ . . . . . . @
@ @ @ . . . @ . @ . . . . . . . . . . . @ . . . . . @ @ . @ . . . . . . . . . . . . . @ . . . . . @ . . . . . . . @ . . @ . . . . . . . @ . . . @ . . . . . @ . . . . . . @ . . . . . . . @ . . . . . @
@ . . . . . . . . @ . @ . . . . . . @ . . . . @ . . . . @ . . @ . . @ . @ . . . . . . . . . . . . . . . . . @ . . . . . @ . @ . . . @ . . . . . . . . . . . . . . . . . @ . . . @ . . . . . @ . . @ . @
@ . . . . @ . . . . . . . . . . @ . . . . @ . . . . @ . . @ . . . . . . . . . . . @ . . . . . . . . . . . . . . . . . . @ . . . . . . . . . . . . . . . . . . @ . . . . . . @ @ . . . . . . . . . . . @
@ @ . . . . . . . @ . . . . . . . @ . . . . . . . . . @ . . . . . . @ . . . . . . . . . . . . . . . . . . . . @ . . . . . . . . . . @ . . @ . . . . @ . . @ . . . . . . . . . . . . . @ . . @ . . . . @
@ . . . . . . . . . . . @ . @ . @ . . . . . . . . . . @ . . . . . . . . . @ . . . . . . . . @ . . . . . . . . @ @ . . @ . . . . . . . @ . . . . . . . . . . . . . . @ . . . . . . . . @ . . . . . . . @
@ @ . . . . . . . . . . . . . @ . . . . . @ . . @ @ . . . @ @ @ @ . . . . . . . @ . . @ . . @ . @ . @ . . . . @ . . @ @ . . @ . . . . . . @ . . . . @ . @ . @ . . . . @ . . . . . . . . . . . . @ . . @
@ . . . . . . . . . . . . @ . . . . . @ @ . . . . @ . . . . . . . . . . . . . . . @ . . . . . . . . @ . . . . . . @ . . . . @ . . . @ . . @ . . . . . . . . . . . . @ . @ . . . @ . . @ @ . @ . . . @ @
@ . . . . @ . . . . . . @ @ . . . . @ . . . . @ . @ . . . @ . . . @ . . . . . . . . . . @ . @ . . . . @ . . . . . . . . . . . @ . . . . . . . . . . . @ . . . . @ . . . . . . . . @ . . . . . . . @ . @
@ . . . . . . . . . . @ . . @ . . @ . . . . . . . @ @ . . . @ . . . . . @ . @ . . @ . . @ . . @ . @ @ . . . . . . . . . . @ @ . . . . . . . . @ @ . @ . . . . . @ . . . . . @ . . @ . . . . . . . . . @
@ . . @ . . . . . . . @ . . . @ . . . . . @ @ . . @ . . . . @ . . . . . . . . . . . @ @ . . . @ . @ @ . . . . . . . . . . . . . . . . . . . . . . . . . @ @ . . . . . . @ . @ . . . . . . @ @ . . . . @
@ . . . . . . . . . . . . . . . . . . . @ . . . @ . . . . . @ . . . . . . . . . @ . . . @ . . . @ @ . @ . . . . . . . . . . @ . . . . @ @ . . @ . . . . . . . @ @ . . . . . @ . . . . @ . . . . . . . @
@ . @ . @ . . . @ . . . . . . . . . . @ @ . @ . . . . . . . . . . . . @ @ @ . . . . . . . @ . . . . @ . . . . . @ @ . . . . . . . @ . . . . @ . . . . @ . . . . . . . . @ @ @ . . . @ . . . @ . @ . . @
@ . . @ . . . @ . . . . . . . . @ . . . . . . . @ @ . . . @ . . . . . . . @ . . . . . . . . . . @ . . . . @ . @ . . . . . . @ . . . . . @ . . . . . . . . . @ . . @ . . . . . @ . . . . . . . . . . . @
@ . . . . @ . @ . . . @ @ . . . @ . . . . @ . . . @ . . . . @ @ @ . @ @ . . . . . . . . . @ . . @ . . . . @ . . . . . @ @ @ . . @ . . @ . . . . . @ . . . @ . . . . . . @ . . @ . . . . . . . @ . . . @
@ . . . @ . . . . . . . @ . . . @ . . @ . . @ . . . @ . . . . . . . . . . . . @ . . . . . . @ . . . . . . . . . . . . . . @ . . @ . . @ . @ . @ @ . . . . @ . @ . . @ . @ . @ . . @ . . . . . . @ . @ @
@ . . . . . . . @ . . . . . . . . @ . . . @ . . . . . . . . . . . . . . @ @ . . . . . . . . . . . . . . . . . . . . . . . . . . . . . . . . . . . . . . . @ @ . . @ . . . . . . . . . . . . . . . @ . @
@ @ . . . @ . . . . . . . . . . . @ . @ . . . . . . . . . . @ . . . . . @ . @ . . . . @ . @ @ . . . . . @ @ . @ @ . @ . . . . . . . . . . @ . . . . . . . @ . @ . . . @ . . . . . . . . . . . . . . . @
@ . . . . . . . . @ . . . . @ @ . . . . @ . . . . . . @ . . . . @ . . . @ @ . @ . . @ . . . @ . @ . . . . . . . . @ . . . . . . . @ . . @ . . . @ . . . . . . @ @ . . . @ @ . @ . @ . @ . . . @ . . . @
@ . . @ @ . . . . @ . . . . . . . @ @ . . . @ . . . @ @ . . . . . . . . @ . . . . . @ . . . . . . . @ . . . . @ . . . . . . . . . . @ . @ . . . . . . . . . . . . . . @ . . . . . . . . . . . . . . . @
@ . . . . @ . @ . . @ . @ . . . . . . @ . . @ . . . @ . . . . . . @ @ . . . @ . @ . . . . . . . . . . . . @ @ . @ . . . . . @ . . . . . . @ @ . . . . . . @ . . @ . . . . @ . . . . . @ . . . @ . . . @
@ @ . . . . @ . . . . . . . . . @ @ @ . . . . @ . . . @ @ . . . . . . . . . . . . @ . . . @ . . . @ . . @ @ . . . @ @ . . . . . @ . . . . @ . . . . . . . . . . . @ . . @ . @ . . @ . . @ . @ . . . . @
@ . . @ . . . . . . @ . . . . . . . . . . . . . . . @ . . @ . . @ . . . . @ . . . @ . . . . @ @ . . @ . @ . . . . . . . . @ . . . @ . . . . . . . . . . . . . . . . . . . . . @ . . . @ . . . . @ . . @
@ . . @ . . @ . . . @ @ . @ . . . . . . . @ @ . . @ . . @ . . . . . . . . . . . . . @ @ . @ . . . . . . . . . . . @ . . . . . . . @ . . . . . . . . @ . @ . . . . @ . . @ . . . . @ . . @ . . @ . . . @
@ . . . . . . @ . @ . . . . @ @ . . . . . . . . . . @ . . . . . . . . @ . . . . . @ . . . . . . @ . . . . . . . . . . . . @ . . . . . . . @ . . . . . . . . . . . . . . . . . . . @ . . . . . . . @ . @
@ . @ . . . . . . . . . . @ . . . . . . . . @ . . . @ . @ . . . . . . . . . . . . . . . . . . @ . . . . . . . . . @ . . . @ . . . . . . . . . . @ . . . @ . . . . @ . @ . . @ . . . . . . . . . . @ . @
@ . @ . . . @ . . . . . . . @ . . . @ . @ . . @ . . . . . . @ . @ . . . . @ . . . . . . . @ @ @ . @ . . . . @ . . . . . . @ . . @ . . . . . . . . . @ . . . @ . @ . . . . . . . . . @ . . . @ . . . . @
@ . @ @ . . . . . . . @ . @ . . . @ . . . @ . . @ . . . . @ . . . . . . . . . . . . . . . . . . @ . . . @ . . . . . . @ @ @ . . . @ . . . . @ . . . . . . . . @ . . . . @ . . . . @ . . @ . . @ . . . @
@ . . @ . . . . . . @ . . . @ . . @ . @ . . . . . . . . . . . @ . . @ . . @ . @ . . . . . . . . . . . . . @ . . . . . @ . . . . @ . . . . . @ @ . . . @ . . . . . . . @ . . @ . . . @ . . . @ . . . . @
@ @ . . . @ . @ . . . . . . . . . . . . . @ . @ . . @ @ . . . . . . . @ . @ . . . . . . . . . . . . . . @ . @ . . . . . . . . @ . . . @ . . . . . . . . . . @ . . . . . . . . . . @ . @ . . . . . . . @
@ . @ . @ . . @ . . @ . . @ . @ . @ . @ . . @ . . . . . . @ . . . . . . @ . . . @ . . . . @ . @ . . . . @ . . . . . . @ . @ . . . . . . . . @ . . . . . @ @ . . . . . . . . . . . . @ . . . @ . . . . @
@ . . . . . @ . . . . . . . @ @ . @ . . . . . . . @ @ . @ . . @ . . . . . . . . . @ @ . . . @ . @ . . @ . . . . . . . . . . . @ . . . . . . @ . @ @ . . . . . . . . . . . . @ . . . . . @ . . . . . . @
@ . @ . . . . @ . @ . . . . . . . . . . @ . . . . @ . . @ . . . . . . . @ @ . . . @ . @ . . @ . . @ . . . . @ . . . . . @ @ . . . . . @ . . . . . . . @ . . . . . . . . . . @ . @ . . . . . . @ . . . @
@ . . . . . . . . . . . . @ . . . . @ . . . . @ @ . . . . . . . . . . . . . . . . . . . @ . . . . . . . @ . . . . . . . . . @ . . . . . . . @ . . . . . . . . . . . @ . . . . . . . @ @ . . . . . . . @
@ . . . . @ @ . . . @ . . . . @ . @ . . @ . . . . . . . . . . . @ . @ . . . . . . . . . . . . . . . @ . . . @ . . . . . . . . . @ . . . . . @ . . . @ . . . . . . . . . . . . . @ @ . . . . @ . . . . @
@ . . . . . @ . @ . . . . . . . . . . . . @ @ . . . . . . . . . . . . @ . . . . . . . . . . . @ @ . . . @ . . . . . . . @ . . . . @ . . . . . . . @ @ . . . . . . . . . . . . . @ . . . . . . @ . @ . @
@ . . . @ . . . . @ . . @ . . @ . . . . . . . . @ . . @ . @ . . . . . @ . . @ . @ @ . . . . . . . . . @ . . @ . . . . . . . . . @ . . . . . . . . . . . . . @ . . @ @ . . . @ . . . . . . @ . . . . @ @
@ . . . . . . . . . . . @ . . . . . @ . . . . . . . . . . . . . . @ @ . . . . @ . . . . . @ . . . . . . . . . . . . . . . . . . . @ . @ . . . . . . . @ . . . . . . . @ . . . @ . . . . . @ . @ . . . @
@ . . . . . . . . . . . . . . . . . . . . @ . @ . . @ . . . . . . . @ . . . . . @ . . . . . . . . . . . . . . @ . . . @ . . @ @ @ . @ . . @ . @ . . . . . . . . . . . . @ . @ . . @ . . . . . . @ . . @
@ @ @ @ @ @ @ @ @ @ @ @ @ @ @ @ @ @ @ @ @ @ @ @ @ @ @ @ @ @ @ @ @ @ @ @ @ @ @ @ @ @ @ @ @ @ @ @ @ @ @ @ @ @ @ @ @ @ @ @ @ @ @ @ @ @ @ @ @ @ @ @ @ @ @ @ @ @ @ @ @ @ @ @ @ @ @ @ @ @ @ @ @ @ @ @ @ @ @ @
3
9 12 55 85
41 52 42 56
96 61 32 44
