50 50
@ @ @ @ @ @ @ @ @ @ @ @ @ @ @ @ @ @ @ @ @ @ @ @ @ @ @ @ @ @ @ @ @ @ @ @ @ @ @ @ @ @ @ @ @ @ @ @ @ @
@ . . . @ . . @ . . . . . . . @ . . . . . . . . . . . . . . . . . . . . . . . . . . @ . . . . . . @
@ @ . . . . . . . . . @ @ . . . . . . . . . . . . @ . . . @ . . @ . . . @ @ . . . . @ . . . . . . @
@ @ @ @ . @ . . @ . . . . . . . . @ . @ @ . . . . . . . . . . . . . . . . . . . . . . . . . . . . @
@ . @ . . . . . . . . @ . . @ . @ . @ . . @ . . @ . . . . . . . . . . . . . @ @ . @ . . @ . . @ . @
@ . . @ . @ . . . . . . . @ . . . . . . . . . . @ . . . . . . . . . . . @ . @ . . . . . . @ . @ . @
@ @ . . . . @ . . . @ . . @ . . @ . . . . . . . . . . . . . . . . . . . . . @ . @ . . . . . @ . . @
@ . . . . . . . . . @ . . . . . . . . @ . . . . . . . . . . . . . . . . . . . @ . . . . . @ . . . @
@ . . . @ . . . . . . @ . . @ . . . @ . @ . @ @ . . . . . . . . . . . . @ . . . . . . . . . . . . @
@ . . . . . @ . @ @ . . . @ . . . @ . . . . . . @ . . . . . @ . . . . . . . . . @ . . . . @ . . @ @
@ . @ . . . . . . . @ . . . . . @ . . . . . @ . . . . . @ . @ . . . . . . . . . . . @ . . . . @ . @
@ @ . . . @ @ @ . . . . . . . @ . . . @ . @ . . . @ . . . @ . @ . . . @ . . . . . @ @ . . . . . . @
@ @ . . . . . . . @ . @ . . . . . . . . . . . @ . . . . @ . @ . . . . . . . . . . . . . . . . . . @
@ . . . . . @ @ . @ . . . @ . . . . . . . . . @ . . @ . . . @ . . @ . @ . . . . . . . . . . . . . @
@ . . . . . . . . . @ . . @ . . @ . . @ . . . . . . . . . . . . . . . . @ . . . . . . . . . . . . @
@ . . @ . . . . . . @ . @ . . . . . . . . . @ @ . . . . @ @ . . . @ . . . . @ . . . . . . . . . . @
@ . . . . . . . . . . . . . . . . . @ @ . . . . . . . . . . @ @ . . . . . . . . . . . . . . . . . @
@ . . . . @ @ . . . . . @ . . @ . . . @ . . @ . . . @ . . . . @ @ . . . . . . . . . @ . . . . . @ @
@ . . . . @ . . . . . @ . @ . . @ . . . . . . . . . . @ . @ . . . . . . . . . @ . . . . . . @ . . @
@ . . . . . @ . @ . @ . . . . . . @ . . . . . . @ @ . . . . . @ . . . . . . . . @ . @ . . @ . . . @
@ . . . . . . @ . . @ @ . . @ . . . . . . . . . . . . . @ . . . . . . . . . . . . @ . . . . . . . @
@ . . @ . . @ . . . . . . @ . . . . @ . . . . @ . . . . . . . . . . . . . . . . @ . . . . . . . @ @
@ @ . . @ . @ . @ . . . . @ @ . . @ . . . . . . . . . . . . . . . . @ . . . . . . . . . @ . . . @ @
@ . . . . . . . . @ @ . . @ . . . . @ . . . . . . . . . @ . . . @ . . . . . . . . . . . . . . @ . @
@ . . . . . . @ . . . @ . @ . @ @ @ . . @ . . . . . . . . . . . . . . . . @ . . . . . . . . . . . @
@ . . . . . . . . . . . . . . . . . . . . . . . . . . . @ . . . . . . . . . . . . . . . @ . . . . @
@ @ . . . . . @ . @ . . . . @ . . . . . . . . . @ . . . . @ . . . . . . . . . . @ . . @ . . . . @ @
@ . . . . . . . . . . @ . @ . @ . @ . . @ . . @ . . . . @ @ . . . . . @ . . . . . . . . . . @ . . @
@ . . @ . . . . . . . . . . . . . . . . @ @ . . . . . . . . . @ . @ . @ . @ . . . @ . @ . @ . . . @
@ @ @ . . . . . . . . . @ @ . . @ . @ . . . @ . . . . . . . . . . . . . . . . . . . @ . . @ . @ . @
@ . . . . . . . . @ . . . . . . . . . . . . @ . . . @ . @ . . . . . . . . . . . . @ . . @ @ . . . @
@ . . . @ . . @ . . . . . @ . . . . @ @ . . @ @ . @ @ . . . . @ . @ . . @ . . @ . . @ @ . . . . . @
@ . . . . . . . . . . . . . . @ . . . . . . . . . . @ . . . @ . @ . . . . . @ . . . . . . . . @ . @
@ . . . . . . . @ . . . @ . . . . . . . . . . . . . . . . . . . . . . @ . . . . . @ . . . @ . @ . @
@ . . . . . . . . @ . . . . . . . . . . . @ . . @ . . @ . . . @ . . @ . @ @ . @ . . . @ . @ @ . . @
@ . . @ . . . . . . . . . . . . . . . . . . . . . . . . . . @ . . . . . . . . . @ . . . . . . . . @
@ . . . . . . @ . . . . @ . . . . . @ . @ . . . . . @ . . . . . . . . @ . . . . . . @ . . . @ . @ @
@ . . . . . . @ . . . @ . . . . . . . . . @ @ . . . . @ . . . . . @ . @ . . . @ . . @ . . . . @ . @
@ . @ . . . . . . @ . . . @ . @ @ . . . . . . . . . @ . @ @ . . . . . . . @ . . . . . . . . . . . @
@ . . . . . @ . . . . . @ . . . . . @ . . . @ . . . . @ @ @ . . @ @ . . . . . . . . @ . . . . . . @
@ . . . . . . . . . . @ . . . @ . . . . . @ . . @ . . . . . . . . . . . . . . . . . . . . . . . . @
@ . @ . . . . . . . . . . . . . @ . . @ . . . . @ . . . . . . . . . . . . . . @ . . . @ . @ . . @ @
@ . . . . . . . . . . @ @ . . @ . @ . @ @ . . . . . @ . . . . . . . . . . . . . @ . . . . . . . . @
@ . . . . . . . . @ . . . . . . @ . . . . . . @ . . . . @ . . . . @ . . . . . . . . . . . . . @ . @
@ . . . . . . . @ . @ . . . . . . . . . @ . . . . . @ . . . . @ . . . . @ . . . . . . . . @ . . . @
@ . . . . . . . . . . . @ . @ @ . . . . . . @ . . . . . . . . . . . . . . . . . @ . . . . . . . . @
@ . . . . @ . . @ . @ . . . . . . . @ . . . . . . . . . . . . @ . . . . . . . @ . . . . . @ . . . @
@ . . . . . . . . . . . . @ . . @ . . @ @ . @ . @ . . . . . @ . . @ . . @ . . . . . . . . @ . . . @
@ . . . . . . . . . . . . @ . . . . . . . . . . . . . . . . . . . . . . . . . . . . @ . . . . . . @
@ @ @ @ @ @ @ @ @ @ @ @ @ @ @ @ @ @ @ @ @ @ @ @ @ @ @ @ @ @ @ @ @ @ @ @ @ @ @ @ @ @ @ @ @ @ @ @ @ @
3
32 43 43 7
47 1 2 39
41 21 27 39
