25 25
@ @ @ @ @ @ @ @ @ @ @ @ @ @ @ @ @ @ @ @ @ @ @ @ @
@ . . . . . . . . . @ . . . @ @ . . . @ . . . . @
@ . . @ . . . . . . . @ . . @ . . . . . . . . . @
@ . @ . . . . . @ . . . . . . . . . . . . . . . @
@ . . . @ . . . . . . . . . . . . . . . . . . . @
@ . . . . . @ . . . . . . . . . . . . . . . @ . @
@ . . . . . . . . . . . . . @ . . . . . @ . @ . @
@ . . @ . . . . . . . . . @ . . . . . . . . . . @
@ . . . . . . . . . . . @ . . @ . @ . . . @ . . @
@ . . . . @ . . @ . . . . . . . . @ . . @ . . . @
@ . . . . @ @ . . . . . @ @ . @ @ . . . @ . . . @
@ . . . . . . . . . . . . . . . . . . . . . . @ @
@ . . @ @ . . . @ . . . . @ . . . . . @ . . @ . @
@ . @ . . . . . . . . @ . . . . . . . . @ . . . @
@ . . . . . @ . . . @ @ . . . . . . @ . @ . @ . @
@ . . . @ . . . . . . . . . @ . . . @ . . @ . . @
@ . . . @ . @ . . . . . . . . . . . . @ @ . @ . @
@ . @ . . . @ . . @ . . . @ . @ . @ . . . @ . . @
@ . . @ . @ . . . . . . @ . . . . . . . . @ . . @
@ @ . . . . . . . @ . . . @ . . . . . . . . . . @
@ . . . . . . . . . @ . . . . . @ . . @ . . . . @
@ . @ @ . . . . . . @ . . . . . . . . . @ . . . @
@ . . @ @ . . @ . . @ . . . @ . . . . @ . . @ . @
@ . @ @ . . . . . . . . . . . . . . @ . . . . . @
@ @ @ @ @ @ @ @ @ @ @ @ @ @ @ @ @ @ @ @ @ @ @ @ @
3
7 12 1 7
11 12 6 17
1 16 6 12
