100 100
@ @ @ @ @ @ @ @ @ @ @ @ @ @ @ @ @ @ @ @ @ @ @ @ @ @ @ @ @ @ @ @ @ @ @ @ @ @ @ @ @ @ @ @ @ @ @ @ @ @ @ @ @ @ @ @ @ @ @ @ @ @ @ @ @ @ @ @ @ @ @ @ @ @ @ @ @ @ @ @ @ @ @ @ @ @ @ @ @ @ @ @ @ @ @ @ @ @ @ @
@ . @ . . . . @ . . . @ . . . . . . . @ . . . @ . . . . . . . @ . . . . . . . . . . . . . . @ @ . . . . . @ . . . . . . . @ . @ . @ . @ . . . . @ . . . . @ . . . . . @ . . . . . . . . . . . . . . . @
@ . . @ . . @ . @ . . . . . . . . . @ . @ . @ @ @ . . . . . . . . . . . . @ . . . . . . . . . @ . . . @ . . . . . @ . . . . . . . . @ . @ . . . . @ . @ @ @ . . . . . . . . . . . . . . . . . . . . . @
@ . @ . . . . @ . . . @ . . . @ . . . . . . . . @ . . . @ @ . . . . @ @ . . . . . . . . . . . . . . . . . . . . . . . @ . . . . @ . . . . . . . . . . . . . @ . . . . . . . . . . . @ . @ . @ . . . @ @
@ . @ . . . @ . . . . . . . . . . . @ . . . . . . . . @ . . . . . @ @ . . . @ . @ @ . . . @ . . . . . . . . . . . . @ . . . @ . . . . . @ @ . @ . . @ @ . . . . . . . . . . . @ . . . . . @ . . . . . @
@ . . . . @ . . . . . . . . . . . . @ . . . @ @ . . . . . . . . . . . @ . . . . . . . @ @ . . . @ . . . . . . . . @ . . . @ @ . . . . . . . . . . . . . . . . . . @ . . @ . . . . . @ @ . . . . . . . @
@ . @ @ . @ . . . . . . . . @ . . . @ . @ . . . . . @ . . . . @ . . @ . @ . . . @ . @ . . . . . @ . . . . . . . . . . . . @ . . . . . . . . . . @ . . . . . . . . . . @ . . . . . . . . . . . . . . . @
@ . . . @ @ . . . . . . . . . . . . . . . . . . @ . . . @ . . @ . . . @ . . . . . . . . . . . . . @ . . @ . @ @ . . @ . . . . . . . . @ . . @ . . . . @ . . . @ . @ . . . . . @ . . . . . . . . @ . @ @
@ . @ . . @ . . . . . . . . . . . @ . . . . @ . . . . @ . . . . . . . . @ . . . . . . . . @ . . . . . @ . . . @ . . . . . . . . . @ . . . . @ . . @ @ . . @ . . . @ . . . . . . . . . . . . . . . @ . @
@ . . @ . . . . . . . @ . . @ . . . . @ @ @ @ . . @ . . . . . @ . . . . . . @ . @ @ . . . . . . . . . . . . . . . @ . . . . . . . @ . . . . . . @ . . . @ @ . . . . . . . @ . . . . . . . . @ . . . @ @
@ @ . @ . . . @ . @ . . @ . . . . . . . . @ . . . . . . . . . . @ @ @ . . . . . . @ . . . . . . . @ . . @ . . @ . @ . @ . . . . @ . . . . . . . . . . . . . . @ @ . . @ @ . . . . . . . . . . . @ . @ @
@ . @ . @ . . . . . . . . . . . . . . @ . @ . . . . . . . . @ . . @ . . . . @ . . . . . . . . . . . . . . . . . @ . @ @ . . . @ . . . @ . . . . . . . @ @ . . . . . @ . . @ . . . . . . . . . @ . @ . @
@ . . . . @ . . . . @ @ . . . . . . @ . . . . . @ . . . @ . . . . . . . . . . @ . @ . @ . . . @ @ @ . @ . . . . . . . . . . . . . . . . . . @ . . . . . . . @ . @ . . . @ . . . @ . . . . . . . @ . . @
@ . @ . . . . . . . . . . @ . @ . @ . . . . . @ . . . . . . @ . . . @ . @ . . . @ . . . . . . . . . . . . . . . . @ . . . . . . . . . . . . . . . . . . . . . . . . @ . . . . . . @ . . . . . . . . @ @
@ . . . . . @ . . . . . . . . @ . . @ . . @ . . . . . . . . . . . . . . . . . @ . . . . @ @ . . . . . . . @ @ . . . @ . . @ . . . . . . @ @ . @ . @ . . . . . @ . . . @ . . . . . . . . @ . . . . . . @
@ . . . . . . @ . . . . . . . . . . . @ @ . . . . . . . . . @ . . @ . . . . . . . @ @ . . . @ . . . @ . . @ . @ @ @ @ . . . . . . . . . . @ @ . . @ . . . . . . . . . . . . . . @ @ @ . . . . . . . . @
@ . . . . . . . . . @ . . . . . . . . . . @ . . . . . . . . . @ . . . @ @ @ . . . @ . @ . . @ . . . @ . . . . . . . . @ . @ @ . . . . . . @ . . . @ . @ . @ . @ . . @ . . . . . . . . . . . . . . . @ @
@ . . @ . . @ . . . . . . . . @ . . . . @ . . @ . . . . . . . . . . . @ . . . . . . @ . . . . . @ . . @ . . . . . . . @ . . . . . @ . . @ . @ @ . . . @ . . . . . . @ . @ . . @ . @ . . . . . . . . . @
@ @ . . @ . . @ . . . . . . . . . . . . . @ . . . . . . . . . . @ . . . . . @ @ @ . . . . . @ . . . . @ . . . . @ . . . . @ . . . . . . . . . . . . . . . . . . . @ . . . @ . . . @ . . . . . @ . . . @
@ . . . . @ . . . @ . . . @ . . @ . . . . . . . @ . . . . . . @ . . @ . @ . . . . . . @ . . @ . . . @ . . . . . . . . . @ . @ . . . . . @ . @ . . . . @ . . . . . . . . @ . . . . . . . @ @ . . . @ . @
@ @ . . . . . . . . @ @ . @ . . @ . . . . . . @ . . . . . . . . . . . . @ . . . . . . . . . . . . . . . . . . . . . . @ . . . . @ . . . . @ . . . . . . @ . . . . . . . . . @ . . . @ . . . . . . . . @
@ . . . @ . . . @ . . . @ . @ . @ @ @ . . . @ . . . . @ . @ . . . . @ . . . . . . . . . . . . . @ . @ . @ @ . . . . @ . . . . . . . . . . . @ . . . . @ . . @ . . . . @ . @ . . . . . . . . . . . . . @
@ . . @ . . . . @ . . . . . . . . . . . . . . . . @ . . . . . . @ . . @ @ . . @ . . @ . . . . . @ @ . @ . . . @ @ . . @ . . . . . . . . @ . . . . @ . . . @ . . . @ . . . . . @ . . @ . . @ . @ . . . @
@ . . . @ @ . @ . . . . . . . . . @ . @ . @ . . @ . . . @ . @ . . . . @ . . @ @ . . . . . . . . . . . . . . . . . . . . . . . . @ . . @ . @ . . . . . . . . . . . . @ . . . @ @ . . @ . . @ . . . . @ @
@ . . . . . . . . . . . . . . @ . . @ . . @ . . . . @ . @ @ . . . @ . . . @ . . @ . . . . . . . . . . . . @ . . . . . . . . @ . . @ . . . . . . . . . . @ . . . . . . . . . . . . . . . . . . . . . . @
@ . . . . . . . . . @ . . . . . . . . @ . . . . . . . . @ . . . . . @ . @ . @ . . . @ . . . . . . . . . . . . . . . @ . . . . . . . . @ . @ . . @ . . . . . . @ . . . . . . @ . . . . @ . . . . . @ . @
@ @ @ . @ . . @ @ @ . @ . . . . . . . . . @ @ . . . . @ . . . . . . . . . . . . . . @ @ . . @ @ . . . . . @ . . . . . . . . . . . . . . . . @ . . @ . . . @ . @ . . . . . . . @ @ . . . . . . @ . . . @
@ @ . . . . . . @ . . . @ . . . . . . . . . . . @ . . . . . . . . . . . . . . . . . . . . . . . . @ . @ . . . . . . . . . @ @ . . @ . @ . @ . . . . . . . . @ . @ . . . . . . @ . . . . . . . . @ @ . @
@ . . . . . . @ . . @ . . @ . . . . . @ . . . . . @ . . . . . . . . . @ @ . . . . . @ . . . . . . . . . . @ . . . . . @ . . . . . . @ . . . . @ . . . . . @ . . . . @ @ . . @ . . . . @ . . . . . . . @
@ . . . . @ . . . . @ @ . . . . @ . @ . . . . . . . . . . . . . . @ . . . . @ @ . . . . . . . . . . @ @ . @ . . . . . @ @ . . . @ . @ . . . @ . . . . . . . @ . . . . . . . @ . . . . . . . . . @ . . @
@ @ . . @ @ . . . . . @ @ . . . . @ . . @ . . . . . . . . . . . . @ . . . . . . . . @ @ . . . . . . . @ . . @ . . . . . . . . . . . . . . . . @ . . . . . @ . . . . @ . . @ . . . @ . @ . . . . . . @ @
@ . . . . @ . . . @ . . . @ @ . . . . . . . . . . @ . @ @ . . . . . . . @ . @ @ . . . . @ . @ @ . @ . . . . . . . . . . . @ . . . . . . @ . . . . . . . . @ @ . . . @ . . . @ . @ . . . . . . . . @ . @
@ . . . @ . . . . . . . . . . . . . . . . . . . . . . . . . . . @ . . . . @ . . . . . . . . @ . @ . . . . . . . . . . @ @ . . @ . @ . . . . . . . . . . . . . . . . . . @ . @ . . @ . . . @ . . . . . @
@ . . . . @ @ @ @ . . @ . . . @ . @ . . . @ . . . . @ . . . . . @ . @ . @ @ . @ . . . . @ @ . . . . . . . . . . . . . @ . . . . . @ . . . . @ . . . . . . . @ . . . . @ . @ . @ @ . . . . . . . . . . @
@ . . . . . . . . . @ . . . @ . . . . . . . . . . @ . . . . . @ . . . @ . . . . . @ . . @ . . . @ . . @ . . . . . @ . . . . . . . . . . . . . . . . . . . . . @ . . . . . . . . . . . . . . . . . @ . @
@ @ . @ . . . . @ . . . @ @ . @ . . . . . . . . . @ . . . . @ @ . . . . @ . . . . . @ @ @ @ . . . @ . . . . @ . . @ . . @ . . . . . . . . . . . . . . . . @ . . . . . . . . . . @ . . . . @ @ . . . @ @
@ . @ @ . . @ . . . . . . . . @ @ . . . . . . . @ . . @ . . . . . . . . . . . . . . . . . . . . . . . . . . @ @ . . @ . . . . . . . . . . . @ . . . . . @ @ . . . . . . . . . . . @ . . . . . . . . . @
@ . . . . @ . . @ . . . . . . . . @ . . . . . . . . @ . . @ . . @ @ . . . . @ . @ . . @ @ . . . . . . @ . . . . . . . . . . . . . . . @ . . . . . . . @ . . . . . . . . . . . . . . @ . @ @ . @ . . . @
@ . . @ @ . . . @ . . . . . . . . . . . . . . . @ . . . . . . @ . @ . . @ . . . . . . . . . . . . . . @ . . . . . . . . . . . . . . . . . . . . @ . . . . . . @ . . @ . . . . @ . . . . . . . . . . . @
@ . . @ . @ . . . . . . . @ . . . . . . @ . . . @ . . . . . . . @ . . . @ . . . . . . . . . . . . @ . @ . @ . . . . . . . @ . . . . . . . . @ . . . . . . @ . . . @ . . . . . . @ . @ . @ @ . . @ . . @
@ . . . . @ . . . . . @ . . . . @ . . @ . . . . . . . . . @ . . . . . . . @ @ . @ @ . . . . . . . @ @ . . @ . . . . . . . . . @ . . . . . . . . . . . @ . . . . . . @ . . . . @ . . . . @ . @ . @ . . @
@ . . . . . @ . . . . @ . . . @ . . . . @ . . . . . . . . . . @ . . @ . . . . @ @ . @ . . . . . . . @ @ . @ . @ . . . . @ . @ . . . @ . @ . @ . . . . . . . . . @ . . . . . . . . . . . . . . . . . . @
@ . . . . . . @ . @ . . . . . . . . @ . . @ . . . . . . . . . . . . @ . . . . . . . @ . . . . . . . . . @ @ . @ . . . @ . . @ . . . . . . @ . . . . . . @ . . . . . . @ . . . . . @ . . . . @ . . @ @ @
@ . . . . . . . . . . . . . . . . @ . . @ . . . . . . @ . . . . . @ . . . . . . . . . . . . . . . . . . @ . . @ . . . . . . . . @ . . . @ . . . . . . . . . @ @ . . . . . . @ . @ . . . . @ . . . . . @
@ . . @ . . . . . . @ . . . . . . . . . . . . . . . . . . . . . . . . . . . @ . . . . @ . @ . . . . . @ . @ . @ . . @ . . . . . . . . . . . . . . . . . @ @ . . . . . . . . . . . @ @ @ . . . . . @ . @
@ . . . . @ . . . @ . . . @ . . . @ . . . @ . @ @ . @ . . . . . . . . . . . . @ . @ . . @ . . . . @ . . . . . . . . . . . . @ . . . . @ . . @ @ . . . . . . @ . @ . . @ . @ . @ . @ . . . . @ . . . . @
@ . . . . . @ @ . . . @ . . . . . . . . @ @ . . @ . . . . @ . . @ @ . . . . . . @ . . . . . . . . . . . . . . @ . . . . @ . . . . . . . . . . . . . @ . . . . . . . . . @ . @ . . . . . . . @ . . @ . @
@ . . @ . . . . . . @ @ . . . . . . @ . . . . . . . . . . . @ . . . . . @ . . @ . . . . . . . @ . . . . . . . . @ . . @ . . @ . . . . . . . . . . . . . . . . . . . @ . . @ . . @ . . . . . . @ @ . . @
@ . . . . . . . @ . . . . @ @ . . . . . . . . @ @ . . . . . . . @ @ . . . . . @ @ . . . . . @ . . . . . . . . . . . . . . @ . . . . . . . @ . . . . . . . . . . . . . . . . . . @ . @ . @ . @ . . . . @
@ . . @ . . @ . . . . @ . @ . @ . . . . . . . . . . . @ . . . . @ . . @ @ . . @ . . . . . . . . . @ @ . . . @ . @ . . . @ . @ . . . . . . . . . @ . . . . . . . @ . . . . . . @ . . . . . . . . . @ . @
@ . . . . . @ . @ . . . . . . . . . . . @ . . . . . . . . . . . . @ . . . @ . . . . . . . @ . . . . . . . @ . . . . . . . . . . . . . . @ @ . . . . . . @ . . . @ . . . . @ . @ @ @ . . . . . . . . @ @
@ . . . . . . . . @ . . . . . @ . @ . . @ . . . @ . @ . . @ . . . . @ . @ . . . . . @ . . . . . . @ . @ . @ @ @ . . @ . . @ . . . . . @ . . . . . . . . . @ . . . . . . . . @ . . . . . . . . . . . . @
@ . . . . . . . . . . . . @ . . . . . . . @ @ . . . . . . . . . @ . . @ . @ . @ . . @ . . @ . . . . @ . @ . @ . @ . . . . @ . . . . . . . . . . . . . . . . . . . . . . . . @ . @ . . . . . . . . . . @
@ . . . . @ . @ . . . . . . . . @ . @ . . . . . . @ . . . . . . @ . . . . . . . . . . @ . . @ . . . . . . . . . . . . . . . @ . . @ . . @ . . . . . @ . . @ . . @ @ . . . @ . . . @ . . @ . . . . . . @
@ . . . . . . . . @ . . . @ . . . . . . . . @ . . . . . . . . @ . . . . . . . . . . . . . . @ . . . . . @ . . . . . . . . . . @ . . . @ . . . . . . . @ . @ . . . @ @ . . . . . . . @ @ . . . . . . . @
@ . @ @ . @ @ @ . . . . . . . @ . . . @ @ @ . . . @ @ . . . . . . . . . . . . . . @ @ . . . @ . . . . . @ . . . . @ @ @ . . . . . . . . . . . . . . . . . . . @ . . . . . @ . . . . @ . . . @ . @ . . @
@ . . . . . . . . @ . @ . . @ . . . . . . . @ @ . . . . . . . . . @ . . . . . . . . . . . . @ . @ . . . . . @ . . . . . . . . . . . . @ . . . . . . . . . . . . . . . . . . . . . . . . . @ . @ . @ . @
@ . @ . . . . . . . . . . . . . . . . . . . . . . . @ @ . . . . . @ @ . . @ . . . @ . . . . . @ . . . . . . @ @ . . . @ . . @ . . . . . . . . . . @ . @ @ . . . . @ . . @ . . . . . . . . . @ @ . . @ @
@ @ . . @ . . . . . . . . . . . @ . . . . . . . . @ . . @ . . . . . . . . . . @ . . . . . . . . . . . . . . . . . . . . . . . @ . . . . @ . . . . . . . @ . . . . @ @ . . @ @ . @ . . . . . . . . . . @
@ . . . . . . @ . . @ . . . @ @ . . . @ . @ . . . . . . . @ . . . . . . @ . . . . . . . @ . . . . @ . @ . . @ . @ . . . . . . . . . . . . . @ . @ . . . . . . . . . . . . @ . . . . @ . . . . . . . . @
@ @ . @ . . . . . . . @ . . . . . . @ . . . @ . @ . @ . . . . . . @ . . . . . . . @ . . @ . @ . . @ . @ . . . . . . . . . @ . . @ . . . . @ . . @ . . @ . . . . . . . @ . . . . . . . . . . . . @ . @ @
@ . @ . . . . . . @ . . @ . . . . . . @ . . @ . . . @ . @ . . . . @ . . @ . @ . . . . . . . . . . . . . . . . . @ . . . . . . @ . @ @ @ @ . . . @ . . . . . @ . . . . . @ @ . . . . . . . . @ . . . . @
@ . @ . . . . . . . . . . . . @ . . . @ . . @ . . . @ @ . . . . @ . . . . . @ @ . . . . . @ . @ . . . . . . @ . . . . @ . . @ . . . . . @ . . . . . . . @ . . . @ @ @ . @ . . . . . . . @ . . . . . . @
@ . @ . . . . . . . . . . . . . @ . @ . @ . . . . . . . . @ . . . . . . . . . . . . . . . . . . . . . @ . . . . . @ @ . . . . @ . . . . . . . . . . . . . . @ . . . @ @ @ . . @ . . . . @ . @ . @ . . @
@ . . . . @ . . . . . . . . . . . @ . . . . @ . . . @ . . . . . . . @ . @ . . . . . @ . . @ . . . . @ . . . . . . . . @ . . . @ . . . @ . . . . . . @ . . @ . . . . . . . . . . . . . . . . @ . . @ . @
@ . . @ @ . @ @ . . . . . . . @ . . @ . @ . . . . @ . @ @ . . . @ . . . . . @ . @ . . . . . . @ . . . . . . . . . @ . . . . . . . . . . . @ . . @ @ . . . . . @ @ @ . . . @ . . . . . . . . . @ . . @ @
@ . . . . . . . . . . . . @ . @ . . . . @ . . . . . . . . . . . . . . . . . . @ . . . . @ . . . . . . . . @ @ . . . . . . . . . . @ . . . . . . @ . @ . . @ . . . @ . . . . . . . . @ . . . . . . . @ @
@ . @ @ . @ . . . . . . . @ . . . . . . . @ . @ . . @ @ @ . . . . . . . @ . . . . @ . . . . . @ . . . . . . . . @ . . . . @ @ @ . . . . . . . . . . . . . . . . . . . . . . . . @ @ . . . @ @ @ . . . @
@ @ . . . . @ . . . . . @ . . . . . @ @ . . . . . . . @ . . . . . . . . . . . . . . @ . @ . . . . . . . @ . . . . @ . @ . @ . @ . . . . . . . . . . . . . @ . . . . @ . . @ . . @ . . . @ . @ @ . @ . @
@ . . . . . . . . . @ . . . . @ . . . @ . . . . . . . @ . . . . . . . . . . @ . . . . . . . . . . @ . . @ @ . @ . . @ . . . . . . . . . . . . . . . . . . . . . . . . @ . . @ @ . . . . . @ . @ . . . @
@ . . @ . . . . @ . @ . @ . . . . @ . . . . . . . . . . @ . @ . . . . . . . . . . . . @ . . . . . @ . . . . . @ . . . . . . . . . . . . . . @ . . . . . . . . . . . @ . . . . . . . . @ . . . @ . . @ @
@ @ . . . . . . . . @ . . . . @ @ . . . . . . . . . @ . . . @ @ . . . . . . . @ . @ . . . @ . . . . . . . . . . . . . @ . . . . @ . . . . @ . . . . . . . . . . . . . . . . . . . @ . . @ . . . @ . . @
@ . @ . . @ . @ . . @ @ . . . . . . . . . . . . . . . @ . . . @ . . . . . . @ . . . @ . . . . . . . . . . . . . . @ @ . . . . . . . . . @ . @ . @ . . . . . . @ . @ . . . @ . . . . . . . . . @ . . . @
@ . . . . . . . . . . . . . . . @ . . . @ . @ . . . . @ . . . . . . . . @ @ . . @ . . @ . . . . . . . . @ . . @ . . @ . @ . . . . . . . . . . . @ . . . @ @ . @ . . . . @ @ @ . . . . @ @ @ . . . . . @
@ @ . @ . . . . . . . . . . . @ . @ . . . . @ . . @ @ . @ . . @ . . . . . . . . . . . . . . . . . . . . . . . . . . . . . . . . . . @ . @ . . . @ . . . . . . . . . . . . . . @ . @ . . . . . . . . . @
@ . . . . . . . . . . @ . . . . @ . . . . . . . @ . . . . @ @ @ . . . @ . . . . . . . . . . . . @ . @ . @ . . . . . . . @ . . . . . @ . . . . . . @ . @ . . . @ . . . @ @ . . . . . . @ . . . . . . @ @
@ . @ @ . . @ . @ . . . . . . . . . . . . . . . . . . . . . . . @ . . . . . . . . . . @ . @ @ . . . . . . . . . . . . @ . . . @ . @ . . @ . . @ . . . @ . . . . @ . . . . . @ . @ @ @ . @ . . . . . . @
@ . . . . . . . . @ . . . . . . . @ @ . @ . . @ . . . . . . . @ . . . . . . . @ . . . . . . . . @ . . . . . . . . . . @ . . . @ . . . . . . . . @ . . . . . . . . . . . . . . . . . @ . . @ . . @ . . @
@ . @ . . . . . . . . . . . . . . . . . . . . . . . . . . . @ . . . . . @ . . . . . . @ . @ . . . . . . . . @ . . . . . . . . . . . . . . . . . . . @ . @ . . @ . . @ . . . @ . . . . . @ . . . . . . @
@ . . . . @ . . . . . . . . . @ . @ . . . . @ . @ . . . . . . . @ . . @ . . @ . . . . . . . . . . @ . . . . . . . . @ . . . . . . . . . @ . . . @ . . . . . . . . . . @ . . @ @ . . . . . . . . @ . . @
@ @ . . . . . . . . . . . . . . . . . . . . . . . . . @ . . . . @ . . . . . . @ @ . . . @ . . . . . . @ @ . . @ . . . . . . . . . . . . @ . . . @ . @ . @ . . . . . . . @ . . @ @ . . . @ @ . . . . . @
@ . . @ . . . . @ . . . . . . . @ . . . . @ . . . . . . @ . @ . . . . . . @ . . . @ . . . @ . . . . @ @ . . @ . . . @ . . . . @ @ . . . . . @ . . . @ . . . . . @ . @ . . . . . . . @ . . @ . . . . @ @
@ . . . . . . . . . . . @ . . . . . . . . . . . . . . @ . . . . @ . . . . . @ . . . . . . . . . . . . . @ . . . @ . . @ . @ . . . . . . . @ . . . . . . . . @ . . @ . . . @ . . . @ . @ . . . . . . . @
@ . . . . @ . . @ . . . . . . . . . . . . . @ . . . . @ . . . . . . . . . @ . . . @ . . @ . . . @ . . . . . @ . @ . @ . . . @ @ @ . . @ . . @ . . . . . . @ . . . . . . . @ @ . @ . . . . @ . @ . . . @
@ . . . . . . . . . . . . . . @ . . . . . . . . . . . . . . . @ . . . . . . . . . . . . . . . . . @ @ . . . @ @ . . @ . . . . . @ . @ . . . . . @ . . . . . . . @ . . @ @ . @ . . . . . . . . . . @ @ @
@ . @ . . . . . @ . . . . @ . . @ . . . . . . . . . . . @ . . . . . . @ . . . . . . . . . . . . . . . . . @ . . . . . . . . . . . . . . . . . @ . . . . . @ . @ . . @ . . . @ . . . . . . . . . . . . @
@ . . . . . . . . . . . . @ . . @ . . . . @ . @ @ . . . @ . . @ . . . . . . @ . . @ . . . . . . @ @ . @ . . @ @ . . @ . . @ . . . . . . . . . . . @ . . . . . . . . . . . . . . . . . . . . . @ @ . . @
@ . . . . . . . . . @ . . . . @ . . . . . . . . . . . @ . . . . @ . . @ @ @ . . @ . . . . . . . . . @ . . . . . . @ . . @ . @ . . . . . . @ . . @ . . . . . @ . . . . @ . . . . . . . @ . . . . . . . @
@ . . @ . . . . . . . . . @ . . . . . . @ . . @ . . . . . . . @ . @ . . . . . @ @ . . @ . @ @ @ . . . . . . . @ @ . . . . @ . . . . @ . . @ . . @ . . . . . @ @ . . . . @ . . . . . . @ @ . . @ . . . @
@ . . . @ . . . . . . . . . . . . . . . . . . . . . . . . . @ . @ . . @ @ . @ . @ . . . @ . . . . . . . @ . . . . . . . . . . . @ . . . . . @ . . . . . @ . . . . . . . . . . . . . . . . . . . . . @ @
@ . @ . . . . . @ . . @ . . . . @ . . . . . . @ . . . . . . . @ . . . . . . . @ . . . . . . . @ . . . . . @ . . . @ . @ . @ . . . . . . . . . . @ . . . . . . . . @ @ . . . @ @ . . . @ . . . . . . . @
@ . . . . @ . @ . . @ . . @ . . @ . . . . . . . . . . . @ . @ @ . . . . . . . . @ @ . . @ @ . . . . . . . . @ @ . . @ . . . . . @ . . . @ . . . @ . . . . . @ . . . . . @ @ . . . . @ . . . . . @ . . @
@ . . @ . . . . . . @ @ . . . . . . @ . . @ . @ . . . . . . @ . . . . @ . . . @ @ . . . . @ . . . @ . . @ . . . . @ . . . . . . . . . . . @ . . . . . . . . . @ @ . . . . . . @ . . . . . . . . . . . @
@ . . . . . @ . . . . @ . . . . @ . . . . . . . . . . . . . . . . @ . . . . . . . . . . . @ . . @ @ . @ . . . . . . . . . . . . . . . . @ . . . . . . @ . . . . . @ . . . . . @ . . . @ . . . @ . . . @
@ . . . @ . @ @ @ @ . . . @ . . . . . @ . . . . @ . @ . . @ . . . . . . . . . . . @ . @ . @ . . . . . @ . . . . . . @ @ . . . . . . @ . . . . . . @ @ . @ . . . . . . . . . . . . . @ . @ . @ . . . . @
@ @ . . . . @ @ . . @ . . @ . . . . . @ . . . . . . . @ @ . . . . . . . . . . . . . . . @ . . . . . . @ . . . . . @ . . . . . . @ . . . . . . . @ . . @ . @ . . . . . . . . . @ . . . . . . . . @ . . @
@ . . @ @ . . . . . . . @ . . . @ . . . . . @ . . . . . . . . . . . @ @ . . . @ . . @ . @ . . . . @ . . . . . . . . . . . . . . @ . . . . . . . . . . . @ . . . . @ . . . . @ . . . . . . . . @ @ . . @
@ . . . . . . . @ . . . . . . . . . @ . . . . . . @ . @ . . . . @ . . . @ . @ . @ . @ . . . . . @ . @ . @ . @ . . . . . . @ . . @ . @ . . . . . @ . . . . @ . . . . . . . . . @ . . . . @ . . . @ @ . @
@ . . . . . . . . . . . . @ . . . . . . . . . . . . . . . . . . . . . . @ . . @ . . . . . . . . @ . . . . @ . @ . . . @ . . . . . . . . . . . . . . @ . . . . . . . @ @ . . . . @ . . . . . . . . . . @
@ @ @ @ @ @ @ @ @ @ @ @ @ @ @ @ @ @ @ @ @ @ @ @ @ @ @ @ @ @ @ @ @ @ @ @ @ @ @ @ @ @ @ @ @ @ @ @ @ @ @ @ @ @ @ @ @ @ @ @ @ @ @ @ @ @ @ @ @ @ @ @ @ @ @ @ @ @ @ @ @ @ @ @ @ @ @ @ @ @ @ @ @ @ @ @ @ @ @ @
3
58 32 38 78
22 46 47 64
34 89 77 1
