12 12
@ @ @ @ @ @ @ @ @ @ @ @
@ . . . . . @ . . . . @
@ . @ @ . . . @ . . . @
@ . . @ . . . . . @ . @
@ . . . . . . . . . . @
@ . . . . . . . . . . @
@ . . . . . . . . . . @
@ . @ . . . @ . . . @ @
@ . . . . . @ . . . . @
@ . . @ . @ . . . . . @
@ . @ . . . @ . . . @ @
@ @ @ @ @ @ @ @ @ @ @ @
3
5 2 8 5
7 9 4 1
4 3 5 3
