12 12
@ @ @ @ @ @ @ @ @ @ @ @
@ . @ . . . . . . . . @
@ . . . . . . . @ . . @
@ . . . . . . . . . . @
@ . . @ . @ @ @ . . @ @
@ . . . . . @ . . . . @
@ @ . . . . . . @ . . @
@ . . . . . . . . @ . @
@ . . . . @ . . . . @ @
@ . . . . . . @ . . . @
@ . . . @ . . . . @ . @
@ @ @ @ @ @ @ @ @ @ @ @
3
3 4 3 6
2 7 1 4
6 2 1 9
