12 12
@ @ @ @ @ @ @ @ @ @ @ @
@ @ . . . . . . . . . @
@ . @ . . . . . . . . @
@ . . @ . . . @ . . . @
@ . . . . . . . . . . @
@ @ . . @ . . @ . . . @
@ . . . . . . . . . . @
@ . @ . . . . . @ . . @
@ . @ . . . . . . . . @
@ . . . @ . . . . . . @
@ . . . . . . . @ . @ @
@ @ @ @ @ @ @ @ @ @ @ @
3
2 7 1 5
5 9 6 3
7 3 10 5
