25 25
@ @ @ @ @ @ @ @ @ @ @ @ @ @ @ @ @ @ @ @ @ @ @ @ @
@ . @ . . . . . @ . . . . . . . . . . . . . . . @
@ . . . . @ . . . . . . . . . . . . . @ . @ @ . @
@ . . . . . @ . . . . . . . @ . . @ . @ . @ . . @
@ . . . . . . . . . @ . . . . . . . . . . . . . @
@ @ . . . . . . . . . . . @ @ . . . . . . . . . @
@ . . @ . . . @ . . . @ @ . . . @ . . @ . . . . @
@ . . . @ . . @ . . @ . . @ . . . . . . . @ . . @
@ . . . @ . . . . . @ . . . . . . . @ . . . . . @
@ . . @ . . . . @ . . @ . . . . . . . @ . @ . . @
@ . . . . @ . . . . . . . . . . . . . . @ . . . @
@ . . @ . . . @ . . . . . . . . . . @ . @ . . . @
@ . . . . . . . . . . . @ . . . . . @ . @ . @ . @
@ . . . @ . . . . @ . . . . . . . . . . . @ . . @
@ . . . . . @ . . . . @ @ @ . . @ @ . . . @ . . @
@ @ . . . . . . . . @ . @ . . . . @ @ . @ . . . @
@ @ . . . @ . . @ @ . . . . . @ . . . @ @ . @ . @
@ @ . . . . . . @ . . . . . @ . . . . . . . @ . @
@ . @ . . . . . . @ . . . . @ . . . . . @ @ . . @
@ . . @ . . . . . . @ . @ @ . . . . . . . @ . @ @
@ . . . . . . . @ . . . . . . @ . . . . . @ . . @
@ @ . . . @ @ . . . @ . . @ . . . . @ . . @ @ . @
@ . . . . . . @ . . . . . . . . . . @ . . . . . @
@ . @ . @ . . @ . . . . . . . @ . . . . . . . . @
@ @ @ @ @ @ @ @ @ @ @ @ @ @ @ @ @ @ @ @ @ @ @ @ @
3
12 23 13 19
22 14 9 5
21 20 18 16
