100 100
@ @ @ @ @ @ @ @ @ @ @ @ @ @ @ @ @ @ @ @ @ @ @ @ @ @ @ @ @ @ @ @ @ @ @ @ @ @ @ @ @ @ @ @ @ @ @ @ @ @ @ @ @ @ @ @ @ @ @ @ @ @ @ @ @ @ @ @ @ @ @ @ @ @ @ @ @ @ @ @ @ @ @ @ @ @ @ @ @ @ @ @ @ @ @ @ @ @ @ @
@ . . . . . . . . . . . . . . . . . . . . . . . . @ . . @ . . . . . . . . . @ . . @ . @ . @ . . . . . @ . . @ . . . . @ . . . . . . . . . @ . . . @ . . . @ @ . . . . @ @ . . . . @ @ . . . . . . . . @
@ . . . . . . . . . . @ . . . . . . @ . @ . . . . . . . . . . . . . . . @ . . @ . . . . . . @ . . . . . . @ . . . . . . . . . @ . . . . . . @ . . @ . @ . . . . . . . . @ @ . . . . . . . . @ . . @ @ @
@ . . @ . . . . @ @ . . . @ @ . . . @ . @ . . . . @ . . . . @ . . . . . . @ . . . . @ . . @ . . . . . @ . @ @ . . . . . . . . . @ @ . . . . . . @ @ @ @ . . @ . . . . . . . . . @ . @ @ . . . . . . . @
@ . . @ . . . . . . . . @ . . @ . . . . . . . . @ . . . . . . . @ @ . . . . @ . @ . . . . . . @ . . . . . . . @ @ . . . @ @ . . . . . . . . @ . . . . . . . . . . . . @ . . @ . . @ . . @ . . . . . . @
@ . @ . . . . . . . @ . . @ . . . . . . . . . . @ . @ . . . . . @ . . . @ . @ . . . . . . . . . @ . @ . . . . . . @ . . . . . . . . . . . . . . . . . . @ . . . . . . . . . @ . . . . . . @ . . . @ . @
@ . . . @ . . . . . . . . @ . @ . . @ . . . . . . . . . . . @ . . . . . . . . . . @ . . . . . . . . . . . . . . @ . . . . . . . . . . . @ . @ @ @ . . . . . . . . . . @ . @ . . . @ . . . . . . @ . . @
@ . . . . . . @ . . . . . . . . . @ . . @ . . . . . @ . . @ . . . . @ @ . . . . @ . @ . . . . . @ . . @ . . . . . . . . . . . . . . @ . . . @ . . . . . . . . . . . @ @ @ . . . . @ . . @ . . @ . . . @
@ . @ . . . . . . . . . @ . @ . . . . . . . . . . @ . . @ . @ . . . . @ @ . . @ . @ . . . @ . . . . . . . . . . . . . . . . . @ . . . . . @ @ . . . . . @ @ @ @ . . . . . . . . @ . @ . . @ . . @ . . @
@ @ . . . . . . @ . . @ . . . . . . . . . . . . @ . . . @ . . . @ . . @ . . . @ . . . . @ . . . . . . . . . . . @ . . . . . . . @ @ . . . . . . . @ . . . . . @ @ . . . . @ . . . . @ . . . . . . . @ @
@ . . . . . . . . . . . . . . . . @ . . . . . . . . . . . . . @ . . . . @ . . . . . . . . . @ . . . . . . . . . @ . @ . . . . @ . @ @ . . @ . . @ . . @ . . . . . . . . . . . . . @ . @ . . . . @ . . @
@ . . . . . . . . . @ . . . . . . @ @ . @ . . . . @ . . . . . . . @ . . . . . . . @ . . . . . . @ . . . @ . @ . . . . @ @ . . . @ . . . . @ @ @ . . . . . @ @ . . . . @ . . . . @ . . . . . . . . . @ @
@ @ . . . . . . @ . . . @ . . . . . @ . . . . . . . . . . . @ @ . . . . . . . . . @ . . . @ . . . . . . . @ . . @ . . . . . . @ . @ . . . @ . . . . . @ . . . . . . @ @ . . . . . . . . . . . @ . . . @
@ . . @ @ . . . . . @ . . @ . . . . @ . . . . . . . . @ . . . @ . . . . . . @ . . . . . @ . @ . . . . . . . . . . @ . . . @ . . . @ @ . @ . . . @ @ . . . . . . . @ . . . . . @ . @ . . . . . @ . . @ @
@ . @ . . . @ @ . @ . . . . . @ . . . . . @ @ . @ . . . . . . . . @ . . . . . . . . . @ . . . . . . . . . . . . . . . . . . . . . . . @ . . . @ . . . . . . . . . . . . @ . . . . . . . . . . . . . . @
@ . . @ . . . @ . @ . @ . . . @ @ . . . . . . . . . . . . . . . . . . . . . . . . @ . . . . . . . . @ . . . . . . . . @ . . . . . @ . . . . @ . . . . @ . . @ . . . . . . @ . . . @ . . . . . . . @ . @
@ . . . . . . . . . . . . . . @ . @ . . . @ . . . @ . . . . . . . . @ @ . @ . @ . . @ @ . @ . . . @ . . @ . . . . . . . . . @ @ . . . . . . @ . . . . . . . . . @ . . . . . . . . . . . . . . . @ . . @
@ . . . . . @ . . . . . . . . . @ . . . . . . . . . . . . . . . @ . . . . . . @ . . . . . . . @ @ . . . . @ . . . . . . . . . . . . . . . @ . @ . . . . . . @ . . . @ . . . . . . . . @ . @ @ . @ . @ @
@ . . . . . @ . @ . . . . . . . . . . . . . @ @ . . @ . . . . . . . . . . . . . . @ . . @ @ . . . . . @ . . . . . . . . . @ . . @ . . @ . . . . . . . . @ . @ . . . . . . . . @ . . . @ . . . . . . . @
@ . . . . . . . . @ . @ . . . . @ @ . . . . . @ @ . . @ . . @ . . . @ . . . . . . . . . @ . . . . . . . . . . . . . . @ . . @ . . . . . . . . @ . . . @ . . . @ . . . @ . . @ . . . . . @ . . . . . . @
@ . . . . . . @ . . @ . @ . . . . . . . . . @ @ . @ . . @ . . . . . . . . . . @ . . . @ . . . . @ . @ @ . . . . . . . . . @ @ . . . . @ . . . . . . . . . . . . . . @ . . . . @ . . . . . @ . . . . @ @
@ . . . @ . . . . . . . . @ . . . @ @ . . . @ . . . . . @ . . . . . . . . . @ . . . . . . . . . . . . . . @ . . . . . . . . . . . . . . . . . . @ . . . . @ . . @ . . . . . . . . . . . . . . . . . . @
@ . . . . . . . . . . . . . @ @ . . . . @ . . . @ . . . . . . . . . . . . . . . . . . @ . . . @ . . . @ . . . . . @ . . @ @ . . . . . . @ . . @ . . . . . . . . . . . . . . @ @ . . . . . . . @ . . . @
@ . . . . . . . @ . @ @ . . . . . . . . . . . . . . . @ . @ . . @ . . @ @ . . . . @ . . @ . @ @ . . . . . . @ . . . . @ . . . . . . . . . . . . . . . . . . . . @ . . . . @ . . @ . . @ . @ @ . @ . . @
@ @ . @ @ . . . @ . . . . . . @ . @ . . . . . . . . @ . . . . . . . . . . @ . . . . . . . . . @ . . . . . . . . . . @ . @ . @ . . . . . . @ @ . . @ . . . . @ . . . . @ . . . . . @ @ . . @ . @ . @ . @
@ . @ . . . . @ . @ . . @ . . . @ . . . @ @ . . . . @ . . . @ . . . @ . . . . . . . @ @ . . . . . . @ . @ . . . . . . . @ . . . . @ . . . . . @ . . @ . . . . . . . @ . . . . . @ . @ . . . @ . . . . @
@ @ . . @ @ @ @ . . . . . . . @ . . . . @ . . . . @ . @ . . . . . . @ . . . . . . . . . . @ . . . . . . @ . . @ . . . . . . . . @ . . . . . @ . @ . . . . . . @ . . . . . . . . . . . . . . @ @ @ . . @
@ . . @ . . . . . . . . . . . . . . @ . . @ . . . . . @ . . . @ . . . . . . . @ . @ . @ . . . . . . . @ . . . . . @ @ . . . @ @ . . . . . . @ . . . . . . . . @ . . . . . . . . . . @ . . . @ . . . @ @
@ . . . @ . . . . . . . . @ . . . . @ . . . . . . . @ . . . @ . . @ . @ @ . . . . . . . . . . . . . . . @ @ . . . . . . . . . . . @ . . . . . @ @ . . . . . . . . @ . . @ . . . @ . . . . @ . . . @ . @
@ . . . . . . @ . . . . . . . . . . @ . . . @ . . . . . . . . . . . @ . . . @ . . . . @ . . . . . . . . . @ @ . . @ @ . . . @ . . . . . . @ @ . . . . . . @ . @ . . @ . . . . . @ @ . . . . . . . . @ @
@ . . . @ . . . . . . @ . . . . . . @ . . . . . . @ . . . @ . . . . . . @ . . . . . @ . . @ . . . . @ . . . . . . . . . . . . . . . . . @ . . @ . . . . . . @ . . . . . . . . . @ . . . . . . . . . . @
@ . . @ . . @ . . @ . . . . @ . . . . . @ . . . @ . . . . . . . . @ . . . . . @ @ . . @ . @ . . @ . . . @ . @ . . @ @ . @ . . . . . @ . . . @ . @ @ . @ . . @ @ . @ . . . . . . . . . . . . @ . . @ . @
@ . . . . . @ . @ . . . . . . . . . . . . @ . @ @ @ . . @ . @ . @ . . . . . . . @ . . . . . . . . . . . @ . . . . @ . @ . . . @ . . . @ @ . @ . @ . . @ @ . . . . . @ . . @ . . . @ . . . . . . . . . @
@ . . . @ @ . @ @ . . . . . @ . . . . . @ . . . @ . @ . . . . . . . . . . . . . . @ . @ . . @ . . . . @ . . . @ . . . . . . . . . @ . . @ . . . . @ . . . . . . . . . . . . . . . . . . . . . . . . . @
@ . . @ . . . . . . . . . . . . . @ . . . . . . . . . @ . . @ . . . @ . . . . . . . . . . . . . . . . . . . . @ . @ @ @ @ . . @ @ . @ . . @ . @ . @ @ . . . @ . . @ . . . . . . @ . . . . . @ @ . . . @
@ . . . @ . @ . . @ . @ . . . . @ . @ . @ . . . . . . . . . . . . @ . . . . . . . . @ . @ @ . @ . @ . . . . @ . . . . . . @ . . . . . . . . . . @ . @ . . . . @ . . . . . @ . . . . . . . . . . @ . . @
@ . . . . . . . . . . . . . . . @ . @ . . @ . @ @ @ . . . . @ . . @ . @ . @ . . @ . . . . . @ . . . @ @ @ @ @ . . . . . . . . @ . . . . . . . . . . @ . . . . . . @ . . @ . . . . . @ . . . . . . . . @
@ . . @ . . . . @ . . . . . . @ . @ . @ . . . @ . . . . @ . @ . @ . . . @ . . . . . @ . . . . . @ . . . . @ . @ . . . . @ @ . . . . . . @ . @ . . . . . . . . @ . . . . . @ . . . . . . @ . . . . . . @
@ . . @ . @ . . @ . @ . . @ @ . . . . . . . . . . . . . . . . . . . @ . . @ @ . . . . . . . @ . . . . @ . . . . . . . @ . . . . . . . . . . . . . . . . . . @ . @ @ . . . . . . @ . @ . @ . . . . @ . @
@ . . . . . . @ . . . . . . . . . . @ . . . . . . . @ . . @ . . . . . . . . . . . . . . . @ . . . . . . . . . . . . @ . . @ . . . . . @ . @ . . . . . . @ . . . . @ . . . . . . @ @ . . . . @ . . . @ @
@ . . . @ @ . . . @ . . . . . . . . . . . . . @ . . . . . . @ . . @ . . . . @ . . . . . . . . . . . . . . . @ . . . . . . . . . . . . . . . @ . . . . . . . . . . . . . . . . . . . . . . . . . . . . @
@ . . . . . . @ @ . . . . . @ . . @ . . . . @ . . . . @ . @ . . @ . @ . . . . . . . . . . . . . @ @ . . . . . . . . . . . . @ . . . . . . . . @ @ . . . . . . . . . . . @ . @ . . . . . . . @ . . . . @
@ . @ . . . . . @ . . . . . @ . . . . . @ . @ . . . @ . . . @ . . . . . . . . . @ @ . . . . . . . . . @ . . . @ . . . . @ @ . . . @ . @ . . . @ . . @ . . @ . . . . . . . @ . . . . . . . . . . . . . @
@ . . @ . . . . . . . @ @ . . . . . . @ . . . @ @ . . . @ . . . . @ . . . . . . . . . . . . . . @ . @ . . . @ . . @ . . . . . . . . . . . . @ . . . . @ . . . . . . . . @ @ . . . . . . @ . . @ . . . @
@ . . . . . . . . . @ @ . . . . . @ . . @ . . . . . . . @ . . . . . . . . . . . . . @ . . . . @ . . . . . . . . . . . . . . . . . . . . @ . . . . . . . . . . . . @ @ . . . . . . . . . . . . . . . . @
@ . . . . @ . . . . . . . . @ . . . . . @ . . . . . . . . . . . . . . . . @ . . . . . . . . . . . . @ . . . . @ . . . . . . . . . @ . . . . @ . . . . . . . . . @ @ . . . . . . @ @ . . . . @ @ . . . @
@ . . . . . . @ . . . . . . . @ . . . . . . . @ . . . . . . . . . . . . . . . @ . . . . . . . @ . . . . . . . . . . . . . . @ . @ . . . . . . . . . . . @ . . . . . @ . . @ . . @ @ . . . . . @ . @ . @
@ . @ . . . @ . . @ . . . @ . @ . @ . . . . . . . @ . . @ @ . . . . . . . . . . . . . . . @ . @ . . . . . . . . . . . . @ . . . @ . . . @ . . . . . . @ . . @ . @ . . . . . @ . . . @ . . . . . . . @ @
@ . . . @ . . . . . . . . . @ . . . . @ . @ . . . . . . . . . . . . . . . @ . . @ . . . . . @ . . . . @ . @ . . . . . . @ @ . @ . . . . . . . . . . . @ . . . . @ . . . . . . . . . . . . . . . . . . @
@ . . @ . . . . @ @ . . . . . . . . . . . . . . . @ . . . @ . @ . @ . . . . . . @ @ . . . @ . @ . . @ . . . @ . . . . . . . . @ @ . . . . . . . . . . . . . . . . . . . . . . . @ . . . . . . . . @ . @
@ . . @ . . . . . . . . @ @ . . @ @ . @ . . . . . . . . . . . . . . . @ @ . . . . @ . . . . . . . @ . . @ . . @ . @ @ . . . . . . . @ . . @ . @ . . @ . @ . . . @ . . . . . @ @ . . . @ . . . @ . . . @
@ . @ . . . . . . . . . . . @ . . @ . . . . . . . . @ . @ . . @ . @ . . . . . . . . . . . . . . . . @ . . . @ . @ . . . @ . . . @ . . . @ . . @ . . . . . . @ . . . . @ . @ . . . . . . @ . . . . . . @
@ . . . . . . . . @ . . . . . . . . . . . . . . . . . . . . . . . @ . @ . @ . @ . . . . . @ . . . . . . @ . . . . . @ . . @ . . . . . . . . . @ . . . . . . . . . . . . . . @ @ . @ . . . . . . . @ @ @
@ . . . . . . . . . . . . . . . @ . . . . . . @ . . . . . . . @ . . . . . . . . . . . . . @ . . @ . . @ . . . . . @ . . . . . . . . . . @ @ . . . . @ . . . . . . @ . . . . . @ @ . @ . . . @ . @ . . @
@ . . . . @ . . . @ . . . @ @ . . . . @ @ . . . . @ . . . . . . . . . . @ . . . . . . . @ . . . . . . @ . . . @ . . . . . . @ . . @ . @ . . @ . . @ . @ . . . @ . . . . @ . . . . . . . . . . . . . @ @
@ . . . . . . . . @ . . . . . @ . . @ @ . . . . . . . . . . . . . . . . @ . @ . . . @ . . . . . @ @ . . . . . . . . @ @ . @ . . . @ . . . . . . @ . @ @ . . . . . . @ . . . . @ @ @ @ @ . . . . . . . @
@ . @ @ . . @ . @ . . . . . . . @ . . . . . . . . . . @ @ . . . . . . . . @ . . . . @ . . . . . . . . . . . . . @ @ . . . . . . . @ . . . @ . @ . . . . @ . . . . @ . . . . . @ . . . . . . . . . . . @
@ . . @ . . @ . . . . . . . . . . . . @ . . @ @ . . . . @ @ . . . @ . . @ . . . . . . . @ @ . @ . . . . @ . . . . . . @ . . . . . . . . @ . . . . . @ . @ . . . . . @ . @ . . . . . . . . . . @ . . . @
@ @ . . . . . . . . . @ . @ . . . . . . @ . . . . . . . . @ . @ . . @ . . . @ . @ . . @ . . . . . . . . . . . . @ . . . . . . . . . . . . . . @ @ . . . . . . . . . . . . @ . . . . . . . . . . . . . @
@ . . . . . . . . . . @ . . . @ @ . . . . . . . . @ . . @ . . @ . . . . @ . . @ . . . . . @ . @ . . . . . @ . . . . . . . . . . . . . . . . @ . . . @ . @ . @ . . . . . . . . . . . @ . . @ . @ . . . @
@ . @ . . . @ . . . . . . @ . . . @ . . . . @ @ . . . . @ . @ . . . . @ . . . . . @ . . . . . . @ . . . . . . . . . . . @ . . . . . . @ . . . . @ . . . . . . . . . . . . . . . . . . . . . . . . . . @
@ . @ . . . . @ . . @ . . . @ @ @ . . @ @ . . . @ . @ . . . @ @ @ . . . . . . . @ . @ . . . . . . @ . . @ . . . . . . . . @ . @ @ . . . . @ . @ . . @ . . . . . . . . . @ . . . . . @ . . @ . . . . . @
@ . . @ . . . . @ . . @ . . . . @ . . . . . . . . @ . @ . . . . . . . . . . . . . . @ . . . . . . . . . . . . @ . . @ @ . . . @ . . . @ . . . @ . @ . . . . . . @ . . . . . . . . . . @ . . @ . . . . @
@ . . @ . . . . . @ . . @ . . . . . . . . . . . . . . . . . . @ . . . . . . . . . @ . . . . @ . . . @ . . . @ . . . . . . . . . . . . . . . . . . . @ . . . @ . . . . . . @ @ . . . . . . . . @ . . . @
@ . . @ . . . . @ . . . . @ . @ . . . . @ @ . . . . . . . . @ . . . . . . . @ . . . . . . . . . . . . @ . @ . @ . . @ . @ . @ . . . . . . . . . . . . . . . . . . . @ @ . . . . . . . @ . . . . @ . @ @
@ . . @ . . . . . @ . . . . . . . . . . @ . . . . . . . @ . @ . . . @ . . . . . . . . @ . . @ . @ . . @ . . . . . . . . . . @ . . . . . . . . . @ . . . . @ . . . . . @ . . . . . . . . . . @ . . . . @
@ @ . @ . . . . . . . . @ . . . @ . . . . . . . @ . . . . . . . . @ . . @ . . . @ . @ . . . . . . . . . . . . . . @ @ . . . . . . . @ . . . . . . . . . . . . . . . . . . . . @ @ . . . . . . . @ . . @
@ . @ . @ . . . @ . @ . . . . . . . . . @ . . . . . . . @ . @ . . . @ . . . . . . @ . . . @ . @ @ . . . . . . . . . . @ . . . . . @ . . . . . . . @ . . . . . . @ . . . . . . . . . . . . . . . . . . @
@ . . . @ . . . . . . . @ . . . . . . . @ . @ . . @ . @ . . . . . . . . . . @ . . . . . . . . . . . . . . . . @ . . . . @ . . . . . . . . . . @ @ . . . @ . . @ . . . . . @ . . . . . @ . . . . @ @ . @
@ . . @ . . . . . . . . @ . . . . . . . . . . . . . . @ . . . . @ @ . . . . . . . . . . . @ . . . . @ . . . . . . @ . . . . . @ . @ . @ . . . . . @ @ . . . . . @ . . . @ . @ . . . . . @ . . . . . . @
@ . . . @ . @ . . . @ . . . . . . . . @ @ . . @ . . . . @ . . . . . . @ @ . . . @ . @ . . . . . . @ . . . . @ . @ . . . . . . . . . . . @ @ . . . . . . . . . . . . . . . . . . . . . . . @ . . . . @ @
@ @ . . . @ . @ @ @ . . @ . . @ . . . . . . . @ @ . . . . . . . . . . . . . . . . . @ . . . . . @ @ . @ . . . . . @ . . @ . . . . . . . . @ . @ . . . @ @ . . @ . . . . @ . . . @ . . . . . . . . . . @
@ . . . . . . . . . . . . . @ . . @ @ . . . . . . @ @ . . . . @ . . . . @ . . . . . . . . . @ . . . @ . . . . @ . . . . @ . @ . . . . @ . . . . . . . . . . . . . . . . . . . . . . . . . . . . . @ @ @
@ . @ . . @ . . . @ . . @ . . . . . . . . . . . . . . . . @ . . . . . . @ . . . @ . @ @ . . . @ . @ @ @ . . . . . . . . . . @ . . . . . . . . . @ . . . . . . @ @ . . . . . . . . . . . . . . . . . . @
@ . . @ . . . . . . . . @ . . . . . . . . . . . . . @ @ . . . @ @ . . @ . . . . . @ . . . . . . @ . . @ . . . . @ . . @ . . . . @ . . @ . . . . . . . . . . . . . . . @ . . . . . . . @ . @ . . . . . @
@ . . . . . . . . . . . @ . . . . . . . . . . @ . . . . . . . @ . . . @ . @ . . . @ . . . . . . . . @ . @ . @ . . . . . . . @ . . . . . @ . . . . . @ . @ . @ . . . . . . . . . . . . . . . . . . . . @
@ . . . @ . . @ . @ . . . . @ . . @ . . . @ . . . . . . . . . . . . @ . . . . . . . @ . . . . . . . . . @ . @ @ . . . @ @ . . . @ . . . . . @ . . . . . . . . @ @ . . . . . @ . @ . . @ . . @ . . . . @
@ . . . . . . . @ . . @ . . . . . . . . . . @ . . @ @ . . @ . . @ . . . . . @ . . . . . . . . . . . @ @ @ . . . . @ . . . . . . . . . . @ @ . . . . . . . . . . . . . . . . . . . . . . . . . . . . . @
@ . @ . . . . @ . . @ . @ . @ . . . . . . @ . . @ . @ @ @ . . . . . . . . . . . . . @ . . . @ . . . @ . . . . . . . . . @ . . . . . . . . . @ . . . . . @ . @ . @ . . . . @ . . . . . @ . . . . . . . @
@ . . @ . @ . @ . . @ . @ . . . . . . . . . . . . @ . . . . . . @ . . . @ @ @ . . . @ . . . . @ . . @ . . . . . . . . . . . . . . . . . . @ . . . . . . . . . @ @ . . . . . . @ . . @ . . . . . @ @ . @
@ . . . . . @ . . . . . . . . . . . @ . . . . @ . . . . @ . . . . . . . . . . . . @ . @ @ . . @ @ . . . . . . . @ . . . . . @ . . . . @ . . @ . . . . . @ . @ . . . . . . . . . . . . . . @ . . @ . . @
@ . . . . @ . . . . . . . . @ . . . . . . . . @ . . . . . . . . @ . . . @ . @ . . @ . . . @ @ . . . . . . . . . . . . . . . @ . . @ . . . . . . . . . @ . . . . @ . . . @ . . @ @ . . . @ @ . . . . . @
@ . . . @ . . . @ . . . . @ . . . . @ . . . . . . . . @ . @ . . . @ . . @ . . . . . . @ . . . @ . . . . . . . . . @ . @ . . . . . . @ @ . . . @ . . @ @ . . . . . . . . . . . . . . . . . . @ . @ . . @
@ @ . . @ . @ . . . . . @ . . . . @ . . . @ @ . @ . . . . . . @ . . @ . . . . . . . . . . . . . . . . @ . . . . . . . . @ . . . . @ . . . . . @ . @ . . . @ . @ . . . . . . @ . . @ . @ . . . @ . . @ @
@ . . @ . . . . . @ . @ . . . . @ . . . . . . . @ . . . . . . . . . . . . . @ @ . . . . @ . . @ . @ . . . @ @ . . . @ . . . . . . . . . . . . . . . . @ . . . . . . . . . . . . . @ . . @ . . . . . . @
@ . . . . . . . . . . . @ @ . . . . . . @ . . @ . . . . . . . . . . . . . . @ . . @ . @ . . @ . @ . @ . . . . . @ . . . . . @ . . . . . @ . . . . . . . . . @ . . . . . . . @ . . . . . . . @ . @ . @ @
@ . . . . . @ . . . @ . . . . . . . . . . . . @ @ . @ . . . . . . @ . . @ . . . . . . . @ . . . . . . @ . . . @ . . . . . . . . . . . . . . . . @ . . . . @ . . @ . . @ . . @ . . @ @ . @ . . @ . . . @
@ . @ . . . . . . . @ . @ . . . @ . . . . . . . . . . @ . . @ . . . @ . @ . . . . @ . . . . . @ @ . . . . . . @ . . @ . . @ . . . . . . . . . . . . . . . . @ . . @ . . . . . . . . . @ . @ . . . . . @
@ . @ . @ . . @ . . . . . @ . . . . @ . . . . . . . @ . . @ . . . . . @ . . . . @ . . @ . . . . @ @ . . . . . . . . @ . . . . @ . . . . . . . . . . . . . @ @ . . . . . @ . . . . @ @ . . . @ . . . @ @
@ . . . @ . @ . . . @ . . . . @ . . . @ . . @ @ . @ @ . . . . . @ . . @ . . . . . . @ . . . . . @ . @ @ . . . . . . . @ . . . @ . . @ . . . . @ @ . . . @ . . . . . . . . @ . . . . . @ . @ . . . . . @
@ . @ . . . . . . . . @ . . . . . @ . . . . . . . . . . @ . . . . . @ . . . . @ . . . . . . . . . . @ . . . . . @ @ . . . . . . . . @ . . . . @ . . . @ . . . @ . . . @ . . . . . . . . . @ . . . . . @
@ . . @ @ . @ . . . . . . . . . . . . @ . @ . . . @ . . @ . . @ . . @ . . . . . @ @ . . . . . . . . . . @ . . @ . . . . . @ . @ . . . . @ @ . . . @ @ . . @ . . . . @ @ . . . . . . @ . @ . . @ @ . @ @
@ . . . . . . . . . . . @ . . @ . . . . . . . . . . . . . . @ . @ . . . . . . . . . . . . . @ . . @ . . . @ . . . @ . . @ . . . . . . . . . . @ . . . . . . . @ . . @ . . @ . @ . . . . . . . . . . . @
@ . . . . . . . . . . . . . . . . . . . . . @ . . @ . . @ . . . . . . . . . . @ . . . . @ . . . . . . . . . . . . . @ @ . . @ . . . . . . . . . . . @ . @ . . . . . . @ . . . . . . . . . . . . . @ . @
@ . . @ . . . @ @ . @ . @ . . . . . . . . . . @ . @ . @ @ . . . . @ . . . . . . . . @ . . . @ . . . . . . @ @ . . . . . . . @ @ . . . . . . . @ . . @ . . . . . . . @ . @ @ . @ . . . . . . @ . . @ @ @
@ . . . . . . . . . . . . . . . . . . . . . . . @ @ . . . @ . @ @ . . . . . . . . . . @ . . . @ . . . . . . . . . @ . . . . . . . . . . . @ . . . . . . . . @ . . @ . . . . . . . @ . . . @ . . . . . @
@ @ . . . @ . . . . @ . . . . . @ . . . @ @ @ . . . . . . @ . @ . . . . . . . . . @ . . . . . . @ . . . . . . . . @ . . . . . . . @ . . . . @ . . @ . . . . . . . @ . @ . . . . @ . . . . . . . . . . @
@ . . . . . . . . . . . . @ . . . . . . . . . @ . . . . . . . . . . . @ . . @ . . . . . . . . . . . . . . . . . @ . @ . . . . . . . . . . . . . . . . @ . . . . . . . @ . . @ . . . . . . @ . . . . . @
@ . . @ . . . @ . . . . . . . . . . . @ . . . . . . . . . . . . . @ . . . . . . . . . . . . . . @ . @ . . . @ . . . . . . . @ . @ . . . . . . @ . . . . . . . . . . . . . . . . . @ . . . . . . . . . @
@ @ @ @ @ @ @ @ @ @ @ @ @ @ @ @ @ @ @ @ @ @ @ @ @ @ @ @ @ @ @ @ @ @ @ @ @ @ @ @ @ @ @ @ @ @ @ @ @ @ @ @ @ @ @ @ @ @ @ @ @ @ @ @ @ @ @ @ @ @ @ @ @ @ @ @ @ @ @ @ @ @ @ @ @ @ @ @ @ @ @ @ @ @ @ @ @ @ @ @
3
52 22 68 28
76 71 67 43
63 88 54 80
