12 12
@ @ @ @ @ @ @ @ @ @ @ @
@ . . . . . . . . . . @
@ . @ . . . . . . @ . @
@ . . . @ . . @ . . . @
@ . . . . . . . . . @ @
@ . . . @ . @ @ . . . @
@ . . . . . . . . . . @
@ . . . . . . . @ @ . @
@ . . . . . @ . . . . @
@ . . . . . . . . . . @
@ . . . . . . . @ . . @
@ @ @ @ @ @ @ @ @ @ @ @
3
1 10 2 8
5 3 4 9
2 1 9 9
