100 100
@ @ @ @ @ @ @ @ @ @ @ @ @ @ @ @ @ @ @ @ @ @ @ @ @ @ @ @ @ @ @ @ @ @ @ @ @ @ @ @ @ @ @ @ @ @ @ @ @ @ @ @ @ @ @ @ @ @ @ @ @ @ @ @ @ @ @ @ @ @ @ @ @ @ @ @ @ @ @ @ @ @ @ @ @ @ @ @ @ @ @ @ @ @ @ @ @ @ @ @
@ . . . . . . . . @ . . . @ . @ . . . . . @ . . . . . . @ @ . . . . . . @ . . . . . . . . . . . . @ . @ . @ . . . . . . . . . . . . . . . @ . . . @ . . . . . . . @ . . . . . @ . . . . . . . . . . @ @
@ . . @ . . @ . @ . . @ . . . . . @ @ . . . @ . @ . . . . @ . . . . . . . . . . @ . . . . . . @ . . . . . . . . @ . . . @ . . . . . . . . @ . @ @ . . . . . . @ . . . @ . @ . . @ . . @ . . . . . . @ @
@ . . . . . @ . . . . . . . . @ . @ . . @ . . @ . . . . . . @ . . . . . @ . @ . . . . @ @ . . . . @ . . . . @ @ . . . . . . . . @ . . . . @ . . . @ . . . . . @ . . . . . . . . . @ . . . . . @ . . . @
@ . . . @ . . @ . . . . . . . . . . . . . . . . . @ . @ @ . @ . . . . . @ . . . . @ . . . . . . . @ . . . . @ . . @ . @ . . @ . @ . @ . . . @ @ @ . @ . . . . . . @ . . . . . . . . . . . . . . . @ . @
@ . @ . @ . @ . . . . . . . . . @ . @ . . @ . . @ . . . . @ @ . . . . . . @ . . . . . . . @ @ . . @ . . . . . . . . . @ . @ . . . . . . . . . . . . . . . . . @ @ . @ @ . . . @ . . . . . . . @ . @ . @
@ @ . . . . . . . . @ . @ . @ . . @ . . . @ . . . . . . . . . . . . . . @ . @ . . . @ . . @ . @ . @ . @ . . . . . . . . @ . . @ . . . @ . . . @ . . . . . . . . @ . . . . @ . @ . . . . . . . . . . . @
@ . . . . . . . . . . . . . . . @ @ @ . . . @ . . . . . . . . @ @ . . . . . . . @ . . . . . . . . . @ . . @ . . . . . . . . . . @ . . . @ . . . . . @ . . . . . @ . . @ . . . . . . . . @ @ . . . . . @
@ @ . . . @ . . . . @ . . . . . @ . . @ . . . . . . @ . . @ . . . . . . . . . . @ . . . @ . . . @ . . . . @ . @ @ . . @ . . @ . @ . @ . . . . . . . . . . . . . . . . . . . . . . . . . . . . . . . . @
@ . . . . . . . @ . . . . . . . . @ @ . . . . @ . . . . @ . @ . . . . . @ . . . . . @ . . . . @ . . . . . . @ . @ . . . . . . . . . . . @ . @ @ @ . . . . @ . . . @ . @ @ . . @ . @ . . . . @ . @ . . @
@ @ . . . . @ . . . . @ . . . . @ . . . . . . . . @ . . . . . @ . @ . . . . . . . @ . . . . . @ . . . @ . . . . . @ . . @ . @ . . . . . . @ . . . . . @ . . @ . @ . . . . @ . . . . . . . . @ . . . . @
@ . . . . . . . . . . . . . . . . @ . . . @ @ . . @ . @ @ . . . . . . @ . . . . . . @ . . . . . . . . . . . . . . . @ . . . . . @ @ @ . . . @ . . @ . . . . . . @ . @ @ . . . @ . . . @ . . . . . . . @
@ . . @ . . . . . @ . . . . . . . . . @ . . . @ . @ . @ . . @ . . . . . . @ . . . . . . . . . . . . . @ . . . . . @ . . . . . . . . . @ . . . . . . . . @ . . . @ . . . @ . @ . . . . . . @ . . . @ . @
@ @ . . . . . . . . . . . . . . . . . . . . . . @ . . . . . . @ @ . . @ . . . . . @ . . . . . . . . . . . . . . . . . . . . @ . . . . . . @ . @ @ . . . . @ . . . . @ . . @ . . . . . . . . @ . @ . . @
@ . @ . @ @ @ . @ @ . @ . . . . . . . @ @ . @ @ . . . @ . . @ . . @ . . @ . . . . @ . . @ . . . . . . @ . . . . . . . . . . . @ @ . . . . . . . . . . . @ @ . . . . . . . . . @ . . @ . . . . . . . . @
@ . . . . . . . . . @ . . . . @ . . . . . . . . . . . . @ . . . . . . . . . . . . @ . . . . @ . . @ . @ @ . @ . . . . @ . . . . @ . . . @ . . . @ . . . @ . . @ . . . . @ . . . . . @ . . @ . . . . . @
@ . @ . . . . . . . . . . . . . @ . . . . . . . . . @ . @ . . . . @ . @ . @ @ . . @ . . . . . @ . . . . . @ . . . . . . @ . . . . . @ . . . . . @ . . . . @ . . @ @ . . . . @ . . @ . @ @ . . . . . . @
@ . . . . . . . . @ . . @ . @ @ . . . . . . . . . . . @ . . . . @ . . . . . . . . . . . . . . @ . . . . . . . . . @ . . . . . . . . @ . . . . . . . . . . . . . @ . . . . . . @ . . @ . . . . . @ . . @
@ . @ . . . . . @ @ . . . . . . . . @ . . . . . . . . @ @ . . . . @ . . . . . . . . . @ . . @ . . @ . . . . . . . . @ @ . . @ . . . . @ . . . . . . . @ . . @ . . . . . . @ . . . . . @ . . . . . @ . @
@ . @ . . . . . . . . @ @ . . . @ . . . . @ . . @ . . . . . . . . . . . @ . . . . . . @ . @ . . . . . . . . @ . . @ . . . @ . . . . . . @ . . . . . . . . . . . @ . . . . . . @ @ @ @ . . . . . . . . @
@ . . . @ . . . . . . @ . . . . . @ . . . @ . . . . . . @ @ . . @ . . . . @ . . @ @ . . . @ @ . . . . . . . . . . . . . . . @ @ @ @ @ @ . . . . @ . . . . @ @ . . @ . @ . . . . @ . @ . . . . . . . . @
@ . . . . . . . . . @ . . @ . . . . . . . . . . . @ @ . . . . . . . . . . . @ . . . . . . . . . . . . . . @ . . . . . . . . . @ . . . . . . . . . . . . @ @ . @ @ . . . . . . @ . . @ . . . . . . . . @
@ . . . . . . . @ . . @ @ . . . . . @ . . @ . . @ . . . . @ . . . @ . . . . . . . . . @ . @ @ . . . . . @ . @ . . @ . . . . . . . . . . . . @ . . . . . . . . . @ . @ . . . . . . @ . . . . . @ . . . @
@ . . . . . . @ . . @ . . . . . . . . @ . . . . . . . . . . . . @ . . . . . . . . . . . @ . . @ . @ . . . @ . . . . @ . @ . @ . . . . . @ . . . . @ . . . . . . . @ . @ . . . . @ . . . . @ . . . @ . @
@ . . . . . . . . . . . . . . . @ . @ . . @ . . . . . . . . . . @ . @ . . @ . . @ . . . . . @ . . . . . . . . . @ . . . @ . . . . . . . @ . . . . . . . . . . . . @ . . . . . . . @ . . . . . . . . . @
@ . . . . . . . . . @ @ @ . @ @ . . @ . . . . . . . . . . . . . . . . . . @ . @ . . . @ . . @ . . @ . . . . @ . . . . . . @ . . . . . . . @ . . . . . . . . . . . . . . . . @ . . . @ . . . . . . . @ @
@ . . . . @ . . . @ . . . . . . . . . . . @ @ . . . . . . . . . . . @ . . . . . . . . @ . . . . . @ . . . . . . . . . . @ . . @ . . . . . . . . . . . . . . . . . . . . . . . . . . . . . . @ . . . . @
@ @ . . . . . . . . . @ @ @ @ . @ . . . . . . . . . @ . . . . . . @ . . . . @ . . . . . @ . @ . . . . . . . . . . . . . . . . . . . @ . . . @ . @ . . @ . . . . . . . . . . @ @ . . . . . . . @ . @ . @
@ . . . . @ . . @ . . . . . . . . . @ . . . . . . . . . . . . . @ . . @ . @ . . . @ . . . . @ . . . . . . . . . . . @ . . @ . . . . . . . . . . . @ . . . . . . . @ . . . . . . . . . . . . . . . . . @
@ . . . . . . . . . @ . . . . . . @ . . . . . . . . . . . . . @ . . . . . @ . . . . . . @ . . . . . . . . . . . . @ . . . . . . . . @ @ . . . . . . @ @ . @ . . @ . . . . . . . . . . . . . @ . . @ . @
@ . . . . . . . @ . . . . . . . . @ . . . . . . . . @ . . . @ . . . . . . . . . . . . . @ @ . . @ . . . . . @ . . . . . @ . . @ @ . . . @ . . @ . @ . . . . . @ . . . . . . @ @ . . . @ . . . @ @ . . @
@ . . . . . . . @ @ . @ @ . . . @ . @ . . . . @ . . . . @ . . . . . @ . . . . . . @ . . . . . . . @ @ . . . . . . @ @ . . . . . . . . . . @ . . @ . . . @ . . . . . . . @ . . . . @ . . @ @ . . . . @ @
@ . . . @ . @ @ . . . . . . . . . . . . . @ @ . . . . . @ . @ . @ . . . . . . . . . @ @ @ . . . . . . . @ . @ . . . . . @ . . . . @ . . @ . . . . @ @ . . . . . . . . . . . @ @ . . @ . . . . @ @ . . @
@ . . . . @ . . . . . . . . . @ @ @ . . @ . . . . . @ . . @ . . . . . . . . . @ . . . . . . . . . . . . . . . . . . @ . . @ @ . . . @ . @ . . . . @ . . . . . . . . . . . @ . . . . . . . @ . @ . . . @
@ . . . . . . . . . . . @ . . . . . . . @ . . @ . . . . @ . @ . . . @ . @ @ @ . . @ . . . . . . @ . . . . @ . . @ . . @ . . . . @ @ @ @ . . . . . . . . @ . . . . . . . . @ . @ . . . . @ . . @ @ . . @
@ . . . . @ . . @ . . . . . . . . . @ . . . . . @ . . . . @ . @ . . . . . @ . @ . . . . . . . @ . . . . . . @ . . . . . . @ . . . . . . . @ . . . . . @ . . . @ . @ . . . . @ . . . . . . . . . . . . @
@ . . . . . . . . @ . @ . . . . . . . @ @ . . @ . . . . @ . . . @ . . . . . . . @ . @ . . @ . @ . @ . . . . . . . . . . . . . . . @ . @ . . @ . . . @ . . @ . . . . . . . . . . . @ . . @ @ . . . . . @
@ . . @ . . . @ . . . . . . . . . . . . . . . @ . . . . . @ @ . . . @ . @ . . . . @ . . . . . @ . . . @ . @ . . . . . . . @ . . @ . . . . . . . . . . . . . . . . . . . . . . . . . . . . . . . . . . @
@ . . . . @ . . . . . . . . . . . . . . @ . . . @ . . . @ . @ . . . . . . . . . @ . . . @ @ . . . . @ . . . . . . . @ . . @ . . . . . . . . @ . . @ . . . @ . @ . . . . . . . . . @ . . . . . . . . . @
@ . @ . . @ . @ . . . . . @ . @ . . . . . . . @ . @ . . . . . . . . . . . @ . . . . . . . . @ . . . . . . . . . @ . . . . . . @ . . @ . @ . . @ . . . . . . . . . @ . . . . . . . . . . . . @ . @ . . @
@ . . . . . . . . @ @ @ . . . . . @ @ . . . . @ . . . . . . . . . . . . . . . @ . . . . . . . @ @ @ @ . . . . . . @ . . . . . @ . . @ . . . . . . . @ . . . @ . . @ . @ . . . . @ . . @ . @ . . . . . @
@ . . . @ . @ . . @ . . . @ @ . . . . . . . . . . . . . @ . . . . . . . . . . . . . . . @ . . . . . . . . . @ . @ . . . . . . . . . . . . @ . @ . . . . @ @ . @ . . . @ . . @ . . . . @ . . @ . . . . @
@ . . . . . . @ . . . @ . . . . . @ . . . @ @ . . @ . . . . . . . . @ . . . . . . . @ . @ . . . . . . . @ . . @ . . @ . . . . . . . . @ @ . . . . . @ . . . . @ @ . . @ . . . . . . @ @ @ @ . @ @ . . @
@ . . . . @ . @ . . . . . . . . . . @ . . . . @ . . . . . . . . . @ . . . @ . . . . . . . . . . @ . @ @ . . . . @ . . . . . . . . . . . . . . . . . . . . . @ . . . . . . . . . . @ . . . . . . @ . . @
@ . @ . . . . . . . @ . . . . . . @ . . . . . . . @ . . . . @ . . . . . . . . . @ . . @ @ . . . . @ . . . . . @ . @ . . @ . . . . . . . . . . . @ . @ . . . . @ . . . . . . . . . . @ . . . . . . . . @
@ . . @ . . @ . . . . . . . . @ . . . . . . @ . . . . @ . @ . . . . . . . . . . . . . . . @ . . . . . . @ @ . . . . @ @ . @ . @ . @ . . . . . . @ . . . . . . . . . . . @ . . . . . @ . @ . . @ . . . @
@ @ @ . . . . . . . . . @ . . . . . . @ . . . . . . . . . . . . . . . . . . . . . . @ . . . . @ . . . . . . . @ . . . . . . @ . . . @ . . . . . . @ . . . . @ . . . . . . . . @ . . . @ . . . . @ . @ @
@ . . @ . . . . . . . . . . . @ . . @ . . . @ @ @ . . @ . . . . @ . . . @ . . . . . . . . . . . . . @ . . . . . @ . @ . . . @ . @ . . . . . @ @ . . . . . . . . . . . . . . . . @ @ . @ . . . . . . @ @
@ . @ . . . @ @ . . . . . . . . . . . . . . . . . . @ . . @ @ . . . @ . . . . . @ @ . . . . . . . . . . . @ @ . . . @ . . . . . . . . . @ @ . . . . @ . @ @ . . @ . . . . . . . @ . . . . . . . @ . . @
@ . . . @ . @ . . @ . . . . @ @ . . . . @ . . . @ @ . . . . . @ . . . . . . . . . . . . . . . . . . . . . @ . . . . . . . . . @ . @ . . . @ . . @ . . . . . . . . . . . . . . . @ . @ . @ @ . . . @ . @
@ . . . . @ @ . . . . . . . . @ . . . @ . . . . . . . . . . . . . . . . . . . . @ . . . . . @ . . @ . @ . . . @ . . @ . . . . @ @ . . . . @ @ . @ . . . . . . . . . @ . . . . . . . @ . . . . . . . . @
@ . . . . . . . . . . . . . @ @ . . . . . @ . @ . . @ . @ . . . @ . . . . . @ . . @ . . @ . . . . . . . . @ @ . . @ @ @ @ @ . . . . @ . . . . . . . @ . @ . . @ . . . . @ @ . . . . . . . . . . . . . @
@ @ . @ @ . . @ . . . . . . . . . . . . . . . . @ . . @ @ . @ . . . . . . . . . . @ . . . . . . . . . . . . . . . . . . . @ @ . . . . . . . @ . . . . . . . . . . @ . . . . . . . . . . @ . . . . . . @
@ . . . . . . . . @ . . . . . . . . . . . @ . . . . @ . . . @ . . . . . @ . . @ . . . . @ . . . . . . @ . @ @ . . . . . . @ . @ . . . . . . . . @ . @ . @ @ . . . @ . . @ . . . . . . @ . . @ . . . . @
@ . . @ @ . . . @ . . @ . @ @ . . . . . . . . . . . . . . . . . @ . . @ . . . . . @ . . . . . @ . . . . . . . . . . @ . . . . . @ . . @ . . . . @ . @ . . . . . . . . . . . . @ @ . . . . @ . . . . . @
@ . . @ . . @ . . . . . @ . . . @ @ . . . . . . . . . . @ . . . . . . @ @ . . . @ . @ . . . . @ . . . . . . . . . . . . . . @ . . . . . . . . . @ . . . . . . . . @ . . . @ . . . . . . . @ @ . @ . @ @
@ . @ . . . . . . . . . . . . . . . . . . . . . . . . @ . . . . . . . @ . . @ @ . . . @ . . . @ . . . @ . . . . @ . . . . . @ . . . . @ . . . . @ . @ . . . . . . . . . . . @ . . . . @ . . . . @ . . @
@ . . . . @ . . . . . . . @ . . . . . . . . . . @ . . . . . . @ . . . . . . . . . . . . . . . @ . . . @ . . . . . . . . . . . . . . . . @ . . . . . . . @ . . @ . . . . @ . . . @ . . . . . . . @ . . @
@ . . . @ . . @ . @ . . . . . . . . . . . @ . @ . . . . . . . . . . . . . . . . @ . . . . @ @ . . @ . . . . @ . . . . . . . . . @ . . . . . . . . . . . @ . . . . . . . . @ @ @ . . . . . . . . . . . @
@ @ . . . . . . . . @ . . @ . . . . . . . . . . . @ . . . @ . . . . . . . . . . . . . . . . @ . . . . . @ . . @ . . . . . . . @ . . . . @ . @ . . . . . . . . . . . @ . @ . . . . . . . . . . . . . . @
@ . . @ . . . @ @ . . . . . . . . . . . . . . . . @ . . . @ . . @ . . . . . @ . . . . . . . . @ . . . . . . . @ . . . . @ @ . @ . . @ . . . . . . . . . . . @ @ . . . . . @ . . . . . . . . . @ . . . @
@ . . . . . . . . . . . . @ . . . . . . . . . . @ . @ . @ . . @ . . @ . @ . @ . . @ . . . . . . . . . @ . . . . . . . . . . . . . @ . . . . @ . . @ . . . . . . . . . . . . . . . @ @ . . . . . . @ . @
@ . . . . . . . . . @ . . . @ . . . . . . . @ . . @ . . . . @ . . . . . . . . . . . @ . . . . . . . . . @ . @ . @ . . . . . . . . . . . . . . . . . . . . . . @ . . . . . @ . . . @ . . . @ . . . . @ @
@ . . . . . . . . . . . . . . @ . . . . . . . . . . . . . . . . @ . . . . . . @ . . . @ @ . . . . . . . @ . . . . . . . . . . . . . . . . . . . . . . . . . @ . . . . . . . . . . @ . @ . . . . . . @ @
@ . @ @ . . @ . . . . @ . . . @ . . . @ . . . . @ @ . . . @ . . . . . . . . @ . . . . . @ . . . . . . . . . . . . . . . . . @ . @ . . @ . . . @ . . . . . . @ @ @ @ . . . . . @ . @ @ . . @ @ . . @ . @
@ . . . . @ @ . . . @ . . @ @ . . @ . . @ @ . . . . @ . . . . . . . . . @ @ . . . @ . @ . . @ . . . @ . @ . . . @ @ . . . . . @ . . . . . @ . . . @ @ . @ . . . . . @ . @ . . . . . @ . . . . @ . . . @
@ . . . . @ . @ . . . . @ . . . . . @ . . . . . . . . . . . . . . . @ . . @ . @ . . . . . . . . @ . . . . . . . . . . . . . @ . . . @ . @ . @ . . . . . . @ . . . . . . @ . @ . . . . . . . . . . . . @
@ . . . . . @ . . . . . . . @ . . @ . @ . . . @ @ . @ . . . . . . . . . . @ . . . . . . . @ . @ . . . @ . . . . . . . . . . . . @ . @ . . . . . . . . . . . @ . . @ @ . . . . . . @ @ . . . . @ . . . @
@ . . . @ . . . . @ . . . . . . . . . . . . . . . . . . . . . . @ . . @ . . @ . . . . . . @ @ . . . . . . @ . . @ . . . @ . . . . @ . @ . . @ @ . @ . . @ . @ . . . . . . . @ . @ . . . . . @ . . @ . @
@ . . . @ . . . . . . . . . . @ @ . . @ . . . . . . . . @ . . . . @ . . . . . @ . @ . . . . . . . . . . . . . . . . . . . . . . @ . . . . . . . . . . @ . . . . . . . @ . @ . . . . @ . @ . . . . . . @
@ . . . @ . . . . @ . . . . . . . . . @ . . . . @ . . @ . . . . . . . . . . . . . . . . . . . @ . . . . . . @ @ . . @ @ . . @ . . @ @ . . . . . . . . . . . . . . . . . . . . @ . . @ . . @ . @ . @ . @
@ . @ . . . . . . . . . . . . @ . . . . . @ . . . . @ . . @ @ . . . . . . . . . . . . . . . . . . . . . . . . . . . @ . . . @ . . . . @ . . . . . @ . . . . . . . @ . . . . . . . @ . . . . . @ . @ . @
@ . . @ . @ . . @ . @ @ . . . . . . @ . @ . @ @ . @ . @ . . . @ . . @ . . . . @ . . . . . . @ . . . . . . . . . . . @ . . . . . . . . . . @ . . . . . @ . @ . . . . . . . @ . . . . . . . . . . . . . @
@ . . . . . . . . . @ . . . . . . . . . . . . . . . @ . @ . . . . . . . . . . @ . . . @ . . . . . @ . @ . . @ . @ . . . . . @ . @ . . . @ . . . . . . . . . . @ @ . . . . . . . @ . . . . . . . . @ . @
@ . @ . . . . . . . . . . @ . @ . . @ . . @ @ . . . . . . . @ . . . . . . . . . . @ . . . @ . . . . . . . . . . . @ . . . @ . . . . @ . . . . . . . . @ . @ . @ @ @ . . @ . . . . . . . @ . @ . . . . @
@ . @ . . . . . . . . . . . . . . . . @ . @ . . . . . . . . . . . . . . . . . . @ . . . . . . @ . . . . . . @ . . . . . . . . . . . @ . . . . . @ @ . @ . . . . . . . . . . . @ . @ . @ . . . @ . . . @
@ . . . . . . @ . @ @ . . @ . . . . @ . . . . . . . . . . @ . . . @ . . . . . . . . . . . @ . . . @ . @ . . . . @ . . . . . . @ @ . . . . . . . . . . @ . . . . . . . @ . . . . . . @ . . . . . . . . @
@ . . . . . . . @ . . @ . . @ @ @ . . . . . . . . . . . . . . . . @ @ . . . . . @ . . . . . . @ . . . . . . . . . . . . @ . . . . @ . . . . . @ . . . . @ @ . . . . . . . . @ . . . . . . @ . @ . . . @
@ @ . . . . . . . . . @ @ . . . . @ . . . . @ . . . @ . . . . . . . . . . . @ . . . . . . . . . . . @ . . . . . . @ . . @ . . . . @ . @ . . . . . . . @ . . . . . . . @ . . . . . . . . . . @ . . @ . @
@ . . @ . . . . @ . . . . . . @ . @ . . . . . @ @ . . . . . . . @ . . . . . . . . . . @ . @ @ . . . . . . . @ . . . . . @ . . @ @ . . . . . . . . . @ . @ . @ . . @ . . . @ . . . . . . . . . @ . . . @
@ . . . . . . . . . . @ . . . . . . . . . . . . . . . . . . . . . . . . . . . . . . . @ . . . . . . . . . . . @ . . . . . . . . . . . . @ . . @ . . . . . . . . . @ . @ . . @ . . . . . @ . . . @ . . @
@ @ . @ . . . . . . @ . . . . . @ . . . . . . . . . . . . @ . @ . . @ . . @ . . @ . . @ . . . @ . . . . . . @ . . . @ . . . @ . . . @ . . @ @ . . . @ . . . . . . . . . @ . . . . @ . . . . . . . . . @
@ . . . . . . @ . . @ . . . . . . . . . . . . . . . @ . . @ @ . @ . . . . . . . @ . . . . . . . . @ . @ . . . . . . . . . @ . . . . . @ . . . . @ . . . . . . . . . @ . . . . @ . @ . @ . . . . . . . @
@ . @ . . . . . . . . . . . . . . . . . . . . . . . . . . . . . . . @ . . . . . . @ . @ . . . . . . . . . . . @ . @ . . @ . . . . . . . . . . . @ . . @ @ . . . . . @ . . . @ . . . . . . . @ . . . . @
@ @ . . @ . . . . . @ . . @ . . . . . . . . . . . @ . . @ @ . . @ @ . @ . @ . . . . @ . . . . . . . . . . @ . . . . . . . . @ . . . . . . . . . . . . . @ . . . . . . . . @ . . . @ . . . . @ . . . . @
@ . . . @ . @ . @ . . . . . . . . . . . @ . . @ . . . . @ @ . @ . . . . @ . . . @ . . . . . @ . @ . . . . . . . . . . . @ . . . . . . . . . . . . @ @ @ . . . . . . . . . . @ . . . @ . . . . @ . . . @
@ @ . . . @ . . @ . @ @ @ . @ . . @ @ @ . . . . . . @ . . . @ . . . . . . @ @ . . @ . . . @ . . . . . . @ . . . @ . . @ . . . . . . . . . . . . @ . . . . . @ . @ @ . . . . . . @ . . . . @ . @ . . . @
@ . @ . . . . . . . . . @ @ . . . . @ . . . . . . . @ . . @ . . . @ . @ . . . @ . . . . . . . @ . . . . . @ . . . . . . . . . . @ . . . @ . @ . . . . . . . . . . . . . . . . . . . @ @ @ . . . . . . @
@ . . @ . @ . . . . . . @ . @ . . . @ . . . . . @ . @ . @ . . @ . . . @ . @ . @ . . . . @ . . . . . . . . @ . @ . @ . . . @ . . @ . . . . . . . . . . @ . . . . . . . . . . . . . . . . . . . . . . . @
@ . . @ . . . . . . @ . . @ . . . . . @ . . @ . . @ . . . . . . @ . . @ @ . . . . . . . . . . . . . . . . . . @ . @ . . . @ @ . . @ . . . . . . . . @ . @ . . . . . . @ . . @ . @ . @ . . . . . . . . @
@ @ . . . . . . . . @ . @ . . . . . @ . . . . . . @ . . . . . @ . . . . @ @ . . . @ . . . . . . . . @ . @ @ . @ @ @ . . . . . . . @ . @ . . . . . . . @ . @ @ . . . . . . . . . . . . . . . . . . . @ @
@ . . . . . @ . . @ . . . . . . @ . @ . @ . . @ . @ . @ . @ . . . . . . . @ . @ . . . . . . . . . . . . . . . . @ . . . . . . . . . . @ . @ . . . @ . . . . . . . . . @ . . . . . . @ . . @ . . . . . @
@ . @ . . . @ @ . . . . . . . . . . . . . . . . . . . . @ . . . . . . @ . . . . . . . @ . . . . . @ . @ . . @ . . @ . . @ . @ . . . . . . . @ . . . . @ @ . . . . . . @ . . @ . . . . . . . . @ . . . @
@ . . . . . . . @ . . . . . . . @ . . @ . . . @ . . . . . @ . . . . . . . . @ . . . . @ @ . . . . . . @ . . . . . . . . . @ . . @ . . @ . . . @ . . . . @ . @ . @ . . . . . . . . . . . @ @ . . @ . . @
@ . @ . . . . . . . . @ @ . . @ . @ . . . . . . . . . . . . . @ . . . @ . . . . . . . . . . . . . . . . . . . @ . @ . . . . . . @ @ . . @ . . @ @ @ @ @ . . . . . . . . . . . . . . @ . . . . . . . . @
@ . . . . . . . . . . . . . . . . . . @ @ @ . . @ . . @ . . @ . @ . . . . . . . . @ . . . . . @ . . . . . . . . @ . . . @ @ . @ . . @ . . . . . . . . . . . . . . . . . . . . @ . @ . . . . . . . @ . @
@ @ @ @ . . . . @ . . . . . . . . . @ . . . . . . . @ @ . . . . @ @ . . . . . . . . . . @ . . . . . . . . . . . . . @ . . . . . @ . . @ . . . . . . . . . . . . @ . @ . . @ . . . . . . . . @ . @ . @ @
@ . . . @ . . . @ . . @ . . . . . @ @ . . . . . . . . . . . . @ . @ . @ . . . . . . . @ . . . @ . . . . . @ . . @ . . . . . . . . . . . . . @ @ . . . . . . . . @ . . @ @ . . . @ @ @ . . @ . . . . . @
@ . . . . . . . @ . . . . . . @ . . . . . . . . . . . . . . . . . . . . . . . . . . . . . . . . . . . . . . . . . . . . . . . . . . @ . . . @ . . . @ @ . . . . . . . . . . . . . . . . . . . . . @ . @
@ @ @ @ @ @ @ @ @ @ @ @ @ @ @ @ @ @ @ @ @ @ @ @ @ @ @ @ @ @ @ @ @ @ @ @ @ @ @ @ @ @ @ @ @ @ @ @ @ @ @ @ @ @ @ @ @ @ @ @ @ @ @ @ @ @ @ @ @ @ @ @ @ @ @ @ @ @ @ @ @ @ @ @ @ @ @ @ @ @ @ @ @ @ @ @ @ @ @ @
3
37 1 48 22
61 17 5 39
52 52 82 55
